id,date,Players_names,final_score,Total_Score,S1,S2,player_1,player_2,group_name,standardized_match,Total,Total P1,Total P2,Fora_1,Fora_2,first_set_total,second_set_total,third_set_total,fourth_set_total,fifth_set_total,first_set_fora,second_set_fora,third_set_fora,fourth_set_fora,fifth_set_fora,modified_fora,swapped_Total_score
20827526,2024-08-14 15:25:00,Diaryan Aleksandr - Papyan Karen,3:0,11:4 - 11:4 - 11:1 - 0:0 - 0:0,3,0,Diaryan Aleksandr,Papyan Karen,fiurst,Diaryan Aleksandr - Papyan Karen,42,33,9,-24,24,15,15,12,0,0,-7,-7,-10,0,0,-24,11:4 - 11:4 - 11:1 - 0:0 - 0:0
20827524,2024-08-14 15:00:00,Asatryan Murad - Gevorgyan Hayk,3:0,11:4 - 11:9 - 11:5 - 0:0 - 0:0,3,0,Asatryan Murad,Gevorgyan Hayk,fiurst,Asatryan Murad - Gevorgyan Hayk,51,33,18,-15,15,15,20,16,0,0,-7,-2,-6,0,0,-15,11:4 - 11:9 - 11:5 - 0:0 - 0:0
20827523,2024-08-14 14:45:00,Nikoghosyan Narek - Diaryan Aleksandr,3:2,11:4 - 7:11 - 9:11 - 11:9 - 11:13,2,3,Nikoghosyan Narek,Diaryan Aleksandr,fiurst,Diaryan Aleksandr - Nikoghosyan Narek,97,48,49,1,-1,15,18,20,20,24,7,-4,-2,2,-2,1,4:11 - 11:7 - 11:9 - 9:11 - 13:11
20827511,2024-08-14 14:30:00,Papyan Karen - Asatryan Murad,3:0,4:11 - 9:11 - 9:11 - 0:0 - 0:0,0,3,Papyan Karen,Asatryan Murad,fiurst,Asatryan Murad - Papyan Karen,55,33,22,-11,11,15,20,20,0,0,-7,-2,-2,0,0,-11,11:4 - 11:9 - 11:9 - 0:0 - 0:0
20827508,2024-08-14 14:15:00,Nikoghosyan Narek - Gevorgyan Hayk,0:3,12:10 - 11:6 - 11:5 - 0:0 - 0:0,3,0,Nikoghosyan Narek,Gevorgyan Hayk,fiurst,Gevorgyan Hayk - Nikoghosyan Narek,55,21,34,13,-13,22,17,16,0,0,2,5,6,0,0,13,10:12 - 6:11 - 5:11 - 0:0 - 0:0
20827507,2024-08-14 14:00:00,Diaryan Aleksandr - Asatryan Murad,0:3,11:7 - 11:3 - 12:10 - 0:0 - 0:0,3,0,Diaryan Aleksandr,Asatryan Murad,fiurst,Asatryan Murad - Diaryan Aleksandr,54,20,34,14,-14,18,14,22,0,0,4,8,2,0,0,14,7:11 - 3:11 - 10:12 - 0:0 - 0:0
20827506,2024-08-14 13:50:00,Papyan Karen - Nikoghosyan Narek,0:3,11:7 - 11:8 - 11:9 - 0:0 - 0:0,3,0,Papyan Karen,Nikoghosyan Narek,fiurst,Nikoghosyan Narek - Papyan Karen,57,24,33,9,-9,18,19,20,0,0,4,3,2,0,0,9,7:11 - 8:11 - 9:11 - 0:0 - 0:0
20827504,2024-08-14 13:40:00,Gevorgyan Hayk - Diaryan Aleksandr,3:0,7:11 - 4:11 - 9:11 - 0:0 - 0:0,0,3,Gevorgyan Hayk,Diaryan Aleksandr,fiurst,Diaryan Aleksandr - Gevorgyan Hayk,53,33,20,-13,13,18,15,20,0,0,-4,-7,-2,0,0,-13,11:7 - 11:4 - 11:9 - 0:0 - 0:0
20827503,2024-08-14 13:15:00,Asatryan Murad - Nikoghosyan Narek,3:0,11:8 - 12:10 - 11:4 - 0:0 - 0:0,3,0,Asatryan Murad,Nikoghosyan Narek,fiurst,Asatryan Murad - Nikoghosyan Narek,56,34,22,-12,12,19,22,15,0,0,-3,-2,-7,0,0,-12,11:8 - 12:10 - 11:4 - 0:0 - 0:0
20827501,2024-08-14 13:00:00,Gevorgyan Hayk - Papyan Karen,2:3,11:8 - 14:12 - 12:14 - 9:11 - 10:12,2,3,Gevorgyan Hayk,Papyan Karen,fiurst,Gevorgyan Hayk - Papyan Karen,113,56,57,1,-1,19,26,26,20,22,-3,-2,2,2,2,1,11:8 - 14:12 - 12:14 - 9:11 - 10:12
20827492,2024-08-14 12:20:00,Diaryan Aleksandr - Nikoghosyan Narek,2:3,11:8 - 10:12 - 8:11 - 11:8 - 7:11,2,3,Diaryan Aleksandr,Nikoghosyan Narek,fiurst,Diaryan Aleksandr - Nikoghosyan Narek,97,47,50,3,-3,19,22,19,19,18,-3,2,3,-3,4,3,11:8 - 10:12 - 8:11 - 11:8 - 7:11
20827484,2024-08-14 12:00:00,Gevorgyan Hayk - Asatryan Murad,3:0,3:11 - 4:11 - 8:11 - 0:0 - 0:0,0,3,Gevorgyan Hayk,Asatryan Murad,fiurst,Asatryan Murad - Gevorgyan Hayk,48,33,15,-18,18,14,15,19,0,0,-8,-7,-3,0,0,-18,11:3 - 11:4 - 11:8 - 0:0 - 0:0
20827475,2024-08-14 11:55:00,Papyan Karen - Diaryan Aleksandr,3:0,3:11 - 8:11 - 2:11 - 0:0 - 0:0,0,3,Papyan Karen,Diaryan Aleksandr,fiurst,Diaryan Aleksandr - Papyan Karen,46,33,13,-20,20,14,19,13,0,0,-8,-3,-9,0,0,-20,11:3 - 11:8 - 11:2 - 0:0 - 0:0
20827474,2024-08-14 11:30:00,Gevorgyan Hayk - Nikoghosyan Narek,1:3,12:10 - 8:11 - 6:11 - 7:11 - 0:0,1,3,Gevorgyan Hayk,Nikoghosyan Narek,fiurst,Gevorgyan Hayk - Nikoghosyan Narek,76,33,43,10,-10,22,19,17,18,0,-2,3,5,4,0,10,12:10 - 8:11 - 6:11 - 7:11 - 0:0
20827473,2024-08-14 11:15:00,Asatryan Murad - Papyan Karen,3:2,8:11 - 9:11 - 11:9 - 11:8 - 11:8,3,2,Asatryan Murad,Papyan Karen,fiurst,Asatryan Murad - Papyan Karen,97,50,47,-3,3,19,20,20,19,19,3,2,-2,-3,-3,-3,8:11 - 9:11 - 11:9 - 11:8 - 11:8
20827460,2024-08-14 11:00:00,Diaryan Aleksandr - Gevorgyan Hayk,3:0,11:4 - 11:4 - 11:5 - 0:0 - 0:0,3,0,Diaryan Aleksandr,Gevorgyan Hayk,fiurst,Diaryan Aleksandr - Gevorgyan Hayk,46,33,13,-20,20,15,15,16,0,0,-7,-7,-6,0,0,-20,11:4 - 11:4 - 11:5 - 0:0 - 0:0
20810210,2024-08-14 10:45:00,Nikoghosyan Narek - Papyan Karen,3:1,5:11 - 11:7 - 14:12 - 11:6 - 0:0,3,1,Nikoghosyan Narek,Papyan Karen,fiurst,Nikoghosyan Narek - Papyan Karen,77,41,36,-5,5,16,18,26,17,0,6,-4,-2,-5,0,-5,5:11 - 11:7 - 14:12 - 11:6 - 0:0
20810197,2024-08-14 10:30:00,Asatryan Murad - Diaryan Aleksandr,3:0,11:7 - 11:5 - 11:9 - 0:0 - 0:0,3,0,Asatryan Murad,Diaryan Aleksandr,fiurst,Asatryan Murad - Diaryan Aleksandr,54,33,21,-12,12,18,16,20,0,0,-4,-6,-2,0,0,-12,11:7 - 11:5 - 11:9 - 0:0 - 0:0
20810192,2024-08-14 10:15:00,Papyan Karen - Gevorgyan Hayk,0:3,11:4 - 11:5 - 11:9 - 0:0 - 0:0,3,0,Papyan Karen,Gevorgyan Hayk,fiurst,Gevorgyan Hayk - Papyan Karen,51,18,33,15,-15,15,16,20,0,0,7,6,2,0,0,15,4:11 - 5:11 - 9:11 - 0:0 - 0:0
20810189,2024-08-14 10:00:00,Nikoghosyan Narek - Asatryan Murad,3:0,7:11 - 9:11 - 9:11 - 0:0 - 0:0,0,3,Nikoghosyan Narek,Asatryan Murad,fiurst,Asatryan Murad - Nikoghosyan Narek,58,33,25,-8,8,18,20,20,0,0,-4,-2,-2,0,0,-8,11:7 - 11:9 - 11:9 - 0:0 - 0:0
20810245,2024-08-13 15:00:00,Gevorgyan Hayk - Nikoghosyan Narek,1:3,11:8 - 6:11 - 2:11 - 5:11 - 0:0,1,3,Gevorgyan Hayk,Nikoghosyan Narek,fiurst,Gevorgyan Hayk - Nikoghosyan Narek,65,24,41,17,-17,19,17,13,16,0,-3,5,9,6,0,17,11:8 - 6:11 - 2:11 - 5:11 - 0:0
20810243,2024-08-13 14:45:00,Diaryan Aleksandr - Nazaryan Mushegh,3:2,11:7 - 9:11 - 9:11 - 11:5 - 11:4,3,2,Diaryan Aleksandr,Nazaryan Mushegh,fiurst,Diaryan Aleksandr - Nazaryan Mushegh,89,51,38,-13,13,18,20,20,16,15,-4,2,2,-6,-7,-13,11:7 - 9:11 - 9:11 - 11:5 - 11:4
20810238,2024-08-13 14:15:00,Diaryan Aleksandr - Nikoghosyan Narek,2:3,11:5 - 7:11 - 7:11 - 11:8 - 3:11,2,3,Diaryan Aleksandr,Nikoghosyan Narek,fiurst,Diaryan Aleksandr - Nikoghosyan Narek,85,39,46,7,-7,16,18,18,19,14,-6,4,4,-3,8,7,11:5 - 7:11 - 7:11 - 11:8 - 3:11
20810224,2024-08-13 14:00:00,Nazaryan Mushegh - Gevorgyan Hayk,1:3,9:11 - 11:9 - 11:8 - 11:9 - 0:0,3,1,Nazaryan Mushegh,Gevorgyan Hayk,fiurst,Gevorgyan Hayk - Nazaryan Mushegh,79,37,42,5,-5,20,20,19,20,0,-2,2,3,2,0,5,11:9 - 9:11 - 8:11 - 9:11 - 0:0
20810220,2024-08-13 13:30:00,Nikoghosyan Narek - Nazaryan Mushegh,3:1,9:11 - 11:7 - 4:11 - 11:13 - 0:0,1,3,Nikoghosyan Narek,Nazaryan Mushegh,fiurst,Nazaryan Mushegh - Nikoghosyan Narek,77,42,35,-7,7,20,18,15,24,0,-2,4,-7,-2,0,-7,11:9 - 7:11 - 11:4 - 13:11 - 0:0
20810218,2024-08-13 13:15:00,Gevorgyan Hayk - Diaryan Aleksandr,2:3,7:11 - 11:8 - 11:7 - 7:11 - 11:9,3,2,Gevorgyan Hayk,Diaryan Aleksandr,fiurst,Diaryan Aleksandr - Gevorgyan Hayk,93,46,47,1,-1,18,19,18,18,20,-4,3,4,-4,2,1,11:7 - 8:11 - 7:11 - 11:7 - 9:11
20810213,2024-08-13 12:15:00,Nazaryan Mushegh - Diaryan Aleksandr,3:0,5:11 - 6:11 - 4:11 - 0:0 - 0:0,0,3,Nazaryan Mushegh,Diaryan Aleksandr,fiurst,Diaryan Aleksandr - Nazaryan Mushegh,48,33,15,-18,18,16,17,15,0,0,-6,-5,-7,0,0,-18,11:5 - 11:6 - 11:4 - 0:0 - 0:0
20810211,2024-08-13 12:00:00,Nikoghosyan Narek - Gevorgyan Hayk,0:3,11:6 - 11:4 - 11:7 - 0:0 - 0:0,3,0,Nikoghosyan Narek,Gevorgyan Hayk,fiurst,Gevorgyan Hayk - Nikoghosyan Narek,50,17,33,16,-16,17,15,18,0,0,5,7,4,0,0,16,6:11 - 4:11 - 7:11 - 0:0 - 0:0
20810209,2024-08-13 11:30:00,Nikoghosyan Narek - Diaryan Aleksandr,3:0,10:12 - 10:12 - 9:11 - 0:0 - 0:0,0,3,Nikoghosyan Narek,Diaryan Aleksandr,fiurst,Diaryan Aleksandr - Nikoghosyan Narek,64,35,29,-6,6,22,22,20,0,0,-2,-2,-2,0,0,-6,12:10 - 12:10 - 11:9 - 0:0 - 0:0
20810193,2024-08-13 11:00:00,Nazaryan Mushegh - Nikoghosyan Narek,3:0,11:6 - 14:12 - 11:6 - 0:0 - 0:0,3,0,Nazaryan Mushegh,Nikoghosyan Narek,fiurst,Nazaryan Mushegh - Nikoghosyan Narek,60,36,24,-12,12,17,26,17,0,0,-5,-2,-5,0,0,-12,11:6 - 14:12 - 11:6 - 0:0 - 0:0
20810190,2024-08-13 10:30:00,Gevorgyan Hayk - Nazaryan Mushegh,0:3,5:11 - 7:11 - 9:11 - 0:0 - 0:0,0,3,Gevorgyan Hayk,Nazaryan Mushegh,fiurst,Gevorgyan Hayk - Nazaryan Mushegh,54,21,33,12,-12,16,18,20,0,0,6,4,2,0,0,12,5:11 - 7:11 - 9:11 - 0:0 - 0:0
20810188,2024-08-13 10:00:00,Diaryan Aleksandr - Gevorgyan Hayk,3:0,11:7 - 11:3 - 11:7 - 0:0 - 0:0,3,0,Diaryan Aleksandr,Gevorgyan Hayk,fiurst,Diaryan Aleksandr - Gevorgyan Hayk,50,33,17,-16,16,18,14,18,0,0,-4,-8,-4,0,0,-16,11:7 - 11:3 - 11:7 - 0:0 - 0:0
20793259,2024-08-12 15:15:00,Papyan Karen - Gevorgyan Hayk,2:3,9:11 - 11:13 - 11:5 - 11:9 - 11:5,3,2,Papyan Karen,Gevorgyan Hayk,fiurst,Gevorgyan Hayk - Papyan Karen,96,43,53,10,-10,20,24,16,20,16,-2,-2,6,2,6,10,11:9 - 13:11 - 5:11 - 9:11 - 5:11
20793255,2024-08-12 15:00:00,Nikoghosyan Narek - Diaryan Aleksandr,3:1,12:10 - 9:11 - 3:11 - 3:11 - 0:0,1,3,Nikoghosyan Narek,Diaryan Aleksandr,fiurst,Diaryan Aleksandr - Nikoghosyan Narek,70,43,27,-16,16,22,20,14,14,0,2,-2,-8,-8,0,-16,10:12 - 11:9 - 11:3 - 11:3 - 0:0
20793253,2024-08-12 14:50:00,Nazaryan Mushegh - Papyan Karen,0:3,8:11 - 8:11 - 8:11 - 0:0 - 0:0,0,3,Nazaryan Mushegh,Papyan Karen,fiurst,Nazaryan Mushegh - Papyan Karen,57,24,33,9,-9,19,19,19,0,0,3,3,3,0,0,9,8:11 - 8:11 - 8:11 - 0:0 - 0:0
20793251,2024-08-12 14:30:00,Gevorgyan Hayk - Nikoghosyan Narek,1:3,5:11 - 4:11 - 11:6 - 7:11 - 0:0,1,3,Gevorgyan Hayk,Nikoghosyan Narek,fiurst,Gevorgyan Hayk - Nikoghosyan Narek,66,27,39,12,-12,16,15,17,18,0,6,7,-5,4,0,12,5:11 - 4:11 - 11:6 - 7:11 - 0:0
20793247,2024-08-12 14:20:00,Nazaryan Mushegh - Diaryan Aleksandr,3:1,8:11 - 11:7 - 9:11 - 3:11 - 0:0,1,3,Nazaryan Mushegh,Diaryan Aleksandr,fiurst,Diaryan Aleksandr - Nazaryan Mushegh,71,40,31,-9,9,19,18,20,14,0,-3,4,-2,-8,0,-9,11:8 - 7:11 - 11:9 - 11:3 - 0:0
20793242,2024-08-12 14:00:00,Papyan Karen - Nikoghosyan Narek,1:3,7:11 - 11:9 - 13:11 - 11:9 - 0:0,3,1,Papyan Karen,Nikoghosyan Narek,fiurst,Nikoghosyan Narek - Papyan Karen,82,40,42,2,-2,18,20,24,20,0,-4,2,2,2,0,2,11:7 - 9:11 - 11:13 - 9:11 - 0:0
20793239,2024-08-12 13:50:00,Gevorgyan Hayk - Nazaryan Mushegh,0:3,7:11 - 11:13 - 4:11 - 0:0 - 0:0,0,3,Gevorgyan Hayk,Nazaryan Mushegh,fiurst,Gevorgyan Hayk - Nazaryan Mushegh,57,22,35,13,-13,18,24,15,0,0,4,2,7,0,0,13,7:11 - 11:13 - 4:11 - 0:0 - 0:0
20793237,2024-08-12 13:30:00,Diaryan Aleksandr - Papyan Karen,3:1,11:13 - 11:7 - 11:3 - 11:9 - 0:0,3,1,Diaryan Aleksandr,Papyan Karen,fiurst,Diaryan Aleksandr - Papyan Karen,76,44,32,-12,12,24,18,14,20,0,2,-4,-8,-2,0,-12,11:13 - 11:7 - 11:3 - 11:9 - 0:0
20793236,2024-08-12 13:15:00,Nikoghosyan Narek - Nazaryan Mushegh,3:1,11:13 - 11:7 - 10:12 - 8:11 - 0:0,1,3,Nikoghosyan Narek,Nazaryan Mushegh,fiurst,Nazaryan Mushegh - Nikoghosyan Narek,83,43,40,-3,3,24,18,22,19,0,-2,4,-2,-3,0,-3,13:11 - 7:11 - 12:10 - 11:8 - 0:0
20793234,2024-08-12 13:00:00,Diaryan Aleksandr - Gevorgyan Hayk,3:0,11:2 - 11:8 - 11:5 - 0:0 - 0:0,3,0,Diaryan Aleksandr,Gevorgyan Hayk,fiurst,Diaryan Aleksandr - Gevorgyan Hayk,48,33,15,-18,18,13,19,16,0,0,-9,-3,-6,0,0,-18,11:2 - 11:8 - 11:5 - 0:0 - 0:0
20793233,2024-08-12 12:15:00,Papyan Karen - Nazaryan Mushegh,1:3,11:9 - 5:11 - 11:9 - 11:7 - 0:0,3,1,Papyan Karen,Nazaryan Mushegh,fiurst,Nazaryan Mushegh - Papyan Karen,74,36,38,2,-2,20,16,20,18,0,2,-6,2,4,0,2,9:11 - 11:5 - 9:11 - 7:11 - 0:0
20793095,2024-08-12 12:00:00,Diaryan Aleksandr - Nikoghosyan Narek,3:0,11:9 - 11:6 - 11:7 - 0:0 - 0:0,3,0,Diaryan Aleksandr,Nikoghosyan Narek,fiurst,Diaryan Aleksandr - Nikoghosyan Narek,55,33,22,-11,11,20,17,18,0,0,-2,-5,-4,0,0,-11,11:9 - 11:6 - 11:7 - 0:0 - 0:0
20793088,2024-08-12 11:45:00,Gevorgyan Hayk - Papyan Karen,0:3,4:11 - 8:11 - 8:11 - 0:0 - 0:0,0,3,Gevorgyan Hayk,Papyan Karen,fiurst,Gevorgyan Hayk - Papyan Karen,53,20,33,13,-13,15,19,19,0,0,7,3,3,0,0,13,4:11 - 8:11 - 8:11 - 0:0 - 0:0
20793076,2024-08-12 11:30:00,Diaryan Aleksandr - Nazaryan Mushegh,3:0,11:5 - 11:5 - 11:6 - 0:0 - 0:0,3,0,Diaryan Aleksandr,Nazaryan Mushegh,fiurst,Diaryan Aleksandr - Nazaryan Mushegh,49,33,16,-17,17,16,16,17,0,0,-6,-6,-5,0,0,-17,11:5 - 11:5 - 11:6 - 0:0 - 0:0
20793072,2024-08-12 11:15:00,Nikoghosyan Narek - Gevorgyan Hayk,0:3,11:6 - 11:5 - 11:6 - 0:0 - 0:0,3,0,Nikoghosyan Narek,Gevorgyan Hayk,fiurst,Gevorgyan Hayk - Nikoghosyan Narek,50,17,33,16,-16,17,16,17,0,0,5,6,5,0,0,16,6:11 - 5:11 - 6:11 - 0:0 - 0:0
20793069,2024-08-12 11:10:00,Papyan Karen - Diaryan Aleksandr,3:1,6:11 - 10:12 - 11:3 - 11:13 - 0:0,1,3,Papyan Karen,Diaryan Aleksandr,fiurst,Diaryan Aleksandr - Papyan Karen,77,39,38,-1,1,17,22,14,24,0,-5,-2,8,-2,0,-1,11:6 - 12:10 - 3:11 - 13:11 - 0:0
20793066,2024-08-12 10:45:00,Nazaryan Mushegh - Gevorgyan Hayk,0:3,11:7 - 11:8 - 11:7 - 0:0 - 0:0,3,0,Nazaryan Mushegh,Gevorgyan Hayk,fiurst,Gevorgyan Hayk - Nazaryan Mushegh,55,22,33,11,-11,18,19,18,0,0,4,3,4,0,0,11,7:11 - 8:11 - 7:11 - 0:0 - 0:0
20793057,2024-08-12 10:30:00,Nikoghosyan Narek - Papyan Karen,2:3,11:8 - 3:11 - 8:11 - 11:9 - 10:12,2,3,Nikoghosyan Narek,Papyan Karen,fiurst,Nikoghosyan Narek - Papyan Karen,94,43,51,8,-8,19,14,19,20,22,-3,8,3,-2,2,8,11:8 - 3:11 - 8:11 - 11:9 - 10:12
20793054,2024-08-12 10:15:00,Gevorgyan Hayk - Diaryan Aleksandr,3:1,11:9 - 6:11 - 6:11 - 9:11 - 0:0,1,3,Gevorgyan Hayk,Diaryan Aleksandr,fiurst,Diaryan Aleksandr - Gevorgyan Hayk,74,42,32,-10,10,20,17,17,20,0,2,-5,-5,-2,0,-10,9:11 - 11:6 - 11:6 - 11:9 - 0:0
20793052,2024-08-12 10:00:00,Nazaryan Mushegh - Nikoghosyan Narek,3:1,7:11 - 11:5 - 11:5 - 11:7 - 0:0,3,1,Nazaryan Mushegh,Nikoghosyan Narek,fiurst,Nazaryan Mushegh - Nikoghosyan Narek,68,40,28,-12,12,18,16,16,18,0,4,-6,-6,-4,0,-12,7:11 - 11:5 - 11:5 - 11:7 - 0:0
20774008,2024-08-11 15:25:00,Rafayelyan Edgar - Nikoghosyan Narek,0:3,12:10 - 11:5 - 12:10 - 0:0 - 0:0,3,0,Rafayelyan Edgar,Nikoghosyan Narek,fiurst,Nikoghosyan Narek - Rafayelyan Edgar,60,25,35,10,-10,22,16,22,0,0,2,6,2,0,0,10,10:12 - 5:11 - 10:12 - 0:0 - 0:0
20774002,2024-08-11 15:00:00,Asatryan Murad - Rafayelyan Edgar,3:2,7:11 - 11:4 - 11:5 - 3:11 - 11:6,3,2,Asatryan Murad,Rafayelyan Edgar,fiurst,Asatryan Murad - Rafayelyan Edgar,80,43,37,-6,6,18,15,16,14,17,4,-7,-6,8,-5,-6,7:11 - 11:4 - 11:5 - 3:11 - 11:6
20774004,2024-08-11 15:00:00,Nazaryan Mushegh - Papyan Karen,0:3,9:11 - 8:11 - 7:11 - 0:0 - 0:0,0,3,Nazaryan Mushegh,Papyan Karen,fiurst,Nazaryan Mushegh - Papyan Karen,57,24,33,9,-9,20,19,18,0,0,2,3,4,0,0,9,9:11 - 8:11 - 7:11 - 0:0 - 0:0
20773969,2024-08-11 14:30:00,Nikoghosyan Narek - Nazaryan Mushegh,0:3,11:8 - 11:7 - 11:9 - 0:0 - 0:0,3,0,Nikoghosyan Narek,Nazaryan Mushegh,fiurst,Nazaryan Mushegh - Nikoghosyan Narek,57,24,33,9,-9,19,18,20,0,0,3,4,2,0,0,9,8:11 - 7:11 - 9:11 - 0:0 - 0:0
20773924,2024-08-11 14:20:00,Asatryan Murad - Papyan Karen,3:2,13:11 - 11:9 - 8:11 - 8:11 - 11:9,3,2,Asatryan Murad,Papyan Karen,fiurst,Asatryan Murad - Papyan Karen,102,51,51,0,0,24,20,19,19,20,-2,-2,3,3,-2,0,13:11 - 11:9 - 8:11 - 8:11 - 11:9
20773921,2024-08-11 14:00:00,Rafayelyan Edgar - Nazaryan Mushegh,0:3,11:6 - 11:4 - 11:6 - 0:0 - 0:0,3,0,Rafayelyan Edgar,Nazaryan Mushegh,fiurst,Nazaryan Mushegh - Rafayelyan Edgar,49,16,33,17,-17,17,15,17,0,0,5,7,5,0,0,17,6:11 - 4:11 - 6:11 - 0:0 - 0:0
20773918,2024-08-11 13:45:00,Nikoghosyan Narek - Asatryan Murad,3:1,7:11 - 1:11 - 11:9 - 9:11 - 0:0,1,3,Nikoghosyan Narek,Asatryan Murad,fiurst,Asatryan Murad - Nikoghosyan Narek,70,42,28,-14,14,18,12,20,20,0,-4,-10,2,-2,0,-14,11:7 - 11:1 - 9:11 - 11:9 - 0:0
20773917,2024-08-11 13:40:00,Papyan Karen - Rafayelyan Edgar,3:0,12:10 - 11:7 - 11:9 - 0:0 - 0:0,3,0,Papyan Karen,Rafayelyan Edgar,fiurst,Papyan Karen - Rafayelyan Edgar,60,34,26,-8,8,22,18,20,0,0,-2,-4,-2,0,0,-8,12:10 - 11:7 - 11:9 - 0:0 - 0:0
20773908,2024-08-11 13:15:00,Nazaryan Mushegh - Asatryan Murad,3:0,3:11 - 3:11 - 8:11 - 0:0 - 0:0,0,3,Nazaryan Mushegh,Asatryan Murad,fiurst,Asatryan Murad - Nazaryan Mushegh,47,33,14,-19,19,14,14,19,0,0,-8,-8,-3,0,0,-19,11:3 - 11:3 - 11:8 - 0:0 - 0:0
20773890,2024-08-11 13:00:00,Papyan Karen - Nikoghosyan Narek,2:3,9:11 - 14:12 - 11:9 - 10:12 - 11:5,3,2,Papyan Karen,Nikoghosyan Narek,fiurst,Nikoghosyan Narek - Papyan Karen,104,49,55,6,-6,20,26,20,22,16,-2,2,2,-2,6,6,11:9 - 12:14 - 9:11 - 12:10 - 5:11
20773877,2024-08-11 12:15:00,Rafayelyan Edgar - Asatryan Murad,3:1,9:11 - 11:9 - 9:11 - 3:11 - 0:0,1,3,Rafayelyan Edgar,Asatryan Murad,fiurst,Asatryan Murad - Rafayelyan Edgar,74,42,32,-10,10,20,20,20,14,0,-2,2,-2,-8,0,-10,11:9 - 9:11 - 11:9 - 11:3 - 0:0
20773875,2024-08-11 12:00:00,Papyan Karen - Nazaryan Mushegh,3:2,12:14 - 11:7 - 9:11 - 17:15 - 4:11,2,3,Papyan Karen,Nazaryan Mushegh,fiurst,Nazaryan Mushegh - Papyan Karen,111,58,53,-5,5,26,18,20,32,15,-2,4,-2,2,-7,-5,14:12 - 7:11 - 11:9 - 15:17 - 11:4
20773872,2024-08-11 11:45:00,Nikoghosyan Narek - Rafayelyan Edgar,0:3,8:11 - 8:11 - 3:11 - 0:0 - 0:0,0,3,Nikoghosyan Narek,Rafayelyan Edgar,fiurst,Nikoghosyan Narek - Rafayelyan Edgar,52,19,33,14,-14,19,19,14,0,0,3,3,8,0,0,14,8:11 - 8:11 - 3:11 - 0:0 - 0:0
20773533,2024-08-11 11:30:00,Papyan Karen - Asatryan Murad,0:3,11:7 - 14:12 - 11:5 - 0:0 - 0:0,3,0,Papyan Karen,Asatryan Murad,fiurst,Asatryan Murad - Papyan Karen,60,24,36,12,-12,18,26,16,0,0,4,2,6,0,0,12,7:11 - 12:14 - 5:11 - 0:0 - 0:0
20773515,2024-08-11 11:15:00,Nazaryan Mushegh - Nikoghosyan Narek,0:3,5:11 - 6:11 - 6:11 - 0:0 - 0:0,0,3,Nazaryan Mushegh,Nikoghosyan Narek,fiurst,Nazaryan Mushegh - Nikoghosyan Narek,50,17,33,16,-16,16,17,17,0,0,6,5,5,0,0,16,5:11 - 6:11 - 6:11 - 0:0 - 0:0
20773508,2024-08-11 11:10:00,Rafayelyan Edgar - Papyan Karen,0:3,11:7 - 11:9 - 11:5 - 0:0 - 0:0,3,0,Rafayelyan Edgar,Papyan Karen,fiurst,Papyan Karen - Rafayelyan Edgar,54,21,33,12,-12,18,20,16,0,0,4,2,6,0,0,12,7:11 - 9:11 - 5:11 - 0:0 - 0:0
20773503,2024-08-11 10:45:00,Asatryan Murad - Nikoghosyan Narek,3:0,11:7 - 13:11 - 11:7 - 0:0 - 0:0,3,0,Asatryan Murad,Nikoghosyan Narek,fiurst,Asatryan Murad - Nikoghosyan Narek,60,35,25,-10,10,18,24,18,0,0,-4,-2,-4,0,0,-10,11:7 - 13:11 - 11:7 - 0:0 - 0:0
20773496,2024-08-11 10:30:00,Nazaryan Mushegh - Rafayelyan Edgar,2:3,11:6 - 11:8 - 11:13 - 8:11 - 5:11,2,3,Nazaryan Mushegh,Rafayelyan Edgar,fiurst,Nazaryan Mushegh - Rafayelyan Edgar,95,46,49,3,-3,17,19,24,19,16,-5,-3,2,3,6,3,11:6 - 11:8 - 11:13 - 8:11 - 5:11
20773484,2024-08-11 10:15:00,Nikoghosyan Narek - Papyan Karen,0:3,8:11 - 13:15 - 10:12 - 0:0 - 0:0,0,3,Nikoghosyan Narek,Papyan Karen,fiurst,Nikoghosyan Narek - Papyan Karen,69,31,38,7,-7,19,28,22,0,0,3,2,2,0,0,7,8:11 - 13:15 - 10:12 - 0:0 - 0:0
20773460,2024-08-11 10:05:00,Asatryan Murad - Nazaryan Mushegh,3:0,11:6 - 11:4 - 11:9 - 0:0 - 0:0,3,0,Asatryan Murad,Nazaryan Mushegh,fiurst,Asatryan Murad - Nazaryan Mushegh,52,33,19,-14,14,17,15,20,0,0,-5,-7,-2,0,0,-14,11:6 - 11:4 - 11:9 - 0:0 - 0:0
20750815,2024-08-10 15:15:00,Nazaryan Mushegh - Rafayelyan Edgar,2:3,11:6 - 4:11 - 7:11 - 11:8 - 3:11,2,3,Nazaryan Mushegh,Rafayelyan Edgar,fiurst,Nazaryan Mushegh - Rafayelyan Edgar,83,36,47,11,-11,17,15,18,19,14,-5,7,4,-3,8,11,11:6 - 4:11 - 7:11 - 11:8 - 3:11
20750814,2024-08-10 15:00:00,Asatryan Murad - Gevorgyan Hayk,3:0,11:5 - 11:8 - 11:7 - 0:0 - 0:0,3,0,Asatryan Murad,Gevorgyan Hayk,fiurst,Asatryan Murad - Gevorgyan Hayk,53,33,20,-13,13,16,19,18,0,0,-6,-3,-4,0,0,-13,11:5 - 11:8 - 11:7 - 0:0 - 0:0
20750813,2024-08-10 14:45:00,Diaryan Aleksandr - Nazaryan Mushegh,3:0,11:4 - 11:9 - 11:5 - 0:0 - 0:0,3,0,Diaryan Aleksandr,Nazaryan Mushegh,fiurst,Diaryan Aleksandr - Nazaryan Mushegh,51,33,18,-15,15,15,20,16,0,0,-7,-2,-6,0,0,-15,11:4 - 11:9 - 11:5 - 0:0 - 0:0
20750812,2024-08-10 14:30:00,Rafayelyan Edgar - Asatryan Murad,0:3,11:9 - 11:8 - 11:6 - 0:0 - 0:0,3,0,Rafayelyan Edgar,Asatryan Murad,fiurst,Asatryan Murad - Rafayelyan Edgar,56,23,33,10,-10,20,19,17,0,0,2,3,5,0,0,10,9:11 - 8:11 - 6:11 - 0:0 - 0:0
20750811,2024-08-10 14:20:00,Diaryan Aleksandr - Gevorgyan Hayk,3:0,11:7 - 11:7 - 12:10 - 0:0 - 0:0,3,0,Diaryan Aleksandr,Gevorgyan Hayk,fiurst,Diaryan Aleksandr - Gevorgyan Hayk,58,34,24,-10,10,18,18,22,0,0,-4,-4,-2,0,0,-10,11:7 - 11:7 - 12:10 - 0:0 - 0:0
20750810,2024-08-10 14:00:00,Nazaryan Mushegh - Asatryan Murad,3:0,6:11 - 4:11 - 8:11 - 0:0 - 0:0,0,3,Nazaryan Mushegh,Asatryan Murad,fiurst,Asatryan Murad - Nazaryan Mushegh,51,33,18,-15,15,17,15,19,0,0,-5,-7,-3,0,0,-15,11:6 - 11:4 - 11:8 - 0:0 - 0:0
20750808,2024-08-10 13:45:00,Rafayelyan Edgar - Diaryan Aleksandr,3:2,11:6 - 11:4 - 8:11 - 9:11 - 10:12,2,3,Rafayelyan Edgar,Diaryan Aleksandr,fiurst,Diaryan Aleksandr - Rafayelyan Edgar,93,44,49,5,-5,17,15,19,20,22,5,7,-3,-2,-2,5,6:11 - 4:11 - 11:8 - 11:9 - 12:10
20750806,2024-08-10 13:30:00,Gevorgyan Hayk - Nazaryan Mushegh,1:3,6:11 - 5:11 - 11:8 - 7:11 - 0:0,1,3,Gevorgyan Hayk,Nazaryan Mushegh,fiurst,Gevorgyan Hayk - Nazaryan Mushegh,70,29,41,12,-12,17,16,19,18,0,5,6,-3,4,0,12,6:11 - 5:11 - 11:8 - 7:11 - 0:0
20750792,2024-08-10 13:15:00,Asatryan Murad - Diaryan Aleksandr,3:1,9:11 - 11:7 - 11:9 - 11:8 - 0:0,3,1,Asatryan Murad,Diaryan Aleksandr,fiurst,Asatryan Murad - Diaryan Aleksandr,77,42,35,-7,7,20,18,20,19,0,2,-4,-2,-3,0,-7,9:11 - 11:7 - 11:9 - 11:8 - 0:0
20750789,2024-08-10 13:00:00,Gevorgyan Hayk - Rafayelyan Edgar,0:3,9:11 - 5:11 - 8:11 - 0:0 - 0:0,0,3,Gevorgyan Hayk,Rafayelyan Edgar,fiurst,Gevorgyan Hayk - Rafayelyan Edgar,55,22,33,11,-11,20,16,19,0,0,2,6,3,0,0,11,9:11 - 5:11 - 8:11 - 0:0 - 0:0
20750785,2024-08-10 12:15:00,Nazaryan Mushegh - Diaryan Aleksandr,3:0,7:11 - 9:11 - 7:11 - 0:0 - 0:0,0,3,Nazaryan Mushegh,Diaryan Aleksandr,fiurst,Diaryan Aleksandr - Nazaryan Mushegh,56,33,23,-10,10,18,20,18,0,0,-4,-2,-4,0,0,-10,11:7 - 11:9 - 11:7 - 0:0 - 0:0
20750784,2024-08-10 12:00:00,Gevorgyan Hayk - Asatryan Murad,3:0,8:11 - 7:11 - 6:11 - 0:0 - 0:0,0,3,Gevorgyan Hayk,Asatryan Murad,fiurst,Asatryan Murad - Gevorgyan Hayk,54,33,21,-12,12,19,18,17,0,0,-3,-4,-5,0,0,-12,11:8 - 11:7 - 11:6 - 0:0 - 0:0
20750783,2024-08-10 11:55:00,Rafayelyan Edgar - Nazaryan Mushegh,0:3,12:10 - 11:4 - 11:4 - 0:0 - 0:0,3,0,Rafayelyan Edgar,Nazaryan Mushegh,fiurst,Nazaryan Mushegh - Rafayelyan Edgar,52,18,34,16,-16,22,15,15,0,0,2,7,7,0,0,16,10:12 - 4:11 - 4:11 - 0:0 - 0:0
20750782,2024-08-10 11:30:00,Gevorgyan Hayk - Diaryan Aleksandr,3:0,4:11 - 9:11 - 8:11 - 0:0 - 0:0,0,3,Gevorgyan Hayk,Diaryan Aleksandr,fiurst,Diaryan Aleksandr - Gevorgyan Hayk,54,33,21,-12,12,15,20,19,0,0,-7,-2,-3,0,0,-12,11:4 - 11:9 - 11:8 - 0:0 - 0:0
20750781,2024-08-10 11:20:00,Asatryan Murad - Rafayelyan Edgar,0:3,11:13 - 8:11 - 7:11 - 0:0 - 0:0,0,3,Asatryan Murad,Rafayelyan Edgar,fiurst,Asatryan Murad - Rafayelyan Edgar,61,26,35,9,-9,24,19,18,0,0,2,3,4,0,0,9,11:13 - 8:11 - 7:11 - 0:0 - 0:0
20750779,2024-08-10 11:00:00,Nazaryan Mushegh - Gevorgyan Hayk,1:3,9:11 - 11:7 - 11:4 - 11:5 - 0:0,3,1,Nazaryan Mushegh,Gevorgyan Hayk,fiurst,Gevorgyan Hayk - Nazaryan Mushegh,69,27,42,15,-15,20,18,15,16,0,-2,4,7,6,0,15,11:9 - 7:11 - 4:11 - 5:11 - 0:0
20750765,2024-08-10 10:45:00,Diaryan Aleksandr - Rafayelyan Edgar,0:3,12:14 - 9:11 - 2:11 - 0:0 - 0:0,0,3,Diaryan Aleksandr,Rafayelyan Edgar,fiurst,Diaryan Aleksandr - Rafayelyan Edgar,59,23,36,13,-13,26,20,13,0,0,2,2,9,0,0,13,12:14 - 9:11 - 2:11 - 0:0 - 0:0
20750763,2024-08-10 10:40:00,Asatryan Murad - Nazaryan Mushegh,3:0,11:6 - 11:4 - 11:6 - 0:0 - 0:0,3,0,Asatryan Murad,Nazaryan Mushegh,fiurst,Asatryan Murad - Nazaryan Mushegh,49,33,16,-17,17,17,15,17,0,0,-5,-7,-5,0,0,-17,11:6 - 11:4 - 11:6 - 0:0 - 0:0
20750751,2024-08-10 10:15:00,Rafayelyan Edgar - Gevorgyan Hayk,0:3,11:5 - 11:4 - 11:8 - 0:0 - 0:0,3,0,Rafayelyan Edgar,Gevorgyan Hayk,fiurst,Gevorgyan Hayk - Rafayelyan Edgar,50,17,33,16,-16,16,15,19,0,0,6,7,3,0,0,16,5:11 - 4:11 - 8:11 - 0:0 - 0:0
20750747,2024-08-10 10:00:00,Diaryan Aleksandr - Asatryan Murad,3:1,14:12 - 9:11 - 6:11 - 14:16 - 0:0,1,3,Diaryan Aleksandr,Asatryan Murad,fiurst,Asatryan Murad - Diaryan Aleksandr,93,50,43,-7,7,26,20,17,30,0,2,-2,-5,-2,0,-7,12:14 - 11:9 - 11:6 - 16:14 - 0:0
20739805,2024-08-09 15:15:00,Papyan Karen - Asatryan Murad,3:1,11:9 - 9:11 - 8:11 - 7:11 - 0:0,1,3,Papyan Karen,Asatryan Murad,fiurst,Asatryan Murad - Papyan Karen,77,42,35,-7,7,20,20,19,18,0,2,-2,-3,-4,0,-7,9:11 - 11:9 - 11:8 - 11:7 - 0:0
20752716,2024-08-09 15:00:00,Diaryan Aleksandr - Rafayelyan Edgar,1:3,11:9 - 6:11 - 7:11 - 9:11 - 0:0,1,3,Diaryan Aleksandr,Rafayelyan Edgar,fiurst,Diaryan Aleksandr - Rafayelyan Edgar,75,33,42,9,-9,20,17,18,20,0,-2,5,4,2,0,9,11:9 - 6:11 - 7:11 - 9:11 - 0:0
20739800,2024-08-09 14:45:00,Nikoghosyan Narek - Papyan Karen,0:3,7:11 - 9:11 - 7:11 - 0:0 - 0:0,0,3,Nikoghosyan Narek,Papyan Karen,fiurst,Nikoghosyan Narek - Papyan Karen,56,23,33,10,-10,18,20,18,0,0,4,2,4,0,0,10,7:11 - 9:11 - 7:11 - 0:0 - 0:0
20739799,2024-08-09 14:30:00,Asatryan Murad - Diaryan Aleksandr,3:0,11:5 - 11:7 - 11:2 - 0:0 - 0:0,3,0,Asatryan Murad,Diaryan Aleksandr,fiurst,Asatryan Murad - Diaryan Aleksandr,47,33,14,-19,19,16,18,13,0,0,-6,-4,-9,0,0,-19,11:5 - 11:7 - 11:2 - 0:0 - 0:0
20752703,2024-08-09 14:15:00,Nikoghosyan Narek - Rafayelyan Edgar,1:3,5:11 - 9:11 - 11:6 - 11:13 - 0:0,1,3,Nikoghosyan Narek,Rafayelyan Edgar,fiurst,Nikoghosyan Narek - Rafayelyan Edgar,77,36,41,5,-5,16,20,17,24,0,6,2,-5,2,0,5,5:11 - 9:11 - 11:6 - 11:13 - 0:0
20739797,2024-08-09 14:10:00,Papyan Karen - Diaryan Aleksandr,0:3,11:8 - 11:9 - 11:6 - 0:0 - 0:0,3,0,Papyan Karen,Diaryan Aleksandr,fiurst,Diaryan Aleksandr - Papyan Karen,56,23,33,10,-10,19,20,17,0,0,3,2,5,0,0,10,8:11 - 9:11 - 6:11 - 0:0 - 0:0
20739795,2024-08-09 13:45:00,Asatryan Murad - Nikoghosyan Narek,3:0,11:9 - 11:8 - 11:9 - 0:0 - 0:0,3,0,Asatryan Murad,Nikoghosyan Narek,fiurst,Asatryan Murad - Nikoghosyan Narek,59,33,26,-7,7,20,19,20,0,0,-2,-3,-2,0,0,-7,11:9 - 11:8 - 11:9 - 0:0 - 0:0
20752698,2024-08-09 13:30:00,Rafayelyan Edgar - Papyan Karen,2:3,11:7 - 14:16 - 11:5 - 6:11 - 11:9,3,2,Rafayelyan Edgar,Papyan Karen,fiurst,Papyan Karen - Rafayelyan Edgar,101,48,53,5,-5,18,30,16,17,20,4,-2,6,-5,2,5,7:11 - 16:14 - 5:11 - 11:6 - 9:11
20739793,2024-08-09 13:15:00,Diaryan Aleksandr - Nikoghosyan Narek,3:1,11:4 - 1:11 - 11:4 - 11:7 - 0:0,3,1,Diaryan Aleksandr,Nikoghosyan Narek,fiurst,Diaryan Aleksandr - Nikoghosyan Narek,60,34,26,-8,8,15,12,15,18,0,-7,10,-7,-4,0,-8,11:4 - 1:11 - 11:4 - 11:7 - 0:0
20752693,2024-08-09 13:00:00,Rafayelyan Edgar - Asatryan Murad,3:1,12:10 - 9:11 - 8:11 - 5:11 - 0:0,1,3,Rafayelyan Edgar,Asatryan Murad,fiurst,Asatryan Murad - Rafayelyan Edgar,77,43,34,-9,9,22,20,19,16,0,2,-2,-3,-6,0,-9,10:12 - 11:9 - 11:8 - 11:5 - 0:0
20739790,2024-08-09 12:25:00,Papyan Karen - Nikoghosyan Narek,3:1,4:11 - 2:11 - 11:5 - 8:11 - 0:0,1,3,Papyan Karen,Nikoghosyan Narek,fiurst,Nikoghosyan Narek - Papyan Karen,63,38,25,-13,13,15,13,16,19,0,-7,-9,6,-3,0,-13,11:4 - 11:2 - 5:11 - 11:8 - 0:0
20739789,2024-08-09 11:55:00,Nazaryan Mushegh - Diaryan Aleksandr,0:0,0:0 - 0:0 - 0:0 - 0:0 - 0:0,0,0,Nazaryan Mushegh,Diaryan Aleksandr,fiurst,Diaryan Aleksandr - Nazaryan Mushegh,0,0,0,0,0,0,0,0,0,0,0,0,0,0,0,0,0:0 - 0:0 - 0:0 - 0:0 - 0:0
20739788,2024-08-09 11:45:00,Asatryan Murad - Papyan Karen,2:3,12:10 - 11:13 - 8:11 - 11:5 - 6:11,2,3,Asatryan Murad,Papyan Karen,fiurst,Asatryan Murad - Papyan Karen,98,48,50,2,-2,22,24,19,16,17,-2,2,3,-6,5,2,12:10 - 11:13 - 8:11 - 11:5 - 6:11
20739786,2024-08-09 11:40:00,Nazaryan Mushegh - Nikoghosyan Narek,0:3,7:11 - 9:11 - 4:11 - 0:0 - 0:0,0,3,Nazaryan Mushegh,Nikoghosyan Narek,fiurst,Nazaryan Mushegh - Nikoghosyan Narek,53,20,33,13,-13,18,20,15,0,0,4,2,7,0,0,13,7:11 - 9:11 - 4:11 - 0:0 - 0:0
20739784,2024-08-09 11:15:00,Diaryan Aleksandr - Asatryan Murad,3:0,6:11 - 7:11 - 7:11 - 0:0 - 0:0,0,3,Diaryan Aleksandr,Asatryan Murad,fiurst,Asatryan Murad - Diaryan Aleksandr,53,33,20,-13,13,17,18,18,0,0,-5,-4,-4,0,0,-13,11:6 - 11:7 - 11:7 - 0:0 - 0:0
20739783,2024-08-09 11:10:00,Papyan Karen - Nazaryan Mushegh,1:3,11:5 - 12:14 - 11:6 - 11:6 - 0:0,3,1,Papyan Karen,Nazaryan Mushegh,fiurst,Nazaryan Mushegh - Papyan Karen,76,31,45,14,-14,16,26,17,17,0,6,-2,5,5,0,14,5:11 - 14:12 - 6:11 - 6:11 - 0:0
20739782,2024-08-09 10:45:00,Nikoghosyan Narek - Asatryan Murad,3:1,6:11 - 7:11 - 11:5 - 0:11 - 0:0,1,3,Nikoghosyan Narek,Asatryan Murad,fiurst,Asatryan Murad - Nikoghosyan Narek,62,38,24,-14,14,17,18,16,11,0,-5,-4,6,-11,0,-14,11:6 - 11:7 - 5:11 - 11:0 - 0:0
20739781,2024-08-09 10:30:00,Diaryan Aleksandr - Papyan Karen,2:3,10:12 - 11:8 - 13:11 - 9:11 - 7:11,2,3,Diaryan Aleksandr,Papyan Karen,fiurst,Diaryan Aleksandr - Papyan Karen,103,50,53,3,-3,22,19,24,20,18,2,-3,-2,2,4,3,10:12 - 11:8 - 13:11 - 9:11 - 7:11
20739780,2024-08-09 10:15:00,Asatryan Murad - Nazaryan Mushegh,3:0,11:4 - 11:7 - 11:6 - 0:0 - 0:0,3,0,Asatryan Murad,Nazaryan Mushegh,fiurst,Asatryan Murad - Nazaryan Mushegh,50,33,17,-16,16,15,18,17,0,0,-7,-4,-5,0,0,-16,11:4 - 11:7 - 11:6 - 0:0 - 0:0
20739779,2024-08-09 10:00:00,Nikoghosyan Narek - Diaryan Aleksandr,3:1,9:11 - 11:9 - 5:11 - 6:11 - 0:0,1,3,Nikoghosyan Narek,Diaryan Aleksandr,fiurst,Diaryan Aleksandr - Nikoghosyan Narek,73,42,31,-11,11,20,20,16,17,0,-2,2,-6,-5,0,-11,11:9 - 9:11 - 11:5 - 11:6 - 0:0
20731383,2024-08-08 15:15:00,Diaryan Aleksandr - Rafayelyan Edgar,0:3,10:12 - 6:11 - 7:11 - 0:0 - 0:0,0,3,Diaryan Aleksandr,Rafayelyan Edgar,fiurst,Diaryan Aleksandr - Rafayelyan Edgar,57,23,34,11,-11,22,17,18,0,0,2,5,4,0,0,11,10:12 - 6:11 - 7:11 - 0:0 - 0:0
20731381,2024-08-08 15:00:00,Nikoghosyan Narek - Gevorgyan Hayk,1:3,4:11 - 11:4 - 12:10 - 11:9 - 0:0,3,1,Nikoghosyan Narek,Gevorgyan Hayk,fiurst,Gevorgyan Hayk - Nikoghosyan Narek,72,34,38,4,-4,15,15,22,20,0,-7,7,2,2,0,4,11:4 - 4:11 - 10:12 - 9:11 - 0:0
20731375,2024-08-08 14:45:00,Papyan Karen - Diaryan Aleksandr,3:2,4:11 - 5:11 - 11:9 - 11:3 - 9:11,2,3,Papyan Karen,Diaryan Aleksandr,fiurst,Diaryan Aleksandr - Papyan Karen,85,45,40,-5,5,15,16,20,14,20,-7,-6,2,8,-2,-5,11:4 - 11:5 - 9:11 - 3:11 - 11:9
20731373,2024-08-08 14:30:00,Rafayelyan Edgar - Nikoghosyan Narek,1:3,11:5 - 9:11 - 11:6 - 11:7 - 0:0,3,1,Rafayelyan Edgar,Nikoghosyan Narek,fiurst,Nikoghosyan Narek - Rafayelyan Edgar,71,29,42,13,-13,16,20,17,18,0,6,-2,5,4,0,13,5:11 - 11:9 - 6:11 - 7:11 - 0:0
20731372,2024-08-08 14:15:00,Papyan Karen - Gevorgyan Hayk,0:3,11:5 - 11:7 - 12:10 - 0:0 - 0:0,3,0,Papyan Karen,Gevorgyan Hayk,fiurst,Gevorgyan Hayk - Papyan Karen,56,22,34,12,-12,16,18,22,0,0,6,4,2,0,0,12,5:11 - 7:11 - 10:12 - 0:0 - 0:0
20731370,2024-08-08 14:00:00,Diaryan Aleksandr - Nikoghosyan Narek,3:1,9:11 - 11:8 - 11:3 - 12:10 - 0:0,3,1,Diaryan Aleksandr,Nikoghosyan Narek,fiurst,Diaryan Aleksandr - Nikoghosyan Narek,75,43,32,-11,11,20,19,14,22,0,2,-3,-8,-2,0,-11,9:11 - 11:8 - 11:3 - 12:10 - 0:0
20731368,2024-08-08 13:45:00,Rafayelyan Edgar - Papyan Karen,0:3,11:5 - 11:7 - 12:10 - 0:0 - 0:0,3,0,Rafayelyan Edgar,Papyan Karen,fiurst,Papyan Karen - Rafayelyan Edgar,56,22,34,12,-12,16,18,22,0,0,6,4,2,0,0,12,5:11 - 7:11 - 10:12 - 0:0 - 0:0
20731366,2024-08-08 13:30:00,Gevorgyan Hayk - Diaryan Aleksandr,3:0,8:11 - 9:11 - 0:11 - 0:0 - 0:0,0,3,Gevorgyan Hayk,Diaryan Aleksandr,fiurst,Diaryan Aleksandr - Gevorgyan Hayk,50,33,17,-16,16,19,20,11,0,0,-3,-2,-11,0,0,-16,11:8 - 11:9 - 11:0 - 0:0 - 0:0
20731363,2024-08-08 13:15:00,Nikoghosyan Narek - Papyan Karen,1:3,6:11 - 9:11 - 11:8 - 7:11 - 0:0,1,3,Nikoghosyan Narek,Papyan Karen,fiurst,Nikoghosyan Narek - Papyan Karen,74,33,41,8,-8,17,20,19,18,0,5,2,-3,4,0,8,6:11 - 9:11 - 11:8 - 7:11 - 0:0
20731361,2024-08-08 13:00:00,Gevorgyan Hayk - Rafayelyan Edgar,0:3,7:11 - 12:14 - 7:11 - 0:0 - 0:0,0,3,Gevorgyan Hayk,Rafayelyan Edgar,fiurst,Gevorgyan Hayk - Rafayelyan Edgar,62,26,36,10,-10,18,26,18,0,0,4,2,4,0,0,10,7:11 - 12:14 - 7:11 - 0:0 - 0:0
20731359,2024-08-08 12:25:00,Diaryan Aleksandr - Papyan Karen,3:1,8:11 - 11:7 - 11:6 - 11:9 - 0:0,3,1,Diaryan Aleksandr,Papyan Karen,fiurst,Diaryan Aleksandr - Papyan Karen,74,41,33,-8,8,19,18,17,20,0,3,-4,-5,-2,0,-8,8:11 - 11:7 - 11:6 - 11:9 - 0:0
20731356,2024-08-08 12:00:00,Gevorgyan Hayk - Nikoghosyan Narek,3:0,11:6 - 12:10 - 11:8 - 0:0 - 0:0,3,0,Gevorgyan Hayk,Nikoghosyan Narek,fiurst,Gevorgyan Hayk - Nikoghosyan Narek,58,34,24,-10,10,17,22,19,0,0,-5,-2,-3,0,0,-10,11:6 - 12:10 - 11:8 - 0:0 - 0:0
20731353,2024-08-08 11:45:00,Rafayelyan Edgar - Diaryan Aleksandr,2:3,11:5 - 11:4 - 5:11 - 7:11 - 11:9,3,2,Rafayelyan Edgar,Diaryan Aleksandr,fiurst,Diaryan Aleksandr - Rafayelyan Edgar,85,40,45,5,-5,16,15,16,18,20,6,7,-6,-4,2,5,5:11 - 4:11 - 11:5 - 11:7 - 9:11
20731351,2024-08-08 11:30:00,Gevorgyan Hayk - Papyan Karen,0:3,6:11 - 8:11 - 7:11 - 0:0 - 0:0,0,3,Gevorgyan Hayk,Papyan Karen,fiurst,Gevorgyan Hayk - Papyan Karen,54,21,33,12,-12,17,19,18,0,0,5,3,4,0,0,12,6:11 - 8:11 - 7:11 - 0:0 - 0:0
20731350,2024-08-08 11:15:00,Nikoghosyan Narek - Rafayelyan Edgar,0:3,6:11 - 5:11 - 6:11 - 0:0 - 0:0,0,3,Nikoghosyan Narek,Rafayelyan Edgar,fiurst,Nikoghosyan Narek - Rafayelyan Edgar,50,17,33,16,-16,17,16,17,0,0,5,6,5,0,0,16,6:11 - 5:11 - 6:11 - 0:0 - 0:0
20731347,2024-08-08 11:00:00,Diaryan Aleksandr - Gevorgyan Hayk,3:0,20:18 - 11:9 - 11:5 - 0:0 - 0:0,3,0,Diaryan Aleksandr,Gevorgyan Hayk,fiurst,Diaryan Aleksandr - Gevorgyan Hayk,74,42,32,-10,10,38,20,16,0,0,-2,-2,-6,0,0,-10,20:18 - 11:9 - 11:5 - 0:0 - 0:0
20731344,2024-08-08 10:45:00,Papyan Karen - Rafayelyan Edgar,3:1,11:7 - 9:11 - 11:8 - 11:8 - 0:0,3,1,Papyan Karen,Rafayelyan Edgar,fiurst,Papyan Karen - Rafayelyan Edgar,76,42,34,-8,8,18,20,19,19,0,-4,2,-3,-3,0,-8,11:7 - 9:11 - 11:8 - 11:8 - 0:0
20731341,2024-08-08 10:30:00,Nikoghosyan Narek - Diaryan Aleksandr,3:0,6:11 - 4:11 - 5:11 - 0:0 - 0:0,0,3,Nikoghosyan Narek,Diaryan Aleksandr,fiurst,Diaryan Aleksandr - Nikoghosyan Narek,48,33,15,-18,18,17,15,16,0,0,-5,-7,-6,0,0,-18,11:6 - 11:4 - 11:5 - 0:0 - 0:0
20731337,2024-08-08 10:15:00,Rafayelyan Edgar - Gevorgyan Hayk,0:3,11:4 - 11:8 - 11:9 - 0:0 - 0:0,3,0,Rafayelyan Edgar,Gevorgyan Hayk,fiurst,Gevorgyan Hayk - Rafayelyan Edgar,54,21,33,12,-12,15,19,20,0,0,7,3,2,0,0,12,4:11 - 8:11 - 9:11 - 0:0 - 0:0
20731334,2024-08-08 10:00:00,Papyan Karen - Nikoghosyan Narek,1:3,11:3 - 11:13 - 11:4 - 11:5 - 0:0,3,1,Papyan Karen,Nikoghosyan Narek,fiurst,Nikoghosyan Narek - Papyan Karen,69,25,44,19,-19,14,24,15,16,0,8,-2,7,6,0,19,3:11 - 13:11 - 4:11 - 5:11 - 0:0
20722706,2024-08-07 15:15:00,Nikoghosyan Narek - Papyan Karen,0:3,11:13 - 8:11 - 3:11 - 0:0 - 0:0,0,3,Nikoghosyan Narek,Papyan Karen,fiurst,Nikoghosyan Narek - Papyan Karen,57,22,35,13,-13,24,19,14,0,0,2,3,8,0,0,13,11:13 - 8:11 - 3:11 - 0:0 - 0:0
20722700,2024-08-07 15:00:00,Rafayelyan Edgar - Asatryan Murad,3:0,9:11 - 7:11 - 9:11 - 0:0 - 0:0,0,3,Rafayelyan Edgar,Asatryan Murad,fiurst,Asatryan Murad - Rafayelyan Edgar,58,33,25,-8,8,20,18,20,0,0,-2,-4,-2,0,0,-8,11:9 - 11:7 - 11:9 - 0:0 - 0:0
20722698,2024-08-07 14:45:00,Gevorgyan Hayk - Nikoghosyan Narek,2:3,5:11 - 11:5 - 10:12 - 12:10 - 7:11,2,3,Gevorgyan Hayk,Nikoghosyan Narek,fiurst,Gevorgyan Hayk - Nikoghosyan Narek,94,45,49,4,-4,16,16,22,22,18,6,-6,2,-2,4,4,5:11 - 11:5 - 10:12 - 12:10 - 7:11
20722697,2024-08-07 14:30:00,Papyan Karen - Rafayelyan Edgar,1:3,6:11 - 11:4 - 10:12 - 9:11 - 0:0,1,3,Papyan Karen,Rafayelyan Edgar,fiurst,Papyan Karen - Rafayelyan Edgar,74,36,38,2,-2,17,15,22,20,0,5,-7,2,2,0,2,6:11 - 11:4 - 10:12 - 9:11 - 0:0
20722681,2024-08-07 14:15:00,Gevorgyan Hayk - Asatryan Murad,3:0,9:11 - 7:11 - 8:11 - 0:0 - 0:0,0,3,Gevorgyan Hayk,Asatryan Murad,fiurst,Asatryan Murad - Gevorgyan Hayk,57,33,24,-9,9,20,18,19,0,0,-2,-4,-3,0,0,-9,11:9 - 11:7 - 11:8 - 0:0 - 0:0
20722676,2024-08-07 14:00:00,Nikoghosyan Narek - Rafayelyan Edgar,2:3,11:5 - 11:5 - 10:12 - 11:13 - 4:11,2,3,Nikoghosyan Narek,Rafayelyan Edgar,fiurst,Nikoghosyan Narek - Rafayelyan Edgar,93,47,46,-1,1,16,16,22,24,15,-6,-6,2,2,7,-1,11:5 - 11:5 - 10:12 - 11:13 - 4:11
20722674,2024-08-07 13:45:00,Papyan Karen - Gevorgyan Hayk,3:0,7:11 - 7:11 - 6:11 - 0:0 - 0:0,0,3,Papyan Karen,Gevorgyan Hayk,fiurst,Gevorgyan Hayk - Papyan Karen,53,33,20,-13,13,18,18,17,0,0,-4,-4,-5,0,0,-13,11:7 - 11:7 - 11:6 - 0:0 - 0:0
20722672,2024-08-07 13:30:00,Asatryan Murad - Nikoghosyan Narek,3:0,11:3 - 11:9 - 11:3 - 0:0 - 0:0,3,0,Asatryan Murad,Nikoghosyan Narek,fiurst,Asatryan Murad - Nikoghosyan Narek,48,33,15,-18,18,14,20,14,0,0,-8,-2,-8,0,0,-18,11:3 - 11:9 - 11:3 - 0:0 - 0:0
20722671,2024-08-07 13:15:00,Rafayelyan Edgar - Gevorgyan Hayk,0:3,11:5 - 11:4 - 11:6 - 0:0 - 0:0,3,0,Rafayelyan Edgar,Gevorgyan Hayk,fiurst,Gevorgyan Hayk - Rafayelyan Edgar,48,15,33,18,-18,16,15,17,0,0,6,7,5,0,0,18,5:11 - 4:11 - 6:11 - 0:0 - 0:0
20722670,2024-08-07 13:00:00,Asatryan Murad - Papyan Karen,3:0,11:8 - 12:10 - 11:4 - 0:0 - 0:0,3,0,Asatryan Murad,Papyan Karen,fiurst,Asatryan Murad - Papyan Karen,56,34,22,-12,12,19,22,15,0,0,-3,-2,-7,0,0,-12,11:8 - 12:10 - 11:4 - 0:0 - 0:0
20722669,2024-08-07 12:20:00,Nikoghosyan Narek - Gevorgyan Hayk,0:3,11:4 - 11:4 - 11:5 - 0:0 - 0:0,3,0,Nikoghosyan Narek,Gevorgyan Hayk,fiurst,Gevorgyan Hayk - Nikoghosyan Narek,46,13,33,20,-20,15,15,16,0,0,7,7,6,0,0,20,4:11 - 4:11 - 5:11 - 0:0 - 0:0
20722445,2024-08-07 12:00:00,Asatryan Murad - Rafayelyan Edgar,3:1,19:17 - 11:2 - 8:11 - 11:9 - 0:0,3,1,Asatryan Murad,Rafayelyan Edgar,fiurst,Asatryan Murad - Rafayelyan Edgar,88,49,39,-10,10,36,13,19,20,0,-2,-9,3,-2,0,-10,19:17 - 11:2 - 8:11 - 11:9 - 0:0
20722442,2024-08-07 11:50:00,Papyan Karen - Nikoghosyan Narek,3:1,11:8 - 8:11 - 8:11 - 8:11 - 0:0,1,3,Papyan Karen,Nikoghosyan Narek,fiurst,Nikoghosyan Narek - Papyan Karen,76,41,35,-6,6,19,19,19,19,0,3,-3,-3,-3,0,-6,8:11 - 11:8 - 11:8 - 11:8 - 0:0
20722441,2024-08-07 11:30:00,Asatryan Murad - Gevorgyan Hayk,3:0,11:9 - 11:3 - 11:9 - 0:0 - 0:0,3,0,Asatryan Murad,Gevorgyan Hayk,fiurst,Asatryan Murad - Gevorgyan Hayk,54,33,21,-12,12,20,14,20,0,0,-2,-8,-2,0,0,-12,11:9 - 11:3 - 11:9 - 0:0 - 0:0
20722437,2024-08-07 11:20:00,Rafayelyan Edgar - Papyan Karen,0:3,11:8 - 11:9 - 11:2 - 0:0 - 0:0,3,0,Rafayelyan Edgar,Papyan Karen,fiurst,Papyan Karen - Rafayelyan Edgar,52,19,33,14,-14,19,20,13,0,0,3,2,9,0,0,14,8:11 - 9:11 - 2:11 - 0:0 - 0:0
20722432,2024-08-07 11:15:00,Nikoghosyan Narek - Asatryan Murad,3:0,7:11 - 6:11 - 2:11 - 0:0 - 0:0,0,3,Nikoghosyan Narek,Asatryan Murad,fiurst,Asatryan Murad - Nikoghosyan Narek,48,33,15,-18,18,18,17,13,0,0,-4,-5,-9,0,0,-18,11:7 - 11:6 - 11:2 - 0:0 - 0:0
20722422,2024-08-07 11:00:00,Gevorgyan Hayk - Papyan Karen,0:3,9:11 - 7:11 - 7:11 - 0:0 - 0:0,0,3,Gevorgyan Hayk,Papyan Karen,fiurst,Gevorgyan Hayk - Papyan Karen,56,23,33,10,-10,20,18,18,0,0,2,4,4,0,0,10,9:11 - 7:11 - 7:11 - 0:0 - 0:0
20722421,2024-08-07 10:55:00,Rafayelyan Edgar - Nikoghosyan Narek,0:3,11:7 - 11:7 - 11:6 - 0:0 - 0:0,3,0,Rafayelyan Edgar,Nikoghosyan Narek,fiurst,Nikoghosyan Narek - Rafayelyan Edgar,53,20,33,13,-13,18,18,17,0,0,4,4,5,0,0,13,7:11 - 7:11 - 6:11 - 0:0 - 0:0
20722414,2024-08-07 10:30:00,Gevorgyan Hayk - Rafayelyan Edgar,1:3,11:6 - 7:11 - 7:11 - 9:11 - 0:0,1,3,Gevorgyan Hayk,Rafayelyan Edgar,fiurst,Gevorgyan Hayk - Rafayelyan Edgar,73,34,39,5,-5,17,18,18,20,0,-5,4,4,2,0,5,11:6 - 7:11 - 7:11 - 9:11 - 0:0
20722420,2024-08-07 10:30:00,Papyan Karen - Asatryan Murad,3:0,4:11 - 8:11 - 9:11 - 0:0 - 0:0,0,3,Papyan Karen,Asatryan Murad,fiurst,Asatryan Murad - Papyan Karen,54,33,21,-12,12,15,19,20,0,0,-7,-3,-2,0,0,-12,11:4 - 11:8 - 11:9 - 0:0 - 0:0
20702215,2024-08-06 15:15:00,Papyan Karen - Diaryan Aleksandr,1:3,11:9 - 2:11 - 11:9 - 11:8 - 0:0,3,1,Papyan Karen,Diaryan Aleksandr,fiurst,Diaryan Aleksandr - Papyan Karen,72,37,35,-2,2,20,13,20,19,0,2,-9,2,3,0,-2,9:11 - 11:2 - 9:11 - 8:11 - 0:0
20702217,2024-08-06 15:15:00,Nazaryan Mushegh - Rafayelyan Edgar,0:3,5:11 - 6:11 - 5:11 - 0:0 - 0:0,0,3,Nazaryan Mushegh,Rafayelyan Edgar,fiurst,Nazaryan Mushegh - Rafayelyan Edgar,49,16,33,17,-17,16,17,16,0,0,6,5,6,0,0,17,5:11 - 6:11 - 5:11 - 0:0 - 0:0
20702214,2024-08-06 14:50:00,Asatryan Murad - Nazaryan Mushegh,3:0,11:6 - 11:6 - 11:4 - 0:0 - 0:0,3,0,Asatryan Murad,Nazaryan Mushegh,fiurst,Asatryan Murad - Nazaryan Mushegh,49,33,16,-17,17,17,17,15,0,0,-5,-5,-7,0,0,-17,11:6 - 11:6 - 11:4 - 0:0 - 0:0
20702212,2024-08-06 14:45:00,Rafayelyan Edgar - Papyan Karen,1:3,9:11 - 11:9 - 11:5 - 11:7 - 0:0,3,1,Rafayelyan Edgar,Papyan Karen,fiurst,Papyan Karen - Rafayelyan Edgar,74,32,42,10,-10,20,20,16,18,0,-2,2,6,4,0,10,11:9 - 9:11 - 5:11 - 7:11 - 0:0
20702211,2024-08-06 14:35:00,Asatryan Murad - Diaryan Aleksandr,1:3,11:5 - 3:11 - 3:11 - 7:11 - 0:0,1,3,Asatryan Murad,Diaryan Aleksandr,fiurst,Asatryan Murad - Diaryan Aleksandr,62,24,38,14,-14,16,14,14,18,0,-6,8,8,4,0,14,11:5 - 3:11 - 3:11 - 7:11 - 0:0
20702210,2024-08-06 14:15:00,Nazaryan Mushegh - Papyan Karen,3:1,11:8 - 11:8 - 10:12 - 11:6 - 0:0,3,1,Nazaryan Mushegh,Papyan Karen,fiurst,Nazaryan Mushegh - Papyan Karen,77,43,34,-9,9,19,19,22,17,0,-3,-3,2,-5,0,-9,11:8 - 11:8 - 10:12 - 11:6 - 0:0
20702209,2024-08-06 13:55:00,Rafayelyan Edgar - Asatryan Murad,1:3,11:9 - 6:11 - 11:6 - 12:10 - 0:0,3,1,Rafayelyan Edgar,Asatryan Murad,fiurst,Asatryan Murad - Rafayelyan Edgar,76,36,40,4,-4,20,17,17,22,0,2,-5,5,2,0,4,9:11 - 11:6 - 6:11 - 10:12 - 0:0
20702205,2024-08-06 13:30:00,Diaryan Aleksandr - Nazaryan Mushegh,3:2,7:11 - 11:8 - 10:12 - 11:6 - 16:14,3,2,Diaryan Aleksandr,Nazaryan Mushegh,fiurst,Diaryan Aleksandr - Nazaryan Mushegh,106,55,51,-4,4,18,19,22,17,30,4,-3,2,-5,-2,-4,7:11 - 11:8 - 10:12 - 11:6 - 16:14
20702203,2024-08-06 13:15:00,Papyan Karen - Asatryan Murad,2:3,11:8 - 8:11 - 5:11 - 11:5 - 11:7,3,2,Papyan Karen,Asatryan Murad,fiurst,Asatryan Murad - Papyan Karen,88,42,46,4,-4,19,19,16,16,18,3,-3,-6,6,4,4,8:11 - 11:8 - 11:5 - 5:11 - 7:11
20702202,2024-08-06 13:00:00,Diaryan Aleksandr - Rafayelyan Edgar,1:3,11:9 - 8:11 - 8:11 - 3:11 - 0:0,1,3,Diaryan Aleksandr,Rafayelyan Edgar,fiurst,Diaryan Aleksandr - Rafayelyan Edgar,72,30,42,12,-12,20,19,19,14,0,-2,3,3,8,0,12,11:9 - 8:11 - 8:11 - 3:11 - 0:0
20702192,2024-08-06 12:15:00,Nazaryan Mushegh - Asatryan Murad,3:0,11:13 - 3:11 - 6:11 - 0:0 - 0:0,0,3,Nazaryan Mushegh,Asatryan Murad,fiurst,Asatryan Murad - Nazaryan Mushegh,55,35,20,-15,15,24,14,17,0,0,-2,-8,-5,0,0,-15,13:11 - 11:3 - 11:6 - 0:0 - 0:0
20702182,2024-08-06 12:05:00,Diaryan Aleksandr - Papyan Karen,1:3,11:9 - 10:12 - 4:11 - 7:11 - 0:0,1,3,Diaryan Aleksandr,Papyan Karen,fiurst,Diaryan Aleksandr - Papyan Karen,75,32,43,11,-11,20,22,15,18,0,-2,2,7,4,0,11,11:9 - 10:12 - 4:11 - 7:11 - 0:0
20702180,2024-08-06 11:55:00,Rafayelyan Edgar - Nazaryan Mushegh,0:3,11:3 - 11:1 - 11:4 - 0:0 - 0:0,3,0,Rafayelyan Edgar,Nazaryan Mushegh,fiurst,Nazaryan Mushegh - Rafayelyan Edgar,41,8,33,25,-25,14,12,15,0,0,8,10,7,0,0,25,3:11 - 1:11 - 4:11 - 0:0 - 0:0
20702178,2024-08-06 11:30:00,Diaryan Aleksandr - Asatryan Murad,3:0,11:13 - 5:11 - 7:11 - 0:0 - 0:0,0,3,Diaryan Aleksandr,Asatryan Murad,fiurst,Asatryan Murad - Diaryan Aleksandr,58,35,23,-12,12,24,16,18,0,0,-2,-6,-4,0,0,-12,13:11 - 11:5 - 11:7 - 0:0 - 0:0
20702175,2024-08-06 11:25:00,Papyan Karen - Rafayelyan Edgar,3:2,13:11 - 11:6 - 8:11 - 10:12 - 11:8,3,2,Papyan Karen,Rafayelyan Edgar,fiurst,Papyan Karen - Rafayelyan Edgar,101,53,48,-5,5,24,17,19,22,19,-2,-5,3,2,-3,-5,13:11 - 11:6 - 8:11 - 10:12 - 11:8
20702174,2024-08-06 11:00:00,Nazaryan Mushegh - Diaryan Aleksandr,3:0,6:11 - 9:11 - 3:11 - 0:0 - 0:0,0,3,Nazaryan Mushegh,Diaryan Aleksandr,fiurst,Diaryan Aleksandr - Nazaryan Mushegh,51,33,18,-15,15,17,20,14,0,0,-5,-2,-8,0,0,-15,11:6 - 11:9 - 11:3 - 0:0 - 0:0
20702165,2024-08-06 10:45:00,Asatryan Murad - Rafayelyan Edgar,3:2,11:13 - 9:11 - 11:9 - 11:6 - 11:9,3,2,Asatryan Murad,Rafayelyan Edgar,fiurst,Asatryan Murad - Rafayelyan Edgar,101,53,48,-5,5,24,20,20,17,20,2,2,-2,-5,-2,-5,11:13 - 9:11 - 11:9 - 11:6 - 11:9
20702148,2024-08-06 10:35:00,Papyan Karen - Nazaryan Mushegh,3:2,11:7 - 8:11 - 11:13 - 11:5 - 6:11,2,3,Papyan Karen,Nazaryan Mushegh,fiurst,Nazaryan Mushegh - Papyan Karen,94,47,47,0,0,18,19,24,16,17,4,-3,-2,6,-5,0,7:11 - 11:8 - 13:11 - 5:11 - 11:6
20702143,2024-08-06 10:15:00,Rafayelyan Edgar - Diaryan Aleksandr,0:3,11:7 - 11:5 - 11:7 - 0:0 - 0:0,3,0,Rafayelyan Edgar,Diaryan Aleksandr,fiurst,Diaryan Aleksandr - Rafayelyan Edgar,52,19,33,14,-14,18,16,18,0,0,4,6,4,0,0,14,7:11 - 5:11 - 7:11 - 0:0 - 0:0
20702135,2024-08-06 10:00:00,Asatryan Murad - Papyan Karen,3:1,11:5 - 11:5 - 12:14 - 11:4 - 0:0,3,1,Asatryan Murad,Papyan Karen,fiurst,Asatryan Murad - Papyan Karen,73,45,28,-17,17,16,16,26,15,0,-6,-6,2,-7,0,-17,11:5 - 11:5 - 12:14 - 11:4 - 0:0
20678460,2024-08-05 15:15:00,Diaryan Aleksandr - Gevorgyan Hayk,3:0,11:6 - 13:11 - 11:8 - 0:0 - 0:0,3,0,Diaryan Aleksandr,Gevorgyan Hayk,fiurst,Diaryan Aleksandr - Gevorgyan Hayk,60,35,25,-10,10,17,24,19,0,0,-5,-2,-3,0,0,-10,11:6 - 13:11 - 11:8 - 0:0 - 0:0
20678459,2024-08-05 15:00:00,Papyan Karen - Nikoghosyan Narek,2:3,6:11 - 11:8 - 9:11 - 11:3 - 14:12,3,2,Papyan Karen,Nikoghosyan Narek,fiurst,Nikoghosyan Narek - Papyan Karen,96,45,51,6,-6,17,19,20,14,26,-5,3,-2,8,2,6,11:6 - 8:11 - 11:9 - 3:11 - 12:14
20678451,2024-08-05 14:50:00,Nazaryan Mushegh - Diaryan Aleksandr,3:1,11:9 - 2:11 - 4:11 - 9:11 - 0:0,1,3,Nazaryan Mushegh,Diaryan Aleksandr,fiurst,Diaryan Aleksandr - Nazaryan Mushegh,68,42,26,-16,16,20,13,15,20,0,2,-9,-7,-2,0,-16,9:11 - 11:2 - 11:4 - 11:9 - 0:0
20678446,2024-08-05 14:30:00,Gevorgyan Hayk - Papyan Karen,3:1,12:10 - 11:6 - 1:11 - 11:6 - 0:0,3,1,Gevorgyan Hayk,Papyan Karen,fiurst,Gevorgyan Hayk - Papyan Karen,68,35,33,-2,2,22,17,12,17,0,-2,-5,10,-5,0,-2,12:10 - 11:6 - 1:11 - 11:6 - 0:0
20678445,2024-08-05 14:15:00,Nazaryan Mushegh - Nikoghosyan Narek,3:0,11:9 - 11:8 - 13:11 - 0:0 - 0:0,3,0,Nazaryan Mushegh,Nikoghosyan Narek,fiurst,Nazaryan Mushegh - Nikoghosyan Narek,63,35,28,-7,7,20,19,24,0,0,-2,-3,-2,0,0,-7,11:9 - 11:8 - 13:11 - 0:0 - 0:0
20678441,2024-08-05 14:10:00,Diaryan Aleksandr - Papyan Karen,3:0,11:5 - 11:8 - 11:5 - 0:0 - 0:0,3,0,Diaryan Aleksandr,Papyan Karen,fiurst,Diaryan Aleksandr - Papyan Karen,51,33,18,-15,15,16,19,16,0,0,-6,-3,-6,0,0,-15,11:5 - 11:8 - 11:5 - 0:0 - 0:0
20678436,2024-08-05 13:50:00,Gevorgyan Hayk - Nazaryan Mushegh,1:3,7:11 - 7:11 - 11:7 - 9:11 - 0:0,1,3,Gevorgyan Hayk,Nazaryan Mushegh,fiurst,Gevorgyan Hayk - Nazaryan Mushegh,74,34,40,6,-6,18,18,18,20,0,4,4,-4,2,0,6,7:11 - 7:11 - 11:7 - 9:11 - 0:0
20678415,2024-08-05 13:30:00,Nikoghosyan Narek - Diaryan Aleksandr,3:2,11:6 - 2:11 - 15:13 - 3:11 - 6:11,2,3,Nikoghosyan Narek,Diaryan Aleksandr,fiurst,Diaryan Aleksandr - Nikoghosyan Narek,89,52,37,-15,15,17,13,28,14,17,5,-9,2,-8,-5,-15,6:11 - 11:2 - 13:15 - 11:3 - 11:6
20678414,2024-08-05 13:15:00,Papyan Karen - Nazaryan Mushegh,3:0,6:11 - 4:11 - 10:12 - 0:0 - 0:0,0,3,Papyan Karen,Nazaryan Mushegh,fiurst,Nazaryan Mushegh - Papyan Karen,54,34,20,-14,14,17,15,22,0,0,-5,-7,-2,0,0,-14,11:6 - 11:4 - 12:10 - 0:0 - 0:0
20678413,2024-08-05 13:00:00,Nikoghosyan Narek - Gevorgyan Hayk,3:0,4:11 - 11:13 - 13:15 - 0:0 - 0:0,0,3,Nikoghosyan Narek,Gevorgyan Hayk,fiurst,Gevorgyan Hayk - Nikoghosyan Narek,67,39,28,-11,11,15,24,28,0,0,-7,-2,-2,0,0,-11,11:4 - 13:11 - 15:13 - 0:0 - 0:0
20678412,2024-08-05 12:15:00,Diaryan Aleksandr - Nazaryan Mushegh,3:0,11:6 - 11:5 - 11:6 - 0:0 - 0:0,3,0,Diaryan Aleksandr,Nazaryan Mushegh,fiurst,Diaryan Aleksandr - Nazaryan Mushegh,50,33,17,-16,16,17,16,17,0,0,-5,-6,-5,0,0,-16,11:6 - 11:5 - 11:6 - 0:0 - 0:0
20678411,2024-08-05 12:00:00,Nikoghosyan Narek - Papyan Karen,3:2,9:11 - 11:13 - 11:8 - 11:8 - 11:8,3,2,Nikoghosyan Narek,Papyan Karen,fiurst,Nikoghosyan Narek - Papyan Karen,101,53,48,-5,5,20,24,19,19,19,2,2,-3,-3,-3,-5,9:11 - 11:13 - 11:8 - 11:8 - 11:8
20678410,2024-08-05 11:55:00,Gevorgyan Hayk - Diaryan Aleksandr,3:0,2:11 - 6:11 - 11:13 - 0:0 - 0:0,0,3,Gevorgyan Hayk,Diaryan Aleksandr,fiurst,Diaryan Aleksandr - Gevorgyan Hayk,54,35,19,-16,16,13,17,24,0,0,-9,-5,-2,0,0,-16,11:2 - 11:6 - 13:11 - 0:0 - 0:0
20678408,2024-08-05 11:35:00,Nikoghosyan Narek - Nazaryan Mushegh,0:3,11:6 - 11:7 - 11:8 - 0:0 - 0:0,3,0,Nikoghosyan Narek,Nazaryan Mushegh,fiurst,Nazaryan Mushegh - Nikoghosyan Narek,54,21,33,12,-12,17,18,19,0,0,5,4,3,0,0,12,6:11 - 7:11 - 8:11 - 0:0 - 0:0
20678015,2024-08-05 11:20:00,Papyan Karen - Gevorgyan Hayk,2:3,11:7 - 12:10 - 7:11 - 12:14 - 11:8,3,2,Papyan Karen,Gevorgyan Hayk,fiurst,Gevorgyan Hayk - Papyan Karen,103,50,53,3,-3,18,22,18,26,19,4,2,-4,-2,3,3,7:11 - 10:12 - 11:7 - 14:12 - 8:11
20678009,2024-08-05 11:05:00,Diaryan Aleksandr - Nikoghosyan Narek,3:1,11:8 - 11:8 - 3:11 - 11:7 - 0:0,3,1,Diaryan Aleksandr,Nikoghosyan Narek,fiurst,Diaryan Aleksandr - Nikoghosyan Narek,70,36,34,-2,2,19,19,14,18,0,-3,-3,8,-4,0,-2,11:8 - 11:8 - 3:11 - 11:7 - 0:0
20677993,2024-08-05 10:55:00,Nazaryan Mushegh - Gevorgyan Hayk,3:0,4:11 - 6:11 - 6:11 - 0:0 - 0:0,0,3,Nazaryan Mushegh,Gevorgyan Hayk,fiurst,Gevorgyan Hayk - Nazaryan Mushegh,49,33,16,-17,17,15,17,17,0,0,-7,-5,-5,0,0,-17,11:4 - 11:6 - 11:6 - 0:0 - 0:0
20677991,2024-08-05 10:30:00,Papyan Karen - Diaryan Aleksandr,3:1,7:11 - 4:11 - 11:9 - 5:11 - 0:0,1,3,Papyan Karen,Diaryan Aleksandr,fiurst,Diaryan Aleksandr - Papyan Karen,69,42,27,-15,15,18,15,20,16,0,-4,-7,2,-6,0,-15,11:7 - 11:4 - 9:11 - 11:5 - 0:0
20677989,2024-08-05 10:15:00,Gevorgyan Hayk - Nikoghosyan Narek,3:2,11:4 - 4:11 - 8:11 - 11:5 - 11:9,3,2,Gevorgyan Hayk,Nikoghosyan Narek,fiurst,Gevorgyan Hayk - Nikoghosyan Narek,85,45,40,-5,5,15,15,19,16,20,-7,7,3,-6,-2,-5,11:4 - 4:11 - 8:11 - 11:5 - 11:9
20677988,2024-08-05 10:00:00,Nazaryan Mushegh - Papyan Karen,0:3,9:11 - 2:11 - 11:13 - 0:0 - 0:0,0,3,Nazaryan Mushegh,Papyan Karen,fiurst,Nazaryan Mushegh - Papyan Karen,57,22,35,13,-13,20,13,24,0,0,2,9,2,0,0,13,9:11 - 2:11 - 11:13 - 0:0 - 0:0
20659128,2024-08-04 15:25:00,Nikoghosyan Narek - Asatryan Murad,3:0,13:15 - 8:11 - 8:11 - 0:0 - 0:0,0,3,Nikoghosyan Narek,Asatryan Murad,fiurst,Asatryan Murad - Nikoghosyan Narek,66,37,29,-8,8,28,19,19,0,0,-2,-3,-3,0,0,-8,15:13 - 11:8 - 11:8 - 0:0 - 0:0
20659126,2024-08-04 15:00:00,Gevorgyan Hayk - Nazaryan Mushegh,0:3,12:14 - 6:11 - 6:11 - 0:0 - 0:0,0,3,Gevorgyan Hayk,Nazaryan Mushegh,fiurst,Gevorgyan Hayk - Nazaryan Mushegh,60,24,36,12,-12,26,17,17,0,0,2,5,5,0,0,12,12:14 - 6:11 - 6:11 - 0:0 - 0:0
20659104,2024-08-04 14:55:00,Rafayelyan Edgar - Nikoghosyan Narek,2:3,5:11 - 11:6 - 11:8 - 2:11 - 11:9,3,2,Rafayelyan Edgar,Nikoghosyan Narek,fiurst,Nikoghosyan Narek - Rafayelyan Edgar,85,45,40,-5,5,16,17,19,13,20,-6,5,3,-9,2,-5,11:5 - 6:11 - 8:11 - 11:2 - 9:11
20659100,2024-08-04 14:30:00,Asatryan Murad - Gevorgyan Hayk,3:0,11:9 - 11:8 - 11:1 - 0:0 - 0:0,3,0,Asatryan Murad,Gevorgyan Hayk,fiurst,Asatryan Murad - Gevorgyan Hayk,51,33,18,-15,15,20,19,12,0,0,-2,-3,-10,0,0,-15,11:9 - 11:8 - 11:1 - 0:0 - 0:0
20659096,2024-08-04 14:20:00,Rafayelyan Edgar - Nazaryan Mushegh,2:3,9:11 - 9:11 - 13:11 - 11:4 - 11:5,3,2,Rafayelyan Edgar,Nazaryan Mushegh,fiurst,Nazaryan Mushegh - Rafayelyan Edgar,95,42,53,11,-11,20,20,24,15,16,-2,-2,2,7,6,11,11:9 - 11:9 - 11:13 - 4:11 - 5:11
20659095,2024-08-04 14:00:00,Nikoghosyan Narek - Gevorgyan Hayk,0:3,11:6 - 11:4 - 11:7 - 0:0 - 0:0,3,0,Nikoghosyan Narek,Gevorgyan Hayk,fiurst,Gevorgyan Hayk - Nikoghosyan Narek,50,17,33,16,-16,17,15,18,0,0,5,7,4,0,0,16,6:11 - 4:11 - 7:11 - 0:0 - 0:0
20659092,2024-08-04 13:45:00,Asatryan Murad - Rafayelyan Edgar,2:3,11:4 - 9:11 - 4:11 - 11:4 - 8:11,2,3,Asatryan Murad,Rafayelyan Edgar,fiurst,Asatryan Murad - Rafayelyan Edgar,84,43,41,-2,2,15,20,15,15,19,-7,2,7,-7,3,-2,11:4 - 9:11 - 4:11 - 11:4 - 8:11
20659089,2024-08-04 13:30:00,Nazaryan Mushegh - Nikoghosyan Narek,0:3,8:11 - 10:12 - 4:11 - 0:0 - 0:0,0,3,Nazaryan Mushegh,Nikoghosyan Narek,fiurst,Nazaryan Mushegh - Nikoghosyan Narek,56,22,34,12,-12,19,22,15,0,0,3,2,7,0,0,12,8:11 - 10:12 - 4:11 - 0:0 - 0:0
20659088,2024-08-04 13:15:00,Gevorgyan Hayk - Rafayelyan Edgar,0:3,2:11 - 4:11 - 10:12 - 0:0 - 0:0,0,3,Gevorgyan Hayk,Rafayelyan Edgar,fiurst,Gevorgyan Hayk - Rafayelyan Edgar,50,16,34,18,-18,13,15,22,0,0,9,7,2,0,0,18,2:11 - 4:11 - 10:12 - 0:0 - 0:0
20659087,2024-08-04 13:10:00,Nazaryan Mushegh - Asatryan Murad,3:0,6:11 - 5:11 - 3:11 - 0:0 - 0:0,0,3,Nazaryan Mushegh,Asatryan Murad,fiurst,Asatryan Murad - Nazaryan Mushegh,47,33,14,-19,19,17,16,14,0,0,-5,-6,-8,0,0,-19,11:6 - 11:5 - 11:3 - 0:0 - 0:0
20659086,2024-08-04 12:15:00,Nikoghosyan Narek - Rafayelyan Edgar,0:3,8:11 - 8:11 - 8:11 - 0:0 - 0:0,0,3,Nikoghosyan Narek,Rafayelyan Edgar,fiurst,Nikoghosyan Narek - Rafayelyan Edgar,57,24,33,9,-9,19,19,19,0,0,3,3,3,0,0,9,8:11 - 8:11 - 8:11 - 0:0 - 0:0
20659082,2024-08-04 12:00:00,Nazaryan Mushegh - Gevorgyan Hayk,1:3,11:7 - 9:11 - 11:3 - 11:8 - 0:0,3,1,Nazaryan Mushegh,Gevorgyan Hayk,fiurst,Gevorgyan Hayk - Nazaryan Mushegh,71,29,42,13,-13,18,20,14,19,0,4,-2,8,3,0,13,7:11 - 11:9 - 3:11 - 8:11 - 0:0
20659081,2024-08-04 11:45:00,Asatryan Murad - Nikoghosyan Narek,3:0,11:5 - 11:8 - 14:12 - 0:0 - 0:0,3,0,Asatryan Murad,Nikoghosyan Narek,fiurst,Asatryan Murad - Nikoghosyan Narek,61,36,25,-11,11,16,19,26,0,0,-6,-3,-2,0,0,-11,11:5 - 11:8 - 14:12 - 0:0 - 0:0
20659080,2024-08-04 11:30:00,Nazaryan Mushegh - Rafayelyan Edgar,1:3,5:11 - 11:7 - 8:11 - 5:11 - 0:0,1,3,Nazaryan Mushegh,Rafayelyan Edgar,fiurst,Nazaryan Mushegh - Rafayelyan Edgar,69,29,40,11,-11,16,18,19,16,0,6,-4,3,6,0,11,5:11 - 11:7 - 8:11 - 5:11 - 0:0
20659079,2024-08-04 11:25:00,Gevorgyan Hayk - Asatryan Murad,3:0,3:11 - 5:11 - 7:11 - 0:0 - 0:0,0,3,Gevorgyan Hayk,Asatryan Murad,fiurst,Asatryan Murad - Gevorgyan Hayk,48,33,15,-18,18,14,16,18,0,0,-8,-6,-4,0,0,-18,11:3 - 11:5 - 11:7 - 0:0 - 0:0
20659076,2024-08-04 11:00:00,Nikoghosyan Narek - Nazaryan Mushegh,0:3,11:6 - 11:8 - 11:5 - 0:0 - 0:0,3,0,Nikoghosyan Narek,Nazaryan Mushegh,fiurst,Nazaryan Mushegh - Nikoghosyan Narek,52,19,33,14,-14,17,19,16,0,0,5,3,6,0,0,14,6:11 - 8:11 - 5:11 - 0:0 - 0:0
20659071,2024-08-04 10:45:00,Rafayelyan Edgar - Asatryan Murad,2:3,6:11 - 11:8 - 11:6 - 2:11 - 11:8,3,2,Rafayelyan Edgar,Asatryan Murad,fiurst,Asatryan Murad - Rafayelyan Edgar,85,44,41,-3,3,17,19,17,13,19,-5,3,5,-9,3,-3,11:6 - 8:11 - 6:11 - 11:2 - 8:11
20659057,2024-08-04 10:30:00,Gevorgyan Hayk - Nikoghosyan Narek,0:3,10:12 - 7:11 - 6:11 - 0:0 - 0:0,0,3,Gevorgyan Hayk,Nikoghosyan Narek,fiurst,Gevorgyan Hayk - Nikoghosyan Narek,57,23,34,11,-11,22,18,17,0,0,2,4,5,0,0,11,10:12 - 7:11 - 6:11 - 0:0 - 0:0
20659055,2024-08-04 10:15:00,Asatryan Murad - Nazaryan Mushegh,3:0,11:5 - 11:7 - 11:6 - 0:0 - 0:0,3,0,Asatryan Murad,Nazaryan Mushegh,fiurst,Asatryan Murad - Nazaryan Mushegh,51,33,18,-15,15,16,18,17,0,0,-6,-4,-5,0,0,-15,11:5 - 11:7 - 11:6 - 0:0 - 0:0
20659054,2024-08-04 10:00:00,Rafayelyan Edgar - Gevorgyan Hayk,0:3,11:9 - 11:8 - 11:4 - 0:0 - 0:0,3,0,Rafayelyan Edgar,Gevorgyan Hayk,fiurst,Gevorgyan Hayk - Rafayelyan Edgar,54,21,33,12,-12,20,19,15,0,0,2,3,7,0,0,12,9:11 - 8:11 - 4:11 - 0:0 - 0:0
20639406,2024-08-03 15:00:00,Nikoghosyan Narek - Nazaryan Mushegh,3:2,11:8 - 8:11 - 6:11 - 11:4 - 8:11,2,3,Nikoghosyan Narek,Nazaryan Mushegh,fiurst,Nazaryan Mushegh - Nikoghosyan Narek,89,45,44,-1,1,19,19,17,15,19,3,-3,-5,7,-3,-1,8:11 - 11:8 - 11:6 - 4:11 - 11:8
20639404,2024-08-03 14:45:00,Diaryan Aleksandr - Rafayelyan Edgar,0:3,4:11 - 3:11 - 8:11 - 0:0 - 0:0,0,3,Diaryan Aleksandr,Rafayelyan Edgar,fiurst,Diaryan Aleksandr - Rafayelyan Edgar,48,15,33,18,-18,15,14,19,0,0,7,8,3,0,0,18,4:11 - 3:11 - 8:11 - 0:0 - 0:0
20639402,2024-08-03 14:15:00,Diaryan Aleksandr - Nazaryan Mushegh,3:0,11:6 - 11:7 - 11:5 - 0:0 - 0:0,3,0,Diaryan Aleksandr,Nazaryan Mushegh,fiurst,Diaryan Aleksandr - Nazaryan Mushegh,51,33,18,-15,15,17,18,16,0,0,-5,-4,-6,0,0,-15,11:6 - 11:7 - 11:5 - 0:0 - 0:0
20639384,2024-08-03 14:00:00,Rafayelyan Edgar - Nikoghosyan Narek,1:3,10:12 - 11:7 - 11:4 - 11:9 - 0:0,3,1,Rafayelyan Edgar,Nikoghosyan Narek,fiurst,Nikoghosyan Narek - Rafayelyan Edgar,75,32,43,11,-11,22,18,15,20,0,-2,4,7,2,0,11,12:10 - 7:11 - 4:11 - 9:11 - 0:0
20639373,2024-08-03 13:30:00,Nazaryan Mushegh - Rafayelyan Edgar,0:3,8:11 - 9:11 - 5:11 - 0:0 - 0:0,0,3,Nazaryan Mushegh,Rafayelyan Edgar,fiurst,Nazaryan Mushegh - Rafayelyan Edgar,55,22,33,11,-11,19,20,16,0,0,3,2,6,0,0,11,8:11 - 9:11 - 5:11 - 0:0 - 0:0
20639371,2024-08-03 13:15:00,Nikoghosyan Narek - Diaryan Aleksandr,3:2,11:4 - 13:11 - 11:13 - 9:11 - 4:11,2,3,Nikoghosyan Narek,Diaryan Aleksandr,fiurst,Diaryan Aleksandr - Nikoghosyan Narek,98,50,48,-2,2,15,24,24,20,15,7,2,-2,-2,-7,-2,4:11 - 11:13 - 13:11 - 11:9 - 11:4
20639308,2024-08-03 12:15:00,Rafayelyan Edgar - Diaryan Aleksandr,3:1,8:11 - 14:12 - 9:11 - 6:11 - 0:0,1,3,Rafayelyan Edgar,Diaryan Aleksandr,fiurst,Diaryan Aleksandr - Rafayelyan Edgar,82,45,37,-8,8,19,26,20,17,0,-3,2,-2,-5,0,-8,11:8 - 12:14 - 11:9 - 11:6 - 0:0
20639305,2024-08-03 12:00:00,Nazaryan Mushegh - Nikoghosyan Narek,2:3,11:9 - 6:11 - 11:5 - 6:11 - 7:11,2,3,Nazaryan Mushegh,Nikoghosyan Narek,fiurst,Nazaryan Mushegh - Nikoghosyan Narek,88,41,47,6,-6,20,17,16,17,18,-2,5,-6,5,4,6,11:9 - 6:11 - 11:5 - 6:11 - 7:11
20639298,2024-08-03 11:45:00,Gevorgyan Hayk - Rafayelyan Edgar,0:3,5:11 - 4:11 - 10:12 - 0:0 - 0:0,0,3,Gevorgyan Hayk,Rafayelyan Edgar,fiurst,Gevorgyan Hayk - Rafayelyan Edgar,53,19,34,15,-15,16,15,22,0,0,6,7,2,0,0,15,5:11 - 4:11 - 10:12 - 0:0 - 0:0
20639296,2024-08-03 11:30:00,Nazaryan Mushegh - Diaryan Aleksandr,3:1,11:8 - 5:11 - 6:11 - 3:11 - 0:0,1,3,Nazaryan Mushegh,Diaryan Aleksandr,fiurst,Diaryan Aleksandr - Nazaryan Mushegh,66,41,25,-16,16,19,16,17,14,0,3,-6,-5,-8,0,-16,8:11 - 11:5 - 11:6 - 11:3 - 0:0
20639294,2024-08-03 11:15:00,Nikoghosyan Narek - Gevorgyan Hayk,0:3,11:8 - 11:4 - 11:3 - 0:0 - 0:0,3,0,Nikoghosyan Narek,Gevorgyan Hayk,fiurst,Gevorgyan Hayk - Nikoghosyan Narek,48,15,33,18,-18,19,15,14,0,0,3,7,8,0,0,18,8:11 - 4:11 - 3:11 - 0:0 - 0:0
20639292,2024-08-03 11:00:00,Rafayelyan Edgar - Nazaryan Mushegh,1:3,9:11 - 14:12 - 11:8 - 11:9 - 0:0,3,1,Rafayelyan Edgar,Nazaryan Mushegh,fiurst,Nazaryan Mushegh - Rafayelyan Edgar,85,40,45,5,-5,20,26,19,20,0,-2,2,3,2,0,5,11:9 - 12:14 - 8:11 - 9:11 - 0:0
20639291,2024-08-03 10:45:00,Diaryan Aleksandr - Gevorgyan Hayk,3:0,11:8 - 11:5 - 11:4 - 0:0 - 0:0,3,0,Diaryan Aleksandr,Gevorgyan Hayk,fiurst,Diaryan Aleksandr - Gevorgyan Hayk,50,33,17,-16,16,19,16,15,0,0,-3,-6,-7,0,0,-16,11:8 - 11:5 - 11:4 - 0:0 - 0:0
20639290,2024-08-03 10:30:00,Nikoghosyan Narek - Rafayelyan Edgar,1:3,11:9 - 5:11 - 2:11 - 3:11 - 0:0,1,3,Nikoghosyan Narek,Rafayelyan Edgar,fiurst,Nikoghosyan Narek - Rafayelyan Edgar,63,21,42,21,-21,20,16,13,14,0,-2,6,9,8,0,21,11:9 - 5:11 - 2:11 - 3:11 - 0:0
20639282,2024-08-03 10:15:00,Gevorgyan Hayk - Nazaryan Mushegh,1:3,11:3 - 6:11 - 6:11 - 8:11 - 0:0,1,3,Gevorgyan Hayk,Nazaryan Mushegh,fiurst,Gevorgyan Hayk - Nazaryan Mushegh,67,31,36,5,-5,14,17,17,19,0,-8,5,5,3,0,5,11:3 - 6:11 - 6:11 - 8:11 - 0:0
20639269,2024-08-03 10:00:00,Diaryan Aleksandr - Nikoghosyan Narek,3:1,11:4 - 11:4 - 7:11 - 11:7 - 0:0,3,1,Diaryan Aleksandr,Nikoghosyan Narek,fiurst,Diaryan Aleksandr - Nikoghosyan Narek,66,40,26,-14,14,15,15,18,18,0,-7,-7,4,-4,0,-14,11:4 - 11:4 - 7:11 - 11:7 - 0:0
20624481,2024-08-02 15:15:00,Nikoghosyan Narek - Rafayelyan Edgar,0:3,6:11 - 7:11 - 8:11 - 0:0 - 0:0,0,3,Nikoghosyan Narek,Rafayelyan Edgar,fiurst,Nikoghosyan Narek - Rafayelyan Edgar,54,21,33,12,-12,17,18,19,0,0,5,4,3,0,0,12,6:11 - 7:11 - 8:11 - 0:0 - 0:0
20624479,2024-08-02 15:10:00,Asatryan Murad - Diaryan Aleksandr,3:0,12:10 - 11:7 - 12:10 - 0:0 - 0:0,3,0,Asatryan Murad,Diaryan Aleksandr,fiurst,Asatryan Murad - Diaryan Aleksandr,62,35,27,-8,8,22,18,22,0,0,-2,-4,-2,0,0,-8,12:10 - 11:7 - 12:10 - 0:0 - 0:0
20624477,2024-08-02 14:45:00,Papyan Karen - Nikoghosyan Narek,1:3,11:6 - 4:11 - 11:9 - 11:8 - 0:0,3,1,Papyan Karen,Nikoghosyan Narek,fiurst,Nikoghosyan Narek - Papyan Karen,71,34,37,3,-3,17,15,20,19,0,5,-7,2,3,0,3,6:11 - 11:4 - 9:11 - 8:11 - 0:0
20624475,2024-08-02 14:40:00,Rafayelyan Edgar - Asatryan Murad,3:0,4:11 - 17:19 - 6:11 - 0:0 - 0:0,0,3,Rafayelyan Edgar,Asatryan Murad,fiurst,Asatryan Murad - Rafayelyan Edgar,68,41,27,-14,14,15,36,17,0,0,-7,-2,-5,0,0,-14,11:4 - 19:17 - 11:6 - 0:0 - 0:0
20624473,2024-08-02 14:15:00,Papyan Karen - Diaryan Aleksandr,3:0,9:11 - 9:11 - 3:11 - 0:0 - 0:0,0,3,Papyan Karen,Diaryan Aleksandr,fiurst,Diaryan Aleksandr - Papyan Karen,54,33,21,-12,12,20,20,14,0,0,-2,-2,-8,0,0,-12,11:9 - 11:9 - 11:3 - 0:0 - 0:0
20624470,2024-08-02 14:10:00,Nikoghosyan Narek - Asatryan Murad,3:1,11:3 - 6:11 - 3:11 - 2:11 - 0:0,1,3,Nikoghosyan Narek,Asatryan Murad,fiurst,Asatryan Murad - Nikoghosyan Narek,58,36,22,-14,14,14,17,14,13,0,8,-5,-8,-9,0,-14,3:11 - 11:6 - 11:3 - 11:2 - 0:0
20624468,2024-08-02 13:45:00,Rafayelyan Edgar - Papyan Karen,3:0,9:11 - 8:11 - 9:11 - 0:0 - 0:0,0,3,Rafayelyan Edgar,Papyan Karen,fiurst,Papyan Karen - Rafayelyan Edgar,59,33,26,-7,7,20,19,20,0,0,-2,-3,-2,0,0,-7,11:9 - 11:8 - 11:9 - 0:0 - 0:0
20624463,2024-08-02 13:40:00,Diaryan Aleksandr - Nikoghosyan Narek,3:1,11:9 - 8:11 - 11:5 - 11:3 - 0:0,3,1,Diaryan Aleksandr,Nikoghosyan Narek,fiurst,Diaryan Aleksandr - Nikoghosyan Narek,69,41,28,-13,13,20,19,16,14,0,-2,3,-6,-8,0,-13,11:9 - 8:11 - 11:5 - 11:3 - 0:0
20624458,2024-08-02 13:15:00,Asatryan Murad - Papyan Karen,0:3,7:11 - 9:11 - 10:12 - 0:0 - 0:0,0,3,Asatryan Murad,Papyan Karen,fiurst,Asatryan Murad - Papyan Karen,60,26,34,8,-8,18,20,22,0,0,4,2,2,0,0,8,7:11 - 9:11 - 10:12 - 0:0 - 0:0
20624452,2024-08-02 13:00:00,Diaryan Aleksandr - Rafayelyan Edgar,3:1,11:5 - 11:13 - 11:6 - 13:11 - 0:0,3,1,Diaryan Aleksandr,Rafayelyan Edgar,fiurst,Diaryan Aleksandr - Rafayelyan Edgar,81,46,35,-11,11,16,24,17,24,0,-6,2,-5,-2,0,-11,11:5 - 11:13 - 11:6 - 13:11 - 0:0
20624449,2024-08-02 12:20:00,Nikoghosyan Narek - Papyan Karen,3:1,11:6 - 11:8 - 11:13 - 11:9 - 0:0,3,1,Nikoghosyan Narek,Papyan Karen,fiurst,Nikoghosyan Narek - Papyan Karen,80,44,36,-8,8,17,19,24,20,0,-5,-3,2,-2,0,-8,11:6 - 11:8 - 11:13 - 11:9 - 0:0
20624447,2024-08-02 12:10:00,Diaryan Aleksandr - Asatryan Murad,3:2,10:12 - 11:8 - 11:3 - 8:11 - 5:11,2,3,Diaryan Aleksandr,Asatryan Murad,fiurst,Asatryan Murad - Diaryan Aleksandr,90,45,45,0,0,22,19,14,19,16,-2,3,8,-3,-6,0,12:10 - 8:11 - 3:11 - 11:8 - 11:5
20624443,2024-08-02 11:55:00,Rafayelyan Edgar - Nikoghosyan Narek,1:3,11:7 - 3:11 - 12:10 - 11:6 - 0:0,3,1,Rafayelyan Edgar,Nikoghosyan Narek,fiurst,Nikoghosyan Narek - Rafayelyan Edgar,71,34,37,3,-3,18,14,22,17,0,4,-8,2,5,0,3,7:11 - 11:3 - 10:12 - 6:11 - 0:0
20624442,2024-08-02 11:40:00,Diaryan Aleksandr - Papyan Karen,0:3,9:11 - 5:11 - 8:11 - 0:0 - 0:0,0,3,Diaryan Aleksandr,Papyan Karen,fiurst,Diaryan Aleksandr - Papyan Karen,55,22,33,11,-11,20,16,19,0,0,2,6,3,0,0,11,9:11 - 5:11 - 8:11 - 0:0 - 0:0
20624437,2024-08-02 11:15:00,Asatryan Murad - Rafayelyan Edgar,1:3,12:10 - 8:11 - 11:13 - 11:13 - 0:0,1,3,Asatryan Murad,Rafayelyan Edgar,fiurst,Asatryan Murad - Rafayelyan Edgar,89,42,47,5,-5,22,19,24,24,0,-2,3,2,2,0,5,12:10 - 8:11 - 11:13 - 11:13 - 0:0
20624435,2024-08-02 11:05:00,Nikoghosyan Narek - Diaryan Aleksandr,3:1,9:11 - 15:13 - 7:11 - 6:11 - 0:0,1,3,Nikoghosyan Narek,Diaryan Aleksandr,fiurst,Diaryan Aleksandr - Nikoghosyan Narek,83,46,37,-9,9,20,28,18,17,0,-2,2,-4,-5,0,-9,11:9 - 13:15 - 11:7 - 11:6 - 0:0
20624433,2024-08-02 10:45:00,Papyan Karen - Rafayelyan Edgar,3:2,11:7 - 6:11 - 11:3 - 5:11 - 11:9,3,2,Papyan Karen,Rafayelyan Edgar,fiurst,Papyan Karen - Rafayelyan Edgar,85,44,41,-3,3,18,17,14,16,20,-4,5,-8,6,-2,-3,11:7 - 6:11 - 11:3 - 5:11 - 11:9
20624432,2024-08-02 10:35:00,Asatryan Murad - Nikoghosyan Narek,3:0,11:3 - 11:5 - 11:4 - 0:0 - 0:0,3,0,Asatryan Murad,Nikoghosyan Narek,fiurst,Asatryan Murad - Nikoghosyan Narek,45,33,12,-21,21,14,16,15,0,0,-8,-6,-7,0,0,-21,11:3 - 11:5 - 11:4 - 0:0 - 0:0
20624431,2024-08-02 10:15:00,Rafayelyan Edgar - Diaryan Aleksandr,3:0,12:14 - 8:11 - 9:11 - 0:0 - 0:0,0,3,Rafayelyan Edgar,Diaryan Aleksandr,fiurst,Diaryan Aleksandr - Rafayelyan Edgar,65,36,29,-7,7,26,19,20,0,0,-2,-3,-2,0,0,-7,14:12 - 11:8 - 11:9 - 0:0 - 0:0
20624430,2024-08-02 10:05:00,Papyan Karen - Asatryan Murad,3:1,7:11 - 11:13 - 11:9 - 6:11 - 0:0,1,3,Papyan Karen,Asatryan Murad,fiurst,Asatryan Murad - Papyan Karen,79,44,35,-9,9,18,24,20,17,0,-4,-2,2,-5,0,-9,11:7 - 13:11 - 9:11 - 11:6 - 0:0
20616878,2024-08-01 15:15:00,Nazaryan Mushegh - Asatryan Murad,3:0,9:11 - 6:11 - 5:11 - 0:0 - 0:0,0,3,Nazaryan Mushegh,Asatryan Murad,fiurst,Asatryan Murad - Nazaryan Mushegh,53,33,20,-13,13,20,17,16,0,0,-2,-5,-6,0,0,-13,11:9 - 11:6 - 11:5 - 0:0 - 0:0
20616876,2024-08-01 15:00:00,Papyan Karen - Diaryan Aleksandr,3:0,5:11 - 3:11 - 5:11 - 0:0 - 0:0,0,3,Papyan Karen,Diaryan Aleksandr,fiurst,Diaryan Aleksandr - Papyan Karen,46,33,13,-20,20,16,14,16,0,0,-6,-8,-6,0,0,-20,11:5 - 11:3 - 11:5 - 0:0 - 0:0
20616875,2024-08-01 14:45:00,Gevorgyan Hayk - Nazaryan Mushegh,1:3,13:15 - 9:11 - 15:13 - 8:11 - 0:0,1,3,Gevorgyan Hayk,Nazaryan Mushegh,fiurst,Gevorgyan Hayk - Nazaryan Mushegh,95,45,50,5,-5,28,20,28,19,0,2,2,-2,3,0,5,13:15 - 9:11 - 15:13 - 8:11 - 0:0
20616873,2024-08-01 14:30:00,Asatryan Murad - Papyan Karen,3:0,11:7 - 11:2 - 11:6 - 0:0 - 0:0,3,0,Asatryan Murad,Papyan Karen,fiurst,Asatryan Murad - Papyan Karen,48,33,15,-18,18,18,13,17,0,0,-4,-9,-5,0,0,-18,11:7 - 11:2 - 11:6 - 0:0 - 0:0
20616870,2024-08-01 14:15:00,Gevorgyan Hayk - Diaryan Aleksandr,3:0,2:11 - 6:11 - 3:11 - 0:0 - 0:0,0,3,Gevorgyan Hayk,Diaryan Aleksandr,fiurst,Diaryan Aleksandr - Gevorgyan Hayk,44,33,11,-22,22,13,17,14,0,0,-9,-5,-8,0,0,-22,11:2 - 11:6 - 11:3 - 0:0 - 0:0
20616868,2024-08-01 14:00:00,Nazaryan Mushegh - Papyan Karen,3:0,11:7 - 11:6 - 11:4 - 0:0 - 0:0,3,0,Nazaryan Mushegh,Papyan Karen,fiurst,Nazaryan Mushegh - Papyan Karen,50,33,17,-16,16,18,17,15,0,0,-4,-5,-7,0,0,-16,11:7 - 11:6 - 11:4 - 0:0 - 0:0
20616867,2024-08-01 13:45:00,Asatryan Murad - Gevorgyan Hayk,3:0,11:2 - 11:6 - 11:3 - 0:0 - 0:0,3,0,Asatryan Murad,Gevorgyan Hayk,fiurst,Asatryan Murad - Gevorgyan Hayk,44,33,11,-22,22,13,17,14,0,0,-9,-5,-8,0,0,-22,11:2 - 11:6 - 11:3 - 0:0 - 0:0
20616862,2024-08-01 13:30:00,Diaryan Aleksandr - Nazaryan Mushegh,3:0,11:4 - 11:9 - 11:3 - 0:0 - 0:0,3,0,Diaryan Aleksandr,Nazaryan Mushegh,fiurst,Diaryan Aleksandr - Nazaryan Mushegh,49,33,16,-17,17,15,20,14,0,0,-7,-2,-8,0,0,-17,11:4 - 11:9 - 11:3 - 0:0 - 0:0
20616860,2024-08-01 13:15:00,Papyan Karen - Gevorgyan Hayk,3:1,4:11 - 11:7 - 5:11 - 3:11 - 0:0,1,3,Papyan Karen,Gevorgyan Hayk,fiurst,Gevorgyan Hayk - Papyan Karen,63,40,23,-17,17,15,18,16,14,0,-7,4,-6,-8,0,-17,11:4 - 7:11 - 11:5 - 11:3 - 0:0
20616859,2024-08-01 13:00:00,Diaryan Aleksandr - Asatryan Murad,3:1,9:11 - 4:11 - 11:7 - 6:11 - 0:0,1,3,Diaryan Aleksandr,Asatryan Murad,fiurst,Asatryan Murad - Diaryan Aleksandr,70,40,30,-10,10,20,15,18,17,0,-2,-7,4,-5,0,-10,11:9 - 11:4 - 7:11 - 11:6 - 0:0
20616854,2024-08-01 12:15:00,Nazaryan Mushegh - Gevorgyan Hayk,3:0,5:11 - 5:11 - 7:11 - 0:0 - 0:0,0,3,Nazaryan Mushegh,Gevorgyan Hayk,fiurst,Gevorgyan Hayk - Nazaryan Mushegh,50,33,17,-16,16,16,16,18,0,0,-6,-6,-4,0,0,-16,11:5 - 11:5 - 11:7 - 0:0 - 0:0
20616851,2024-08-01 12:00:00,Diaryan Aleksandr - Papyan Karen,3:2,14:12 - 8:11 - 8:11 - 11:7 - 11:1,3,2,Diaryan Aleksandr,Papyan Karen,fiurst,Diaryan Aleksandr - Papyan Karen,94,52,42,-10,10,26,19,19,18,12,-2,3,3,-4,-10,-10,14:12 - 8:11 - 8:11 - 11:7 - 11:1
20616850,2024-08-01 11:45:00,Asatryan Murad - Nazaryan Mushegh,3:0,11:5 - 11:5 - 11:4 - 0:0 - 0:0,3,0,Asatryan Murad,Nazaryan Mushegh,fiurst,Asatryan Murad - Nazaryan Mushegh,47,33,14,-19,19,16,16,15,0,0,-6,-6,-7,0,0,-19,11:5 - 11:5 - 11:4 - 0:0 - 0:0
20616849,2024-08-01 11:30:00,Diaryan Aleksandr - Gevorgyan Hayk,3:0,12:10 - 11:9 - 11:4 - 0:0 - 0:0,3,0,Diaryan Aleksandr,Gevorgyan Hayk,fiurst,Diaryan Aleksandr - Gevorgyan Hayk,57,34,23,-11,11,22,20,15,0,0,-2,-2,-7,0,0,-11,12:10 - 11:9 - 11:4 - 0:0 - 0:0
20616846,2024-08-01 11:15:00,Papyan Karen - Asatryan Murad,3:0,6:11 - 8:11 - 6:11 - 0:0 - 0:0,0,3,Papyan Karen,Asatryan Murad,fiurst,Asatryan Murad - Papyan Karen,53,33,20,-13,13,17,19,17,0,0,-5,-3,-5,0,0,-13,11:6 - 11:8 - 11:6 - 0:0 - 0:0
20616844,2024-08-01 11:00:00,Nazaryan Mushegh - Diaryan Aleksandr,3:0,9:11 - 3:11 - 8:11 - 0:0 - 0:0,0,3,Nazaryan Mushegh,Diaryan Aleksandr,fiurst,Diaryan Aleksandr - Nazaryan Mushegh,53,33,20,-13,13,20,14,19,0,0,-2,-8,-3,0,0,-13,11:9 - 11:3 - 11:8 - 0:0 - 0:0
20616842,2024-08-01 10:55:00,Gevorgyan Hayk - Asatryan Murad,3:0,2:11 - 5:11 - 5:11 - 0:0 - 0:0,0,3,Gevorgyan Hayk,Asatryan Murad,fiurst,Asatryan Murad - Gevorgyan Hayk,45,33,12,-21,21,13,16,16,0,0,-9,-6,-6,0,0,-21,11:2 - 11:5 - 11:5 - 0:0 - 0:0
20616840,2024-08-01 10:30:00,Papyan Karen - Nazaryan Mushegh,1:3,9:11 - 11:9 - 11:9 - 11:7 - 0:0,3,1,Papyan Karen,Nazaryan Mushegh,fiurst,Nazaryan Mushegh - Papyan Karen,78,36,42,6,-6,20,20,20,18,0,-2,2,2,4,0,6,11:9 - 9:11 - 9:11 - 7:11 - 0:0
20616839,2024-08-01 10:15:00,Asatryan Murad - Diaryan Aleksandr,3:2,8:11 - 12:10 - 9:11 - 11:1 - 11:8,3,2,Asatryan Murad,Diaryan Aleksandr,fiurst,Asatryan Murad - Diaryan Aleksandr,92,51,41,-10,10,19,22,20,12,19,3,-2,2,-10,-3,-10,8:11 - 12:10 - 9:11 - 11:1 - 11:8
20616836,2024-08-01 10:00:00,Gevorgyan Hayk - Papyan Karen,1:3,11:13 - 11:3 - 7:11 - 9:11 - 0:0,1,3,Gevorgyan Hayk,Papyan Karen,fiurst,Gevorgyan Hayk - Papyan Karen,76,38,38,0,0,24,14,18,20,0,2,-8,4,2,0,0,11:13 - 11:3 - 7:11 - 9:11 - 0:0
20605135,2024-07-31 15:20:00,Papyan Karen - Gevorgyan Hayk,1:3,8:11 - 12:10 - 11:3 - 11:9 - 0:0,3,1,Papyan Karen,Gevorgyan Hayk,fiurst,Gevorgyan Hayk - Papyan Karen,75,33,42,9,-9,19,22,14,20,0,-3,2,8,2,0,9,11:8 - 10:12 - 3:11 - 9:11 - 0:0
20605130,2024-07-31 15:00:00,Nazaryan Mushegh - Rafayelyan Edgar,0:3,5:11 - 2:11 - 10:12 - 0:0 - 0:0,0,3,Nazaryan Mushegh,Rafayelyan Edgar,fiurst,Nazaryan Mushegh - Rafayelyan Edgar,51,17,34,17,-17,16,13,22,0,0,6,9,2,0,0,17,5:11 - 2:11 - 10:12 - 0:0 - 0:0
20605128,2024-07-31 14:45:00,Nikoghosyan Narek - Papyan Karen,2:3,11:8 - 13:15 - 11:13 - 11:2 - 13:15,2,3,Nikoghosyan Narek,Papyan Karen,fiurst,Nikoghosyan Narek - Papyan Karen,112,59,53,-6,6,19,28,24,13,28,-3,2,2,-9,2,-6,11:8 - 13:15 - 11:13 - 11:2 - 13:15
20605125,2024-07-31 14:35:00,Gevorgyan Hayk - Nazaryan Mushegh,3:1,11:6 - 9:11 - 11:5 - 11:7 - 0:0,3,1,Gevorgyan Hayk,Nazaryan Mushegh,fiurst,Gevorgyan Hayk - Nazaryan Mushegh,71,42,29,-13,13,17,20,16,18,0,-5,2,-6,-4,0,-13,11:6 - 9:11 - 11:5 - 11:7 - 0:0
20605086,2024-07-31 14:15:00,Nikoghosyan Narek - Rafayelyan Edgar,1:3,5:11 - 7:11 - 11:6 - 10:12 - 0:0,1,3,Nikoghosyan Narek,Rafayelyan Edgar,fiurst,Nikoghosyan Narek - Rafayelyan Edgar,73,33,40,7,-7,16,18,17,22,0,6,4,-5,2,0,7,5:11 - 7:11 - 11:6 - 10:12 - 0:0
20605079,2024-07-31 14:05:00,Papyan Karen - Nazaryan Mushegh,3:0,6:11 - 2:11 - 16:18 - 0:0 - 0:0,0,3,Papyan Karen,Nazaryan Mushegh,fiurst,Nazaryan Mushegh - Papyan Karen,64,40,24,-16,16,17,13,34,0,0,-5,-9,-2,0,0,-16,11:6 - 11:2 - 18:16 - 0:0 - 0:0
20605077,2024-07-31 13:55:00,Gevorgyan Hayk - Nikoghosyan Narek,0:3,5:11 - 7:11 - 4:11 - 0:0 - 0:0,0,3,Gevorgyan Hayk,Nikoghosyan Narek,fiurst,Gevorgyan Hayk - Nikoghosyan Narek,49,16,33,17,-17,16,18,15,0,0,6,4,7,0,0,17,5:11 - 7:11 - 4:11 - 0:0 - 0:0
20605076,2024-07-31 13:30:00,Rafayelyan Edgar - Papyan Karen,1:3,11:6 - 10:12 - 11:6 - 11:8 - 0:0,3,1,Rafayelyan Edgar,Papyan Karen,fiurst,Papyan Karen - Rafayelyan Edgar,75,32,43,11,-11,17,22,17,19,0,5,-2,5,3,0,11,6:11 - 12:10 - 6:11 - 8:11 - 0:0
20605074,2024-07-31 13:15:00,Nazaryan Mushegh - Nikoghosyan Narek,2:3,5:11 - 11:5 - 19:17 - 8:11 - 10:12,2,3,Nazaryan Mushegh,Nikoghosyan Narek,fiurst,Nazaryan Mushegh - Nikoghosyan Narek,109,53,56,3,-3,16,16,36,19,22,6,-6,-2,3,2,3,5:11 - 11:5 - 19:17 - 8:11 - 10:12
20605070,2024-07-31 13:00:00,Rafayelyan Edgar - Gevorgyan Hayk,0:3,11:7 - 11:7 - 11:6 - 0:0 - 0:0,3,0,Rafayelyan Edgar,Gevorgyan Hayk,fiurst,Gevorgyan Hayk - Rafayelyan Edgar,53,20,33,13,-13,18,18,17,0,0,4,4,5,0,0,13,7:11 - 7:11 - 6:11 - 0:0 - 0:0
20605069,2024-07-31 12:15:00,Papyan Karen - Nikoghosyan Narek,0:3,11:8 - 11:8 - 11:7 - 0:0 - 0:0,3,0,Papyan Karen,Nikoghosyan Narek,fiurst,Nikoghosyan Narek - Papyan Karen,56,23,33,10,-10,19,19,18,0,0,3,3,4,0,0,10,8:11 - 8:11 - 7:11 - 0:0 - 0:0
20605066,2024-07-31 12:00:00,Rafayelyan Edgar - Nazaryan Mushegh,0:3,15:13 - 11:6 - 11:7 - 0:0 - 0:0,3,0,Rafayelyan Edgar,Nazaryan Mushegh,fiurst,Nazaryan Mushegh - Rafayelyan Edgar,63,26,37,11,-11,28,17,18,0,0,2,5,4,0,0,11,13:15 - 6:11 - 7:11 - 0:0 - 0:0
20605057,2024-07-31 11:45:00,Gevorgyan Hayk - Papyan Karen,0:3,10:12 - 9:11 - 7:11 - 0:0 - 0:0,0,3,Gevorgyan Hayk,Papyan Karen,fiurst,Gevorgyan Hayk - Papyan Karen,60,26,34,8,-8,22,20,18,0,0,2,2,4,0,0,8,10:12 - 9:11 - 7:11 - 0:0 - 0:0
20605044,2024-07-31 11:40:00,Rafayelyan Edgar - Nikoghosyan Narek,0:3,11:5 - 11:8 - 11:6 - 0:0 - 0:0,3,0,Rafayelyan Edgar,Nikoghosyan Narek,fiurst,Nikoghosyan Narek - Rafayelyan Edgar,52,19,33,14,-14,16,19,17,0,0,6,3,5,0,0,14,5:11 - 8:11 - 6:11 - 0:0 - 0:0
20605041,2024-07-31 11:15:00,Nazaryan Mushegh - Gevorgyan Hayk,0:3,11:7 - 11:5 - 14:12 - 0:0 - 0:0,3,0,Nazaryan Mushegh,Gevorgyan Hayk,fiurst,Gevorgyan Hayk - Nazaryan Mushegh,60,24,36,12,-12,18,16,26,0,0,4,6,2,0,0,12,7:11 - 5:11 - 12:14 - 0:0 - 0:0
20605038,2024-07-31 11:10:00,Papyan Karen - Rafayelyan Edgar,2:3,5:11 - 11:7 - 9:11 - 14:12 - 4:11,2,3,Papyan Karen,Rafayelyan Edgar,fiurst,Papyan Karen - Rafayelyan Edgar,95,43,52,9,-9,16,18,20,26,15,6,-4,2,-2,7,9,5:11 - 11:7 - 9:11 - 14:12 - 4:11
20605036,2024-07-31 10:45:00,Nikoghosyan Narek - Gevorgyan Hayk,1:3,8:11 - 11:9 - 11:9 - 11:1 - 0:0,3,1,Nikoghosyan Narek,Gevorgyan Hayk,fiurst,Gevorgyan Hayk - Nikoghosyan Narek,71,30,41,11,-11,19,20,20,12,0,-3,2,2,10,0,11,11:8 - 9:11 - 9:11 - 1:11 - 0:0
20605033,2024-07-31 10:35:00,Nazaryan Mushegh - Papyan Karen,1:3,10:12 - 11:8 - 11:13 - 9:11 - 0:0,1,3,Nazaryan Mushegh,Papyan Karen,fiurst,Nazaryan Mushegh - Papyan Karen,85,41,44,3,-3,22,19,24,20,0,2,-3,2,2,0,3,10:12 - 11:8 - 11:13 - 9:11 - 0:0
20605030,2024-07-31 10:15:00,Gevorgyan Hayk - Rafayelyan Edgar,0:3,4:11 - 9:11 - 14:16 - 0:0 - 0:0,0,3,Gevorgyan Hayk,Rafayelyan Edgar,fiurst,Gevorgyan Hayk - Rafayelyan Edgar,65,27,38,11,-11,15,20,30,0,0,7,2,2,0,0,11,4:11 - 9:11 - 14:16 - 0:0 - 0:0
20605021,2024-07-31 10:10:00,Nikoghosyan Narek - Nazaryan Mushegh,2:3,11:9 - 6:11 - 7:11 - 11:6 - 11:7,3,2,Nikoghosyan Narek,Nazaryan Mushegh,fiurst,Nazaryan Mushegh - Nikoghosyan Narek,90,44,46,2,-2,20,17,18,17,18,2,-5,-4,5,4,2,9:11 - 11:6 - 11:7 - 6:11 - 7:11
20587162,2024-07-30 15:15:00,Diaryan Aleksandr - Asatryan Murad,3:1,7:11 - 11:9 - 6:11 - 4:11 - 0:0,1,3,Diaryan Aleksandr,Asatryan Murad,fiurst,Asatryan Murad - Diaryan Aleksandr,70,42,28,-14,14,18,20,17,15,0,-4,2,-5,-7,0,-14,11:7 - 9:11 - 11:6 - 11:4 - 0:0
20587154,2024-07-30 15:00:00,Rafayelyan Edgar - Diaryan Aleksandr,0:3,11:5 - 11:9 - 11:4 - 0:0 - 0:0,3,0,Rafayelyan Edgar,Diaryan Aleksandr,fiurst,Diaryan Aleksandr - Rafayelyan Edgar,51,18,33,15,-15,16,20,15,0,0,6,2,7,0,0,15,5:11 - 9:11 - 4:11 - 0:0 - 0:0
20587155,2024-07-30 15:00:00,Gevorgyan Hayk - Nikoghosyan Narek,1:3,11:8 - 8:11 - 9:11 - 11:13 - 0:0,1,3,Gevorgyan Hayk,Nikoghosyan Narek,fiurst,Gevorgyan Hayk - Nikoghosyan Narek,82,39,43,4,-4,19,19,20,24,0,-3,3,2,2,0,4,11:8 - 8:11 - 9:11 - 11:13 - 0:0
20587152,2024-07-30 14:35:00,Asatryan Murad - Gevorgyan Hayk,3:1,9:11 - 11:7 - 11:7 - 11:8 - 0:0,3,1,Asatryan Murad,Gevorgyan Hayk,fiurst,Asatryan Murad - Gevorgyan Hayk,75,42,33,-9,9,20,18,18,19,0,2,-4,-4,-3,0,-9,9:11 - 11:7 - 11:7 - 11:8 - 0:0
20587151,2024-07-30 14:30:00,Rafayelyan Edgar - Nikoghosyan Narek,1:3,11:5 - 8:11 - 11:4 - 11:3 - 0:0,3,1,Rafayelyan Edgar,Nikoghosyan Narek,fiurst,Nikoghosyan Narek - Rafayelyan Edgar,64,23,41,18,-18,16,19,15,14,0,6,-3,7,8,0,18,5:11 - 11:8 - 4:11 - 3:11 - 0:0
20587150,2024-07-30 14:10:00,Diaryan Aleksandr - Gevorgyan Hayk,3:0,11:6 - 14:12 - 14:12 - 0:0 - 0:0,3,0,Diaryan Aleksandr,Gevorgyan Hayk,fiurst,Diaryan Aleksandr - Gevorgyan Hayk,69,39,30,-9,9,17,26,26,0,0,-5,-2,-2,0,0,-9,11:6 - 14:12 - 14:12 - 0:0 - 0:0
20587145,2024-07-30 13:45:00,Asatryan Murad - Rafayelyan Edgar,2:3,5:11 - 8:11 - 11:8 - 11:9 - 8:11,2,3,Asatryan Murad,Rafayelyan Edgar,fiurst,Asatryan Murad - Rafayelyan Edgar,93,43,50,7,-7,16,19,19,20,19,6,3,-3,-2,3,7,5:11 - 8:11 - 11:8 - 11:9 - 8:11
20587134,2024-07-30 13:35:00,Nikoghosyan Narek - Diaryan Aleksandr,3:2,7:11 - 7:11 - 11:8 - 11:9 - 10:12,2,3,Nikoghosyan Narek,Diaryan Aleksandr,fiurst,Diaryan Aleksandr - Nikoghosyan Narek,97,51,46,-5,5,18,18,19,20,22,-4,-4,3,2,-2,-5,11:7 - 11:7 - 8:11 - 9:11 - 12:10
20587132,2024-07-30 13:15:00,Gevorgyan Hayk - Rafayelyan Edgar,0:3,2:11 - 5:11 - 4:11 - 0:0 - 0:0,0,3,Gevorgyan Hayk,Rafayelyan Edgar,fiurst,Gevorgyan Hayk - Rafayelyan Edgar,44,11,33,22,-22,13,16,15,0,0,9,6,7,0,0,22,2:11 - 5:11 - 4:11 - 0:0 - 0:0
20587131,2024-07-30 13:00:00,Nikoghosyan Narek - Asatryan Murad,3:1,11:8 - 5:11 - 5:11 - 4:11 - 0:0,1,3,Nikoghosyan Narek,Asatryan Murad,fiurst,Asatryan Murad - Nikoghosyan Narek,66,41,25,-16,16,19,16,16,15,0,3,-6,-6,-7,0,-16,8:11 - 11:5 - 11:5 - 11:4 - 0:0
20587104,2024-07-30 12:20:00,Diaryan Aleksandr - Rafayelyan Edgar,0:3,8:11 - 6:11 - 7:11 - 0:0 - 0:0,0,3,Diaryan Aleksandr,Rafayelyan Edgar,fiurst,Diaryan Aleksandr - Rafayelyan Edgar,54,21,33,12,-12,19,17,18,0,0,3,5,4,0,0,12,8:11 - 6:11 - 7:11 - 0:0 - 0:0
20587100,2024-07-30 12:00:00,Asatryan Murad - Diaryan Aleksandr,3:0,11:3 - 11:2 - 11:6 - 0:0 - 0:0,3,0,Asatryan Murad,Diaryan Aleksandr,fiurst,Asatryan Murad - Diaryan Aleksandr,44,33,11,-22,22,14,13,17,0,0,-8,-9,-5,0,0,-22,11:3 - 11:2 - 11:6 - 0:0 - 0:0
20587102,2024-07-30 12:00:00,Nikoghosyan Narek - Gevorgyan Hayk,2:3,6:11 - 12:10 - 11:3 - 3:11 - 11:4,3,2,Nikoghosyan Narek,Gevorgyan Hayk,fiurst,Gevorgyan Hayk - Nikoghosyan Narek,82,39,43,4,-4,17,22,14,14,15,-5,2,8,-8,7,4,11:6 - 10:12 - 3:11 - 11:3 - 4:11
20587097,2024-07-30 11:35:00,Nikoghosyan Narek - Rafayelyan Edgar,1:3,11:4 - 2:11 - 9:11 - 5:11 - 0:0,1,3,Nikoghosyan Narek,Rafayelyan Edgar,fiurst,Nikoghosyan Narek - Rafayelyan Edgar,64,27,37,10,-10,15,13,20,16,0,-7,9,2,6,0,10,11:4 - 2:11 - 9:11 - 5:11 - 0:0
20587095,2024-07-30 11:25:00,Gevorgyan Hayk - Asatryan Murad,3:1,16:18 - 10:12 - 11:8 - 6:11 - 0:0,1,3,Gevorgyan Hayk,Asatryan Murad,fiurst,Asatryan Murad - Gevorgyan Hayk,92,49,43,-6,6,34,22,19,17,0,-2,-2,3,-5,0,-6,18:16 - 12:10 - 8:11 - 11:6 - 0:0
20587094,2024-07-30 11:00:00,Diaryan Aleksandr - Nikoghosyan Narek,3:1,8:11 - 11:5 - 11:9 - 11:2 - 0:0,3,1,Diaryan Aleksandr,Nikoghosyan Narek,fiurst,Diaryan Aleksandr - Nikoghosyan Narek,68,41,27,-14,14,19,16,20,13,0,3,-6,-2,-9,0,-14,8:11 - 11:5 - 11:9 - 11:2 - 0:0
20587084,2024-07-30 10:45:00,Rafayelyan Edgar - Asatryan Murad,3:2,11:8 - 8:11 - 11:9 - 6:11 - 5:11,2,3,Rafayelyan Edgar,Asatryan Murad,fiurst,Asatryan Murad - Rafayelyan Edgar,91,50,41,-9,9,19,19,20,17,16,3,-3,2,-5,-6,-9,8:11 - 11:8 - 9:11 - 11:6 - 11:5
20587079,2024-07-30 10:30:00,Gevorgyan Hayk - Diaryan Aleksandr,3:0,10:12 - 10:12 - 10:12 - 0:0 - 0:0,0,3,Gevorgyan Hayk,Diaryan Aleksandr,fiurst,Diaryan Aleksandr - Gevorgyan Hayk,66,36,30,-6,6,22,22,22,0,0,-2,-2,-2,0,0,-6,12:10 - 12:10 - 12:10 - 0:0 - 0:0
20587070,2024-07-30 10:15:00,Asatryan Murad - Nikoghosyan Narek,3:0,11:9 - 13:11 - 11:5 - 0:0 - 0:0,3,0,Asatryan Murad,Nikoghosyan Narek,fiurst,Asatryan Murad - Nikoghosyan Narek,60,35,25,-10,10,20,24,16,0,0,-2,-2,-6,0,0,-10,11:9 - 13:11 - 11:5 - 0:0 - 0:0
20587069,2024-07-30 10:00:00,Rafayelyan Edgar - Gevorgyan Hayk,1:3,11:6 - 11:3 - 8:11 - 11:7 - 0:0,3,1,Rafayelyan Edgar,Gevorgyan Hayk,fiurst,Gevorgyan Hayk - Rafayelyan Edgar,68,27,41,14,-14,17,14,19,18,0,5,8,-3,4,0,14,6:11 - 3:11 - 11:8 - 7:11 - 0:0
20571535,2024-07-29 15:40:00,Rafayelyan Edgar - Nazaryan Mushegh,0:3,11:7 - 11:2 - 11:7 - 0:0 - 0:0,3,0,Rafayelyan Edgar,Nazaryan Mushegh,fiurst,Nazaryan Mushegh - Rafayelyan Edgar,49,16,33,17,-17,18,13,18,0,0,4,9,4,0,0,17,7:11 - 2:11 - 7:11 - 0:0 - 0:0
20571530,2024-07-29 15:25:00,Papyan Karen - Diaryan Aleksandr,3:1,12:10 - 12:14 - 8:11 - 4:11 - 0:0,1,3,Papyan Karen,Diaryan Aleksandr,fiurst,Diaryan Aleksandr - Papyan Karen,82,46,36,-10,10,22,26,19,15,0,2,-2,-3,-7,0,-10,10:12 - 14:12 - 11:8 - 11:4 - 0:0
20571521,2024-07-29 15:05:00,Asatryan Murad - Rafayelyan Edgar,3:2,8:11 - 6:11 - 13:11 - 11:5 - 13:11,3,2,Asatryan Murad,Rafayelyan Edgar,fiurst,Asatryan Murad - Rafayelyan Edgar,100,51,49,-2,2,19,17,24,16,24,3,5,-2,-6,-2,-2,8:11 - 6:11 - 13:11 - 11:5 - 13:11
20571511,2024-07-29 14:55:00,Nazaryan Mushegh - Papyan Karen,3:2,11:5 - 12:10 - 10:12 - 10:12 - 11:5,3,2,Nazaryan Mushegh,Papyan Karen,fiurst,Nazaryan Mushegh - Papyan Karen,98,54,44,-10,10,16,22,22,22,16,-6,-2,2,2,-6,-10,11:5 - 12:10 - 10:12 - 10:12 - 11:5
20571506,2024-07-29 14:40:00,Asatryan Murad - Diaryan Aleksandr,3:1,11:8 - 3:11 - 11:7 - 11:8 - 0:0,3,1,Asatryan Murad,Diaryan Aleksandr,fiurst,Asatryan Murad - Diaryan Aleksandr,70,36,34,-2,2,19,14,18,19,0,-3,8,-4,-3,0,-2,11:8 - 3:11 - 11:7 - 11:8 - 0:0
20571505,2024-07-29 14:35:00,Rafayelyan Edgar - Papyan Karen,1:3,11:8 - 6:11 - 11:6 - 11:5 - 0:0,3,1,Rafayelyan Edgar,Papyan Karen,fiurst,Papyan Karen - Rafayelyan Edgar,69,30,39,9,-9,19,17,17,16,0,3,-5,5,6,0,9,8:11 - 11:6 - 6:11 - 5:11 - 0:0
20571504,2024-07-29 14:25:00,Nazaryan Mushegh - Asatryan Murad,3:0,6:11 - 6:11 - 2:11 - 0:0 - 0:0,0,3,Nazaryan Mushegh,Asatryan Murad,fiurst,Asatryan Murad - Nazaryan Mushegh,47,33,14,-19,19,17,17,13,0,0,-5,-5,-9,0,0,-19,11:6 - 11:6 - 11:2 - 0:0 - 0:0
20571501,2024-07-29 14:15:00,Diaryan Aleksandr - Rafayelyan Edgar,1:3,7:11 - 11:8 - 7:11 - 2:11 - 0:0,1,3,Diaryan Aleksandr,Rafayelyan Edgar,fiurst,Diaryan Aleksandr - Rafayelyan Edgar,68,27,41,14,-14,18,19,18,13,0,4,-3,4,9,0,14,7:11 - 11:8 - 7:11 - 2:11 - 0:0
20571497,2024-07-29 14:10:00,Papyan Karen - Asatryan Murad,3:0,5:11 - 5:11 - 9:11 - 0:0 - 0:0,0,3,Papyan Karen,Asatryan Murad,fiurst,Asatryan Murad - Papyan Karen,52,33,19,-14,14,16,16,20,0,0,-6,-6,-2,0,0,-14,11:5 - 11:5 - 11:9 - 0:0 - 0:0
20571480,2024-07-29 13:50:00,Rafayelyan Edgar - Asatryan Murad,3:0,6:11 - 6:11 - 7:11 - 0:0 - 0:0,0,3,Rafayelyan Edgar,Asatryan Murad,fiurst,Asatryan Murad - Rafayelyan Edgar,52,33,19,-14,14,17,17,18,0,0,-5,-5,-4,0,0,-14,11:6 - 11:6 - 11:7 - 0:0 - 0:0
20571484,2024-07-29 13:50:00,Diaryan Aleksandr - Nazaryan Mushegh,3:0,11:5 - 15:13 - 11:7 - 0:0 - 0:0,3,0,Diaryan Aleksandr,Nazaryan Mushegh,fiurst,Diaryan Aleksandr - Nazaryan Mushegh,62,37,25,-12,12,16,28,18,0,0,-6,-2,-4,0,0,-12,11:5 - 15:13 - 11:7 - 0:0 - 0:0
20571478,2024-07-29 13:20:00,Diaryan Aleksandr - Papyan Karen,3:1,12:10 - 14:16 - 16:14 - 11:5 - 0:0,3,1,Diaryan Aleksandr,Papyan Karen,fiurst,Diaryan Aleksandr - Papyan Karen,98,53,45,-8,8,22,30,30,16,0,-2,2,-2,-6,0,-8,12:10 - 14:16 - 16:14 - 11:5 - 0:0
20571476,2024-07-29 13:00:00,Nazaryan Mushegh - Rafayelyan Edgar,0:3,11:13 - 7:11 - 9:11 - 0:0 - 0:0,0,3,Nazaryan Mushegh,Rafayelyan Edgar,fiurst,Nazaryan Mushegh - Rafayelyan Edgar,62,27,35,8,-8,24,18,20,0,0,2,4,2,0,0,8,11:13 - 7:11 - 9:11 - 0:0 - 0:0
20571475,2024-07-29 12:35:00,Diaryan Aleksandr - Asatryan Murad,3:0,8:11 - 3:11 - 6:11 - 0:0 - 0:0,0,3,Diaryan Aleksandr,Asatryan Murad,fiurst,Asatryan Murad - Diaryan Aleksandr,50,33,17,-16,16,19,14,17,0,0,-3,-8,-5,0,0,-16,11:8 - 11:3 - 11:6 - 0:0 - 0:0
20571474,2024-07-29 11:20:00,Papyan Karen - Nazaryan Mushegh,1:3,9:11 - 11:5 - 11:9 - 11:7 - 0:0,3,1,Papyan Karen,Nazaryan Mushegh,fiurst,Nazaryan Mushegh - Papyan Karen,74,32,42,10,-10,20,16,20,18,0,-2,6,2,4,0,10,11:9 - 5:11 - 9:11 - 7:11 - 0:0
20571472,2024-07-29 11:00:00,Rafayelyan Edgar - Diaryan Aleksandr,3:0,5:11 - 8:11 - 10:12 - 0:0 - 0:0,0,3,Rafayelyan Edgar,Diaryan Aleksandr,fiurst,Diaryan Aleksandr - Rafayelyan Edgar,57,34,23,-11,11,16,19,22,0,0,-6,-3,-2,0,0,-11,11:5 - 11:8 - 12:10 - 0:0 - 0:0
20571471,2024-07-29 10:45:00,Asatryan Murad - Nazaryan Mushegh,3:1,15:13 - 11:5 - 9:11 - 11:6 - 0:0,3,1,Asatryan Murad,Nazaryan Mushegh,fiurst,Asatryan Murad - Nazaryan Mushegh,81,46,35,-11,11,28,16,20,17,0,-2,-6,2,-5,0,-11,15:13 - 11:5 - 9:11 - 11:6 - 0:0
20571470,2024-07-29 10:30:00,Papyan Karen - Rafayelyan Edgar,2:3,8:11 - 11:4 - 4:11 - 11:8 - 3:11,2,3,Papyan Karen,Rafayelyan Edgar,fiurst,Papyan Karen - Rafayelyan Edgar,82,37,45,8,-8,19,15,15,19,14,3,-7,7,-3,8,8,8:11 - 11:4 - 4:11 - 11:8 - 3:11
20571469,2024-07-29 10:15:00,Nazaryan Mushegh - Diaryan Aleksandr,3:2,11:8 - 9:11 - 6:11 - 11:8 - 2:11,2,3,Nazaryan Mushegh,Diaryan Aleksandr,fiurst,Diaryan Aleksandr - Nazaryan Mushegh,88,49,39,-10,10,19,20,17,19,13,3,-2,-5,3,-9,-10,8:11 - 11:9 - 11:6 - 8:11 - 11:2
20571466,2024-07-29 10:00:00,Asatryan Murad - Papyan Karen,3:0,11:9 - 11:2 - 11:4 - 0:0 - 0:0,3,0,Asatryan Murad,Papyan Karen,fiurst,Asatryan Murad - Papyan Karen,48,33,15,-18,18,20,13,15,0,0,-2,-9,-7,0,0,-18,11:9 - 11:2 - 11:4 - 0:0 - 0:0
20550749,2024-07-28 15:15:00,Papyan Karen - Gevorgyan Hayk,0:3,11:9 - 11:2 - 11:5 - 0:0 - 0:0,3,0,Papyan Karen,Gevorgyan Hayk,fiurst,Gevorgyan Hayk - Papyan Karen,49,16,33,17,-17,20,13,16,0,0,2,9,6,0,0,17,9:11 - 2:11 - 5:11 - 0:0 - 0:0
20550737,2024-07-28 15:00:00,Rafayelyan Edgar - Nikoghosyan Narek,3:1,5:11 - 12:10 - 12:14 - 5:11 - 0:0,1,3,Rafayelyan Edgar,Nikoghosyan Narek,fiurst,Nikoghosyan Narek - Rafayelyan Edgar,80,46,34,-12,12,16,22,26,16,0,-6,2,-2,-6,0,-12,11:5 - 10:12 - 14:12 - 11:5 - 0:0
20550733,2024-07-28 14:50:00,Nazaryan Mushegh - Papyan Karen,0:3,9:11 - 9:11 - 5:11 - 0:0 - 0:0,0,3,Nazaryan Mushegh,Papyan Karen,fiurst,Nazaryan Mushegh - Papyan Karen,56,23,33,10,-10,20,20,16,0,0,2,2,6,0,0,10,9:11 - 9:11 - 5:11 - 0:0 - 0:0
20550730,2024-07-28 14:30:00,Gevorgyan Hayk - Rafayelyan Edgar,1:3,11:9 - 9:11 - 5:11 - 10:12 - 0:0,1,3,Gevorgyan Hayk,Rafayelyan Edgar,fiurst,Gevorgyan Hayk - Rafayelyan Edgar,78,35,43,8,-8,20,20,16,22,0,-2,2,6,2,0,8,11:9 - 9:11 - 5:11 - 10:12 - 0:0
20550529,2024-07-28 14:20:00,Nazaryan Mushegh - Nikoghosyan Narek,0:3,8:11 - 11:13 - 5:11 - 0:0 - 0:0,0,3,Nazaryan Mushegh,Nikoghosyan Narek,fiurst,Nazaryan Mushegh - Nikoghosyan Narek,59,24,35,11,-11,19,24,16,0,0,3,2,6,0,0,11,8:11 - 11:13 - 5:11 - 0:0 - 0:0
20550526,2024-07-28 14:10:00,Papyan Karen - Rafayelyan Edgar,0:3,4:11 - 6:11 - 9:11 - 0:0 - 0:0,0,3,Papyan Karen,Rafayelyan Edgar,fiurst,Papyan Karen - Rafayelyan Edgar,52,19,33,14,-14,15,17,20,0,0,7,5,2,0,0,14,4:11 - 6:11 - 9:11 - 0:0 - 0:0
20550523,2024-07-28 13:45:00,Gevorgyan Hayk - Nazaryan Mushegh,2:3,11:13 - 11:4 - 3:11 - 11:7 - 9:11,2,3,Gevorgyan Hayk,Nazaryan Mushegh,fiurst,Gevorgyan Hayk - Nazaryan Mushegh,91,45,46,1,-1,24,15,14,18,20,2,-7,8,-4,2,1,11:13 - 11:4 - 3:11 - 11:7 - 9:11
20550521,2024-07-28 13:30:00,Nikoghosyan Narek - Papyan Karen,1:3,9:11 - 12:14 - 11:5 - 5:11 - 0:0,1,3,Nikoghosyan Narek,Papyan Karen,fiurst,Nikoghosyan Narek - Papyan Karen,78,37,41,4,-4,20,26,16,16,0,2,2,-6,6,0,4,9:11 - 12:14 - 11:5 - 5:11 - 0:0
20550518,2024-07-28 13:15:00,Rafayelyan Edgar - Nazaryan Mushegh,0:3,11:5 - 11:5 - 11:9 - 0:0 - 0:0,3,0,Rafayelyan Edgar,Nazaryan Mushegh,fiurst,Nazaryan Mushegh - Rafayelyan Edgar,52,19,33,14,-14,16,16,20,0,0,6,6,2,0,0,14,5:11 - 5:11 - 9:11 - 0:0 - 0:0
20550517,2024-07-28 13:00:00,Nikoghosyan Narek - Gevorgyan Hayk,2:3,11:8 - 8:11 - 11:5 - 8:11 - 11:5,3,2,Nikoghosyan Narek,Gevorgyan Hayk,fiurst,Gevorgyan Hayk - Nikoghosyan Narek,89,40,49,9,-9,19,19,16,19,16,3,-3,6,-3,6,9,8:11 - 11:8 - 5:11 - 11:8 - 5:11
20550515,2024-07-28 12:15:00,Papyan Karen - Nazaryan Mushegh,3:0,8:11 - 9:11 - 10:12 - 0:0 - 0:0,0,3,Papyan Karen,Nazaryan Mushegh,fiurst,Nazaryan Mushegh - Papyan Karen,61,34,27,-7,7,19,20,22,0,0,-3,-2,-2,0,0,-7,11:8 - 11:9 - 12:10 - 0:0 - 0:0
20550511,2024-07-28 12:05:00,Nikoghosyan Narek - Rafayelyan Edgar,0:3,7:11 - 4:11 - 3:11 - 0:0 - 0:0,0,3,Nikoghosyan Narek,Rafayelyan Edgar,fiurst,Nikoghosyan Narek - Rafayelyan Edgar,47,14,33,19,-19,18,15,14,0,0,4,7,8,0,0,19,7:11 - 4:11 - 3:11 - 0:0 - 0:0
20550506,2024-07-28 11:50:00,Gevorgyan Hayk - Papyan Karen,0:3,9:11 - 11:13 - 5:11 - 0:0 - 0:0,0,3,Gevorgyan Hayk,Papyan Karen,fiurst,Gevorgyan Hayk - Papyan Karen,60,25,35,10,-10,20,24,16,0,0,2,2,6,0,0,10,9:11 - 11:13 - 5:11 - 0:0 - 0:0
20550493,2024-07-28 11:35:00,Nikoghosyan Narek - Nazaryan Mushegh,0:3,11:7 - 11:4 - 11:6 - 0:0 - 0:0,3,0,Nikoghosyan Narek,Nazaryan Mushegh,fiurst,Nazaryan Mushegh - Nikoghosyan Narek,50,17,33,16,-16,18,15,17,0,0,4,7,5,0,0,16,7:11 - 4:11 - 6:11 - 0:0 - 0:0
20550489,2024-07-28 11:20:00,Rafayelyan Edgar - Gevorgyan Hayk,1:3,10:12 - 12:10 - 11:6 - 11:6 - 0:0,3,1,Rafayelyan Edgar,Gevorgyan Hayk,fiurst,Gevorgyan Hayk - Rafayelyan Edgar,78,34,44,10,-10,22,22,17,17,0,-2,2,5,5,0,10,12:10 - 10:12 - 6:11 - 6:11 - 0:0
20550484,2024-07-28 11:00:00,Papyan Karen - Nikoghosyan Narek,3:2,7:11 - 11:7 - 11:7 - 10:12 - 8:11,2,3,Papyan Karen,Nikoghosyan Narek,fiurst,Nikoghosyan Narek - Papyan Karen,95,48,47,-1,1,18,18,18,22,19,-4,4,4,-2,-3,-1,11:7 - 7:11 - 7:11 - 12:10 - 11:8
20550480,2024-07-28 10:45:00,Nazaryan Mushegh - Gevorgyan Hayk,3:2,13:11 - 14:12 - 7:11 - 4:11 - 5:11,2,3,Nazaryan Mushegh,Gevorgyan Hayk,fiurst,Gevorgyan Hayk - Nazaryan Mushegh,99,56,43,-13,13,24,26,18,15,16,2,2,-4,-7,-6,-13,11:13 - 12:14 - 11:7 - 11:4 - 11:5
20550471,2024-07-28 10:30:00,Rafayelyan Edgar - Papyan Karen,0:3,11:9 - 11:3 - 11:4 - 0:0 - 0:0,3,0,Rafayelyan Edgar,Papyan Karen,fiurst,Papyan Karen - Rafayelyan Edgar,49,16,33,17,-17,20,14,15,0,0,2,8,7,0,0,17,9:11 - 3:11 - 4:11 - 0:0 - 0:0
20550468,2024-07-28 10:15:00,Gevorgyan Hayk - Nikoghosyan Narek,1:3,7:11 - 11:9 - 7:11 - 8:11 - 0:0,1,3,Gevorgyan Hayk,Nikoghosyan Narek,fiurst,Gevorgyan Hayk - Nikoghosyan Narek,75,33,42,9,-9,18,20,18,19,0,4,-2,4,3,0,9,7:11 - 11:9 - 7:11 - 8:11 - 0:0
20550467,2024-07-28 10:00:00,Nazaryan Mushegh - Rafayelyan Edgar,0:3,4:11 - 9:11 - 8:11 - 0:0 - 0:0,0,3,Nazaryan Mushegh,Rafayelyan Edgar,fiurst,Nazaryan Mushegh - Rafayelyan Edgar,54,21,33,12,-12,15,20,19,0,0,7,2,3,0,0,12,4:11 - 9:11 - 8:11 - 0:0 - 0:0
20529794,2024-07-27 15:15:00,Nikoghosyan Narek - Asatryan Murad,3:0,4:11 - 9:11 - 9:11 - 0:0 - 0:0,0,3,Nikoghosyan Narek,Asatryan Murad,fiurst,Asatryan Murad - Nikoghosyan Narek,55,33,22,-11,11,15,20,20,0,0,-7,-2,-2,0,0,-11,11:4 - 11:9 - 11:9 - 0:0 - 0:0
20529790,2024-07-27 15:00:00,Nazaryan Mushegh - Papyan Karen,0:3,5:11 - 8:11 - 4:11 - 0:0 - 0:0,0,3,Nazaryan Mushegh,Papyan Karen,fiurst,Nazaryan Mushegh - Papyan Karen,50,17,33,16,-16,16,19,15,0,0,6,3,7,0,0,16,5:11 - 8:11 - 4:11 - 0:0 - 0:0
20529785,2024-07-27 14:50:00,Diaryan Aleksandr - Nikoghosyan Narek,3:1,11:3 - 11:9 - 6:11 - 11:8 - 0:0,3,1,Diaryan Aleksandr,Nikoghosyan Narek,fiurst,Diaryan Aleksandr - Nikoghosyan Narek,70,39,31,-8,8,14,20,17,19,0,-8,-2,5,-3,0,-8,11:3 - 11:9 - 6:11 - 11:8 - 0:0
20529784,2024-07-27 14:35:00,Asatryan Murad - Nazaryan Mushegh,3:0,11:6 - 11:5 - 11:6 - 0:0 - 0:0,3,0,Asatryan Murad,Nazaryan Mushegh,fiurst,Asatryan Murad - Nazaryan Mushegh,50,33,17,-16,16,17,16,17,0,0,-5,-6,-5,0,0,-16,11:6 - 11:5 - 11:6 - 0:0 - 0:0
20529783,2024-07-27 14:15:00,Diaryan Aleksandr - Papyan Karen,2:3,8:11 - 12:10 - 10:12 - 11:5 - 9:11,2,3,Diaryan Aleksandr,Papyan Karen,fiurst,Diaryan Aleksandr - Papyan Karen,99,50,49,-1,1,19,22,22,16,20,3,-2,2,-6,2,-1,8:11 - 12:10 - 10:12 - 11:5 - 9:11
20529782,2024-07-27 14:05:00,Nikoghosyan Narek - Nazaryan Mushegh,3:1,11:7 - 9:11 - 7:11 - 11:13 - 0:0,1,3,Nikoghosyan Narek,Nazaryan Mushegh,fiurst,Nazaryan Mushegh - Nikoghosyan Narek,80,42,38,-4,4,18,20,18,24,0,4,-2,-4,-2,0,-4,7:11 - 11:9 - 11:7 - 13:11 - 0:0
20529768,2024-07-27 13:45:00,Asatryan Murad - Diaryan Aleksandr,3:0,11:5 - 11:8 - 11:9 - 0:0 - 0:0,3,0,Asatryan Murad,Diaryan Aleksandr,fiurst,Asatryan Murad - Diaryan Aleksandr,55,33,22,-11,11,16,19,20,0,0,-6,-3,-2,0,0,-11,11:5 - 11:8 - 11:9 - 0:0 - 0:0
20529767,2024-07-27 13:35:00,Papyan Karen - Nikoghosyan Narek,3:1,7:11 - 11:7 - 4:11 - 7:11 - 0:0,1,3,Papyan Karen,Nikoghosyan Narek,fiurst,Nikoghosyan Narek - Papyan Karen,69,40,29,-11,11,18,18,15,18,0,-4,4,-7,-4,0,-11,11:7 - 7:11 - 11:4 - 11:7 - 0:0
20529765,2024-07-27 13:15:00,Nazaryan Mushegh - Diaryan Aleksandr,3:0,8:11 - 4:11 - 6:11 - 0:0 - 0:0,0,3,Nazaryan Mushegh,Diaryan Aleksandr,fiurst,Diaryan Aleksandr - Nazaryan Mushegh,51,33,18,-15,15,19,15,17,0,0,-3,-7,-5,0,0,-15,11:8 - 11:4 - 11:6 - 0:0 - 0:0
20529764,2024-07-27 13:00:00,Papyan Karen - Asatryan Murad,3:2,11:8 - 9:11 - 12:10 - 7:11 - 4:11,2,3,Papyan Karen,Asatryan Murad,fiurst,Asatryan Murad - Papyan Karen,94,51,43,-8,8,19,20,22,18,15,3,-2,2,-4,-7,-8,8:11 - 11:9 - 10:12 - 11:7 - 11:4
20529763,2024-07-27 12:15:00,Nikoghosyan Narek - Diaryan Aleksandr,3:0,8:11 - 3:11 - 6:11 - 0:0 - 0:0,0,3,Nikoghosyan Narek,Diaryan Aleksandr,fiurst,Diaryan Aleksandr - Nikoghosyan Narek,50,33,17,-16,16,19,14,17,0,0,-3,-8,-5,0,0,-16,11:8 - 11:3 - 11:6 - 0:0 - 0:0
20529762,2024-07-27 12:00:00,Papyan Karen - Nazaryan Mushegh,3:1,11:13 - 13:11 - 9:11 - 2:11 - 0:0,1,3,Papyan Karen,Nazaryan Mushegh,fiurst,Nazaryan Mushegh - Papyan Karen,81,46,35,-11,11,24,24,20,13,0,-2,2,-2,-9,0,-11,13:11 - 11:13 - 11:9 - 11:2 - 0:0
20529760,2024-07-27 11:45:00,Asatryan Murad - Nikoghosyan Narek,3:0,11:7 - 11:9 - 11:4 - 0:0 - 0:0,3,0,Asatryan Murad,Nikoghosyan Narek,fiurst,Asatryan Murad - Nikoghosyan Narek,53,33,20,-13,13,18,20,15,0,0,-4,-2,-7,0,0,-13,11:7 - 11:9 - 11:4 - 0:0 - 0:0
20529759,2024-07-27 11:30:00,Papyan Karen - Diaryan Aleksandr,3:0,9:11 - 8:11 - 4:11 - 0:0 - 0:0,0,3,Papyan Karen,Diaryan Aleksandr,fiurst,Diaryan Aleksandr - Papyan Karen,54,33,21,-12,12,20,19,15,0,0,-2,-3,-7,0,0,-12,11:9 - 11:8 - 11:4 - 0:0 - 0:0
20529757,2024-07-27 11:15:00,Nazaryan Mushegh - Asatryan Murad,3:1,13:11 - 9:11 - 7:11 - 4:11 - 0:0,1,3,Nazaryan Mushegh,Asatryan Murad,fiurst,Asatryan Murad - Nazaryan Mushegh,77,44,33,-11,11,24,20,18,15,0,2,-2,-4,-7,0,-11,11:13 - 11:9 - 11:7 - 11:4 - 0:0
20529756,2024-07-27 11:00:00,Nikoghosyan Narek - Papyan Karen,1:3,11:7 - 8:11 - 10:12 - 7:11 - 0:0,1,3,Nikoghosyan Narek,Papyan Karen,fiurst,Nikoghosyan Narek - Papyan Karen,77,36,41,5,-5,18,19,22,18,0,-4,3,2,4,0,5,11:7 - 8:11 - 10:12 - 7:11 - 0:0
20529755,2024-07-27 10:45:00,Diaryan Aleksandr - Asatryan Murad,3:0,8:11 - 4:11 - 8:11 - 0:0 - 0:0,0,3,Diaryan Aleksandr,Asatryan Murad,fiurst,Asatryan Murad - Diaryan Aleksandr,53,33,20,-13,13,19,15,19,0,0,-3,-7,-3,0,0,-13,11:8 - 11:4 - 11:8 - 0:0 - 0:0
20529754,2024-07-27 10:30:00,Nazaryan Mushegh - Nikoghosyan Narek,3:1,11:8 - 6:11 - 11:6 - 14:12 - 0:0,3,1,Nazaryan Mushegh,Nikoghosyan Narek,fiurst,Nazaryan Mushegh - Nikoghosyan Narek,79,42,37,-5,5,19,17,17,26,0,-3,5,-5,-2,0,-5,11:8 - 6:11 - 11:6 - 14:12 - 0:0
20529753,2024-07-27 10:15:00,Asatryan Murad - Papyan Karen,3:1,11:5 - 11:4 - 5:11 - 11:7 - 0:0,3,1,Asatryan Murad,Papyan Karen,fiurst,Asatryan Murad - Papyan Karen,65,38,27,-11,11,16,15,16,18,0,-6,-7,6,-4,0,-11,11:5 - 11:4 - 5:11 - 11:7 - 0:0
20529746,2024-07-27 10:10:00,Diaryan Aleksandr - Nazaryan Mushegh,3:0,11:9 - 11:8 - 11:3 - 0:0 - 0:0,3,0,Diaryan Aleksandr,Nazaryan Mushegh,fiurst,Diaryan Aleksandr - Nazaryan Mushegh,53,33,20,-13,13,20,19,14,0,0,-2,-3,-8,0,0,-13,11:9 - 11:8 - 11:3 - 0:0 - 0:0
20509922,2024-07-26 15:15:00,Nazaryan Mushegh - Hovhannesyan Rafik,3:0,3:11 - 2:11 - 10:12 - 0:0 - 0:0,0,3,Nazaryan Mushegh,Hovhannesyan Rafik,fiurst,Hovhannesyan Rafik - Nazaryan Mushegh,49,34,15,-19,19,14,13,22,0,0,-8,-9,-2,0,0,-19,11:3 - 11:2 - 12:10 - 0:0 - 0:0
20509921,2024-07-26 15:00:00,Asatryan Murad - Rafayelyan Edgar,3:1,11:6 - 11:13 - 11:5 - 11:7 - 0:0,3,1,Asatryan Murad,Rafayelyan Edgar,fiurst,Asatryan Murad - Rafayelyan Edgar,75,44,31,-13,13,17,24,16,18,0,-5,2,-6,-4,0,-13,11:6 - 11:13 - 11:5 - 11:7 - 0:0
20509903,2024-07-26 14:45:00,Papyan Karen - Nazaryan Mushegh,0:3,11:8 - 11:8 - 11:7 - 0:0 - 0:0,3,0,Papyan Karen,Nazaryan Mushegh,fiurst,Nazaryan Mushegh - Papyan Karen,56,23,33,10,-10,19,19,18,0,0,3,3,4,0,0,10,8:11 - 8:11 - 7:11 - 0:0 - 0:0
20509898,2024-07-26 14:30:00,Hovhannesyan Rafik - Asatryan Murad,3:0,0:11 - 3:11 - 8:11 - 0:0 - 0:0,0,3,Hovhannesyan Rafik,Asatryan Murad,fiurst,Asatryan Murad - Hovhannesyan Rafik,44,33,11,-22,22,11,14,19,0,0,-11,-8,-3,0,0,-22,11:0 - 11:3 - 11:8 - 0:0 - 0:0
20509896,2024-07-26 14:15:00,Papyan Karen - Rafayelyan Edgar,3:1,11:6 - 14:12 - 10:12 - 11:8 - 0:0,3,1,Papyan Karen,Rafayelyan Edgar,fiurst,Papyan Karen - Rafayelyan Edgar,84,46,38,-8,8,17,26,22,19,0,-5,-2,2,-3,0,-8,11:6 - 14:12 - 10:12 - 11:8 - 0:0
20509893,2024-07-26 14:00:00,Nazaryan Mushegh - Asatryan Murad,3:0,4:11 - 7:11 - 6:11 - 0:0 - 0:0,0,3,Nazaryan Mushegh,Asatryan Murad,fiurst,Asatryan Murad - Nazaryan Mushegh,50,33,17,-16,16,15,18,17,0,0,-7,-4,-5,0,0,-16,11:4 - 11:7 - 11:6 - 0:0 - 0:0
20509892,2024-07-26 13:45:00,Hovhannesyan Rafik - Papyan Karen,0:3,9:11 - 6:11 - 2:11 - 0:0 - 0:0,0,3,Hovhannesyan Rafik,Papyan Karen,fiurst,Hovhannesyan Rafik - Papyan Karen,50,17,33,16,-16,20,17,13,0,0,2,5,9,0,0,16,9:11 - 6:11 - 2:11 - 0:0 - 0:0
20509890,2024-07-26 13:30:00,Rafayelyan Edgar - Nazaryan Mushegh,0:3,11:5 - 11:8 - 11:9 - 0:0 - 0:0,3,0,Rafayelyan Edgar,Nazaryan Mushegh,fiurst,Nazaryan Mushegh - Rafayelyan Edgar,55,22,33,11,-11,16,19,20,0,0,6,3,2,0,0,11,5:11 - 8:11 - 9:11 - 0:0 - 0:0
20509887,2024-07-26 13:15:00,Asatryan Murad - Papyan Karen,3:0,11:5 - 12:10 - 11:7 - 0:0 - 0:0,3,0,Asatryan Murad,Papyan Karen,fiurst,Asatryan Murad - Papyan Karen,56,34,22,-12,12,16,22,18,0,0,-6,-2,-4,0,0,-12,11:5 - 12:10 - 11:7 - 0:0 - 0:0
20509877,2024-07-26 13:00:00,Rafayelyan Edgar - Hovhannesyan Rafik,0:3,11:6 - 11:9 - 13:11 - 0:0 - 0:0,3,0,Rafayelyan Edgar,Hovhannesyan Rafik,fiurst,Hovhannesyan Rafik - Rafayelyan Edgar,61,26,35,9,-9,17,20,24,0,0,5,2,2,0,0,9,6:11 - 9:11 - 11:13 - 0:0 - 0:0
20509872,2024-07-26 12:15:00,Nazaryan Mushegh - Papyan Karen,3:1,12:10 - 11:5 - 7:11 - 11:8 - 0:0,3,1,Nazaryan Mushegh,Papyan Karen,fiurst,Nazaryan Mushegh - Papyan Karen,75,41,34,-7,7,22,16,18,19,0,-2,-6,4,-3,0,-7,12:10 - 11:5 - 7:11 - 11:8 - 0:0
20509870,2024-07-26 12:00:00,Rafayelyan Edgar - Asatryan Murad,3:0,4:11 - 2:11 - 3:11 - 0:0 - 0:0,0,3,Rafayelyan Edgar,Asatryan Murad,fiurst,Asatryan Murad - Rafayelyan Edgar,42,33,9,-24,24,15,13,14,0,0,-7,-9,-8,0,0,-24,11:4 - 11:2 - 11:3 - 0:0 - 0:0
20509869,2024-07-26 11:45:00,Hovhannesyan Rafik - Nazaryan Mushegh,1:3,6:11 - 11:8 - 8:11 - 8:11 - 0:0,1,3,Hovhannesyan Rafik,Nazaryan Mushegh,fiurst,Hovhannesyan Rafik - Nazaryan Mushegh,74,33,41,8,-8,17,19,19,19,0,5,-3,3,3,0,8,6:11 - 11:8 - 8:11 - 8:11 - 0:0
20509867,2024-07-26 11:30:00,Rafayelyan Edgar - Papyan Karen,0:3,11:3 - 14:12 - 11:9 - 0:0 - 0:0,3,0,Rafayelyan Edgar,Papyan Karen,fiurst,Papyan Karen - Rafayelyan Edgar,60,24,36,12,-12,14,26,20,0,0,8,2,2,0,0,12,3:11 - 12:14 - 9:11 - 0:0 - 0:0
20509866,2024-07-26 11:15:00,Asatryan Murad - Hovhannesyan Rafik,3:0,11:2 - 11:6 - 11:8 - 0:0 - 0:0,3,0,Asatryan Murad,Hovhannesyan Rafik,fiurst,Asatryan Murad - Hovhannesyan Rafik,49,33,16,-17,17,13,17,19,0,0,-9,-5,-3,0,0,-17,11:2 - 11:6 - 11:8 - 0:0 - 0:0
20509849,2024-07-26 11:00:00,Nazaryan Mushegh - Rafayelyan Edgar,0:3,6:11 - 6:11 - 6:11 - 0:0 - 0:0,0,3,Nazaryan Mushegh,Rafayelyan Edgar,fiurst,Nazaryan Mushegh - Rafayelyan Edgar,51,18,33,15,-15,17,17,17,0,0,5,5,5,0,0,15,6:11 - 6:11 - 6:11 - 0:0 - 0:0
20509840,2024-07-26 10:55:00,Papyan Karen - Hovhannesyan Rafik,2:3,11:7 - 10:12 - 12:10 - 5:11 - 11:7,3,2,Papyan Karen,Hovhannesyan Rafik,fiurst,Hovhannesyan Rafik - Papyan Karen,96,47,49,2,-2,18,22,22,16,18,4,-2,2,-6,4,2,7:11 - 12:10 - 10:12 - 11:5 - 7:11
20509836,2024-07-26 10:30:00,Hovhannesyan Rafik - Rafayelyan Edgar,1:3,11:6 - 1:11 - 10:12 - 7:11 - 0:0,1,3,Hovhannesyan Rafik,Rafayelyan Edgar,fiurst,Hovhannesyan Rafik - Rafayelyan Edgar,69,29,40,11,-11,17,12,22,18,0,-5,10,2,4,0,11,11:6 - 1:11 - 10:12 - 7:11 - 0:0
20509838,2024-07-26 10:30:00,Asatryan Murad - Nazaryan Mushegh,3:0,11:6 - 11:5 - 11:8 - 0:0 - 0:0,3,0,Asatryan Murad,Nazaryan Mushegh,fiurst,Asatryan Murad - Nazaryan Mushegh,52,33,19,-14,14,17,16,19,0,0,-5,-6,-3,0,0,-14,11:6 - 11:5 - 11:8 - 0:0 - 0:0
20509832,2024-07-26 10:05:00,Papyan Karen - Asatryan Murad,3:1,3:11 - 11:8 - 0:11 - 7:11 - 0:0,1,3,Papyan Karen,Asatryan Murad,fiurst,Asatryan Murad - Papyan Karen,62,41,21,-20,20,14,19,11,18,0,-8,3,-11,-4,0,-20,11:3 - 8:11 - 11:0 - 11:7 - 0:0
20495565,2024-07-25 15:15:00,Diaryan Aleksandr - Gevorgyan Hayk,3:0,11:6 - 11:5 - 11:7 - 0:0 - 0:0,3,0,Diaryan Aleksandr,Gevorgyan Hayk,fiurst,Diaryan Aleksandr - Gevorgyan Hayk,51,33,18,-15,15,17,16,18,0,0,-5,-6,-4,0,0,-15,11:6 - 11:5 - 11:7 - 0:0 - 0:0
20495563,2024-07-25 15:00:00,Rafayelyan Edgar - Hovhannesyan Rafik,2:3,9:11 - 11:4 - 8:11 - 11:6 - 11:6,3,2,Rafayelyan Edgar,Hovhannesyan Rafik,fiurst,Hovhannesyan Rafik - Rafayelyan Edgar,88,38,50,12,-12,20,15,19,17,17,-2,7,-3,5,5,12,11:9 - 4:11 - 11:8 - 6:11 - 6:11
20495560,2024-07-25 14:45:00,Nikoghosyan Narek - Diaryan Aleksandr,0:3,11:6 - 11:9 - 11:9 - 0:0 - 0:0,3,0,Nikoghosyan Narek,Diaryan Aleksandr,fiurst,Diaryan Aleksandr - Nikoghosyan Narek,57,24,33,9,-9,17,20,20,0,0,5,2,2,0,0,9,6:11 - 9:11 - 9:11 - 0:0 - 0:0
20495405,2024-07-25 14:30:00,Gevorgyan Hayk - Rafayelyan Edgar,1:3,12:10 - 8:11 - 8:11 - 8:11 - 0:0,1,3,Gevorgyan Hayk,Rafayelyan Edgar,fiurst,Gevorgyan Hayk - Rafayelyan Edgar,79,36,43,7,-7,22,19,19,19,0,-2,3,3,3,0,7,12:10 - 8:11 - 8:11 - 8:11 - 0:0
20495402,2024-07-25 14:15:00,Nikoghosyan Narek - Hovhannesyan Rafik,0:3,11:4 - 11:6 - 11:7 - 0:0 - 0:0,3,0,Nikoghosyan Narek,Hovhannesyan Rafik,fiurst,Hovhannesyan Rafik - Nikoghosyan Narek,50,17,33,16,-16,15,17,18,0,0,7,5,4,0,0,16,4:11 - 6:11 - 7:11 - 0:0 - 0:0
20495400,2024-07-25 14:00:00,Diaryan Aleksandr - Rafayelyan Edgar,3:1,11:5 - 10:12 - 12:10 - 12:10 - 0:0,3,1,Diaryan Aleksandr,Rafayelyan Edgar,fiurst,Diaryan Aleksandr - Rafayelyan Edgar,82,45,37,-8,8,16,22,22,22,0,-6,2,-2,-2,0,-8,11:5 - 10:12 - 12:10 - 12:10 - 0:0
20495398,2024-07-25 13:45:00,Gevorgyan Hayk - Nikoghosyan Narek,3:0,11:9 - 11:9 - 11:9 - 0:0 - 0:0,3,0,Gevorgyan Hayk,Nikoghosyan Narek,fiurst,Gevorgyan Hayk - Nikoghosyan Narek,60,33,27,-6,6,20,20,20,0,0,-2,-2,-2,0,0,-6,11:9 - 11:9 - 11:9 - 0:0 - 0:0
20495395,2024-07-25 13:30:00,Hovhannesyan Rafik - Diaryan Aleksandr,3:1,11:7 - 3:11 - 11:13 - 4:11 - 0:0,1,3,Hovhannesyan Rafik,Diaryan Aleksandr,fiurst,Diaryan Aleksandr - Hovhannesyan Rafik,71,42,29,-13,13,18,14,24,15,0,4,-8,-2,-7,0,-13,7:11 - 11:3 - 13:11 - 11:4 - 0:0
20495378,2024-07-25 13:15:00,Rafayelyan Edgar - Nikoghosyan Narek,0:3,11:5 - 11:7 - 11:6 - 0:0 - 0:0,3,0,Rafayelyan Edgar,Nikoghosyan Narek,fiurst,Nikoghosyan Narek - Rafayelyan Edgar,51,18,33,15,-15,16,18,17,0,0,6,4,5,0,0,15,5:11 - 7:11 - 6:11 - 0:0 - 0:0
20495376,2024-07-25 13:00:00,Hovhannesyan Rafik - Gevorgyan Hayk,1:3,11:8 - 10:12 - 11:8 - 11:6 - 0:0,3,1,Hovhannesyan Rafik,Gevorgyan Hayk,fiurst,Gevorgyan Hayk - Hovhannesyan Rafik,77,34,43,9,-9,19,22,19,17,0,3,-2,3,5,0,9,8:11 - 12:10 - 8:11 - 6:11 - 0:0
20495372,2024-07-25 12:30:00,Diaryan Aleksandr - Nikoghosyan Narek,3:1,11:7 - 11:3 - 6:11 - 11:9 - 0:0,3,1,Diaryan Aleksandr,Nikoghosyan Narek,fiurst,Diaryan Aleksandr - Nikoghosyan Narek,69,39,30,-9,9,18,14,17,20,0,-4,-8,5,-2,0,-9,11:7 - 11:3 - 6:11 - 11:9 - 0:0
20495357,2024-07-25 12:00:00,Hovhannesyan Rafik - Rafayelyan Edgar,0:3,7:11 - 6:11 - 10:12 - 0:0 - 0:0,0,3,Hovhannesyan Rafik,Rafayelyan Edgar,fiurst,Hovhannesyan Rafik - Rafayelyan Edgar,57,23,34,11,-11,18,17,22,0,0,4,5,2,0,0,11,7:11 - 6:11 - 10:12 - 0:0 - 0:0
20495353,2024-07-25 11:55:00,Gevorgyan Hayk - Diaryan Aleksandr,3:1,17:15 - 10:12 - 6:11 - 8:11 - 0:0,1,3,Gevorgyan Hayk,Diaryan Aleksandr,fiurst,Diaryan Aleksandr - Gevorgyan Hayk,90,49,41,-8,8,32,22,17,19,0,2,-2,-5,-3,0,-8,15:17 - 12:10 - 11:6 - 11:8 - 0:0
20495344,2024-07-25 11:35:00,Hovhannesyan Rafik - Nikoghosyan Narek,1:3,6:11 - 11:8 - 5:11 - 9:11 - 0:0,1,3,Hovhannesyan Rafik,Nikoghosyan Narek,fiurst,Hovhannesyan Rafik - Nikoghosyan Narek,72,31,41,10,-10,17,19,16,20,0,5,-3,6,2,0,10,6:11 - 11:8 - 5:11 - 9:11 - 0:0
20495328,2024-07-25 11:30:00,Rafayelyan Edgar - Gevorgyan Hayk,0:3,11:5 - 11:8 - 11:7 - 0:0 - 0:0,3,0,Rafayelyan Edgar,Gevorgyan Hayk,fiurst,Gevorgyan Hayk - Rafayelyan Edgar,53,20,33,13,-13,16,19,18,0,0,6,3,4,0,0,13,5:11 - 8:11 - 7:11 - 0:0 - 0:0
20495319,2024-07-25 11:00:00,Diaryan Aleksandr - Hovhannesyan Rafik,3:0,11:4 - 11:4 - 11:7 - 0:0 - 0:0,3,0,Diaryan Aleksandr,Hovhannesyan Rafik,fiurst,Diaryan Aleksandr - Hovhannesyan Rafik,48,33,15,-18,18,15,15,18,0,0,-7,-7,-4,0,0,-18,11:4 - 11:4 - 11:7 - 0:0 - 0:0
20495318,2024-07-25 10:45:00,Nikoghosyan Narek - Gevorgyan Hayk,2:3,9:11 - 10:12 - 12:10 - 14:12 - 11:6,3,2,Nikoghosyan Narek,Gevorgyan Hayk,fiurst,Gevorgyan Hayk - Nikoghosyan Narek,107,51,56,5,-5,20,22,22,26,17,-2,-2,2,2,5,5,11:9 - 12:10 - 10:12 - 12:14 - 6:11
20495317,2024-07-25 10:30:00,Rafayelyan Edgar - Diaryan Aleksandr,1:3,11:4 - 10:12 - 11:2 - 11:5 - 0:0,3,1,Rafayelyan Edgar,Diaryan Aleksandr,fiurst,Diaryan Aleksandr - Rafayelyan Edgar,66,23,43,20,-20,15,22,13,16,0,7,-2,9,6,0,20,4:11 - 12:10 - 2:11 - 5:11 - 0:0
20494340,2024-07-25 10:15:00,Gevorgyan Hayk - Hovhannesyan Rafik,0:3,5:11 - 10:12 - 2:11 - 0:0 - 0:0,0,3,Gevorgyan Hayk,Hovhannesyan Rafik,fiurst,Gevorgyan Hayk - Hovhannesyan Rafik,51,17,34,17,-17,16,22,13,0,0,6,2,9,0,0,17,5:11 - 10:12 - 2:11 - 0:0 - 0:0
20494336,2024-07-25 10:00:00,Nikoghosyan Narek - Rafayelyan Edgar,1:3,7:11 - 11:7 - 6:11 - 8:11 - 0:0,1,3,Nikoghosyan Narek,Rafayelyan Edgar,fiurst,Nikoghosyan Narek - Rafayelyan Edgar,72,32,40,8,-8,18,18,17,19,0,4,-4,5,3,0,8,7:11 - 11:7 - 6:11 - 8:11 - 0:0
20476957,2024-07-24 15:15:00,Nikoghosyan Narek - Rafayelyan Edgar,2:3,8:11 - 11:8 - 6:11 - 11:6 - 3:11,2,3,Nikoghosyan Narek,Rafayelyan Edgar,fiurst,Nikoghosyan Narek - Rafayelyan Edgar,86,39,47,8,-8,19,19,17,17,14,3,-3,5,-5,8,8,8:11 - 11:8 - 6:11 - 11:6 - 3:11
20476955,2024-07-24 15:00:00,Gevorgyan Hayk - Diaryan Aleksandr,3:1,5:11 - 5:11 - 11:9 - 7:11 - 0:0,1,3,Gevorgyan Hayk,Diaryan Aleksandr,fiurst,Diaryan Aleksandr - Gevorgyan Hayk,70,42,28,-14,14,16,16,20,18,0,-6,-6,2,-4,0,-14,11:5 - 11:5 - 9:11 - 11:7 - 0:0
20476951,2024-07-24 14:45:00,Papyan Karen - Nikoghosyan Narek,1:3,11:8 - 11:8 - 3:11 - 11:9 - 0:0,3,1,Papyan Karen,Nikoghosyan Narek,fiurst,Nikoghosyan Narek - Papyan Karen,72,36,36,0,0,19,19,14,20,0,3,3,-8,2,0,0,8:11 - 8:11 - 11:3 - 9:11 - 0:0
20476950,2024-07-24 14:30:00,Rafayelyan Edgar - Gevorgyan Hayk,0:3,11:7 - 11:5 - 11:8 - 0:0 - 0:0,3,0,Rafayelyan Edgar,Gevorgyan Hayk,fiurst,Gevorgyan Hayk - Rafayelyan Edgar,53,20,33,13,-13,18,16,19,0,0,4,6,3,0,0,13,7:11 - 5:11 - 8:11 - 0:0 - 0:0
20476946,2024-07-24 14:15:00,Papyan Karen - Diaryan Aleksandr,3:0,9:11 - 9:11 - 5:11 - 0:0 - 0:0,0,3,Papyan Karen,Diaryan Aleksandr,fiurst,Diaryan Aleksandr - Papyan Karen,56,33,23,-10,10,20,20,16,0,0,-2,-2,-6,0,0,-10,11:9 - 11:9 - 11:5 - 0:0 - 0:0
20476945,2024-07-24 14:00:00,Nikoghosyan Narek - Gevorgyan Hayk,0:3,11:3 - 11:8 - 11:8 - 0:0 - 0:0,3,0,Nikoghosyan Narek,Gevorgyan Hayk,fiurst,Gevorgyan Hayk - Nikoghosyan Narek,52,19,33,14,-14,14,19,19,0,0,8,3,3,0,0,14,3:11 - 8:11 - 8:11 - 0:0 - 0:0
20476943,2024-07-24 13:45:00,Rafayelyan Edgar - Papyan Karen,3:2,8:11 - 9:11 - 13:11 - 11:7 - 9:11,2,3,Rafayelyan Edgar,Papyan Karen,fiurst,Papyan Karen - Rafayelyan Edgar,101,51,50,-1,1,19,20,24,18,20,-3,-2,2,4,-2,-1,11:8 - 11:9 - 11:13 - 7:11 - 11:9
20476934,2024-07-24 13:35:00,Diaryan Aleksandr - Nikoghosyan Narek,3:0,11:7 - 11:6 - 13:11 - 0:0 - 0:0,3,0,Diaryan Aleksandr,Nikoghosyan Narek,fiurst,Diaryan Aleksandr - Nikoghosyan Narek,59,35,24,-11,11,18,17,24,0,0,-4,-5,-2,0,0,-11,11:7 - 11:6 - 13:11 - 0:0 - 0:0
20476928,2024-07-24 13:15:00,Gevorgyan Hayk - Papyan Karen,0:3,8:11 - 7:11 - 9:11 - 0:0 - 0:0,0,3,Gevorgyan Hayk,Papyan Karen,fiurst,Gevorgyan Hayk - Papyan Karen,57,24,33,9,-9,19,18,20,0,0,3,4,2,0,0,9,8:11 - 7:11 - 9:11 - 0:0 - 0:0
20476926,2024-07-24 13:00:00,Diaryan Aleksandr - Rafayelyan Edgar,3:1,12:10 - 11:9 - 7:11 - 14:12 - 0:0,3,1,Diaryan Aleksandr,Rafayelyan Edgar,fiurst,Diaryan Aleksandr - Rafayelyan Edgar,86,44,42,-2,2,22,20,18,26,0,-2,-2,4,-2,0,-2,12:10 - 11:9 - 7:11 - 14:12 - 0:0
20476925,2024-07-24 12:15:00,Nikoghosyan Narek - Papyan Karen,0:3,3:11 - 14:16 - 8:11 - 0:0 - 0:0,0,3,Nikoghosyan Narek,Papyan Karen,fiurst,Nikoghosyan Narek - Papyan Karen,63,25,38,13,-13,14,30,19,0,0,8,2,3,0,0,13,3:11 - 14:16 - 8:11 - 0:0 - 0:0
20476924,2024-07-24 12:10:00,Diaryan Aleksandr - Gevorgyan Hayk,3:1,7:11 - 12:10 - 11:6 - 11:4 - 0:0,3,1,Diaryan Aleksandr,Gevorgyan Hayk,fiurst,Diaryan Aleksandr - Gevorgyan Hayk,72,41,31,-10,10,18,22,17,15,0,4,-2,-5,-7,0,-10,7:11 - 12:10 - 11:6 - 11:4 - 0:0
20476913,2024-07-24 11:45:00,Rafayelyan Edgar - Nikoghosyan Narek,0:3,11:9 - 11:9 - 11:6 - 0:0 - 0:0,3,0,Rafayelyan Edgar,Nikoghosyan Narek,fiurst,Nikoghosyan Narek - Rafayelyan Edgar,57,24,33,9,-9,20,20,17,0,0,2,2,5,0,0,9,9:11 - 9:11 - 6:11 - 0:0 - 0:0
20476899,2024-07-24 11:40:00,Diaryan Aleksandr - Papyan Karen,2:3,12:10 - 9:11 - 7:11 - 11:6 - 6:11,2,3,Diaryan Aleksandr,Papyan Karen,fiurst,Diaryan Aleksandr - Papyan Karen,94,45,49,4,-4,22,20,18,17,17,-2,2,4,-5,5,4,12:10 - 9:11 - 7:11 - 11:6 - 6:11
20476786,2024-07-24 11:15:00,Gevorgyan Hayk - Rafayelyan Edgar,1:3,13:11 - 5:11 - 6:11 - 6:11 - 0:0,1,3,Gevorgyan Hayk,Rafayelyan Edgar,fiurst,Gevorgyan Hayk - Rafayelyan Edgar,74,30,44,14,-14,24,16,17,17,0,-2,6,5,5,0,14,13:11 - 5:11 - 6:11 - 6:11 - 0:0
20476784,2024-07-24 11:00:00,Nikoghosyan Narek - Diaryan Aleksandr,3:1,7:11 - 15:13 - 4:11 - 5:11 - 0:0,1,3,Nikoghosyan Narek,Diaryan Aleksandr,fiurst,Diaryan Aleksandr - Nikoghosyan Narek,77,46,31,-15,15,18,28,15,16,0,-4,2,-7,-6,0,-15,11:7 - 13:15 - 11:4 - 11:5 - 0:0
20476782,2024-07-24 10:45:00,Papyan Karen - Rafayelyan Edgar,1:3,8:11 - 12:10 - 3:11 - 8:11 - 0:0,1,3,Papyan Karen,Rafayelyan Edgar,fiurst,Papyan Karen - Rafayelyan Edgar,74,31,43,12,-12,19,22,14,19,0,3,-2,8,3,0,12,8:11 - 12:10 - 3:11 - 8:11 - 0:0
20476692,2024-07-24 10:30:00,Gevorgyan Hayk - Nikoghosyan Narek,2:3,11:8 - 12:10 - 8:11 - 4:11 - 4:11,2,3,Gevorgyan Hayk,Nikoghosyan Narek,fiurst,Gevorgyan Hayk - Nikoghosyan Narek,90,39,51,12,-12,19,22,19,15,15,-3,-2,3,7,7,12,11:8 - 12:10 - 8:11 - 4:11 - 4:11
20476690,2024-07-24 10:15:00,Rafayelyan Edgar - Diaryan Aleksandr,0:3,11:5 - 11:7 - 11:2 - 0:0 - 0:0,3,0,Rafayelyan Edgar,Diaryan Aleksandr,fiurst,Diaryan Aleksandr - Rafayelyan Edgar,47,14,33,19,-19,16,18,13,0,0,6,4,9,0,0,19,5:11 - 7:11 - 2:11 - 0:0 - 0:0
20476689,2024-07-24 10:00:00,Papyan Karen - Gevorgyan Hayk,1:3,11:7 - 12:14 - 11:7 - 11:8 - 0:0,3,1,Papyan Karen,Gevorgyan Hayk,fiurst,Gevorgyan Hayk - Papyan Karen,81,36,45,9,-9,18,26,18,19,0,4,-2,4,3,0,9,7:11 - 14:12 - 7:11 - 8:11 - 0:0
20451365,2024-07-23 15:15:00,Hovhannesyan Rafik - Papyan Karen,0:3,8:11 - 8:11 - 5:11 - 0:0 - 0:0,0,3,Hovhannesyan Rafik,Papyan Karen,fiurst,Hovhannesyan Rafik - Papyan Karen,54,21,33,12,-12,19,19,16,0,0,3,3,6,0,0,12,8:11 - 8:11 - 5:11 - 0:0 - 0:0
20451361,2024-07-23 15:00:00,Asatryan Murad - Nikoghosyan Narek,3:1,11:9 - 11:6 - 3:11 - 11:9 - 0:0,3,1,Asatryan Murad,Nikoghosyan Narek,fiurst,Asatryan Murad - Nikoghosyan Narek,71,36,35,-1,1,20,17,14,20,0,-2,-5,8,-2,0,-1,11:9 - 11:6 - 3:11 - 11:9 - 0:0
20451357,2024-07-23 14:45:00,Rafayelyan Edgar - Hovhannesyan Rafik,0:3,11:9 - 11:7 - 11:9 - 0:0 - 0:0,3,0,Rafayelyan Edgar,Hovhannesyan Rafik,fiurst,Hovhannesyan Rafik - Rafayelyan Edgar,58,25,33,8,-8,20,18,20,0,0,2,4,2,0,0,8,9:11 - 7:11 - 9:11 - 0:0 - 0:0
20451352,2024-07-23 14:35:00,Papyan Karen - Asatryan Murad,3:0,8:11 - 7:11 - 8:11 - 0:0 - 0:0,0,3,Papyan Karen,Asatryan Murad,fiurst,Asatryan Murad - Papyan Karen,56,33,23,-10,10,19,18,19,0,0,-3,-4,-3,0,0,-10,11:8 - 11:7 - 11:8 - 0:0 - 0:0
20451350,2024-07-23 14:15:00,Rafayelyan Edgar - Nikoghosyan Narek,0:3,11:9 - 11:6 - 11:8 - 0:0 - 0:0,3,0,Rafayelyan Edgar,Nikoghosyan Narek,fiurst,Nikoghosyan Narek - Rafayelyan Edgar,56,23,33,10,-10,20,17,19,0,0,2,5,3,0,0,10,9:11 - 6:11 - 8:11 - 0:0 - 0:0
20451347,2024-07-23 14:05:00,Hovhannesyan Rafik - Asatryan Murad,3:2,11:7 - 7:11 - 11:8 - 5:11 - 5:11,2,3,Hovhannesyan Rafik,Asatryan Murad,fiurst,Asatryan Murad - Hovhannesyan Rafik,87,48,39,-9,9,18,18,19,16,16,4,-4,3,-6,-6,-9,7:11 - 11:7 - 8:11 - 11:5 - 11:5
20451343,2024-07-23 13:45:00,Papyan Karen - Rafayelyan Edgar,3:1,11:9 - 12:10 - 7:11 - 12:10 - 0:0,3,1,Papyan Karen,Rafayelyan Edgar,fiurst,Papyan Karen - Rafayelyan Edgar,82,42,40,-2,2,20,22,18,22,0,-2,-2,4,-2,0,-2,11:9 - 12:10 - 7:11 - 12:10 - 0:0
20451341,2024-07-23 13:30:00,Nikoghosyan Narek - Hovhannesyan Rafik,0:3,14:12 - 11:7 - 11:5 - 0:0 - 0:0,3,0,Nikoghosyan Narek,Hovhannesyan Rafik,fiurst,Hovhannesyan Rafik - Nikoghosyan Narek,60,24,36,12,-12,26,18,16,0,0,2,4,6,0,0,12,12:14 - 7:11 - 5:11 - 0:0 - 0:0
20451335,2024-07-23 13:15:00,Asatryan Murad - Rafayelyan Edgar,0:3,7:11 - 9:11 - 8:11 - 0:0 - 0:0,0,3,Asatryan Murad,Rafayelyan Edgar,fiurst,Asatryan Murad - Rafayelyan Edgar,57,24,33,9,-9,18,20,19,0,0,4,2,3,0,0,9,7:11 - 9:11 - 8:11 - 0:0 - 0:0
20451316,2024-07-23 13:00:00,Nikoghosyan Narek - Papyan Karen,3:1,11:7 - 11:8 - 5:11 - 11:5 - 0:0,3,1,Nikoghosyan Narek,Papyan Karen,fiurst,Nikoghosyan Narek - Papyan Karen,69,38,31,-7,7,18,19,16,16,0,-4,-3,6,-6,0,-7,11:7 - 11:8 - 5:11 - 11:5 - 0:0
20451314,2024-07-23 12:20:00,Hovhannesyan Rafik - Rafayelyan Edgar,1:3,11:7 - 10:12 - 7:11 - 13:15 - 0:0,1,3,Hovhannesyan Rafik,Rafayelyan Edgar,fiurst,Hovhannesyan Rafik - Rafayelyan Edgar,86,41,45,4,-4,18,22,18,28,0,-4,2,4,2,0,4,11:7 - 10:12 - 7:11 - 13:15 - 0:0
20451310,2024-07-23 12:10:00,Nikoghosyan Narek - Asatryan Murad,3:1,4:11 - 2:11 - 11:8 - 5:11 - 0:0,1,3,Nikoghosyan Narek,Asatryan Murad,fiurst,Asatryan Murad - Nikoghosyan Narek,63,41,22,-19,19,15,13,19,16,0,-7,-9,3,-6,0,-19,11:4 - 11:2 - 8:11 - 11:5 - 0:0
20451308,2024-07-23 12:00:00,Papyan Karen - Hovhannesyan Rafik,1:3,11:8 - 11:13 - 11:6 - 11:6 - 0:0,3,1,Papyan Karen,Hovhannesyan Rafik,fiurst,Hovhannesyan Rafik - Papyan Karen,77,33,44,11,-11,19,24,17,17,0,3,-2,5,5,0,11,8:11 - 13:11 - 6:11 - 6:11 - 0:0
20451302,2024-07-23 11:30:00,Nikoghosyan Narek - Rafayelyan Edgar,3:2,4:11 - 12:14 - 11:7 - 11:8 - 11:9,3,2,Nikoghosyan Narek,Rafayelyan Edgar,fiurst,Nikoghosyan Narek - Rafayelyan Edgar,98,49,49,0,0,15,26,18,19,20,7,2,-4,-3,-2,0,4:11 - 12:14 - 11:7 - 11:8 - 11:9
20451299,2024-07-23 11:25:00,Asatryan Murad - Papyan Karen,1:3,8:11 - 7:11 - 11:9 - 9:11 - 0:0,1,3,Asatryan Murad,Papyan Karen,fiurst,Asatryan Murad - Papyan Karen,77,35,42,7,-7,19,18,20,20,0,3,4,-2,2,0,7,8:11 - 7:11 - 11:9 - 9:11 - 0:0
20451297,2024-07-23 11:05:00,Hovhannesyan Rafik - Nikoghosyan Narek,0:3,7:11 - 9:11 - 4:11 - 0:0 - 0:0,0,3,Hovhannesyan Rafik,Nikoghosyan Narek,fiurst,Hovhannesyan Rafik - Nikoghosyan Narek,53,20,33,13,-13,18,20,15,0,0,4,2,7,0,0,13,7:11 - 9:11 - 4:11 - 0:0 - 0:0
20451294,2024-07-23 10:50:00,Rafayelyan Edgar - Papyan Karen,3:2,13:15 - 12:10 - 11:9 - 8:11 - 4:11,2,3,Rafayelyan Edgar,Papyan Karen,fiurst,Papyan Karen - Rafayelyan Edgar,104,56,48,-8,8,28,22,20,19,15,-2,2,2,-3,-7,-8,15:13 - 10:12 - 9:11 - 11:8 - 11:4
20451283,2024-07-23 10:30:00,Asatryan Murad - Hovhannesyan Rafik,3:1,11:6 - 9:11 - 11:7 - 11:2 - 0:0,3,1,Asatryan Murad,Hovhannesyan Rafik,fiurst,Asatryan Murad - Hovhannesyan Rafik,68,42,26,-16,16,17,20,18,13,0,-5,2,-4,-9,0,-16,11:6 - 9:11 - 11:7 - 11:2 - 0:0
20451269,2024-07-23 10:15:00,Papyan Karen - Nikoghosyan Narek,1:3,11:8 - 4:11 - 12:10 - 11:5 - 0:0,3,1,Papyan Karen,Nikoghosyan Narek,fiurst,Nikoghosyan Narek - Papyan Karen,72,34,38,4,-4,19,15,22,16,0,3,-7,2,6,0,4,8:11 - 11:4 - 10:12 - 5:11 - 0:0
20451263,2024-07-23 10:00:00,Rafayelyan Edgar - Asatryan Murad,3:0,3:11 - 7:11 - 6:11 - 0:0 - 0:0,0,3,Rafayelyan Edgar,Asatryan Murad,fiurst,Asatryan Murad - Rafayelyan Edgar,49,33,16,-17,17,14,18,17,0,0,-8,-4,-5,0,0,-17,11:3 - 11:7 - 11:6 - 0:0 - 0:0
20436380,2024-07-22 15:20:00,Asatryan Murad - Papyan Karen,3:1,11:8 - 8:11 - 12:10 - 18:16 - 0:0,3,1,Asatryan Murad,Papyan Karen,fiurst,Asatryan Murad - Papyan Karen,94,49,45,-4,4,19,19,22,34,0,-3,3,-2,-2,0,-4,11:8 - 8:11 - 12:10 - 18:16 - 0:0
20436367,2024-07-22 15:00:00,Diaryan Aleksandr - Rafayelyan Edgar,3:1,11:1 - 12:10 - 5:11 - 11:7 - 0:0,3,1,Diaryan Aleksandr,Rafayelyan Edgar,fiurst,Diaryan Aleksandr - Rafayelyan Edgar,68,39,29,-10,10,12,22,16,18,0,-10,-2,6,-4,0,-10,11:1 - 12:10 - 5:11 - 11:7 - 0:0
20436366,2024-07-22 14:45:00,Hovhannesyan Rafik - Asatryan Murad,3:0,3:11 - 9:11 - 7:11 - 0:0 - 0:0,0,3,Hovhannesyan Rafik,Asatryan Murad,fiurst,Asatryan Murad - Hovhannesyan Rafik,52,33,19,-14,14,14,20,18,0,0,-8,-2,-4,0,0,-14,11:3 - 11:9 - 11:7 - 0:0 - 0:0
20436365,2024-07-22 14:30:00,Papyan Karen - Diaryan Aleksandr,3:0,9:11 - 7:11 - 2:11 - 0:0 - 0:0,0,3,Papyan Karen,Diaryan Aleksandr,fiurst,Diaryan Aleksandr - Papyan Karen,51,33,18,-15,15,20,18,13,0,0,-2,-4,-9,0,0,-15,11:9 - 11:7 - 11:2 - 0:0 - 0:0
20436364,2024-07-22 14:15:00,Hovhannesyan Rafik - Rafayelyan Edgar,0:3,3:11 - 7:11 - 8:11 - 0:0 - 0:0,0,3,Hovhannesyan Rafik,Rafayelyan Edgar,fiurst,Hovhannesyan Rafik - Rafayelyan Edgar,51,18,33,15,-15,14,18,19,0,0,8,4,3,0,0,15,3:11 - 7:11 - 8:11 - 0:0 - 0:0
20436363,2024-07-22 14:00:00,Asatryan Murad - Diaryan Aleksandr,3:1,7:11 - 11:8 - 11:7 - 15:13 - 0:0,3,1,Asatryan Murad,Diaryan Aleksandr,fiurst,Asatryan Murad - Diaryan Aleksandr,83,44,39,-5,5,18,19,18,28,0,4,-3,-4,-2,0,-5,7:11 - 11:8 - 11:7 - 15:13 - 0:0
20436360,2024-07-22 13:50:00,Papyan Karen - Hovhannesyan Rafik,3:0,8:11 - 5:11 - 6:11 - 0:0 - 0:0,0,3,Papyan Karen,Hovhannesyan Rafik,fiurst,Hovhannesyan Rafik - Papyan Karen,52,33,19,-14,14,19,16,17,0,0,-3,-6,-5,0,0,-14,11:8 - 11:5 - 11:6 - 0:0 - 0:0
20436359,2024-07-22 13:30:00,Rafayelyan Edgar - Asatryan Murad,3:0,8:11 - 8:11 - 9:11 - 0:0 - 0:0,0,3,Rafayelyan Edgar,Asatryan Murad,fiurst,Asatryan Murad - Rafayelyan Edgar,58,33,25,-8,8,19,19,20,0,0,-3,-3,-2,0,0,-8,11:8 - 11:8 - 11:9 - 0:0 - 0:0
20436358,2024-07-22 13:15:00,Diaryan Aleksandr - Hovhannesyan Rafik,3:0,11:8 - 12:10 - 11:8 - 0:0 - 0:0,3,0,Diaryan Aleksandr,Hovhannesyan Rafik,fiurst,Diaryan Aleksandr - Hovhannesyan Rafik,60,34,26,-8,8,19,22,19,0,0,-3,-2,-3,0,0,-8,11:8 - 12:10 - 11:8 - 0:0 - 0:0
20436357,2024-07-22 13:00:00,Rafayelyan Edgar - Papyan Karen,3:2,11:8 - 11:9 - 9:11 - 7:11 - 9:11,2,3,Rafayelyan Edgar,Papyan Karen,fiurst,Papyan Karen - Rafayelyan Edgar,97,50,47,-3,3,19,20,20,18,20,3,2,-2,-4,-2,-3,8:11 - 9:11 - 11:9 - 11:7 - 11:9
20436355,2024-07-22 12:15:00,Asatryan Murad - Hovhannesyan Rafik,3:2,11:13 - 8:11 - 12:10 - 11:9 - 11:7,3,2,Asatryan Murad,Hovhannesyan Rafik,fiurst,Asatryan Murad - Hovhannesyan Rafik,103,53,50,-3,3,24,19,22,20,18,2,3,-2,-2,-4,-3,11:13 - 8:11 - 12:10 - 11:9 - 11:7
20436341,2024-07-22 12:00:00,Rafayelyan Edgar - Diaryan Aleksandr,3:0,10:12 - 10:12 - 7:11 - 0:0 - 0:0,0,3,Rafayelyan Edgar,Diaryan Aleksandr,fiurst,Diaryan Aleksandr - Rafayelyan Edgar,62,35,27,-8,8,22,22,18,0,0,-2,-2,-4,0,0,-8,12:10 - 12:10 - 11:7 - 0:0 - 0:0
20436339,2024-07-22 11:45:00,Papyan Karen - Asatryan Murad,3:1,5:11 - 11:9 - 5:11 - 4:11 - 0:0,1,3,Papyan Karen,Asatryan Murad,fiurst,Asatryan Murad - Papyan Karen,67,42,25,-17,17,16,20,16,15,0,-6,2,-6,-7,0,-17,11:5 - 9:11 - 11:5 - 11:4 - 0:0
20436337,2024-07-22 11:30:00,Rafayelyan Edgar - Hovhannesyan Rafik,0:3,11:9 - 11:9 - 11:5 - 0:0 - 0:0,3,0,Rafayelyan Edgar,Hovhannesyan Rafik,fiurst,Hovhannesyan Rafik - Rafayelyan Edgar,56,23,33,10,-10,20,20,16,0,0,2,2,6,0,0,10,9:11 - 9:11 - 5:11 - 0:0 - 0:0
20436336,2024-07-22 11:15:00,Diaryan Aleksandr - Papyan Karen,3:0,11:8 - 13:11 - 11:7 - 0:0 - 0:0,3,0,Diaryan Aleksandr,Papyan Karen,fiurst,Diaryan Aleksandr - Papyan Karen,61,35,26,-9,9,19,24,18,0,0,-3,-2,-4,0,0,-9,11:8 - 13:11 - 11:7 - 0:0 - 0:0
20436334,2024-07-22 11:10:00,Asatryan Murad - Rafayelyan Edgar,3:0,11:5 - 11:9 - 12:10 - 0:0 - 0:0,3,0,Asatryan Murad,Rafayelyan Edgar,fiurst,Asatryan Murad - Rafayelyan Edgar,58,34,24,-10,10,16,20,22,0,0,-6,-2,-2,0,0,-10,11:5 - 11:9 - 12:10 - 0:0 - 0:0
20436331,2024-07-22 10:50:00,Hovhannesyan Rafik - Papyan Karen,3:1,6:11 - 11:4 - 11:5 - 11:6 - 0:0,3,1,Hovhannesyan Rafik,Papyan Karen,fiurst,Hovhannesyan Rafik - Papyan Karen,65,39,26,-13,13,17,15,16,17,0,5,-7,-6,-5,0,-13,6:11 - 11:4 - 11:5 - 11:6 - 0:0
20436328,2024-07-22 10:30:00,Diaryan Aleksandr - Asatryan Murad,2:3,11:6 - 10:12 - 7:11 - 11:6 - 11:9,3,2,Diaryan Aleksandr,Asatryan Murad,fiurst,Asatryan Murad - Diaryan Aleksandr,94,44,50,6,-6,17,22,18,17,20,5,-2,-4,5,2,6,6:11 - 12:10 - 11:7 - 6:11 - 9:11
20436327,2024-07-22 10:15:00,Papyan Karen - Rafayelyan Edgar,1:3,4:11 - 7:11 - 11:9 - 9:11 - 0:0,1,3,Papyan Karen,Rafayelyan Edgar,fiurst,Papyan Karen - Rafayelyan Edgar,73,31,42,11,-11,15,18,20,20,0,7,4,-2,2,0,11,4:11 - 7:11 - 11:9 - 9:11 - 0:0
20436325,2024-07-22 10:00:00,Hovhannesyan Rafik - Diaryan Aleksandr,3:0,7:11 - 8:11 - 10:12 - 0:0 - 0:0,0,3,Hovhannesyan Rafik,Diaryan Aleksandr,fiurst,Diaryan Aleksandr - Hovhannesyan Rafik,59,34,25,-9,9,18,19,22,0,0,-4,-3,-2,0,0,-9,11:7 - 11:8 - 12:10 - 0:0 - 0:0
20419563,2024-07-21 15:15:00,Nikoghosyan Narek - Diaryan Aleksandr,3:1,11:7 - 7:11 - 5:11 - 7:11 - 0:0,1,3,Nikoghosyan Narek,Diaryan Aleksandr,fiurst,Diaryan Aleksandr - Nikoghosyan Narek,70,40,30,-10,10,18,18,16,18,0,4,-4,-6,-4,0,-10,7:11 - 11:7 - 11:5 - 11:7 - 0:0
20419551,2024-07-21 15:00:00,Rafayelyan Edgar - Gevorgyan Hayk,0:3,11:8 - 11:7 - 11:8 - 0:0 - 0:0,3,0,Rafayelyan Edgar,Gevorgyan Hayk,fiurst,Gevorgyan Hayk - Rafayelyan Edgar,56,23,33,10,-10,19,18,19,0,0,3,4,3,0,0,10,8:11 - 7:11 - 8:11 - 0:0 - 0:0
20419548,2024-07-21 14:45:00,Asatryan Murad - Nikoghosyan Narek,3:0,11:8 - 11:6 - 11:6 - 0:0 - 0:0,3,0,Asatryan Murad,Nikoghosyan Narek,fiurst,Asatryan Murad - Nikoghosyan Narek,53,33,20,-13,13,19,17,17,0,0,-3,-5,-5,0,0,-13,11:8 - 11:6 - 11:6 - 0:0 - 0:0
20419547,2024-07-21 14:30:00,Diaryan Aleksandr - Rafayelyan Edgar,2:3,7:11 - 9:11 - 11:9 - 11:6 - 6:11,2,3,Diaryan Aleksandr,Rafayelyan Edgar,fiurst,Diaryan Aleksandr - Rafayelyan Edgar,92,44,48,4,-4,18,20,20,17,17,4,2,-2,-5,5,4,7:11 - 9:11 - 11:9 - 11:6 - 6:11
20419546,2024-07-21 14:15:00,Asatryan Murad - Gevorgyan Hayk,3:0,11:4 - 11:5 - 11:2 - 0:0 - 0:0,3,0,Asatryan Murad,Gevorgyan Hayk,fiurst,Asatryan Murad - Gevorgyan Hayk,44,33,11,-22,22,15,16,13,0,0,-7,-6,-9,0,0,-22,11:4 - 11:5 - 11:2 - 0:0 - 0:0
20419542,2024-07-21 14:00:00,Nikoghosyan Narek - Rafayelyan Edgar,0:3,6:11 - 1:11 - 10:12 - 0:0 - 0:0,0,3,Nikoghosyan Narek,Rafayelyan Edgar,fiurst,Nikoghosyan Narek - Rafayelyan Edgar,51,17,34,17,-17,17,12,22,0,0,5,10,2,0,0,17,6:11 - 1:11 - 10:12 - 0:0 - 0:0
20419540,2024-07-21 13:50:00,Diaryan Aleksandr - Asatryan Murad,3:1,9:11 - 11:8 - 8:11 - 5:11 - 0:0,1,3,Diaryan Aleksandr,Asatryan Murad,fiurst,Asatryan Murad - Diaryan Aleksandr,74,41,33,-8,8,20,19,19,16,0,-2,3,-3,-6,0,-8,11:9 - 8:11 - 11:8 - 11:5 - 0:0
20419539,2024-07-21 13:30:00,Gevorgyan Hayk - Nikoghosyan Narek,0:3,6:11 - 5:11 - 5:11 - 0:0 - 0:0,0,3,Gevorgyan Hayk,Nikoghosyan Narek,fiurst,Gevorgyan Hayk - Nikoghosyan Narek,49,16,33,17,-17,17,16,16,0,0,5,6,6,0,0,17,6:11 - 5:11 - 5:11 - 0:0 - 0:0
20419536,2024-07-21 13:15:00,Rafayelyan Edgar - Asatryan Murad,3:1,6:11 - 11:8 - 4:11 - 5:11 - 0:0,1,3,Rafayelyan Edgar,Asatryan Murad,fiurst,Asatryan Murad - Rafayelyan Edgar,67,41,26,-15,15,17,19,15,16,0,-5,3,-7,-6,0,-15,11:6 - 8:11 - 11:4 - 11:5 - 0:0
20419528,2024-07-21 13:00:00,Gevorgyan Hayk - Diaryan Aleksandr,3:0,7:11 - 4:11 - 5:11 - 0:0 - 0:0,0,3,Gevorgyan Hayk,Diaryan Aleksandr,fiurst,Diaryan Aleksandr - Gevorgyan Hayk,49,33,16,-17,17,18,15,16,0,0,-4,-7,-6,0,0,-17,11:7 - 11:4 - 11:5 - 0:0 - 0:0
20419519,2024-07-21 12:20:00,Nikoghosyan Narek - Asatryan Murad,3:0,6:11 - 7:11 - 10:12 - 0:0 - 0:0,0,3,Nikoghosyan Narek,Asatryan Murad,fiurst,Asatryan Murad - Nikoghosyan Narek,57,34,23,-11,11,17,18,22,0,0,-5,-4,-2,0,0,-11,11:6 - 11:7 - 12:10 - 0:0 - 0:0
20419515,2024-07-21 12:00:00,Gevorgyan Hayk - Rafayelyan Edgar,1:3,11:8 - 8:11 - 6:11 - 9:11 - 0:0,1,3,Gevorgyan Hayk,Rafayelyan Edgar,fiurst,Gevorgyan Hayk - Rafayelyan Edgar,75,34,41,7,-7,19,19,17,20,0,-3,3,5,2,0,7,11:8 - 8:11 - 6:11 - 9:11 - 0:0
20419514,2024-07-21 11:45:00,Diaryan Aleksandr - Nikoghosyan Narek,3:0,12:10 - 11:6 - 11:9 - 0:0 - 0:0,3,0,Diaryan Aleksandr,Nikoghosyan Narek,fiurst,Diaryan Aleksandr - Nikoghosyan Narek,59,34,25,-9,9,22,17,20,0,0,-2,-5,-2,0,0,-9,12:10 - 11:6 - 11:9 - 0:0 - 0:0
20419510,2024-07-21 11:30:00,Gevorgyan Hayk - Asatryan Murad,3:1,11:7 - 8:11 - 5:11 - 9:11 - 0:0,1,3,Gevorgyan Hayk,Asatryan Murad,fiurst,Asatryan Murad - Gevorgyan Hayk,73,40,33,-7,7,18,19,16,20,0,4,-3,-6,-2,0,-7,7:11 - 11:8 - 11:5 - 11:9 - 0:0
20419509,2024-07-21 11:15:00,Rafayelyan Edgar - Diaryan Aleksandr,3:1,11:9 - 9:11 - 9:11 - 7:11 - 0:0,1,3,Rafayelyan Edgar,Diaryan Aleksandr,fiurst,Diaryan Aleksandr - Rafayelyan Edgar,78,42,36,-6,6,20,20,20,18,0,2,-2,-2,-4,0,-6,9:11 - 11:9 - 11:9 - 11:7 - 0:0
20419503,2024-07-21 11:00:00,Nikoghosyan Narek - Gevorgyan Hayk,0:3,11:6 - 11:1 - 11:5 - 0:0 - 0:0,3,0,Nikoghosyan Narek,Gevorgyan Hayk,fiurst,Gevorgyan Hayk - Nikoghosyan Narek,45,12,33,21,-21,17,12,16,0,0,5,10,6,0,0,21,6:11 - 1:11 - 5:11 - 0:0 - 0:0
20419490,2024-07-21 10:45:00,Asatryan Murad - Diaryan Aleksandr,3:0,11:9 - 11:2 - 11:5 - 0:0 - 0:0,3,0,Asatryan Murad,Diaryan Aleksandr,fiurst,Asatryan Murad - Diaryan Aleksandr,49,33,16,-17,17,20,13,16,0,0,-2,-9,-6,0,0,-17,11:9 - 11:2 - 11:5 - 0:0 - 0:0
20419487,2024-07-21 10:30:00,Rafayelyan Edgar - Nikoghosyan Narek,1:3,11:7 - 11:13 - 11:6 - 11:3 - 0:0,3,1,Rafayelyan Edgar,Nikoghosyan Narek,fiurst,Nikoghosyan Narek - Rafayelyan Edgar,73,29,44,15,-15,18,24,17,14,0,4,-2,5,8,0,15,7:11 - 13:11 - 6:11 - 3:11 - 0:0
20419483,2024-07-21 10:15:00,Diaryan Aleksandr - Gevorgyan Hayk,3:1,11:6 - 11:5 - 9:11 - 11:2 - 0:0,3,1,Diaryan Aleksandr,Gevorgyan Hayk,fiurst,Diaryan Aleksandr - Gevorgyan Hayk,66,42,24,-18,18,17,16,20,13,0,-5,-6,2,-9,0,-18,11:6 - 11:5 - 9:11 - 11:2 - 0:0
20419480,2024-07-21 10:00:00,Asatryan Murad - Rafayelyan Edgar,3:0,11:5 - 11:6 - 11:4 - 0:0 - 0:0,3,0,Asatryan Murad,Rafayelyan Edgar,fiurst,Asatryan Murad - Rafayelyan Edgar,48,33,15,-18,18,16,17,15,0,0,-6,-5,-7,0,0,-18,11:5 - 11:6 - 11:4 - 0:0 - 0:0
20398998,2024-07-20 15:25:00,Gevorgyan Hayk - Hovhannesyan Rafik,1:3,11:5 - 12:14 - 6:11 - 9:11 - 0:0,1,3,Gevorgyan Hayk,Hovhannesyan Rafik,fiurst,Gevorgyan Hayk - Hovhannesyan Rafik,79,38,41,3,-3,16,26,17,20,0,-6,2,5,2,0,3,11:5 - 12:14 - 6:11 - 9:11 - 0:0
20398996,2024-07-20 15:10:00,Asatryan Murad - Diaryan Aleksandr,1:3,9:11 - 12:10 - 5:11 - 9:11 - 0:0,1,3,Asatryan Murad,Diaryan Aleksandr,fiurst,Asatryan Murad - Diaryan Aleksandr,78,35,43,8,-8,20,22,16,20,0,2,-2,6,2,0,8,9:11 - 12:10 - 5:11 - 9:11 - 0:0
20398982,2024-07-20 14:45:00,Nikoghosyan Narek - Gevorgyan Hayk,3:2,11:5 - 7:11 - 4:11 - 11:8 - 9:11,2,3,Nikoghosyan Narek,Gevorgyan Hayk,fiurst,Gevorgyan Hayk - Nikoghosyan Narek,88,46,42,-4,4,16,18,15,19,20,6,-4,-7,3,-2,-4,5:11 - 11:7 - 11:4 - 8:11 - 11:9
20398978,2024-07-20 14:30:00,Hovhannesyan Rafik - Asatryan Murad,3:2,12:10 - 11:8 - 3:11 - 10:12 - 4:11,2,3,Hovhannesyan Rafik,Asatryan Murad,fiurst,Asatryan Murad - Hovhannesyan Rafik,92,52,40,-12,12,22,19,14,22,15,2,3,-8,-2,-7,-12,10:12 - 8:11 - 11:3 - 12:10 - 11:4
20398975,2024-07-20 14:15:00,Nikoghosyan Narek - Diaryan Aleksandr,3:0,7:11 - 6:11 - 8:11 - 0:0 - 0:0,0,3,Nikoghosyan Narek,Diaryan Aleksandr,fiurst,Diaryan Aleksandr - Nikoghosyan Narek,54,33,21,-12,12,18,17,19,0,0,-4,-5,-3,0,0,-12,11:7 - 11:6 - 11:8 - 0:0 - 0:0
20398973,2024-07-20 14:00:00,Gevorgyan Hayk - Asatryan Murad,3:0,6:11 - 6:11 - 7:11 - 0:0 - 0:0,0,3,Gevorgyan Hayk,Asatryan Murad,fiurst,Asatryan Murad - Gevorgyan Hayk,52,33,19,-14,14,17,17,18,0,0,-5,-5,-4,0,0,-14,11:6 - 11:6 - 11:7 - 0:0 - 0:0
20398972,2024-07-20 13:50:00,Hovhannesyan Rafik - Nikoghosyan Narek,3:2,2:11 - 11:7 - 12:14 - 11:3 - 11:5,3,2,Hovhannesyan Rafik,Nikoghosyan Narek,fiurst,Hovhannesyan Rafik - Nikoghosyan Narek,87,47,40,-7,7,13,18,26,14,16,9,-4,2,-8,-6,-7,2:11 - 11:7 - 12:14 - 11:3 - 11:5
20398971,2024-07-20 13:30:00,Diaryan Aleksandr - Gevorgyan Hayk,3:0,13:11 - 11:9 - 11:2 - 0:0 - 0:0,3,0,Diaryan Aleksandr,Gevorgyan Hayk,fiurst,Diaryan Aleksandr - Gevorgyan Hayk,57,35,22,-13,13,24,20,13,0,0,-2,-2,-9,0,0,-13,13:11 - 11:9 - 11:2 - 0:0 - 0:0
20398961,2024-07-20 13:25:00,Asatryan Murad - Nikoghosyan Narek,3:0,11:8 - 13:11 - 11:6 - 0:0 - 0:0,3,0,Asatryan Murad,Nikoghosyan Narek,fiurst,Asatryan Murad - Nikoghosyan Narek,60,35,25,-10,10,19,24,17,0,0,-3,-2,-5,0,0,-10,11:8 - 13:11 - 11:6 - 0:0 - 0:0
20398956,2024-07-20 13:00:00,Diaryan Aleksandr - Hovhannesyan Rafik,3:1,11:9 - 11:8 - 8:11 - 11:5 - 0:0,3,1,Diaryan Aleksandr,Hovhannesyan Rafik,fiurst,Diaryan Aleksandr - Hovhannesyan Rafik,74,41,33,-8,8,20,19,19,16,0,-2,-3,3,-6,0,-8,11:9 - 11:8 - 8:11 - 11:5 - 0:0
20398954,2024-07-20 12:20:00,Gevorgyan Hayk - Nikoghosyan Narek,2:3,11:7 - 13:11 - 9:11 - 8:11 - 10:12,2,3,Gevorgyan Hayk,Nikoghosyan Narek,fiurst,Gevorgyan Hayk - Nikoghosyan Narek,103,51,52,1,-1,18,24,20,19,22,-4,-2,2,3,2,1,11:7 - 13:11 - 9:11 - 8:11 - 10:12
20398951,2024-07-20 12:05:00,Diaryan Aleksandr - Asatryan Murad,2:3,11:6 - 8:11 - 11:8 - 3:11 - 11:6,3,2,Diaryan Aleksandr,Asatryan Murad,fiurst,Asatryan Murad - Diaryan Aleksandr,86,42,44,2,-2,17,19,19,14,17,5,-3,3,-8,5,2,6:11 - 11:8 - 8:11 - 11:3 - 6:11
20398950,2024-07-20 11:50:00,Hovhannesyan Rafik - Gevorgyan Hayk,1:3,11:9 - 13:15 - 11:8 - 11:7 - 0:0,3,1,Hovhannesyan Rafik,Gevorgyan Hayk,fiurst,Gevorgyan Hayk - Hovhannesyan Rafik,85,39,46,7,-7,20,28,19,18,0,2,-2,3,4,0,7,9:11 - 15:13 - 8:11 - 7:11 - 0:0
20398937,2024-07-20 11:30:00,Diaryan Aleksandr - Nikoghosyan Narek,3:1,9:11 - 11:9 - 11:4 - 11:4 - 0:0,3,1,Diaryan Aleksandr,Nikoghosyan Narek,fiurst,Diaryan Aleksandr - Nikoghosyan Narek,70,42,28,-14,14,20,20,15,15,0,2,-2,-7,-7,0,-14,9:11 - 11:9 - 11:4 - 11:4 - 0:0
20398936,2024-07-20 11:20:00,Asatryan Murad - Hovhannesyan Rafik,3:0,11:6 - 11:6 - 11:3 - 0:0 - 0:0,3,0,Asatryan Murad,Hovhannesyan Rafik,fiurst,Asatryan Murad - Hovhannesyan Rafik,48,33,15,-18,18,17,17,14,0,0,-5,-5,-8,0,0,-18,11:6 - 11:6 - 11:3 - 0:0 - 0:0
20398934,2024-07-20 11:05:00,Gevorgyan Hayk - Diaryan Aleksandr,3:0,2:11 - 5:11 - 6:11 - 0:0 - 0:0,0,3,Gevorgyan Hayk,Diaryan Aleksandr,fiurst,Diaryan Aleksandr - Gevorgyan Hayk,46,33,13,-20,20,13,16,17,0,0,-9,-6,-5,0,0,-20,11:2 - 11:5 - 11:6 - 0:0 - 0:0
20398876,2024-07-20 10:45:00,Nikoghosyan Narek - Hovhannesyan Rafik,3:0,8:11 - 9:11 - 9:11 - 0:0 - 0:0,0,3,Nikoghosyan Narek,Hovhannesyan Rafik,fiurst,Hovhannesyan Rafik - Nikoghosyan Narek,59,33,26,-7,7,19,20,20,0,0,-3,-2,-2,0,0,-7,11:8 - 11:9 - 11:9 - 0:0 - 0:0
20398869,2024-07-20 10:40:00,Asatryan Murad - Gevorgyan Hayk,3:0,11:4 - 11:8 - 11:9 - 0:0 - 0:0,3,0,Asatryan Murad,Gevorgyan Hayk,fiurst,Asatryan Murad - Gevorgyan Hayk,54,33,21,-12,12,15,19,20,0,0,-7,-3,-2,0,0,-12,11:4 - 11:8 - 11:9 - 0:0 - 0:0
20398867,2024-07-20 10:15:00,Hovhannesyan Rafik - Diaryan Aleksandr,3:0,5:11 - 3:11 - 6:11 - 0:0 - 0:0,0,3,Hovhannesyan Rafik,Diaryan Aleksandr,fiurst,Diaryan Aleksandr - Hovhannesyan Rafik,47,33,14,-19,19,16,14,17,0,0,-6,-8,-5,0,0,-19,11:5 - 11:3 - 11:6 - 0:0 - 0:0
20382345,2024-07-19 15:20:00,Rafayelyan Edgar - Asatryan Murad,2:3,11:8 - 1:11 - 14:12 - 4:11 - 11:9,3,2,Rafayelyan Edgar,Asatryan Murad,fiurst,Asatryan Murad - Rafayelyan Edgar,92,51,41,-10,10,19,12,26,15,20,3,-10,2,-7,2,-10,8:11 - 11:1 - 12:14 - 11:4 - 9:11
20382341,2024-07-19 15:00:00,Hovhannesyan Rafik - Diaryan Aleksandr,3:0,9:11 - 8:11 - 6:11 - 0:0 - 0:0,0,3,Hovhannesyan Rafik,Diaryan Aleksandr,fiurst,Diaryan Aleksandr - Hovhannesyan Rafik,56,33,23,-10,10,20,19,17,0,0,-2,-3,-5,0,0,-10,11:9 - 11:8 - 11:6 - 0:0 - 0:0
20382340,2024-07-19 14:45:00,Gevorgyan Hayk - Rafayelyan Edgar,1:3,11:9 - 7:11 - 7:11 - 9:11 - 0:0,1,3,Gevorgyan Hayk,Rafayelyan Edgar,fiurst,Gevorgyan Hayk - Rafayelyan Edgar,76,34,42,8,-8,20,18,18,20,0,-2,4,4,2,0,8,11:9 - 7:11 - 7:11 - 9:11 - 0:0
20382338,2024-07-19 14:30:00,Asatryan Murad - Hovhannesyan Rafik,3:0,11:6 - 11:5 - 11:2 - 0:0 - 0:0,3,0,Asatryan Murad,Hovhannesyan Rafik,fiurst,Asatryan Murad - Hovhannesyan Rafik,46,33,13,-20,20,17,16,13,0,0,-5,-6,-9,0,0,-20,11:6 - 11:5 - 11:2 - 0:0 - 0:0
20382336,2024-07-19 14:20:00,Gevorgyan Hayk - Diaryan Aleksandr,3:0,8:11 - 7:11 - 5:11 - 0:0 - 0:0,0,3,Gevorgyan Hayk,Diaryan Aleksandr,fiurst,Diaryan Aleksandr - Gevorgyan Hayk,53,33,20,-13,13,19,18,16,0,0,-3,-4,-6,0,0,-13,11:8 - 11:7 - 11:5 - 0:0 - 0:0
20382335,2024-07-19 14:00:00,Rafayelyan Edgar - Hovhannesyan Rafik,1:3,7:11 - 11:6 - 11:8 - 11:7 - 0:0,3,1,Rafayelyan Edgar,Hovhannesyan Rafik,fiurst,Hovhannesyan Rafik - Rafayelyan Edgar,72,32,40,8,-8,18,17,19,18,0,-4,5,3,4,0,8,11:7 - 6:11 - 8:11 - 7:11 - 0:0
20382332,2024-07-19 13:50:00,Asatryan Murad - Gevorgyan Hayk,3:1,11:3 - 11:4 - 7:11 - 11:5 - 0:0,3,1,Asatryan Murad,Gevorgyan Hayk,fiurst,Asatryan Murad - Gevorgyan Hayk,63,40,23,-17,17,14,15,18,16,0,-8,-7,4,-6,0,-17,11:3 - 11:4 - 7:11 - 11:5 - 0:0
20382329,2024-07-19 13:30:00,Diaryan Aleksandr - Rafayelyan Edgar,2:3,8:11 - 11:2 - 11:9 - 9:11 - 3:11,2,3,Diaryan Aleksandr,Rafayelyan Edgar,fiurst,Diaryan Aleksandr - Rafayelyan Edgar,86,42,44,2,-2,19,13,20,20,14,3,-9,-2,2,8,2,8:11 - 11:2 - 11:9 - 9:11 - 3:11
20382316,2024-07-19 13:15:00,Hovhannesyan Rafik - Gevorgyan Hayk,3:0,4:11 - 7:11 - 3:11 - 0:0 - 0:0,0,3,Hovhannesyan Rafik,Gevorgyan Hayk,fiurst,Gevorgyan Hayk - Hovhannesyan Rafik,47,33,14,-19,19,15,18,14,0,0,-7,-4,-8,0,0,-19,11:4 - 11:7 - 11:3 - 0:0 - 0:0
20382314,2024-07-19 13:00:00,Diaryan Aleksandr - Asatryan Murad,3:0,9:11 - 6:11 - 9:11 - 0:0 - 0:0,0,3,Diaryan Aleksandr,Asatryan Murad,fiurst,Asatryan Murad - Diaryan Aleksandr,57,33,24,-9,9,20,17,20,0,0,-2,-5,-2,0,0,-9,11:9 - 11:6 - 11:9 - 0:0 - 0:0
20382305,2024-07-19 12:15:00,Rafayelyan Edgar - Gevorgyan Hayk,1:3,11:6 - 11:9 - 8:11 - 11:3 - 0:0,3,1,Rafayelyan Edgar,Gevorgyan Hayk,fiurst,Gevorgyan Hayk - Rafayelyan Edgar,70,29,41,12,-12,17,20,19,14,0,5,2,-3,8,0,12,6:11 - 9:11 - 11:8 - 3:11 - 0:0
20382303,2024-07-19 12:00:00,Diaryan Aleksandr - Hovhannesyan Rafik,3:0,11:7 - 11:5 - 11:3 - 0:0 - 0:0,3,0,Diaryan Aleksandr,Hovhannesyan Rafik,fiurst,Diaryan Aleksandr - Hovhannesyan Rafik,48,33,15,-18,18,18,16,14,0,0,-4,-6,-8,0,0,-18,11:7 - 11:5 - 11:3 - 0:0 - 0:0
20382301,2024-07-19 11:45:00,Asatryan Murad - Rafayelyan Edgar,3:0,11:6 - 11:8 - 11:4 - 0:0 - 0:0,3,0,Asatryan Murad,Rafayelyan Edgar,fiurst,Asatryan Murad - Rafayelyan Edgar,51,33,18,-15,15,17,19,15,0,0,-5,-3,-7,0,0,-15,11:6 - 11:8 - 11:4 - 0:0 - 0:0
20382299,2024-07-19 11:30:00,Diaryan Aleksandr - Gevorgyan Hayk,3:0,11:6 - 11:4 - 11:3 - 0:0 - 0:0,3,0,Diaryan Aleksandr,Gevorgyan Hayk,fiurst,Diaryan Aleksandr - Gevorgyan Hayk,46,33,13,-20,20,17,15,14,0,0,-5,-7,-8,0,0,-20,11:6 - 11:4 - 11:3 - 0:0 - 0:0
20382296,2024-07-19 11:15:00,Hovhannesyan Rafik - Asatryan Murad,3:1,13:11 - 10:12 - 10:12 - 4:11 - 0:0,1,3,Hovhannesyan Rafik,Asatryan Murad,fiurst,Asatryan Murad - Hovhannesyan Rafik,83,46,37,-9,9,24,22,22,15,0,2,-2,-2,-7,0,-9,11:13 - 12:10 - 12:10 - 11:4 - 0:0
20382283,2024-07-19 11:00:00,Rafayelyan Edgar - Diaryan Aleksandr,1:3,12:10 - 6:11 - 11:9 - 11:9 - 0:0,3,1,Rafayelyan Edgar,Diaryan Aleksandr,fiurst,Diaryan Aleksandr - Rafayelyan Edgar,79,39,40,1,-1,22,17,20,20,0,2,-5,2,2,0,1,10:12 - 11:6 - 9:11 - 9:11 - 0:0
20382279,2024-07-19 10:45:00,Gevorgyan Hayk - Asatryan Murad,3:0,5:11 - 8:11 - 5:11 - 0:0 - 0:0,0,3,Gevorgyan Hayk,Asatryan Murad,fiurst,Asatryan Murad - Gevorgyan Hayk,51,33,18,-15,15,16,19,16,0,0,-6,-3,-6,0,0,-15,11:5 - 11:8 - 11:5 - 0:0 - 0:0
20382278,2024-07-19 10:30:00,Hovhannesyan Rafik - Rafayelyan Edgar,1:3,5:11 - 13:11 - 6:11 - 2:11 - 0:0,1,3,Hovhannesyan Rafik,Rafayelyan Edgar,fiurst,Hovhannesyan Rafik - Rafayelyan Edgar,70,26,44,18,-18,16,24,17,13,0,6,-2,5,9,0,18,5:11 - 13:11 - 6:11 - 2:11 - 0:0
20382277,2024-07-19 10:15:00,Asatryan Murad - Diaryan Aleksandr,3:1,11:6 - 11:5 - 5:11 - 11:8 - 0:0,3,1,Asatryan Murad,Diaryan Aleksandr,fiurst,Asatryan Murad - Diaryan Aleksandr,68,38,30,-8,8,17,16,16,19,0,-5,-6,6,-3,0,-8,11:6 - 11:5 - 5:11 - 11:8 - 0:0
20382274,2024-07-19 10:00:00,Gevorgyan Hayk - Hovhannesyan Rafik,0:3,5:11 - 9:11 - 8:11 - 0:0 - 0:0,0,3,Gevorgyan Hayk,Hovhannesyan Rafik,fiurst,Gevorgyan Hayk - Hovhannesyan Rafik,55,22,33,11,-11,16,20,19,0,0,6,2,3,0,0,11,5:11 - 9:11 - 8:11 - 0:0 - 0:0
20359467,2024-07-18 15:25:00,Nikoghosyan Narek - Hovhannesyan Rafik,1:3,10:12 - 11:4 - 11:3 - 13:11 - 0:0,3,1,Nikoghosyan Narek,Hovhannesyan Rafik,fiurst,Hovhannesyan Rafik - Nikoghosyan Narek,75,30,45,15,-15,22,15,14,24,0,-2,7,8,2,0,15,12:10 - 4:11 - 3:11 - 11:13 - 0:0
20359465,2024-07-18 15:00:00,Rafayelyan Edgar - Gevorgyan Hayk,0:3,11:2 - 11:6 - 11:7 - 0:0 - 0:0,3,0,Rafayelyan Edgar,Gevorgyan Hayk,fiurst,Gevorgyan Hayk - Rafayelyan Edgar,48,15,33,18,-18,13,17,18,0,0,9,5,4,0,0,18,2:11 - 6:11 - 7:11 - 0:0 - 0:0
20359464,2024-07-18 14:45:00,Diaryan Aleksandr - Nikoghosyan Narek,1:3,8:11 - 11:9 - 10:12 - 6:11 - 0:0,1,3,Diaryan Aleksandr,Nikoghosyan Narek,fiurst,Diaryan Aleksandr - Nikoghosyan Narek,78,35,43,8,-8,19,20,22,17,0,3,-2,2,5,0,8,8:11 - 11:9 - 10:12 - 6:11 - 0:0
20359462,2024-07-18 14:30:00,Hovhannesyan Rafik - Rafayelyan Edgar,0:3,7:11 - 9:11 - 9:11 - 0:0 - 0:0,0,3,Hovhannesyan Rafik,Rafayelyan Edgar,fiurst,Hovhannesyan Rafik - Rafayelyan Edgar,58,25,33,8,-8,18,20,20,0,0,4,2,2,0,0,8,7:11 - 9:11 - 9:11 - 0:0 - 0:0
20359461,2024-07-18 14:20:00,Diaryan Aleksandr - Gevorgyan Hayk,3:0,11:4 - 11:5 - 11:5 - 0:0 - 0:0,3,0,Diaryan Aleksandr,Gevorgyan Hayk,fiurst,Diaryan Aleksandr - Gevorgyan Hayk,47,33,14,-19,19,15,16,16,0,0,-7,-6,-6,0,0,-19,11:4 - 11:5 - 11:5 - 0:0 - 0:0
20359460,2024-07-18 14:00:00,Nikoghosyan Narek - Rafayelyan Edgar,0:3,9:11 - 9:11 - 5:11 - 0:0 - 0:0,0,3,Nikoghosyan Narek,Rafayelyan Edgar,fiurst,Nikoghosyan Narek - Rafayelyan Edgar,56,23,33,10,-10,20,20,16,0,0,2,2,6,0,0,10,9:11 - 9:11 - 5:11 - 0:0 - 0:0
20359434,2024-07-18 13:45:00,Hovhannesyan Rafik - Diaryan Aleksandr,3:0,9:11 - 13:15 - 7:11 - 0:0 - 0:0,0,3,Hovhannesyan Rafik,Diaryan Aleksandr,fiurst,Diaryan Aleksandr - Hovhannesyan Rafik,66,37,29,-8,8,20,28,18,0,0,-2,-2,-4,0,0,-8,11:9 - 15:13 - 11:7 - 0:0 - 0:0
20359402,2024-07-18 13:40:00,Gevorgyan Hayk - Nikoghosyan Narek,0:3,4:11 - 4:11 - 4:11 - 0:0 - 0:0,0,3,Gevorgyan Hayk,Nikoghosyan Narek,fiurst,Gevorgyan Hayk - Nikoghosyan Narek,45,12,33,21,-21,15,15,15,0,0,7,7,7,0,0,21,4:11 - 4:11 - 4:11 - 0:0 - 0:0
20359366,2024-07-18 13:15:00,Rafayelyan Edgar - Diaryan Aleksandr,0:3,11:9 - 11:6 - 11:8 - 0:0 - 0:0,3,0,Rafayelyan Edgar,Diaryan Aleksandr,fiurst,Diaryan Aleksandr - Rafayelyan Edgar,56,23,33,10,-10,20,17,19,0,0,2,5,3,0,0,10,9:11 - 6:11 - 8:11 - 0:0 - 0:0
20359364,2024-07-18 13:00:00,Gevorgyan Hayk - Hovhannesyan Rafik,2:3,11:8 - 5:11 - 11:13 - 11:8 - 4:11,2,3,Gevorgyan Hayk,Hovhannesyan Rafik,fiurst,Gevorgyan Hayk - Hovhannesyan Rafik,93,42,51,9,-9,19,16,24,19,15,-3,6,2,-3,7,9,11:8 - 5:11 - 11:13 - 11:8 - 4:11
20359361,2024-07-18 12:15:00,Nikoghosyan Narek - Diaryan Aleksandr,3:2,13:11 - 3:11 - 11:8 - 13:15 - 11:13,2,3,Nikoghosyan Narek,Diaryan Aleksandr,fiurst,Diaryan Aleksandr - Nikoghosyan Narek,109,58,51,-7,7,24,14,19,28,24,2,-8,3,-2,-2,-7,11:13 - 11:3 - 8:11 - 15:13 - 13:11
20359355,2024-07-18 12:00:00,Gevorgyan Hayk - Rafayelyan Edgar,1:3,11:9 - 4:11 - 8:11 - 5:11 - 0:0,1,3,Gevorgyan Hayk,Rafayelyan Edgar,fiurst,Gevorgyan Hayk - Rafayelyan Edgar,70,28,42,14,-14,20,15,19,16,0,-2,7,3,6,0,14,11:9 - 4:11 - 8:11 - 5:11 - 0:0
20359334,2024-07-18 11:45:00,Hovhannesyan Rafik - Nikoghosyan Narek,3:0,14:12 - 11:7 - 11:8 - 0:0 - 0:0,3,0,Hovhannesyan Rafik,Nikoghosyan Narek,fiurst,Hovhannesyan Rafik - Nikoghosyan Narek,63,36,27,-9,9,26,18,19,0,0,-2,-4,-3,0,0,-9,14:12 - 11:7 - 11:8 - 0:0 - 0:0
20359332,2024-07-18 11:30:00,Gevorgyan Hayk - Diaryan Aleksandr,3:0,8:11 - 6:11 - 8:11 - 0:0 - 0:0,0,3,Gevorgyan Hayk,Diaryan Aleksandr,fiurst,Diaryan Aleksandr - Gevorgyan Hayk,55,33,22,-11,11,19,17,19,0,0,-3,-5,-3,0,0,-11,11:8 - 11:6 - 11:8 - 0:0 - 0:0
20359330,2024-07-18 11:15:00,Rafayelyan Edgar - Hovhannesyan Rafik,0:3,11:4 - 11:6 - 11:9 - 0:0 - 0:0,3,0,Rafayelyan Edgar,Hovhannesyan Rafik,fiurst,Hovhannesyan Rafik - Rafayelyan Edgar,52,19,33,14,-14,15,17,20,0,0,7,5,2,0,0,14,4:11 - 6:11 - 9:11 - 0:0 - 0:0
20359328,2024-07-18 11:00:00,Nikoghosyan Narek - Gevorgyan Hayk,0:3,11:4 - 11:4 - 11:6 - 0:0 - 0:0,3,0,Nikoghosyan Narek,Gevorgyan Hayk,fiurst,Gevorgyan Hayk - Nikoghosyan Narek,47,14,33,19,-19,15,15,17,0,0,7,7,5,0,0,19,4:11 - 4:11 - 6:11 - 0:0 - 0:0
20359324,2024-07-18 10:45:00,Diaryan Aleksandr - Hovhannesyan Rafik,3:0,11:8 - 11:6 - 11:8 - 0:0 - 0:0,3,0,Diaryan Aleksandr,Hovhannesyan Rafik,fiurst,Diaryan Aleksandr - Hovhannesyan Rafik,55,33,22,-11,11,19,17,19,0,0,-3,-5,-3,0,0,-11,11:8 - 11:6 - 11:8 - 0:0 - 0:0
20359320,2024-07-18 10:30:00,Rafayelyan Edgar - Nikoghosyan Narek,0:3,12:10 - 12:10 - 11:9 - 0:0 - 0:0,3,0,Rafayelyan Edgar,Nikoghosyan Narek,fiurst,Nikoghosyan Narek - Rafayelyan Edgar,64,29,35,6,-6,22,22,20,0,0,2,2,2,0,0,6,10:12 - 10:12 - 9:11 - 0:0 - 0:0
20359317,2024-07-18 10:15:00,Hovhannesyan Rafik - Gevorgyan Hayk,0:3,11:7 - 13:11 - 11:2 - 0:0 - 0:0,3,0,Hovhannesyan Rafik,Gevorgyan Hayk,fiurst,Gevorgyan Hayk - Hovhannesyan Rafik,55,20,35,15,-15,18,24,13,0,0,4,2,9,0,0,15,7:11 - 11:13 - 2:11 - 0:0 - 0:0
20359302,2024-07-18 10:00:00,Diaryan Aleksandr - Rafayelyan Edgar,1:3,11:7 - 7:11 - 9:11 - 8:11 - 0:0,1,3,Diaryan Aleksandr,Rafayelyan Edgar,fiurst,Diaryan Aleksandr - Rafayelyan Edgar,75,35,40,5,-5,18,18,20,19,0,-4,4,2,3,0,5,11:7 - 7:11 - 9:11 - 8:11 - 0:0
20332901,2024-07-17 15:15:00,Asatryan Murad - Diaryan Aleksandr,3:1,11:9 - 11:9 - 11:13 - 13:11 - 0:0,3,1,Asatryan Murad,Diaryan Aleksandr,fiurst,Asatryan Murad - Diaryan Aleksandr,88,46,42,-4,4,20,20,24,24,0,-2,-2,2,-2,0,-4,11:9 - 11:9 - 11:13 - 13:11 - 0:0
20332881,2024-07-17 15:00:00,Gevorgyan Hayk - Nikoghosyan Narek,1:3,7:11 - 7:11 - 11:5 - 7:11 - 0:0,1,3,Gevorgyan Hayk,Nikoghosyan Narek,fiurst,Gevorgyan Hayk - Nikoghosyan Narek,70,32,38,6,-6,18,18,16,18,0,4,4,-6,4,0,6,7:11 - 7:11 - 11:5 - 7:11 - 0:0
20332876,2024-07-17 14:45:00,Rafayelyan Edgar - Asatryan Murad,3:0,10:12 - 7:11 - 8:11 - 0:0 - 0:0,0,3,Rafayelyan Edgar,Asatryan Murad,fiurst,Asatryan Murad - Rafayelyan Edgar,59,34,25,-9,9,22,18,19,0,0,-2,-4,-3,0,0,-9,12:10 - 11:7 - 11:8 - 0:0 - 0:0
20332867,2024-07-17 14:35:00,Diaryan Aleksandr - Gevorgyan Hayk,3:1,11:4 - 11:3 - 9:11 - 11:3 - 0:0,3,1,Diaryan Aleksandr,Gevorgyan Hayk,fiurst,Diaryan Aleksandr - Gevorgyan Hayk,63,42,21,-21,21,15,14,20,14,0,-7,-8,2,-8,0,-21,11:4 - 11:3 - 9:11 - 11:3 - 0:0
20332866,2024-07-17 14:15:00,Rafayelyan Edgar - Nikoghosyan Narek,1:3,11:6 - 11:3 - 8:11 - 11:3 - 0:0,3,1,Rafayelyan Edgar,Nikoghosyan Narek,fiurst,Nikoghosyan Narek - Rafayelyan Edgar,64,23,41,18,-18,17,14,19,14,0,5,8,-3,8,0,18,6:11 - 3:11 - 11:8 - 3:11 - 0:0
20332865,2024-07-17 14:00:00,Asatryan Murad - Gevorgyan Hayk,3:0,11:4 - 11:5 - 11:6 - 0:0 - 0:0,3,0,Asatryan Murad,Gevorgyan Hayk,fiurst,Asatryan Murad - Gevorgyan Hayk,48,33,15,-18,18,15,16,17,0,0,-7,-6,-5,0,0,-18,11:4 - 11:5 - 11:6 - 0:0 - 0:0
20332852,2024-07-17 13:45:00,Diaryan Aleksandr - Rafayelyan Edgar,3:1,11:8 - 4:11 - 11:5 - 11:4 - 0:0,3,1,Diaryan Aleksandr,Rafayelyan Edgar,fiurst,Diaryan Aleksandr - Rafayelyan Edgar,65,37,28,-9,9,19,15,16,15,0,-3,7,-6,-7,0,-9,11:8 - 4:11 - 11:5 - 11:4 - 0:0
20332847,2024-07-17 13:30:00,Nikoghosyan Narek - Asatryan Murad,3:1,5:11 - 11:8 - 10:12 - 9:11 - 0:0,1,3,Nikoghosyan Narek,Asatryan Murad,fiurst,Asatryan Murad - Nikoghosyan Narek,77,42,35,-7,7,16,19,22,20,0,-6,3,-2,-2,0,-7,11:5 - 8:11 - 12:10 - 11:9 - 0:0
20332840,2024-07-17 13:15:00,Gevorgyan Hayk - Rafayelyan Edgar,1:3,4:11 - 16:14 - 8:11 - 5:11 - 0:0,1,3,Gevorgyan Hayk,Rafayelyan Edgar,fiurst,Gevorgyan Hayk - Rafayelyan Edgar,80,33,47,14,-14,15,30,19,16,0,7,-2,3,6,0,14,4:11 - 16:14 - 8:11 - 5:11 - 0:0
20332837,2024-07-17 13:00:00,Nikoghosyan Narek - Diaryan Aleksandr,3:0,8:11 - 13:15 - 3:11 - 0:0 - 0:0,0,3,Nikoghosyan Narek,Diaryan Aleksandr,fiurst,Diaryan Aleksandr - Nikoghosyan Narek,61,37,24,-13,13,19,28,14,0,0,-3,-2,-8,0,0,-13,11:8 - 15:13 - 11:3 - 0:0 - 0:0
20332835,2024-07-17 12:20:00,Asatryan Murad - Rafayelyan Edgar,3:2,11:4 - 10:12 - 11:6 - 8:11 - 11:9,3,2,Asatryan Murad,Rafayelyan Edgar,fiurst,Asatryan Murad - Rafayelyan Edgar,93,51,42,-9,9,15,22,17,19,20,-7,2,-5,3,-2,-9,11:4 - 10:12 - 11:6 - 8:11 - 11:9
20332833,2024-07-17 12:00:00,Nikoghosyan Narek - Gevorgyan Hayk,1:3,8:11 - 11:9 - 11:6 - 11:5 - 0:0,3,1,Nikoghosyan Narek,Gevorgyan Hayk,fiurst,Gevorgyan Hayk - Nikoghosyan Narek,72,31,41,10,-10,19,20,17,16,0,-3,2,5,6,0,10,11:8 - 9:11 - 6:11 - 5:11 - 0:0
20332832,2024-07-17 11:45:00,Diaryan Aleksandr - Asatryan Murad,3:2,11:9 - 11:4 - 9:11 - 6:11 - 8:11,2,3,Diaryan Aleksandr,Asatryan Murad,fiurst,Asatryan Murad - Diaryan Aleksandr,91,46,45,-1,1,20,15,20,17,19,2,7,-2,-5,-3,-1,9:11 - 4:11 - 11:9 - 11:6 - 11:8
20332831,2024-07-17 11:30:00,Nikoghosyan Narek - Rafayelyan Edgar,0:3,8:11 - 8:11 - 9:11 - 0:0 - 0:0,0,3,Nikoghosyan Narek,Rafayelyan Edgar,fiurst,Nikoghosyan Narek - Rafayelyan Edgar,58,25,33,8,-8,19,19,20,0,0,3,3,2,0,0,8,8:11 - 8:11 - 9:11 - 0:0 - 0:0
20332824,2024-07-17 11:15:00,Gevorgyan Hayk - Diaryan Aleksandr,3:0,4:11 - 7:11 - 5:11 - 0:0 - 0:0,0,3,Gevorgyan Hayk,Diaryan Aleksandr,fiurst,Diaryan Aleksandr - Gevorgyan Hayk,49,33,16,-17,17,15,18,16,0,0,-7,-4,-6,0,0,-17,11:4 - 11:7 - 11:5 - 0:0 - 0:0
20332823,2024-07-17 11:00:00,Asatryan Murad - Nikoghosyan Narek,3:0,12:10 - 11:1 - 11:5 - 0:0 - 0:0,3,0,Asatryan Murad,Nikoghosyan Narek,fiurst,Asatryan Murad - Nikoghosyan Narek,50,34,16,-18,18,22,12,16,0,0,-2,-10,-6,0,0,-18,12:10 - 11:1 - 11:5 - 0:0 - 0:0
20332821,2024-07-17 10:45:00,Rafayelyan Edgar - Diaryan Aleksandr,2:3,11:9 - 11:5 - 4:11 - 8:11 - 11:7,3,2,Rafayelyan Edgar,Diaryan Aleksandr,fiurst,Diaryan Aleksandr - Rafayelyan Edgar,88,43,45,2,-2,20,16,15,19,18,2,6,-7,-3,4,2,9:11 - 5:11 - 11:4 - 11:8 - 7:11
20332808,2024-07-17 10:30:00,Gevorgyan Hayk - Asatryan Murad,3:0,5:11 - 6:11 - 10:12 - 0:0 - 0:0,0,3,Gevorgyan Hayk,Asatryan Murad,fiurst,Asatryan Murad - Gevorgyan Hayk,55,34,21,-13,13,16,17,22,0,0,-6,-5,-2,0,0,-13,11:5 - 11:6 - 12:10 - 0:0 - 0:0
20332795,2024-07-17 10:15:00,Diaryan Aleksandr - Nikoghosyan Narek,3:0,11:9 - 11:1 - 11:4 - 0:0 - 0:0,3,0,Diaryan Aleksandr,Nikoghosyan Narek,fiurst,Diaryan Aleksandr - Nikoghosyan Narek,47,33,14,-19,19,20,12,15,0,0,-2,-10,-7,0,0,-19,11:9 - 11:1 - 11:4 - 0:0 - 0:0
20332793,2024-07-17 10:00:00,Rafayelyan Edgar - Gevorgyan Hayk,1:3,9:11 - 11:7 - 11:6 - 11:4 - 0:0,3,1,Rafayelyan Edgar,Gevorgyan Hayk,fiurst,Gevorgyan Hayk - Rafayelyan Edgar,70,28,42,14,-14,20,18,17,15,0,-2,4,5,7,0,14,11:9 - 7:11 - 6:11 - 4:11 - 0:0
20308415,2024-07-15 15:15:00,Hovhannesyan Rafik - Papyan Karen,1:3,11:2 - 7:11 - 7:11 - 8:11 - 0:0,1,3,Hovhannesyan Rafik,Papyan Karen,fiurst,Hovhannesyan Rafik - Papyan Karen,68,33,35,2,-2,13,18,18,19,0,-9,4,4,3,0,2,11:2 - 7:11 - 7:11 - 8:11 - 0:0
20308413,2024-07-15 15:10:00,Diaryan Aleksandr - Gevorgyan Hayk,3:1,8:11 - 11:5 - 11:5 - 11:4 - 0:0,3,1,Diaryan Aleksandr,Gevorgyan Hayk,fiurst,Diaryan Aleksandr - Gevorgyan Hayk,66,41,25,-16,16,19,16,16,15,0,3,-6,-6,-7,0,-16,8:11 - 11:5 - 11:5 - 11:4 - 0:0
20308411,2024-07-15 14:45:00,Asatryan Murad - Hovhannesyan Rafik,3:0,11:6 - 11:6 - 11:5 - 0:0 - 0:0,3,0,Asatryan Murad,Hovhannesyan Rafik,fiurst,Asatryan Murad - Hovhannesyan Rafik,50,33,17,-16,16,17,17,16,0,0,-5,-5,-6,0,0,-16,11:6 - 11:6 - 11:5 - 0:0 - 0:0
20308409,2024-07-15 14:30:00,Papyan Karen - Diaryan Aleksandr,1:3,11:5 - 11:13 - 11:9 - 15:13 - 0:0,3,1,Papyan Karen,Diaryan Aleksandr,fiurst,Diaryan Aleksandr - Papyan Karen,88,40,48,8,-8,16,24,20,28,0,6,-2,2,2,0,8,5:11 - 13:11 - 9:11 - 13:15 - 0:0
20308407,2024-07-15 14:15:00,Asatryan Murad - Gevorgyan Hayk,3:0,11:6 - 11:7 - 11:9 - 0:0 - 0:0,3,0,Asatryan Murad,Gevorgyan Hayk,fiurst,Asatryan Murad - Gevorgyan Hayk,55,33,22,-11,11,17,18,20,0,0,-5,-4,-2,0,0,-11,11:6 - 11:7 - 11:9 - 0:0 - 0:0
20308404,2024-07-15 14:05:00,Hovhannesyan Rafik - Diaryan Aleksandr,3:0,9:11 - 10:12 - 3:11 - 0:0 - 0:0,0,3,Hovhannesyan Rafik,Diaryan Aleksandr,fiurst,Diaryan Aleksandr - Hovhannesyan Rafik,56,34,22,-12,12,20,22,14,0,0,-2,-2,-8,0,0,-12,11:9 - 12:10 - 11:3 - 0:0 - 0:0
20308396,2024-07-15 13:45:00,Papyan Karen - Asatryan Murad,3:0,3:11 - 8:11 - 8:11 - 0:0 - 0:0,0,3,Papyan Karen,Asatryan Murad,fiurst,Asatryan Murad - Papyan Karen,52,33,19,-14,14,14,19,19,0,0,-8,-3,-3,0,0,-14,11:3 - 11:8 - 11:8 - 0:0 - 0:0
20308387,2024-07-15 13:30:00,Gevorgyan Hayk - Hovhannesyan Rafik,1:3,11:13 - 9:11 - 12:10 - 5:11 - 0:0,1,3,Gevorgyan Hayk,Hovhannesyan Rafik,fiurst,Gevorgyan Hayk - Hovhannesyan Rafik,82,37,45,8,-8,24,20,22,16,0,2,2,-2,6,0,8,11:13 - 9:11 - 12:10 - 5:11 - 0:0
20308383,2024-07-15 13:15:00,Diaryan Aleksandr - Asatryan Murad,3:0,6:11 - 5:11 - 6:11 - 0:0 - 0:0,0,3,Diaryan Aleksandr,Asatryan Murad,fiurst,Asatryan Murad - Diaryan Aleksandr,50,33,17,-16,16,17,16,17,0,0,-5,-6,-5,0,0,-16,11:6 - 11:5 - 11:6 - 0:0 - 0:0
20308379,2024-07-15 13:00:00,Gevorgyan Hayk - Papyan Karen,0:3,9:11 - 5:11 - 10:12 - 0:0 - 0:0,0,3,Gevorgyan Hayk,Papyan Karen,fiurst,Gevorgyan Hayk - Papyan Karen,58,24,34,10,-10,20,16,22,0,0,2,6,2,0,0,10,9:11 - 5:11 - 10:12 - 0:0 - 0:0
20308369,2024-07-15 12:15:00,Hovhannesyan Rafik - Asatryan Murad,3:0,8:11 - 4:11 - 4:11 - 0:0 - 0:0,0,3,Hovhannesyan Rafik,Asatryan Murad,fiurst,Asatryan Murad - Hovhannesyan Rafik,49,33,16,-17,17,19,15,15,0,0,-3,-7,-7,0,0,-17,11:8 - 11:4 - 11:4 - 0:0 - 0:0
20308368,2024-07-15 12:00:00,Gevorgyan Hayk - Diaryan Aleksandr,3:0,6:11 - 5:11 - 3:11 - 0:0 - 0:0,0,3,Gevorgyan Hayk,Diaryan Aleksandr,fiurst,Diaryan Aleksandr - Gevorgyan Hayk,47,33,14,-19,19,17,16,14,0,0,-5,-6,-8,0,0,-19,11:6 - 11:5 - 11:3 - 0:0 - 0:0
20308365,2024-07-15 11:45:00,Papyan Karen - Hovhannesyan Rafik,2:3,15:13 - 8:11 - 11:8 - 7:11 - 11:8,3,2,Papyan Karen,Hovhannesyan Rafik,fiurst,Hovhannesyan Rafik - Papyan Karen,103,51,52,1,-1,28,19,19,18,19,2,-3,3,-4,3,1,13:15 - 11:8 - 8:11 - 11:7 - 8:11
20308362,2024-07-15 11:35:00,Gevorgyan Hayk - Asatryan Murad,3:0,7:11 - 9:11 - 8:11 - 0:0 - 0:0,0,3,Gevorgyan Hayk,Asatryan Murad,fiurst,Asatryan Murad - Gevorgyan Hayk,57,33,24,-9,9,18,20,19,0,0,-4,-2,-3,0,0,-9,11:7 - 11:9 - 11:8 - 0:0 - 0:0
20308361,2024-07-15 11:20:00,Diaryan Aleksandr - Papyan Karen,3:0,11:7 - 12:10 - 11:5 - 0:0 - 0:0,3,0,Diaryan Aleksandr,Papyan Karen,fiurst,Diaryan Aleksandr - Papyan Karen,56,34,22,-12,12,18,22,16,0,0,-4,-2,-6,0,0,-12,11:7 - 12:10 - 11:5 - 0:0 - 0:0
20308360,2024-07-15 11:05:00,Hovhannesyan Rafik - Gevorgyan Hayk,1:3,7:11 - 14:12 - 11:5 - 11:7 - 0:0,3,1,Hovhannesyan Rafik,Gevorgyan Hayk,fiurst,Gevorgyan Hayk - Hovhannesyan Rafik,78,35,43,8,-8,18,26,16,18,0,-4,2,6,4,0,8,11:7 - 12:14 - 5:11 - 7:11 - 0:0
20308353,2024-07-15 10:45:00,Asatryan Murad - Papyan Karen,3:0,11:5 - 11:3 - 11:2 - 0:0 - 0:0,3,0,Asatryan Murad,Papyan Karen,fiurst,Asatryan Murad - Papyan Karen,43,33,10,-23,23,16,14,13,0,0,-6,-8,-9,0,0,-23,11:5 - 11:3 - 11:2 - 0:0 - 0:0
20308346,2024-07-15 10:30:00,Diaryan Aleksandr - Hovhannesyan Rafik,3:1,11:9 - 10:12 - 11:7 - 11:4 - 0:0,3,1,Diaryan Aleksandr,Hovhannesyan Rafik,fiurst,Diaryan Aleksandr - Hovhannesyan Rafik,75,43,32,-11,11,20,22,18,15,0,-2,2,-4,-7,0,-11,11:9 - 10:12 - 11:7 - 11:4 - 0:0
20308342,2024-07-15 10:15:00,Papyan Karen - Gevorgyan Hayk,2:3,10:12 - 11:8 - 11:9 - 13:15 - 11:8,3,2,Papyan Karen,Gevorgyan Hayk,fiurst,Gevorgyan Hayk - Papyan Karen,108,52,56,4,-4,22,19,20,28,19,-2,3,2,-2,3,4,12:10 - 8:11 - 9:11 - 15:13 - 8:11
20308341,2024-07-15 10:00:00,Asatryan Murad - Diaryan Aleksandr,3:0,11:9 - 13:11 - 11:2 - 0:0 - 0:0,3,0,Asatryan Murad,Diaryan Aleksandr,fiurst,Asatryan Murad - Diaryan Aleksandr,57,35,22,-13,13,20,24,13,0,0,-2,-2,-9,0,0,-13,11:9 - 13:11 - 11:2 - 0:0 - 0:0
20290768,2024-07-14 15:15:00,Rafayelyan Edgar - Nikoghosyan Narek,1:3,11:7 - 11:4 - 8:11 - 11:9 - 0:0,3,1,Rafayelyan Edgar,Nikoghosyan Narek,fiurst,Nikoghosyan Narek - Rafayelyan Edgar,72,31,41,10,-10,18,15,19,20,0,4,7,-3,2,0,10,7:11 - 4:11 - 11:8 - 9:11 - 0:0
20290772,2024-07-14 15:15:00,Hovhannesyan Rafik - Diaryan Aleksandr,3:1,11:2 - 11:13 - 9:11 - 1:11 - 0:0,1,3,Hovhannesyan Rafik,Diaryan Aleksandr,fiurst,Diaryan Aleksandr - Hovhannesyan Rafik,69,37,32,-5,5,13,24,20,12,0,9,-2,-2,-10,0,-5,2:11 - 13:11 - 11:9 - 11:1 - 0:0
20290751,2024-07-14 14:50:00,Papyan Karen - Hovhannesyan Rafik,0:0,0:0 - 0:0 - 0:0 - 0:0 - 0:0,0,0,Papyan Karen,Hovhannesyan Rafik,fiurst,Hovhannesyan Rafik - Papyan Karen,0,0,0,0,0,0,0,0,0,0,0,0,0,0,0,0,0:0 - 0:0 - 0:0 - 0:0 - 0:0
20290750,2024-07-14 14:40:00,Diaryan Aleksandr - Rafayelyan Edgar,2:3,11:9 - 9:11 - 3:11 - 11:6 - 9:11,2,3,Diaryan Aleksandr,Rafayelyan Edgar,fiurst,Diaryan Aleksandr - Rafayelyan Edgar,91,43,48,5,-5,20,20,14,17,20,-2,2,8,-5,2,5,11:9 - 9:11 - 3:11 - 11:6 - 9:11
20290749,2024-07-14 14:15:00,Papyan Karen - Nikoghosyan Narek,2:3,11:6 - 8:11 - 9:11 - 11:9 - 13:11,3,2,Papyan Karen,Nikoghosyan Narek,fiurst,Nikoghosyan Narek - Papyan Karen,100,48,52,4,-4,17,19,20,20,24,5,-3,-2,2,2,4,6:11 - 11:8 - 11:9 - 9:11 - 11:13
20290731,2024-07-14 14:10:00,Hovhannesyan Rafik - Rafayelyan Edgar,1:3,11:5 - 8:11 - 8:11 - 4:11 - 0:0,1,3,Hovhannesyan Rafik,Rafayelyan Edgar,fiurst,Hovhannesyan Rafik - Rafayelyan Edgar,69,31,38,7,-7,16,19,19,15,0,-6,3,3,7,0,7,11:5 - 8:11 - 8:11 - 4:11 - 0:0
20290312,2024-07-14 13:45:00,Diaryan Aleksandr - Papyan Karen,0:3,8:11 - 11:13 - 12:14 - 0:0 - 0:0,0,3,Diaryan Aleksandr,Papyan Karen,fiurst,Diaryan Aleksandr - Papyan Karen,69,31,38,7,-7,19,24,26,0,0,3,2,2,0,0,7,8:11 - 11:13 - 12:14 - 0:0 - 0:0
20290305,2024-07-14 13:35:00,Nikoghosyan Narek - Hovhannesyan Rafik,3:1,10:12 - 9:11 - 12:10 - 8:11 - 0:0,1,3,Nikoghosyan Narek,Hovhannesyan Rafik,fiurst,Hovhannesyan Rafik - Nikoghosyan Narek,83,44,39,-5,5,22,20,22,19,0,-2,-2,2,-3,0,-5,12:10 - 11:9 - 10:12 - 11:8 - 0:0
20290291,2024-07-14 13:15:00,Rafayelyan Edgar - Papyan Karen,0:3,11:9 - 11:5 - 11:7 - 0:0 - 0:0,3,0,Rafayelyan Edgar,Papyan Karen,fiurst,Papyan Karen - Rafayelyan Edgar,54,21,33,12,-12,20,16,18,0,0,2,6,4,0,0,12,9:11 - 5:11 - 7:11 - 0:0 - 0:0
20290290,2024-07-14 13:00:00,Nikoghosyan Narek - Diaryan Aleksandr,1:3,11:7 - 8:11 - 11:6 - 11:3 - 0:0,3,1,Nikoghosyan Narek,Diaryan Aleksandr,fiurst,Diaryan Aleksandr - Nikoghosyan Narek,68,27,41,14,-14,18,19,17,14,0,4,-3,5,8,0,14,7:11 - 11:8 - 6:11 - 3:11 - 0:0
20290282,2024-07-14 12:15:00,Hovhannesyan Rafik - Papyan Karen,3:2,11:13 - 9:11 - 11:7 - 11:8 - 11:2,3,2,Hovhannesyan Rafik,Papyan Karen,fiurst,Hovhannesyan Rafik - Papyan Karen,94,53,41,-12,12,24,20,18,19,13,2,2,-4,-3,-9,-12,11:13 - 9:11 - 11:7 - 11:8 - 11:2
20290278,2024-07-14 12:05:00,Nikoghosyan Narek - Rafayelyan Edgar,1:3,9:11 - 11:8 - 6:11 - 8:11 - 0:0,1,3,Nikoghosyan Narek,Rafayelyan Edgar,fiurst,Nikoghosyan Narek - Rafayelyan Edgar,75,34,41,7,-7,20,19,17,19,0,2,-3,5,3,0,7,9:11 - 11:8 - 6:11 - 8:11 - 0:0
20290277,2024-07-14 11:45:00,Diaryan Aleksandr - Hovhannesyan Rafik,3:0,11:6 - 11:8 - 11:7 - 0:0 - 0:0,3,0,Diaryan Aleksandr,Hovhannesyan Rafik,fiurst,Diaryan Aleksandr - Hovhannesyan Rafik,54,33,21,-12,12,17,19,18,0,0,-5,-3,-4,0,0,-12,11:6 - 11:8 - 11:7 - 0:0 - 0:0
20290275,2024-07-14 11:30:00,Nikoghosyan Narek - Papyan Karen,3:1,13:11 - 5:11 - 11:9 - 11:0 - 0:0,3,1,Nikoghosyan Narek,Papyan Karen,fiurst,Nikoghosyan Narek - Papyan Karen,71,40,31,-9,9,24,16,20,11,0,-2,6,-2,-11,0,-9,13:11 - 5:11 - 11:9 - 11:0 - 0:0
20290274,2024-07-14 11:20:00,Rafayelyan Edgar - Diaryan Aleksandr,2:3,8:11 - 1:11 - 11:4 - 11:7 - 11:5,3,2,Rafayelyan Edgar,Diaryan Aleksandr,fiurst,Diaryan Aleksandr - Rafayelyan Edgar,80,38,42,4,-4,19,12,15,18,16,-3,-10,7,4,6,4,11:8 - 11:1 - 4:11 - 7:11 - 5:11
20290273,2024-07-14 11:00:00,Hovhannesyan Rafik - Nikoghosyan Narek,0:3,5:11 - 8:11 - 8:11 - 0:0 - 0:0,0,3,Hovhannesyan Rafik,Nikoghosyan Narek,fiurst,Hovhannesyan Rafik - Nikoghosyan Narek,54,21,33,12,-12,16,19,19,0,0,6,3,3,0,0,12,5:11 - 8:11 - 8:11 - 0:0 - 0:0
20290270,2024-07-14 10:50:00,Papyan Karen - Diaryan Aleksandr,3:1,5:11 - 9:11 - 14:12 - 5:11 - 0:0,1,3,Papyan Karen,Diaryan Aleksandr,fiurst,Diaryan Aleksandr - Papyan Karen,78,45,33,-12,12,16,20,26,16,0,-6,-2,2,-6,0,-12,11:5 - 11:9 - 12:14 - 11:5 - 0:0
20290268,2024-07-14 10:40:00,Rafayelyan Edgar - Hovhannesyan Rafik,0:3,11:9 - 11:6 - 11:6 - 0:0 - 0:0,3,0,Rafayelyan Edgar,Hovhannesyan Rafik,fiurst,Hovhannesyan Rafik - Rafayelyan Edgar,54,21,33,12,-12,20,17,17,0,0,2,5,5,0,0,12,9:11 - 6:11 - 6:11 - 0:0 - 0:0
20290267,2024-07-14 10:15:00,Diaryan Aleksandr - Nikoghosyan Narek,3:2,12:10 - 4:11 - 7:11 - 11:8 - 11:4,3,2,Diaryan Aleksandr,Nikoghosyan Narek,fiurst,Diaryan Aleksandr - Nikoghosyan Narek,89,45,44,-1,1,22,15,18,19,15,-2,7,4,-3,-7,-1,12:10 - 4:11 - 7:11 - 11:8 - 11:4
20290266,2024-07-14 10:00:00,Papyan Karen - Rafayelyan Edgar,0:3,7:11 - 7:11 - 2:11 - 0:0 - 0:0,0,3,Papyan Karen,Rafayelyan Edgar,fiurst,Papyan Karen - Rafayelyan Edgar,49,16,33,17,-17,18,18,13,0,0,4,4,9,0,0,17,7:11 - 7:11 - 2:11 - 0:0 - 0:0
20272136,2024-07-13 15:20:00,Gevorgyan Hayk - Rafayelyan Edgar,0:3,7:11 - 8:11 - 9:11 - 0:0 - 0:0,0,3,Gevorgyan Hayk,Rafayelyan Edgar,fiurst,Gevorgyan Hayk - Rafayelyan Edgar,57,24,33,9,-9,18,19,20,0,0,4,3,2,0,0,9,7:11 - 8:11 - 9:11 - 0:0 - 0:0
20272133,2024-07-13 15:00:00,Papyan Karen - Asatryan Murad,3:1,2:11 - 3:11 - 11:8 - 3:11 - 0:0,1,3,Papyan Karen,Asatryan Murad,fiurst,Asatryan Murad - Papyan Karen,60,41,19,-22,22,13,14,19,14,0,-9,-8,3,-8,0,-22,11:2 - 11:3 - 8:11 - 11:3 - 0:0
20272132,2024-07-13 14:45:00,Nikoghosyan Narek - Gevorgyan Hayk,2:3,5:11 - 11:7 - 11:7 - 7:11 - 11:8,3,2,Nikoghosyan Narek,Gevorgyan Hayk,fiurst,Gevorgyan Hayk - Nikoghosyan Narek,89,44,45,1,-1,16,18,18,18,19,-6,4,4,-4,3,1,11:5 - 7:11 - 7:11 - 11:7 - 8:11
20272129,2024-07-13 14:30:00,Rafayelyan Edgar - Papyan Karen,2:3,13:15 - 11:6 - 11:6 - 9:11 - 11:9,3,2,Rafayelyan Edgar,Papyan Karen,fiurst,Papyan Karen - Rafayelyan Edgar,102,47,55,8,-8,28,17,17,20,20,-2,5,5,-2,2,8,15:13 - 6:11 - 6:11 - 11:9 - 9:11
20272126,2024-07-13 14:20:00,Nikoghosyan Narek - Asatryan Murad,3:0,6:11 - 4:11 - 5:11 - 0:0 - 0:0,0,3,Nikoghosyan Narek,Asatryan Murad,fiurst,Asatryan Murad - Nikoghosyan Narek,48,33,15,-18,18,17,15,16,0,0,-5,-7,-6,0,0,-18,11:6 - 11:4 - 11:5 - 0:0 - 0:0
20272125,2024-07-13 14:10:00,Gevorgyan Hayk - Papyan Karen,0:3,8:11 - 8:11 - 8:11 - 0:0 - 0:0,0,3,Gevorgyan Hayk,Papyan Karen,fiurst,Gevorgyan Hayk - Papyan Karen,57,24,33,9,-9,19,19,19,0,0,3,3,3,0,0,9,8:11 - 8:11 - 8:11 - 0:0 - 0:0
20272124,2024-07-13 13:45:00,Rafayelyan Edgar - Nikoghosyan Narek,1:3,11:8 - 10:12 - 11:8 - 12:10 - 0:0,3,1,Rafayelyan Edgar,Nikoghosyan Narek,fiurst,Nikoghosyan Narek - Rafayelyan Edgar,82,38,44,6,-6,19,22,19,22,0,3,-2,3,2,0,6,8:11 - 12:10 - 8:11 - 10:12 - 0:0
20272123,2024-07-13 13:30:00,Asatryan Murad - Gevorgyan Hayk,2:3,8:11 - 7:11 - 12:10 - 11:8 - 7:11,2,3,Asatryan Murad,Gevorgyan Hayk,fiurst,Asatryan Murad - Gevorgyan Hayk,96,45,51,6,-6,19,18,22,19,18,3,4,-2,-3,4,6,8:11 - 7:11 - 12:10 - 11:8 - 7:11
20272120,2024-07-13 13:15:00,Papyan Karen - Nikoghosyan Narek,0:3,11:7 - 11:9 - 11:6 - 0:0 - 0:0,3,0,Papyan Karen,Nikoghosyan Narek,fiurst,Nikoghosyan Narek - Papyan Karen,55,22,33,11,-11,18,20,17,0,0,4,2,5,0,0,11,7:11 - 9:11 - 6:11 - 0:0 - 0:0
20272116,2024-07-13 13:00:00,Asatryan Murad - Rafayelyan Edgar,0:3,7:11 - 8:11 - 2:11 - 0:0 - 0:0,0,3,Asatryan Murad,Rafayelyan Edgar,fiurst,Asatryan Murad - Rafayelyan Edgar,50,17,33,16,-16,18,19,13,0,0,4,3,9,0,0,16,7:11 - 8:11 - 2:11 - 0:0 - 0:0
20272106,2024-07-13 12:15:00,Gevorgyan Hayk - Nikoghosyan Narek,1:3,11:7 - 7:11 - 12:14 - 7:11 - 0:0,1,3,Gevorgyan Hayk,Nikoghosyan Narek,fiurst,Gevorgyan Hayk - Nikoghosyan Narek,80,37,43,6,-6,18,18,26,18,0,-4,4,2,4,0,6,11:7 - 7:11 - 12:14 - 7:11 - 0:0
20272103,2024-07-13 12:00:00,Asatryan Murad - Papyan Karen,3:0,11:5 - 11:4 - 11:8 - 0:0 - 0:0,3,0,Asatryan Murad,Papyan Karen,fiurst,Asatryan Murad - Papyan Karen,50,33,17,-16,16,16,15,19,0,0,-6,-7,-3,0,0,-16,11:5 - 11:4 - 11:8 - 0:0 - 0:0
20272102,2024-07-13 11:45:00,Rafayelyan Edgar - Gevorgyan Hayk,0:3,11:8 - 11:5 - 11:7 - 0:0 - 0:0,3,0,Rafayelyan Edgar,Gevorgyan Hayk,fiurst,Gevorgyan Hayk - Rafayelyan Edgar,53,20,33,13,-13,19,16,18,0,0,3,6,4,0,0,13,8:11 - 5:11 - 7:11 - 0:0 - 0:0
20272096,2024-07-13 11:30:00,Asatryan Murad - Nikoghosyan Narek,3:1,11:4 - 11:4 - 8:11 - 11:6 - 0:0,3,1,Asatryan Murad,Nikoghosyan Narek,fiurst,Asatryan Murad - Nikoghosyan Narek,66,41,25,-16,16,15,15,19,17,0,-7,-7,3,-5,0,-16,11:4 - 11:4 - 8:11 - 11:6 - 0:0
20272072,2024-07-13 11:15:00,Papyan Karen - Rafayelyan Edgar,0:3,2:11 - 8:11 - 7:11 - 0:0 - 0:0,0,3,Papyan Karen,Rafayelyan Edgar,fiurst,Papyan Karen - Rafayelyan Edgar,50,17,33,16,-16,13,19,18,0,0,9,3,4,0,0,16,2:11 - 8:11 - 7:11 - 0:0 - 0:0
20272071,2024-07-13 11:00:00,Gevorgyan Hayk - Asatryan Murad,3:0,2:11 - 3:11 - 3:11 - 0:0 - 0:0,0,3,Gevorgyan Hayk,Asatryan Murad,fiurst,Asatryan Murad - Gevorgyan Hayk,41,33,8,-25,25,13,14,14,0,0,-9,-8,-8,0,0,-25,11:2 - 11:3 - 11:3 - 0:0 - 0:0
20272070,2024-07-13 10:45:00,Nikoghosyan Narek - Rafayelyan Edgar,1:3,11:8 - 10:12 - 4:11 - 9:11 - 0:0,1,3,Nikoghosyan Narek,Rafayelyan Edgar,fiurst,Nikoghosyan Narek - Rafayelyan Edgar,76,34,42,8,-8,19,22,15,20,0,-3,2,7,2,0,8,11:8 - 10:12 - 4:11 - 9:11 - 0:0
20272069,2024-07-13 10:30:00,Papyan Karen - Gevorgyan Hayk,3:1,9:11 - 11:9 - 6:11 - 9:11 - 0:0,1,3,Papyan Karen,Gevorgyan Hayk,fiurst,Gevorgyan Hayk - Papyan Karen,77,42,35,-7,7,20,20,17,20,0,-2,2,-5,-2,0,-7,11:9 - 9:11 - 11:6 - 11:9 - 0:0
20272067,2024-07-13 10:15:00,Rafayelyan Edgar - Asatryan Murad,3:1,4:11 - 8:11 - 11:5 - 8:11 - 0:0,1,3,Rafayelyan Edgar,Asatryan Murad,fiurst,Asatryan Murad - Rafayelyan Edgar,69,38,31,-7,7,15,19,16,19,0,-7,-3,6,-3,0,-7,11:4 - 11:8 - 5:11 - 11:8 - 0:0
20272064,2024-07-13 10:00:00,Nikoghosyan Narek - Papyan Karen,3:2,11:8 - 5:11 - 8:11 - 11:7 - 11:7,3,2,Nikoghosyan Narek,Papyan Karen,fiurst,Nikoghosyan Narek - Papyan Karen,90,46,44,-2,2,19,16,19,18,18,-3,6,3,-4,-4,-2,11:8 - 5:11 - 8:11 - 11:7 - 11:7
20248905,2024-07-12 15:20:00,Papyan Karen - Nikoghosyan Narek,2:3,8:11 - 11:9 - 10:12 - 11:9 - 11:9,3,2,Papyan Karen,Nikoghosyan Narek,fiurst,Nikoghosyan Narek - Papyan Karen,101,50,51,1,-1,19,20,22,20,20,-3,2,-2,2,2,1,11:8 - 9:11 - 12:10 - 9:11 - 9:11
20248902,2024-07-12 15:00:00,Asatryan Murad - Hovhannesyan Rafik,3:0,11:4 - 11:6 - 11:2 - 0:0 - 0:0,3,0,Asatryan Murad,Hovhannesyan Rafik,fiurst,Asatryan Murad - Hovhannesyan Rafik,45,33,12,-21,21,15,17,13,0,0,-7,-5,-9,0,0,-21,11:4 - 11:6 - 11:2 - 0:0 - 0:0
20248899,2024-07-12 14:45:00,Gevorgyan Hayk - Papyan Karen,2:3,11:5 - 10:12 - 11:8 - 10:12 - 7:11,2,3,Gevorgyan Hayk,Papyan Karen,fiurst,Gevorgyan Hayk - Papyan Karen,97,49,48,-1,1,16,22,19,22,18,-6,2,-3,2,4,-1,11:5 - 10:12 - 11:8 - 10:12 - 7:11
20248898,2024-07-12 14:30:00,Nikoghosyan Narek - Asatryan Murad,3:0,1:11 - 5:11 - 5:11 - 0:0 - 0:0,0,3,Nikoghosyan Narek,Asatryan Murad,fiurst,Asatryan Murad - Nikoghosyan Narek,44,33,11,-22,22,12,16,16,0,0,-10,-6,-6,0,0,-22,11:1 - 11:5 - 11:5 - 0:0 - 0:0
20248897,2024-07-12 14:20:00,Gevorgyan Hayk - Hovhannesyan Rafik,3:1,11:9 - 11:5 - 9:11 - 11:9 - 0:0,3,1,Gevorgyan Hayk,Hovhannesyan Rafik,fiurst,Gevorgyan Hayk - Hovhannesyan Rafik,76,42,34,-8,8,20,16,20,20,0,-2,-6,2,-2,0,-8,11:9 - 11:5 - 9:11 - 11:9 - 0:0
20248896,2024-07-12 14:00:00,Papyan Karen - Asatryan Murad,3:1,10:12 - 13:11 - 5:11 - 7:11 - 0:0,1,3,Papyan Karen,Asatryan Murad,fiurst,Asatryan Murad - Papyan Karen,80,45,35,-10,10,22,24,16,18,0,-2,2,-6,-4,0,-10,12:10 - 11:13 - 11:5 - 11:7 - 0:0
20248891,2024-07-12 13:45:00,Nikoghosyan Narek - Gevorgyan Hayk,2:3,11:13 - 11:8 - 11:6 - 7:11 - 11:7,3,2,Nikoghosyan Narek,Gevorgyan Hayk,fiurst,Gevorgyan Hayk - Nikoghosyan Narek,96,45,51,6,-6,24,19,17,18,18,-2,3,5,-4,4,6,13:11 - 8:11 - 6:11 - 11:7 - 7:11
20248881,2024-07-12 13:30:00,Hovhannesyan Rafik - Papyan Karen,1:3,9:11 - 11:6 - 7:11 - 8:11 - 0:0,1,3,Hovhannesyan Rafik,Papyan Karen,fiurst,Hovhannesyan Rafik - Papyan Karen,74,35,39,4,-4,20,17,18,19,0,2,-5,4,3,0,4,9:11 - 11:6 - 7:11 - 8:11 - 0:0
20248879,2024-07-12 13:15:00,Asatryan Murad - Gevorgyan Hayk,3:1,9:11 - 11:5 - 11:2 - 11:5 - 0:0,3,1,Asatryan Murad,Gevorgyan Hayk,fiurst,Asatryan Murad - Gevorgyan Hayk,65,42,23,-19,19,20,16,13,16,0,2,-6,-9,-6,0,-19,9:11 - 11:5 - 11:2 - 11:5 - 0:0
20248878,2024-07-12 13:00:00,Hovhannesyan Rafik - Nikoghosyan Narek,3:0,11:8 - 11:6 - 13:11 - 0:0 - 0:0,3,0,Hovhannesyan Rafik,Nikoghosyan Narek,fiurst,Hovhannesyan Rafik - Nikoghosyan Narek,60,35,25,-10,10,19,17,24,0,0,-3,-5,-2,0,0,-10,11:8 - 11:6 - 13:11 - 0:0 - 0:0
20248876,2024-07-12 12:20:00,Papyan Karen - Gevorgyan Hayk,0:3,11:9 - 11:4 - 11:8 - 0:0 - 0:0,3,0,Papyan Karen,Gevorgyan Hayk,fiurst,Gevorgyan Hayk - Papyan Karen,54,21,33,12,-12,20,15,19,0,0,2,7,3,0,0,12,9:11 - 4:11 - 8:11 - 0:0 - 0:0
20248875,2024-07-12 12:05:00,Hovhannesyan Rafik - Asatryan Murad,3:0,0:11 - 6:11 - 12:14 - 0:0 - 0:0,0,3,Hovhannesyan Rafik,Asatryan Murad,fiurst,Asatryan Murad - Hovhannesyan Rafik,54,36,18,-18,18,11,17,26,0,0,-11,-5,-2,0,0,-18,11:0 - 11:6 - 14:12 - 0:0 - 0:0
20248864,2024-07-12 11:50:00,Nikoghosyan Narek - Papyan Karen,2:3,9:11 - 11:5 - 4:11 - 12:10 - 10:12,2,3,Nikoghosyan Narek,Papyan Karen,fiurst,Nikoghosyan Narek - Papyan Karen,95,46,49,3,-3,20,16,15,22,22,2,-6,7,-2,2,3,9:11 - 11:5 - 4:11 - 12:10 - 10:12
20248859,2024-07-12 11:40:00,Hovhannesyan Rafik - Gevorgyan Hayk,0:3,11:5 - 11:2 - 11:9 - 0:0 - 0:0,3,0,Hovhannesyan Rafik,Gevorgyan Hayk,fiurst,Gevorgyan Hayk - Hovhannesyan Rafik,49,16,33,17,-17,16,13,20,0,0,6,9,2,0,0,17,5:11 - 2:11 - 9:11 - 0:0 - 0:0
20248854,2024-07-12 11:15:00,Asatryan Murad - Nikoghosyan Narek,3:1,11:9 - 8:11 - 11:6 - 11:9 - 0:0,3,1,Asatryan Murad,Nikoghosyan Narek,fiurst,Asatryan Murad - Nikoghosyan Narek,76,41,35,-6,6,20,19,17,20,0,-2,3,-5,-2,0,-6,11:9 - 8:11 - 11:6 - 11:9 - 0:0
20248852,2024-07-12 11:00:00,Papyan Karen - Hovhannesyan Rafik,3:1,13:15 - 9:11 - 11:9 - 9:11 - 0:0,1,3,Papyan Karen,Hovhannesyan Rafik,fiurst,Hovhannesyan Rafik - Papyan Karen,88,46,42,-4,4,28,20,20,20,0,-2,-2,2,-2,0,-4,15:13 - 11:9 - 9:11 - 11:9 - 0:0
20248851,2024-07-12 10:45:00,Gevorgyan Hayk - Nikoghosyan Narek,0:3,8:11 - 4:11 - 4:11 - 0:0 - 0:0,0,3,Gevorgyan Hayk,Nikoghosyan Narek,fiurst,Gevorgyan Hayk - Nikoghosyan Narek,49,16,33,17,-17,19,15,15,0,0,3,7,7,0,0,17,8:11 - 4:11 - 4:11 - 0:0 - 0:0
20248849,2024-07-12 10:30:00,Asatryan Murad - Papyan Karen,3:1,9:11 - 11:5 - 11:7 - 11:9 - 0:0,3,1,Asatryan Murad,Papyan Karen,fiurst,Asatryan Murad - Papyan Karen,74,42,32,-10,10,20,16,18,20,0,2,-6,-4,-2,0,-10,9:11 - 11:5 - 11:7 - 11:9 - 0:0
20248848,2024-07-12 10:15:00,Nikoghosyan Narek - Hovhannesyan Rafik,0:3,11:6 - 11:6 - 11:3 - 0:0 - 0:0,3,0,Nikoghosyan Narek,Hovhannesyan Rafik,fiurst,Hovhannesyan Rafik - Nikoghosyan Narek,48,15,33,18,-18,17,17,14,0,0,5,5,8,0,0,18,6:11 - 6:11 - 3:11 - 0:0 - 0:0
20248835,2024-07-12 10:00:00,Gevorgyan Hayk - Asatryan Murad,3:1,8:11 - 11:8 - 6:11 - 10:12 - 0:0,1,3,Gevorgyan Hayk,Asatryan Murad,fiurst,Asatryan Murad - Gevorgyan Hayk,77,42,35,-7,7,19,19,17,22,0,-3,3,-5,-2,0,-7,11:8 - 8:11 - 11:6 - 12:10 - 0:0
20191208,2024-07-11 15:15:00,Rafayelyan Edgar - Asatryan Murad,3:1,11:7 - 8:11 - 10:12 - 5:11 - 0:0,1,3,Rafayelyan Edgar,Asatryan Murad,fiurst,Asatryan Murad - Rafayelyan Edgar,75,41,34,-7,7,18,19,22,16,0,4,-3,-2,-6,0,-7,7:11 - 11:8 - 12:10 - 11:5 - 0:0
20191200,2024-07-11 15:05:00,Gevorgyan Hayk - Diaryan Aleksandr,3:0,5:11 - 8:11 - 9:11 - 0:0 - 0:0,0,3,Gevorgyan Hayk,Diaryan Aleksandr,fiurst,Diaryan Aleksandr - Gevorgyan Hayk,55,33,22,-11,11,16,19,20,0,0,-6,-3,-2,0,0,-11,11:5 - 11:8 - 11:9 - 0:0 - 0:0
20191198,2024-07-11 14:55:00,Hovhannesyan Rafik - Rafayelyan Edgar,0:3,8:11 - 9:11 - 8:11 - 0:0 - 0:0,0,3,Hovhannesyan Rafik,Rafayelyan Edgar,fiurst,Hovhannesyan Rafik - Rafayelyan Edgar,58,25,33,8,-8,19,20,19,0,0,3,2,3,0,0,8,8:11 - 9:11 - 8:11 - 0:0 - 0:0
20191185,2024-07-11 14:30:00,Asatryan Murad - Gevorgyan Hayk,3:0,13:11 - 11:5 - 11:5 - 0:0 - 0:0,3,0,Asatryan Murad,Gevorgyan Hayk,fiurst,Asatryan Murad - Gevorgyan Hayk,56,35,21,-14,14,24,16,16,0,0,-2,-6,-6,0,0,-14,13:11 - 11:5 - 11:5 - 0:0 - 0:0
20191183,2024-07-11 14:15:00,Hovhannesyan Rafik - Diaryan Aleksandr,1:3,5:11 - 11:8 - 11:9 - 11:8 - 0:0,3,1,Hovhannesyan Rafik,Diaryan Aleksandr,fiurst,Diaryan Aleksandr - Hovhannesyan Rafik,74,36,38,2,-2,16,19,20,19,0,-6,3,2,3,0,2,11:5 - 8:11 - 9:11 - 8:11 - 0:0
20191176,2024-07-11 14:10:00,Rafayelyan Edgar - Gevorgyan Hayk,0:3,11:2 - 11:7 - 11:5 - 0:0 - 0:0,3,0,Rafayelyan Edgar,Gevorgyan Hayk,fiurst,Gevorgyan Hayk - Rafayelyan Edgar,47,14,33,19,-19,13,18,16,0,0,9,4,6,0,0,19,2:11 - 7:11 - 5:11 - 0:0 - 0:0
20191152,2024-07-11 13:45:00,Asatryan Murad - Hovhannesyan Rafik,3:0,11:3 - 11:4 - 11:4 - 0:0 - 0:0,3,0,Asatryan Murad,Hovhannesyan Rafik,fiurst,Asatryan Murad - Hovhannesyan Rafik,44,33,11,-22,22,14,15,15,0,0,-8,-7,-7,0,0,-22,11:3 - 11:4 - 11:4 - 0:0 - 0:0
20191149,2024-07-11 13:30:00,Diaryan Aleksandr - Rafayelyan Edgar,2:3,12:10 - 8:11 - 3:11 - 11:8 - 14:16,2,3,Diaryan Aleksandr,Rafayelyan Edgar,fiurst,Diaryan Aleksandr - Rafayelyan Edgar,104,48,56,8,-8,22,19,14,19,30,-2,3,8,-3,2,8,12:10 - 8:11 - 3:11 - 11:8 - 14:16
20191136,2024-07-11 13:15:00,Gevorgyan Hayk - Hovhannesyan Rafik,0:3,11:13 - 8:11 - 9:11 - 0:0 - 0:0,0,3,Gevorgyan Hayk,Hovhannesyan Rafik,fiurst,Gevorgyan Hayk - Hovhannesyan Rafik,63,28,35,7,-7,24,19,20,0,0,2,3,2,0,0,7,11:13 - 8:11 - 9:11 - 0:0 - 0:0
20191124,2024-07-11 13:00:00,Diaryan Aleksandr - Asatryan Murad,3:0,10:12 - 7:11 - 3:11 - 0:0 - 0:0,0,3,Diaryan Aleksandr,Asatryan Murad,fiurst,Asatryan Murad - Diaryan Aleksandr,54,34,20,-14,14,22,18,14,0,0,-2,-4,-8,0,0,-14,12:10 - 11:7 - 11:3 - 0:0 - 0:0
20191107,2024-07-11 12:15:00,Rafayelyan Edgar - Hovhannesyan Rafik,1:3,8:11 - 11:7 - 11:3 - 11:5 - 0:0,3,1,Rafayelyan Edgar,Hovhannesyan Rafik,fiurst,Hovhannesyan Rafik - Rafayelyan Edgar,67,26,41,15,-15,19,18,14,16,0,-3,4,8,6,0,15,11:8 - 7:11 - 3:11 - 5:11 - 0:0
20191038,2024-07-11 12:00:00,Diaryan Aleksandr - Gevorgyan Hayk,3:0,11:5 - 11:6 - 11:5 - 0:0 - 0:0,3,0,Diaryan Aleksandr,Gevorgyan Hayk,fiurst,Diaryan Aleksandr - Gevorgyan Hayk,49,33,16,-17,17,16,17,16,0,0,-6,-5,-6,0,0,-17,11:5 - 11:6 - 11:5 - 0:0 - 0:0
20191034,2024-07-11 11:45:00,Asatryan Murad - Rafayelyan Edgar,3:0,11:5 - 11:8 - 11:5 - 0:0 - 0:0,3,0,Asatryan Murad,Rafayelyan Edgar,fiurst,Asatryan Murad - Rafayelyan Edgar,51,33,18,-15,15,16,19,16,0,0,-6,-3,-6,0,0,-15,11:5 - 11:8 - 11:5 - 0:0 - 0:0
20191010,2024-07-11 11:30:00,Diaryan Aleksandr - Hovhannesyan Rafik,3:0,11:4 - 11:9 - 11:3 - 0:0 - 0:0,3,0,Diaryan Aleksandr,Hovhannesyan Rafik,fiurst,Diaryan Aleksandr - Hovhannesyan Rafik,49,33,16,-17,17,15,20,14,0,0,-7,-2,-8,0,0,-17,11:4 - 11:9 - 11:3 - 0:0 - 0:0
20191003,2024-07-11 11:15:00,Gevorgyan Hayk - Asatryan Murad,3:0,6:11 - 3:11 - 8:11 - 0:0 - 0:0,0,3,Gevorgyan Hayk,Asatryan Murad,fiurst,Asatryan Murad - Gevorgyan Hayk,50,33,17,-16,16,17,14,19,0,0,-5,-8,-3,0,0,-16,11:6 - 11:3 - 11:8 - 0:0 - 0:0
20190982,2024-07-11 11:00:00,Rafayelyan Edgar - Diaryan Aleksandr,1:3,11:4 - 7:11 - 11:4 - 11:8 - 0:0,3,1,Rafayelyan Edgar,Diaryan Aleksandr,fiurst,Diaryan Aleksandr - Rafayelyan Edgar,67,27,40,13,-13,15,18,15,19,0,7,-4,7,3,0,13,4:11 - 11:7 - 4:11 - 8:11 - 0:0
20190942,2024-07-11 10:50:00,Gevorgyan Hayk - Rafayelyan Edgar,0:3,7:11 - 5:11 - 7:11 - 0:0 - 0:0,0,3,Gevorgyan Hayk,Rafayelyan Edgar,fiurst,Gevorgyan Hayk - Rafayelyan Edgar,52,19,33,14,-14,18,16,18,0,0,4,6,4,0,0,14,7:11 - 5:11 - 7:11 - 0:0 - 0:0
20190972,2024-07-11 10:50:00,Hovhannesyan Rafik - Asatryan Murad,3:0,5:11 - 5:11 - 4:11 - 0:0 - 0:0,0,3,Hovhannesyan Rafik,Asatryan Murad,fiurst,Asatryan Murad - Hovhannesyan Rafik,47,33,14,-19,19,16,16,15,0,0,-6,-6,-7,0,0,-19,11:5 - 11:5 - 11:4 - 0:0 - 0:0
20190935,2024-07-11 10:15:00,Asatryan Murad - Diaryan Aleksandr,3:1,11:5 - 6:11 - 11:5 - 11:2 - 0:0,3,1,Asatryan Murad,Diaryan Aleksandr,fiurst,Asatryan Murad - Diaryan Aleksandr,62,39,23,-16,16,16,17,16,13,0,-6,5,-6,-9,0,-16,11:5 - 6:11 - 11:5 - 11:2 - 0:0
20190933,2024-07-11 10:10:00,Hovhannesyan Rafik - Gevorgyan Hayk,2:3,9:11 - 9:11 - 11:3 - 14:12 - 11:8,3,2,Hovhannesyan Rafik,Gevorgyan Hayk,fiurst,Gevorgyan Hayk - Hovhannesyan Rafik,99,45,54,9,-9,20,20,14,26,19,-2,-2,8,2,3,9,11:9 - 11:9 - 3:11 - 12:14 - 8:11
20118181,2024-07-10 15:30:00,Nikoghosyan Narek - Gevorgyan Hayk,3:0,7:11 - 8:11 - 12:14 - 0:0 - 0:0,0,3,Nikoghosyan Narek,Gevorgyan Hayk,fiurst,Gevorgyan Hayk - Nikoghosyan Narek,63,36,27,-9,9,18,19,26,0,0,-4,-3,-2,0,0,-9,11:7 - 11:8 - 14:12 - 0:0 - 0:0
20118176,2024-07-10 15:20:00,Rafayelyan Edgar - Papyan Karen,1:3,11:8 - 3:11 - 11:6 - 13:11 - 0:0,3,1,Rafayelyan Edgar,Papyan Karen,fiurst,Papyan Karen - Rafayelyan Edgar,74,36,38,2,-2,19,14,17,24,0,3,-8,5,2,0,2,8:11 - 11:3 - 6:11 - 11:13 - 0:0
20118152,2024-07-10 15:05:00,Diaryan Aleksandr - Nikoghosyan Narek,0:3,8:11 - 3:11 - 7:11 - 0:0 - 0:0,0,3,Diaryan Aleksandr,Nikoghosyan Narek,fiurst,Diaryan Aleksandr - Nikoghosyan Narek,51,18,33,15,-15,19,14,18,0,0,3,8,4,0,0,15,8:11 - 3:11 - 7:11 - 0:0 - 0:0
20118148,2024-07-10 14:55:00,Gevorgyan Hayk - Rafayelyan Edgar,1:3,11:7 - 8:11 - 6:11 - 7:11 - 0:0,1,3,Gevorgyan Hayk,Rafayelyan Edgar,fiurst,Gevorgyan Hayk - Rafayelyan Edgar,72,32,40,8,-8,18,19,17,18,0,-4,3,5,4,0,8,11:7 - 8:11 - 6:11 - 7:11 - 0:0
20118142,2024-07-10 14:25:00,Diaryan Aleksandr - Papyan Karen,2:3,11:2 - 11:9 - 11:13 - 8:11 - 9:11,2,3,Diaryan Aleksandr,Papyan Karen,fiurst,Diaryan Aleksandr - Papyan Karen,96,50,46,-4,4,13,20,24,19,20,-9,-2,2,3,2,-4,11:2 - 11:9 - 11:13 - 8:11 - 9:11
20118119,2024-07-10 14:15:00,Nikoghosyan Narek - Rafayelyan Edgar,3:2,11:8 - 12:14 - 15:13 - 11:13 - 11:8,3,2,Nikoghosyan Narek,Rafayelyan Edgar,fiurst,Nikoghosyan Narek - Rafayelyan Edgar,116,60,56,-4,4,19,26,28,24,19,-3,2,-2,2,-3,-4,11:8 - 12:14 - 15:13 - 11:13 - 11:8
20118116,2024-07-10 13:55:00,Gevorgyan Hayk - Diaryan Aleksandr,3:0,5:11 - 8:11 - 5:11 - 0:0 - 0:0,0,3,Gevorgyan Hayk,Diaryan Aleksandr,fiurst,Diaryan Aleksandr - Gevorgyan Hayk,51,33,18,-15,15,16,19,16,0,0,-6,-3,-6,0,0,-15,11:5 - 11:8 - 11:5 - 0:0 - 0:0
20118107,2024-07-10 13:30:00,Papyan Karen - Nikoghosyan Narek,2:3,11:9 - 11:8 - 6:11 - 9:11 - 17:15,3,2,Papyan Karen,Nikoghosyan Narek,fiurst,Nikoghosyan Narek - Papyan Karen,108,54,54,0,0,20,19,17,20,32,2,3,-5,-2,2,0,9:11 - 8:11 - 11:6 - 11:9 - 15:17
20118089,2024-07-10 13:15:00,Rafayelyan Edgar - Diaryan Aleksandr,3:2,9:11 - 7:11 - 11:3 - 11:6 - 6:11,2,3,Rafayelyan Edgar,Diaryan Aleksandr,fiurst,Diaryan Aleksandr - Rafayelyan Edgar,86,42,44,2,-2,20,18,14,17,17,-2,-4,8,5,-5,2,11:9 - 11:7 - 3:11 - 6:11 - 11:6
20118073,2024-07-10 13:00:00,Papyan Karen - Gevorgyan Hayk,0:3,12:10 - 11:9 - 11:8 - 0:0 - 0:0,3,0,Papyan Karen,Gevorgyan Hayk,fiurst,Gevorgyan Hayk - Papyan Karen,61,27,34,7,-7,22,20,19,0,0,2,2,3,0,0,7,10:12 - 9:11 - 8:11 - 0:0 - 0:0
20118072,2024-07-10 12:15:00,Nikoghosyan Narek - Diaryan Aleksandr,2:3,4:11 - 11:8 - 13:11 - 5:11 - 11:8,3,2,Nikoghosyan Narek,Diaryan Aleksandr,fiurst,Diaryan Aleksandr - Nikoghosyan Narek,93,49,44,-5,5,15,19,24,16,19,-7,3,2,-6,3,-5,11:4 - 8:11 - 11:13 - 11:5 - 8:11
20118066,2024-07-10 12:00:00,Papyan Karen - Rafayelyan Edgar,1:3,9:11 - 9:11 - 11:8 - 3:11 - 0:0,1,3,Papyan Karen,Rafayelyan Edgar,fiurst,Papyan Karen - Rafayelyan Edgar,73,32,41,9,-9,20,20,19,14,0,2,2,-3,8,0,9,9:11 - 9:11 - 11:8 - 3:11 - 0:0
20118059,2024-07-10 11:45:00,Gevorgyan Hayk - Nikoghosyan Narek,0:3,6:11 - 6:11 - 7:11 - 0:0 - 0:0,0,3,Gevorgyan Hayk,Nikoghosyan Narek,fiurst,Gevorgyan Hayk - Nikoghosyan Narek,52,19,33,14,-14,17,17,18,0,0,5,5,4,0,0,14,6:11 - 6:11 - 7:11 - 0:0 - 0:0
20118058,2024-07-10 11:30:00,Papyan Karen - Diaryan Aleksandr,2:3,7:11 - 9:11 - 11:9 - 11:8 - 11:4,3,2,Papyan Karen,Diaryan Aleksandr,fiurst,Diaryan Aleksandr - Papyan Karen,92,43,49,6,-6,18,20,20,19,15,-4,-2,2,3,7,6,11:7 - 11:9 - 9:11 - 8:11 - 4:11
20118056,2024-07-10 11:15:00,Rafayelyan Edgar - Gevorgyan Hayk,0:3,11:6 - 11:6 - 11:7 - 0:0 - 0:0,3,0,Rafayelyan Edgar,Gevorgyan Hayk,fiurst,Gevorgyan Hayk - Rafayelyan Edgar,52,19,33,14,-14,17,17,18,0,0,5,5,4,0,0,14,6:11 - 6:11 - 7:11 - 0:0 - 0:0
20118054,2024-07-10 11:00:00,Nikoghosyan Narek - Papyan Karen,3:1,11:7 - 11:13 - 11:9 - 11:6 - 0:0,3,1,Nikoghosyan Narek,Papyan Karen,fiurst,Nikoghosyan Narek - Papyan Karen,79,44,35,-9,9,18,24,20,17,0,-4,2,-2,-5,0,-9,11:7 - 11:13 - 11:9 - 11:6 - 0:0
20118046,2024-07-10 10:45:00,Diaryan Aleksandr - Gevorgyan Hayk,3:0,11:8 - 11:4 - 11:7 - 0:0 - 0:0,3,0,Diaryan Aleksandr,Gevorgyan Hayk,fiurst,Diaryan Aleksandr - Gevorgyan Hayk,52,33,19,-14,14,19,15,18,0,0,-3,-7,-4,0,0,-14,11:8 - 11:4 - 11:7 - 0:0 - 0:0
20118044,2024-07-10 10:30:00,Rafayelyan Edgar - Nikoghosyan Narek,1:3,14:12 - 11:4 - 8:11 - 11:7 - 0:0,3,1,Rafayelyan Edgar,Nikoghosyan Narek,fiurst,Nikoghosyan Narek - Rafayelyan Edgar,78,34,44,10,-10,26,15,19,18,0,2,7,-3,4,0,10,12:14 - 4:11 - 11:8 - 7:11 - 0:0
20118042,2024-07-10 10:15:00,Gevorgyan Hayk - Papyan Karen,3:1,11:7-8:11-11:8-11:9,3,1,Gevorgyan Hayk,Papyan Karen,fiurst,Gevorgyan Hayk - Papyan Karen,0,11,0,-11,11,0,0,0,0,0,0,0,0,0,0,-11,11:7-8:11-11:8-11:9
20117997,2024-07-10 10:00:00,Diaryan Aleksandr - Rafayelyan Edgar,3:0,11:8 - 11:4 - 11:8 - 0:0 - 0:0,3,0,Diaryan Aleksandr,Rafayelyan Edgar,fiurst,Diaryan Aleksandr - Rafayelyan Edgar,53,33,20,-13,13,19,15,19,0,0,-3,-7,-3,0,0,-13,11:8 - 11:4 - 11:8 - 0:0 - 0:0
20039106,2024-07-09 15:15:00,Papyan Karen - Diaryan Aleksandr,1:3,12:10 - 11:7 - 7:11 - 11:7 - 0:0,3,1,Papyan Karen,Diaryan Aleksandr,fiurst,Diaryan Aleksandr - Papyan Karen,76,35,41,6,-6,22,18,18,18,0,2,4,-4,4,0,6,10:12 - 7:11 - 11:7 - 7:11 - 0:0
20039101,2024-07-09 15:00:00,Hovhannesyan Rafik - Asatryan Murad,3:0,6:11 - 6:11 - 6:11 - 0:0 - 0:0,0,3,Hovhannesyan Rafik,Asatryan Murad,fiurst,Asatryan Murad - Hovhannesyan Rafik,51,33,18,-15,15,17,17,17,0,0,-5,-5,-5,0,0,-15,11:6 - 11:6 - 11:6 - 0:0 - 0:0
20039092,2024-07-09 14:45:00,Nikoghosyan Narek - Papyan Karen,0:3,10:12 - 6:11 - 8:11 - 0:0 - 0:0,0,3,Nikoghosyan Narek,Papyan Karen,fiurst,Nikoghosyan Narek - Papyan Karen,58,24,34,10,-10,22,17,19,0,0,2,5,3,0,0,10,10:12 - 6:11 - 8:11 - 0:0 - 0:0
20039069,2024-07-09 14:30:00,Diaryan Aleksandr - Hovhannesyan Rafik,3:0,11:4 - 11:7 - 11:3 - 0:0 - 0:0,3,0,Diaryan Aleksandr,Hovhannesyan Rafik,fiurst,Diaryan Aleksandr - Hovhannesyan Rafik,47,33,14,-19,19,15,18,14,0,0,-7,-4,-8,0,0,-19,11:4 - 11:7 - 11:3 - 0:0 - 0:0
20039062,2024-07-09 14:15:00,Nikoghosyan Narek - Asatryan Murad,3:2,11:8 - 9:11 - 3:11 - 11:8 - 6:11,2,3,Nikoghosyan Narek,Asatryan Murad,fiurst,Asatryan Murad - Nikoghosyan Narek,89,49,40,-9,9,19,20,14,19,17,3,-2,-8,3,-5,-9,8:11 - 11:9 - 11:3 - 8:11 - 11:6
20039054,2024-07-09 14:00:00,Papyan Karen - Hovhannesyan Rafik,3:1,9:11 - 5:11 - 11:7 - 6:11 - 0:0,1,3,Papyan Karen,Hovhannesyan Rafik,fiurst,Hovhannesyan Rafik - Papyan Karen,71,40,31,-9,9,20,16,18,17,0,-2,-6,4,-5,0,-9,11:9 - 11:5 - 7:11 - 11:6 - 0:0
20039053,2024-07-09 13:45:00,Diaryan Aleksandr - Nikoghosyan Narek,3:0,11:4 - 13:11 - 11:6 - 0:0 - 0:0,3,0,Diaryan Aleksandr,Nikoghosyan Narek,fiurst,Diaryan Aleksandr - Nikoghosyan Narek,56,35,21,-14,14,15,24,17,0,0,-7,-2,-5,0,0,-14,11:4 - 13:11 - 11:6 - 0:0 - 0:0
20039048,2024-07-09 13:30:00,Asatryan Murad - Papyan Karen,3:0,11:7 - 11:8 - 11:5 - 0:0 - 0:0,3,0,Asatryan Murad,Papyan Karen,fiurst,Asatryan Murad - Papyan Karen,53,33,20,-13,13,18,19,16,0,0,-4,-3,-6,0,0,-13,11:7 - 11:8 - 11:5 - 0:0 - 0:0
20039047,2024-07-09 13:15:00,Hovhannesyan Rafik - Nikoghosyan Narek,3:1,11:8 - 5:11 - 12:10 - 11:9 - 0:0,3,1,Hovhannesyan Rafik,Nikoghosyan Narek,fiurst,Hovhannesyan Rafik - Nikoghosyan Narek,77,39,38,-1,1,19,16,22,20,0,-3,6,-2,-2,0,-1,11:8 - 5:11 - 12:10 - 11:9 - 0:0
20039025,2024-07-09 13:00:00,Asatryan Murad - Diaryan Aleksandr,3:0,12:10 - 11:7 - 12:10 - 0:0 - 0:0,3,0,Asatryan Murad,Diaryan Aleksandr,fiurst,Asatryan Murad - Diaryan Aleksandr,62,35,27,-8,8,22,18,22,0,0,-2,-4,-2,0,0,-8,12:10 - 11:7 - 12:10 - 0:0 - 0:0
20039024,2024-07-09 12:15:00,Papyan Karen - Nikoghosyan Narek,3:0,11:13 - 3:11 - 3:11 - 0:0 - 0:0,0,3,Papyan Karen,Nikoghosyan Narek,fiurst,Nikoghosyan Narek - Papyan Karen,52,35,17,-18,18,24,14,14,0,0,-2,-8,-8,0,0,-18,13:11 - 11:3 - 11:3 - 0:0 - 0:0
20039005,2024-07-09 12:00:00,Asatryan Murad - Hovhannesyan Rafik,3:0,11:8 - 11:7 - 11:8 - 0:0 - 0:0,3,0,Asatryan Murad,Hovhannesyan Rafik,fiurst,Asatryan Murad - Hovhannesyan Rafik,56,33,23,-10,10,19,18,19,0,0,-3,-4,-3,0,0,-10,11:8 - 11:7 - 11:8 - 0:0 - 0:0
20038986,2024-07-09 11:45:00,Diaryan Aleksandr - Papyan Karen,3:0,11:7 - 12:10 - 11:0 - 0:0 - 0:0,3,0,Diaryan Aleksandr,Papyan Karen,fiurst,Diaryan Aleksandr - Papyan Karen,51,34,17,-17,17,18,22,11,0,0,-4,-2,-11,0,0,-17,11:7 - 12:10 - 11:0 - 0:0 - 0:0
20038962,2024-07-09 11:30:00,Hovhannesyan Rafik - Diaryan Aleksandr,3:0,5:11 - 5:11 - 3:11 - 0:0 - 0:0,0,3,Hovhannesyan Rafik,Diaryan Aleksandr,fiurst,Diaryan Aleksandr - Hovhannesyan Rafik,46,33,13,-20,20,16,16,14,0,0,-6,-6,-8,0,0,-20,11:5 - 11:5 - 11:3 - 0:0 - 0:0
20038981,2024-07-09 11:30:00,Asatryan Murad - Nikoghosyan Narek,3:0,11:5 - 11:4 - 11:9 - 0:0 - 0:0,3,0,Asatryan Murad,Nikoghosyan Narek,fiurst,Asatryan Murad - Nikoghosyan Narek,51,33,18,-15,15,16,15,20,0,0,-6,-7,-2,0,0,-15,11:5 - 11:4 - 11:9 - 0:0 - 0:0
20038934,2024-07-09 11:00:00,Papyan Karen - Asatryan Murad,3:1,11:13 - 7:11 - 11:9 - 5:11 - 0:0,1,3,Papyan Karen,Asatryan Murad,fiurst,Asatryan Murad - Papyan Karen,78,44,34,-10,10,24,18,20,16,0,-2,-4,2,-6,0,-10,13:11 - 11:7 - 9:11 - 11:5 - 0:0
20038933,2024-07-09 10:45:00,Nikoghosyan Narek - Diaryan Aleksandr,0:3,11:3 - 12:10 - 11:8 - 0:0 - 0:0,3,0,Nikoghosyan Narek,Diaryan Aleksandr,fiurst,Diaryan Aleksandr - Nikoghosyan Narek,55,21,34,13,-13,14,22,19,0,0,8,2,3,0,0,13,3:11 - 10:12 - 8:11 - 0:0 - 0:0
20038926,2024-07-09 10:40:00,Hovhannesyan Rafik - Papyan Karen,1:3,8:11 - 11:8 - 9:11 - 6:11 - 0:0,1,3,Hovhannesyan Rafik,Papyan Karen,fiurst,Hovhannesyan Rafik - Papyan Karen,75,34,41,7,-7,19,19,20,17,0,3,-3,2,5,0,7,8:11 - 11:8 - 9:11 - 6:11 - 0:0
20038908,2024-07-09 10:15:00,Diaryan Aleksandr - Asatryan Murad,3:1,8:11 - 6:11 - 11:9 - 6:11 - 0:0,1,3,Diaryan Aleksandr,Asatryan Murad,fiurst,Asatryan Murad - Diaryan Aleksandr,73,42,31,-11,11,19,17,20,17,0,-3,-5,2,-5,0,-11,11:8 - 11:6 - 9:11 - 11:6 - 0:0
20038901,2024-07-09 10:00:00,Nikoghosyan Narek - Hovhannesyan Rafik,3:2,11:2 - 9:11 - 4:11 - 14:12 - 12:14,2,3,Nikoghosyan Narek,Hovhannesyan Rafik,fiurst,Hovhannesyan Rafik - Nikoghosyan Narek,100,50,50,0,0,13,20,15,26,26,9,-2,-7,2,-2,0,2:11 - 11:9 - 11:4 - 12:14 - 14:12
19969674,2024-07-08 15:15:00,Papyan Karen - Hovhannesyan Rafik,3:1,12:10 - 9:11 - 6:11 - 9:11 - 0:0,1,3,Papyan Karen,Hovhannesyan Rafik,fiurst,Hovhannesyan Rafik - Papyan Karen,79,43,36,-7,7,22,20,17,20,0,2,-2,-5,-2,0,-7,10:12 - 11:9 - 11:6 - 11:9 - 0:0
19969673,2024-07-08 15:00:00,Gevorgyan Hayk - Rafayelyan Edgar,0:3,7:11 - 10:12 - 5:11 - 0:0 - 0:0,0,3,Gevorgyan Hayk,Rafayelyan Edgar,fiurst,Gevorgyan Hayk - Rafayelyan Edgar,56,22,34,12,-12,18,22,16,0,0,4,2,6,0,0,12,7:11 - 10:12 - 5:11 - 0:0 - 0:0
19969669,2024-07-08 14:45:00,Asatryan Murad - Papyan Karen,3:0,11:5 - 11:9 - 13:11 - 0:0 - 0:0,3,0,Asatryan Murad,Papyan Karen,fiurst,Asatryan Murad - Papyan Karen,60,35,25,-10,10,16,20,24,0,0,-6,-2,-2,0,0,-10,11:5 - 11:9 - 13:11 - 0:0 - 0:0
19969655,2024-07-08 14:35:00,Hovhannesyan Rafik - Gevorgyan Hayk,0:3,11:6 - 11:6 - 11:5 - 0:0 - 0:0,3,0,Hovhannesyan Rafik,Gevorgyan Hayk,fiurst,Gevorgyan Hayk - Hovhannesyan Rafik,50,17,33,16,-16,17,17,16,0,0,5,5,6,0,0,16,6:11 - 6:11 - 5:11 - 0:0 - 0:0
19969646,2024-07-08 14:15:00,Asatryan Murad - Rafayelyan Edgar,3:0,11:4 - 13:11 - 11:5 - 0:0 - 0:0,3,0,Asatryan Murad,Rafayelyan Edgar,fiurst,Asatryan Murad - Rafayelyan Edgar,55,35,20,-15,15,15,24,16,0,0,-7,-2,-6,0,0,-15,11:4 - 13:11 - 11:5 - 0:0 - 0:0
19969639,2024-07-08 14:00:00,Papyan Karen - Gevorgyan Hayk,2:3,4:11 - 11:7 - 11:3 - 11:13 - 11:8,3,2,Papyan Karen,Gevorgyan Hayk,fiurst,Gevorgyan Hayk - Papyan Karen,90,42,48,6,-6,15,18,14,24,19,-7,4,8,-2,3,6,11:4 - 7:11 - 3:11 - 13:11 - 8:11
19969637,2024-07-08 13:45:00,Hovhannesyan Rafik - Asatryan Murad,3:0,3:11 - 8:11 - 3:11 - 0:0 - 0:0,0,3,Hovhannesyan Rafik,Asatryan Murad,fiurst,Asatryan Murad - Hovhannesyan Rafik,47,33,14,-19,19,14,19,14,0,0,-8,-3,-8,0,0,-19,11:3 - 11:8 - 11:3 - 0:0 - 0:0
19969622,2024-07-08 13:30:00,Rafayelyan Edgar - Papyan Karen,3:1,10:12 - 11:7 - 7:11 - 5:11 - 0:0,1,3,Rafayelyan Edgar,Papyan Karen,fiurst,Papyan Karen - Rafayelyan Edgar,74,41,33,-8,8,22,18,18,16,0,-2,4,-4,-6,0,-8,12:10 - 7:11 - 11:7 - 11:5 - 0:0
19969615,2024-07-08 13:15:00,Gevorgyan Hayk - Asatryan Murad,3:0,12:14 - 6:11 - 6:11 - 0:0 - 0:0,0,3,Gevorgyan Hayk,Asatryan Murad,fiurst,Asatryan Murad - Gevorgyan Hayk,60,36,24,-12,12,26,17,17,0,0,-2,-5,-5,0,0,-12,14:12 - 11:6 - 11:6 - 0:0 - 0:0
19969597,2024-07-08 13:00:00,Rafayelyan Edgar - Hovhannesyan Rafik,1:3,11:5 - 11:9 - 9:11 - 11:6 - 0:0,3,1,Rafayelyan Edgar,Hovhannesyan Rafik,fiurst,Hovhannesyan Rafik - Rafayelyan Edgar,73,31,42,11,-11,16,20,20,17,0,6,2,-2,5,0,11,5:11 - 9:11 - 11:9 - 6:11 - 0:0
19969544,2024-07-08 12:20:00,Rafayelyan Edgar - Gevorgyan Hayk,0:3,11:9 - 12:10 - 11:7 - 0:0 - 0:0,3,0,Rafayelyan Edgar,Gevorgyan Hayk,fiurst,Gevorgyan Hayk - Rafayelyan Edgar,60,26,34,8,-8,20,22,18,0,0,2,2,4,0,0,8,9:11 - 10:12 - 7:11 - 0:0 - 0:0
19969548,2024-07-08 12:20:00,Papyan Karen - Asatryan Murad,3:0,9:11 - 1:11 - 6:11 - 0:0 - 0:0,0,3,Papyan Karen,Asatryan Murad,fiurst,Asatryan Murad - Papyan Karen,49,33,16,-17,17,20,12,17,0,0,-2,-10,-5,0,0,-17,11:9 - 11:1 - 11:6 - 0:0 - 0:0
19969520,2024-07-08 11:45:00,Hovhannesyan Rafik - Papyan Karen,0:3,9:11 - 12:14 - 12:14 - 0:0 - 0:0,0,3,Hovhannesyan Rafik,Papyan Karen,fiurst,Hovhannesyan Rafik - Papyan Karen,72,33,39,6,-6,20,26,26,0,0,2,2,2,0,0,6,9:11 - 12:14 - 12:14 - 0:0 - 0:0
19969517,2024-07-08 11:30:00,Rafayelyan Edgar - Asatryan Murad,3:2,13:11 - 11:7 - 6:11 - 10:12 - 15:17,2,3,Rafayelyan Edgar,Asatryan Murad,fiurst,Asatryan Murad - Rafayelyan Edgar,113,58,55,-3,3,24,18,17,22,32,2,4,-5,-2,-2,-3,11:13 - 7:11 - 11:6 - 12:10 - 17:15
19969501,2024-07-08 11:15:00,Gevorgyan Hayk - Hovhannesyan Rafik,3:1,11:7 - 2:11 - 16:14 - 11:7 - 0:0,3,1,Gevorgyan Hayk,Hovhannesyan Rafik,fiurst,Gevorgyan Hayk - Hovhannesyan Rafik,79,40,39,-1,1,18,13,30,18,0,-4,9,-2,-4,0,-1,11:7 - 2:11 - 16:14 - 11:7 - 0:0
19969498,2024-07-08 11:00:00,Papyan Karen - Rafayelyan Edgar,0:3,4:11 - 10:12 - 7:11 - 0:0 - 0:0,0,3,Papyan Karen,Rafayelyan Edgar,fiurst,Papyan Karen - Rafayelyan Edgar,55,21,34,13,-13,15,22,18,0,0,7,2,4,0,0,13,4:11 - 10:12 - 7:11 - 0:0 - 0:0
19969494,2024-07-08 10:45:00,Asatryan Murad - Hovhannesyan Rafik,3:1,11:3 - 11:7 - 9:11 - 11:5 - 0:0,3,1,Asatryan Murad,Hovhannesyan Rafik,fiurst,Asatryan Murad - Hovhannesyan Rafik,68,42,26,-16,16,14,18,20,16,0,-8,-4,2,-6,0,-16,11:3 - 11:7 - 9:11 - 11:5 - 0:0
19969479,2024-07-08 10:30:00,Gevorgyan Hayk - Papyan Karen,0:3,6:11 - 9:11 - 9:11 - 0:0 - 0:0,0,3,Gevorgyan Hayk,Papyan Karen,fiurst,Gevorgyan Hayk - Papyan Karen,57,24,33,9,-9,17,20,20,0,0,5,2,2,0,0,9,6:11 - 9:11 - 9:11 - 0:0 - 0:0
19969472,2024-07-08 10:15:00,Hovhannesyan Rafik - Rafayelyan Edgar,0:3,7:11 - 10:12 - 6:11 - 0:0 - 0:0,0,3,Hovhannesyan Rafik,Rafayelyan Edgar,fiurst,Hovhannesyan Rafik - Rafayelyan Edgar,57,23,34,11,-11,18,22,17,0,0,4,2,5,0,0,11,7:11 - 10:12 - 6:11 - 0:0 - 0:0
19969453,2024-07-08 10:00:00,Asatryan Murad - Gevorgyan Hayk,3:0,11:2 - 11:2 - 11:6 - 0:0 - 0:0,3,0,Asatryan Murad,Gevorgyan Hayk,fiurst,Asatryan Murad - Gevorgyan Hayk,43,33,10,-23,23,13,13,17,0,0,-9,-9,-5,0,0,-23,11:2 - 11:2 - 11:6 - 0:0 - 0:0
19902537,2024-07-07 15:15:00,Nazaryan Mushegh - Gevorgyan Hayk,3:0,9:11 - 7:11 - 3:11 - 0:0 - 0:0,0,3,Nazaryan Mushegh,Gevorgyan Hayk,fiurst,Gevorgyan Hayk - Nazaryan Mushegh,52,33,19,-14,14,20,18,14,0,0,-2,-4,-8,0,0,-14,11:9 - 11:7 - 11:3 - 0:0 - 0:0
19902533,2024-07-07 15:00:00,Nikoghosyan Narek - Diaryan Aleksandr,3:0,9:11 - 3:11 - 4:11 - 0:0 - 0:0,0,3,Nikoghosyan Narek,Diaryan Aleksandr,fiurst,Diaryan Aleksandr - Nikoghosyan Narek,49,33,16,-17,17,20,14,15,0,0,-2,-8,-7,0,0,-17,11:9 - 11:3 - 11:4 - 0:0 - 0:0
19902516,2024-07-07 14:45:00,Rafayelyan Edgar - Nazaryan Mushegh,0:3,11:6 - 11:9 - 11:5 - 0:0 - 0:0,3,0,Rafayelyan Edgar,Nazaryan Mushegh,fiurst,Nazaryan Mushegh - Rafayelyan Edgar,53,20,33,13,-13,17,20,16,0,0,5,2,6,0,0,13,6:11 - 9:11 - 5:11 - 0:0 - 0:0
19902497,2024-07-07 14:30:00,Gevorgyan Hayk - Nikoghosyan Narek,0:3,5:11 - 4:11 - 3:11 - 0:0 - 0:0,0,3,Gevorgyan Hayk,Nikoghosyan Narek,fiurst,Gevorgyan Hayk - Nikoghosyan Narek,45,12,33,21,-21,16,15,14,0,0,6,7,8,0,0,21,5:11 - 4:11 - 3:11 - 0:0 - 0:0
19902491,2024-07-07 14:15:00,Rafayelyan Edgar - Diaryan Aleksandr,0:3,11:9 - 11:6 - 11:6 - 0:0 - 0:0,3,0,Rafayelyan Edgar,Diaryan Aleksandr,fiurst,Diaryan Aleksandr - Rafayelyan Edgar,54,21,33,12,-12,20,17,17,0,0,2,5,5,0,0,12,9:11 - 6:11 - 6:11 - 0:0 - 0:0
19902488,2024-07-07 14:00:00,Nazaryan Mushegh - Nikoghosyan Narek,0:3,9:11 - 5:11 - 5:11 - 0:0 - 0:0,0,3,Nazaryan Mushegh,Nikoghosyan Narek,fiurst,Nazaryan Mushegh - Nikoghosyan Narek,52,19,33,14,-14,20,16,16,0,0,2,6,6,0,0,14,9:11 - 5:11 - 5:11 - 0:0 - 0:0
19902439,2024-07-07 13:45:00,Gevorgyan Hayk - Rafayelyan Edgar,1:3,9:11 - 9:11 - 12:10 - 9:11 - 0:0,1,3,Gevorgyan Hayk,Rafayelyan Edgar,fiurst,Gevorgyan Hayk - Rafayelyan Edgar,82,39,43,4,-4,20,20,22,20,0,2,2,-2,2,0,4,9:11 - 9:11 - 12:10 - 9:11 - 0:0
19902431,2024-07-07 13:30:00,Diaryan Aleksandr - Nazaryan Mushegh,3:0,11:7 - 11:8 - 11:4 - 0:0 - 0:0,3,0,Diaryan Aleksandr,Nazaryan Mushegh,fiurst,Diaryan Aleksandr - Nazaryan Mushegh,52,33,19,-14,14,18,19,15,0,0,-4,-3,-7,0,0,-14,11:7 - 11:8 - 11:4 - 0:0 - 0:0
19902406,2024-07-07 13:15:00,Nikoghosyan Narek - Rafayelyan Edgar,1:3,11:7 - 7:11 - 5:11 - 8:11 - 0:0,1,3,Nikoghosyan Narek,Rafayelyan Edgar,fiurst,Nikoghosyan Narek - Rafayelyan Edgar,71,31,40,9,-9,18,18,16,19,0,-4,4,6,3,0,9,11:7 - 7:11 - 5:11 - 8:11 - 0:0
19902401,2024-07-07 13:05:00,Diaryan Aleksandr - Gevorgyan Hayk,3:2,11:4 - 11:5 - 9:11 - 10:12 - 11:4,3,2,Diaryan Aleksandr,Gevorgyan Hayk,fiurst,Diaryan Aleksandr - Gevorgyan Hayk,88,52,36,-16,16,15,16,20,22,15,-7,-6,2,2,-7,-16,11:4 - 11:5 - 9:11 - 10:12 - 11:4
19902377,2024-07-07 12:20:00,Nazaryan Mushegh - Rafayelyan Edgar,0:3,6:11 - 6:11 - 8:11 - 0:0 - 0:0,0,3,Nazaryan Mushegh,Rafayelyan Edgar,fiurst,Nazaryan Mushegh - Rafayelyan Edgar,53,20,33,13,-13,17,17,19,0,0,5,5,3,0,0,13,6:11 - 6:11 - 8:11 - 0:0 - 0:0
19902370,2024-07-07 12:00:00,Diaryan Aleksandr - Nikoghosyan Narek,3:2,10:12 - 11:7 - 16:18 - 11:9 - 12:10,3,2,Diaryan Aleksandr,Nikoghosyan Narek,fiurst,Diaryan Aleksandr - Nikoghosyan Narek,116,60,56,-4,4,22,18,34,20,22,2,-4,2,-2,-2,-4,10:12 - 11:7 - 16:18 - 11:9 - 12:10
19902335,2024-07-07 11:50:00,Gevorgyan Hayk - Nazaryan Mushegh,3:0,11:7 - 11:8 - 11:6 - 0:0 - 0:0,3,0,Gevorgyan Hayk,Nazaryan Mushegh,fiurst,Gevorgyan Hayk - Nazaryan Mushegh,54,33,21,-12,12,18,19,17,0,0,-4,-3,-5,0,0,-12,11:7 - 11:8 - 11:6 - 0:0 - 0:0
19902330,2024-07-07 11:30:00,Diaryan Aleksandr - Rafayelyan Edgar,2:3,11:7 - 9:11 - 8:11 - 12:10 - 9:11,2,3,Diaryan Aleksandr,Rafayelyan Edgar,fiurst,Diaryan Aleksandr - Rafayelyan Edgar,99,49,50,1,-1,18,20,19,22,20,-4,2,3,-2,2,1,11:7 - 9:11 - 8:11 - 12:10 - 9:11
19902316,2024-07-07 11:15:00,Nikoghosyan Narek - Gevorgyan Hayk,3:2,11:7 - 7:11 - 11:3 - 2:11 - 9:11,2,3,Nikoghosyan Narek,Gevorgyan Hayk,fiurst,Gevorgyan Hayk - Nikoghosyan Narek,83,43,40,-3,3,18,18,14,13,20,4,-4,8,-9,-2,-3,7:11 - 11:7 - 3:11 - 11:2 - 11:9
19902313,2024-07-07 11:00:00,Nazaryan Mushegh - Diaryan Aleksandr,3:0,6:11 - 5:11 - 6:11 - 0:0 - 0:0,0,3,Nazaryan Mushegh,Diaryan Aleksandr,fiurst,Diaryan Aleksandr - Nazaryan Mushegh,50,33,17,-16,16,17,16,17,0,0,-5,-6,-5,0,0,-16,11:6 - 11:5 - 11:6 - 0:0 - 0:0
19902310,2024-07-07 10:45:00,Rafayelyan Edgar - Gevorgyan Hayk,0:3,11:5 - 11:8 - 11:6 - 0:0 - 0:0,3,0,Rafayelyan Edgar,Gevorgyan Hayk,fiurst,Gevorgyan Hayk - Rafayelyan Edgar,52,19,33,14,-14,16,19,17,0,0,6,3,5,0,0,14,5:11 - 8:11 - 6:11 - 0:0 - 0:0
19902295,2024-07-07 10:30:00,Nikoghosyan Narek - Nazaryan Mushegh,0:3,11:6 - 11:4 - 11:7 - 0:0 - 0:0,3,0,Nikoghosyan Narek,Nazaryan Mushegh,fiurst,Nazaryan Mushegh - Nikoghosyan Narek,50,17,33,16,-16,17,15,18,0,0,5,7,4,0,0,16,6:11 - 4:11 - 7:11 - 0:0 - 0:0
19902291,2024-07-07 10:15:00,Gevorgyan Hayk - Diaryan Aleksandr,3:1,3:11 - 7:11 - 11:5 - 3:11 - 0:0,1,3,Gevorgyan Hayk,Diaryan Aleksandr,fiurst,Diaryan Aleksandr - Gevorgyan Hayk,62,38,24,-14,14,14,18,16,14,0,-8,-4,6,-8,0,-14,11:3 - 11:7 - 5:11 - 11:3 - 0:0
19902266,2024-07-07 10:00:00,Rafayelyan Edgar - Nikoghosyan Narek,1:3,9:11 - 11:5 - 11:6 - 11:6 - 0:0,3,1,Rafayelyan Edgar,Nikoghosyan Narek,fiurst,Nikoghosyan Narek - Rafayelyan Edgar,70,28,42,14,-14,20,16,17,17,0,-2,6,5,5,0,14,11:9 - 5:11 - 6:11 - 6:11 - 0:0
19837029,2024-07-06 15:15:00,Asatryan Murad - Rafayelyan Edgar,3:1,12:10 - 9:11 - 11:5 - 11:6 - 0:0,3,1,Asatryan Murad,Rafayelyan Edgar,fiurst,Asatryan Murad - Rafayelyan Edgar,75,43,32,-11,11,22,20,16,17,0,-2,2,-6,-5,0,-11,12:10 - 9:11 - 11:5 - 11:6 - 0:0
19837027,2024-07-06 15:00:00,Nazaryan Mushegh - Nikoghosyan Narek,3:1,13:15 - 12:10 - 11:5 - 11:8 - 0:0,3,1,Nazaryan Mushegh,Nikoghosyan Narek,fiurst,Nazaryan Mushegh - Nikoghosyan Narek,85,47,38,-9,9,28,22,16,19,0,2,-2,-6,-3,0,-9,13:15 - 12:10 - 11:5 - 11:8 - 0:0
19836985,2024-07-06 14:45:00,Papyan Karen - Asatryan Murad,3:1,11:4 - 10:12 - 7:11 - 9:11 - 0:0,1,3,Papyan Karen,Asatryan Murad,fiurst,Asatryan Murad - Papyan Karen,75,38,37,-1,1,15,22,18,20,0,7,-2,-4,-2,0,-1,4:11 - 12:10 - 11:7 - 11:9 - 0:0
19836982,2024-07-06 14:30:00,Rafayelyan Edgar - Nazaryan Mushegh,1:3,11:7 - 5:11 - 11:9 - 11:5 - 0:0,3,1,Rafayelyan Edgar,Nazaryan Mushegh,fiurst,Nazaryan Mushegh - Rafayelyan Edgar,70,32,38,6,-6,18,16,20,16,0,4,-6,2,6,0,6,7:11 - 11:5 - 9:11 - 5:11 - 0:0
19836968,2024-07-06 14:15:00,Papyan Karen - Nikoghosyan Narek,0:3,11:3 - 11:7 - 11:4 - 0:0 - 0:0,3,0,Papyan Karen,Nikoghosyan Narek,fiurst,Nikoghosyan Narek - Papyan Karen,47,14,33,19,-19,14,18,15,0,0,8,4,7,0,0,19,3:11 - 7:11 - 4:11 - 0:0 - 0:0
19836948,2024-07-06 14:00:00,Asatryan Murad - Nazaryan Mushegh,3:1,11:6 - 10:12 - 11:6 - 11:7 - 0:0,3,1,Asatryan Murad,Nazaryan Mushegh,fiurst,Asatryan Murad - Nazaryan Mushegh,74,43,31,-12,12,17,22,17,18,0,-5,2,-5,-4,0,-12,11:6 - 10:12 - 11:6 - 11:7 - 0:0
19836933,2024-07-06 13:45:00,Rafayelyan Edgar - Papyan Karen,0:3,12:10 - 12:10 - 11:6 - 0:0 - 0:0,3,0,Rafayelyan Edgar,Papyan Karen,fiurst,Papyan Karen - Rafayelyan Edgar,61,26,35,9,-9,22,22,17,0,0,2,2,5,0,0,9,10:12 - 10:12 - 6:11 - 0:0 - 0:0
19836906,2024-07-06 13:30:00,Nikoghosyan Narek - Asatryan Murad,3:0,5:11 - 10:12 - 6:11 - 0:0 - 0:0,0,3,Nikoghosyan Narek,Asatryan Murad,fiurst,Asatryan Murad - Nikoghosyan Narek,55,34,21,-13,13,16,22,17,0,0,-6,-2,-5,0,0,-13,11:5 - 12:10 - 11:6 - 0:0 - 0:0
19836823,2024-07-06 13:15:00,Nazaryan Mushegh - Papyan Karen,3:1,11:3 - 11:7 - 9:11 - 11:5 - 0:0,3,1,Nazaryan Mushegh,Papyan Karen,fiurst,Nazaryan Mushegh - Papyan Karen,68,42,26,-16,16,14,18,20,16,0,-8,-4,2,-6,0,-16,11:3 - 11:7 - 9:11 - 11:5 - 0:0
19836796,2024-07-06 13:00:00,Nikoghosyan Narek - Rafayelyan Edgar,1:3,14:12 - 8:11 - 4:11 - 4:11 - 0:0,1,3,Nikoghosyan Narek,Rafayelyan Edgar,fiurst,Nikoghosyan Narek - Rafayelyan Edgar,75,30,45,15,-15,26,19,15,15,0,-2,3,7,7,0,15,14:12 - 8:11 - 4:11 - 4:11 - 0:0
19836790,2024-07-06 12:15:00,Asatryan Murad - Papyan Karen,3:0,11:9 - 11:9 - 11:3 - 0:0 - 0:0,3,0,Asatryan Murad,Papyan Karen,fiurst,Asatryan Murad - Papyan Karen,54,33,21,-12,12,20,20,14,0,0,-2,-2,-8,0,0,-12,11:9 - 11:9 - 11:3 - 0:0 - 0:0
19836759,2024-07-06 12:05:00,Nikoghosyan Narek - Nazaryan Mushegh,0:3,11:6 - 11:6 - 11:5 - 0:0 - 0:0,3,0,Nikoghosyan Narek,Nazaryan Mushegh,fiurst,Nazaryan Mushegh - Nikoghosyan Narek,50,17,33,16,-16,17,17,16,0,0,5,5,6,0,0,16,6:11 - 6:11 - 5:11 - 0:0 - 0:0
19836753,2024-07-06 11:45:00,Rafayelyan Edgar - Asatryan Murad,2:3,11:7 - 11:7 - 5:11 - 9:11 - 11:9,3,2,Rafayelyan Edgar,Asatryan Murad,fiurst,Asatryan Murad - Rafayelyan Edgar,92,45,47,2,-2,18,18,16,20,20,4,4,-6,-2,2,2,7:11 - 7:11 - 11:5 - 11:9 - 9:11
19836752,2024-07-06 11:30:00,Nikoghosyan Narek - Papyan Karen,3:2,7:11 - 11:8 - 10:12 - 11:4 - 11:5,3,2,Nikoghosyan Narek,Papyan Karen,fiurst,Nikoghosyan Narek - Papyan Karen,90,50,40,-10,10,18,19,22,15,16,4,-3,2,-7,-6,-10,7:11 - 11:8 - 10:12 - 11:4 - 11:5
19836750,2024-07-06 11:20:00,Nazaryan Mushegh - Rafayelyan Edgar,3:2,11:7 - 7:11 - 11:6 - 9:11 - 11:7,3,2,Nazaryan Mushegh,Rafayelyan Edgar,fiurst,Nazaryan Mushegh - Rafayelyan Edgar,91,49,42,-7,7,18,18,17,20,18,-4,4,-5,2,-4,-7,11:7 - 7:11 - 11:6 - 9:11 - 11:7
19836748,2024-07-06 11:00:00,Asatryan Murad - Nikoghosyan Narek,3:0,11:9 - 12:10 - 11:5 - 0:0 - 0:0,3,0,Asatryan Murad,Nikoghosyan Narek,fiurst,Asatryan Murad - Nikoghosyan Narek,58,34,24,-10,10,20,22,16,0,0,-2,-2,-6,0,0,-10,11:9 - 12:10 - 11:5 - 0:0 - 0:0
19836698,2024-07-06 10:45:00,Papyan Karen - Rafayelyan Edgar,1:3,11:13 - 11:8 - 6:11 - 9:11 - 0:0,1,3,Papyan Karen,Rafayelyan Edgar,fiurst,Papyan Karen - Rafayelyan Edgar,80,37,43,6,-6,24,19,17,20,0,2,-3,5,2,0,6,11:13 - 11:8 - 6:11 - 9:11 - 0:0
19836671,2024-07-06 10:30:00,Nazaryan Mushegh - Asatryan Murad,3:1,8:11 - 6:11 - 11:9 - 5:11 - 0:0,1,3,Nazaryan Mushegh,Asatryan Murad,fiurst,Asatryan Murad - Nazaryan Mushegh,72,42,30,-12,12,19,17,20,16,0,-3,-5,2,-6,0,-12,11:8 - 11:6 - 9:11 - 11:5 - 0:0
19836663,2024-07-06 10:15:00,Rafayelyan Edgar - Nikoghosyan Narek,0:3,14:12 - 11:9 - 11:4 - 0:0 - 0:0,3,0,Rafayelyan Edgar,Nikoghosyan Narek,fiurst,Nikoghosyan Narek - Rafayelyan Edgar,61,25,36,11,-11,26,20,15,0,0,2,2,7,0,0,11,12:14 - 9:11 - 4:11 - 0:0 - 0:0
19836643,2024-07-06 10:00:00,Papyan Karen - Nazaryan Mushegh,3:2,9:11 - 11:4 - 11:9 - 3:11 - 13:15,2,3,Papyan Karen,Nazaryan Mushegh,fiurst,Nazaryan Mushegh - Papyan Karen,97,50,47,-3,3,20,15,20,14,28,-2,7,2,-8,-2,-3,11:9 - 4:11 - 9:11 - 11:3 - 15:13
19764704,2024-07-05 15:15:00,Nikoghosyan Narek - Papyan Karen,3:2,9:11 - 11:4 - 7:11 - 11:3 - 11:8,3,2,Nikoghosyan Narek,Papyan Karen,fiurst,Nikoghosyan Narek - Papyan Karen,86,49,37,-12,12,20,15,18,14,19,2,-7,4,-8,-3,-12,9:11 - 11:4 - 7:11 - 11:3 - 11:8
19764669,2024-07-05 15:00:00,Diaryan Aleksandr - Asatryan Murad,3:1,6:11 - 11:9 - 8:11 - 7:11 - 0:0,1,3,Diaryan Aleksandr,Asatryan Murad,fiurst,Asatryan Murad - Diaryan Aleksandr,74,42,32,-10,10,17,20,19,18,0,-5,2,-3,-4,0,-10,11:6 - 9:11 - 11:8 - 11:7 - 0:0
19764662,2024-07-05 14:50:00,Gevorgyan Hayk - Nikoghosyan Narek,0:3,3:11 - 6:11 - 7:11 - 0:0 - 0:0,0,3,Gevorgyan Hayk,Nikoghosyan Narek,fiurst,Gevorgyan Hayk - Nikoghosyan Narek,49,16,33,17,-17,14,17,18,0,0,8,5,4,0,0,17,3:11 - 6:11 - 7:11 - 0:0 - 0:0
19764632,2024-07-05 14:30:00,Papyan Karen - Diaryan Aleksandr,3:2,11:8 - 8:11 - 11:7 - 10:12 - 9:11,2,3,Papyan Karen,Diaryan Aleksandr,fiurst,Diaryan Aleksandr - Papyan Karen,98,49,49,0,0,19,19,18,22,20,3,-3,4,-2,-2,0,8:11 - 11:8 - 7:11 - 12:10 - 11:9
19764629,2024-07-05 14:15:00,Gevorgyan Hayk - Asatryan Murad,3:1,8:11 - 12:10 - 8:11 - 11:13 - 0:0,1,3,Gevorgyan Hayk,Asatryan Murad,fiurst,Asatryan Murad - Gevorgyan Hayk,84,45,39,-6,6,19,22,19,24,0,-3,2,-3,-2,0,-6,11:8 - 10:12 - 11:8 - 13:11 - 0:0
19764622,2024-07-05 14:00:00,Nikoghosyan Narek - Diaryan Aleksandr,2:3,6:11 - 11:5 - 9:11 - 11:8 - 11:4,3,2,Nikoghosyan Narek,Diaryan Aleksandr,fiurst,Diaryan Aleksandr - Nikoghosyan Narek,87,39,48,9,-9,17,16,20,19,15,-5,6,-2,3,7,9,11:6 - 5:11 - 11:9 - 8:11 - 4:11
19764599,2024-07-05 13:45:00,Papyan Karen - Gevorgyan Hayk,1:3,11:8 - 11:6 - 7:11 - 12:10 - 0:0,3,1,Papyan Karen,Gevorgyan Hayk,fiurst,Gevorgyan Hayk - Papyan Karen,76,35,41,6,-6,19,17,18,22,0,3,5,-4,2,0,6,8:11 - 6:11 - 11:7 - 10:12 - 0:0
19764589,2024-07-05 13:30:00,Asatryan Murad - Nikoghosyan Narek,3:1,6:11 - 11:9 - 11:5 - 11:8 - 0:0,3,1,Asatryan Murad,Nikoghosyan Narek,fiurst,Asatryan Murad - Nikoghosyan Narek,72,39,33,-6,6,17,20,16,19,0,5,-2,-6,-3,0,-6,6:11 - 11:9 - 11:5 - 11:8 - 0:0
19764564,2024-07-05 13:15:00,Diaryan Aleksandr - Gevorgyan Hayk,0:3,6:11 - 10:12 - 3:11 - 0:0 - 0:0,0,3,Diaryan Aleksandr,Gevorgyan Hayk,fiurst,Diaryan Aleksandr - Gevorgyan Hayk,53,19,34,15,-15,17,22,14,0,0,5,2,8,0,0,15,6:11 - 10:12 - 3:11 - 0:0 - 0:0
19764548,2024-07-05 13:00:00,Asatryan Murad - Papyan Karen,3:1,11:8 - 12:14 - 11:3 - 11:3 - 0:0,3,1,Asatryan Murad,Papyan Karen,fiurst,Asatryan Murad - Papyan Karen,73,45,28,-17,17,19,26,14,14,0,-3,2,-8,-8,0,-17,11:8 - 12:14 - 11:3 - 11:3 - 0:0
19764536,2024-07-05 12:15:00,Nikoghosyan Narek - Gevorgyan Hayk,1:3,11:9 - 11:4 - 5:11 - 11:9 - 0:0,3,1,Nikoghosyan Narek,Gevorgyan Hayk,fiurst,Gevorgyan Hayk - Nikoghosyan Narek,71,33,38,5,-5,20,15,16,20,0,2,7,-6,2,0,5,9:11 - 4:11 - 11:5 - 9:11 - 0:0
19764531,2024-07-05 12:00:00,Asatryan Murad - Diaryan Aleksandr,3:1,13:11 - 7:11 - 11:9 - 11:7 - 0:0,3,1,Asatryan Murad,Diaryan Aleksandr,fiurst,Asatryan Murad - Diaryan Aleksandr,80,42,38,-4,4,24,18,20,18,0,-2,4,-2,-4,0,-4,13:11 - 7:11 - 11:9 - 11:7 - 0:0
19764529,2024-07-05 11:45:00,Papyan Karen - Nikoghosyan Narek,1:3,11:6 - 11:9 - 9:11 - 14:12 - 0:0,3,1,Papyan Karen,Nikoghosyan Narek,fiurst,Nikoghosyan Narek - Papyan Karen,83,38,45,7,-7,17,20,20,26,0,5,2,-2,2,0,7,6:11 - 9:11 - 11:9 - 12:14 - 0:0
19764514,2024-07-05 11:30:00,Asatryan Murad - Gevorgyan Hayk,3:0,11:5 - 11:4 - 11:8 - 0:0 - 0:0,3,0,Asatryan Murad,Gevorgyan Hayk,fiurst,Asatryan Murad - Gevorgyan Hayk,50,33,17,-16,16,16,15,19,0,0,-6,-7,-3,0,0,-16,11:5 - 11:4 - 11:8 - 0:0 - 0:0
19764510,2024-07-05 11:20:00,Diaryan Aleksandr - Papyan Karen,3:0,11:7 - 11:5 - 13:11 - 0:0 - 0:0,3,0,Diaryan Aleksandr,Papyan Karen,fiurst,Diaryan Aleksandr - Papyan Karen,58,35,23,-12,12,18,16,24,0,0,-4,-6,-2,0,0,-12,11:7 - 11:5 - 13:11 - 0:0 - 0:0
19764496,2024-07-05 11:00:00,Nikoghosyan Narek - Asatryan Murad,3:1,11:8 - 5:11 - 9:11 - 8:11 - 0:0,1,3,Nikoghosyan Narek,Asatryan Murad,fiurst,Asatryan Murad - Nikoghosyan Narek,74,41,33,-8,8,19,16,20,19,0,3,-6,-2,-3,0,-8,8:11 - 11:5 - 11:9 - 11:8 - 0:0
19764493,2024-07-05 10:45:00,Gevorgyan Hayk - Papyan Karen,1:3,14:16 - 11:7 - 10:12 - 10:12 - 0:0,1,3,Gevorgyan Hayk,Papyan Karen,fiurst,Gevorgyan Hayk - Papyan Karen,92,45,47,2,-2,30,18,22,22,0,2,-4,2,2,0,2,14:16 - 11:7 - 10:12 - 10:12 - 0:0
19764481,2024-07-05 10:30:00,Diaryan Aleksandr - Nikoghosyan Narek,3:0,12:10 - 11:8 - 11:5 - 0:0 - 0:0,3,0,Diaryan Aleksandr,Nikoghosyan Narek,fiurst,Diaryan Aleksandr - Nikoghosyan Narek,57,34,23,-11,11,22,19,16,0,0,-2,-3,-6,0,0,-11,12:10 - 11:8 - 11:5 - 0:0 - 0:0
19764479,2024-07-05 10:15:00,Papyan Karen - Asatryan Murad,3:0,12:14 - 3:11 - 7:11 - 0:0 - 0:0,0,3,Papyan Karen,Asatryan Murad,fiurst,Asatryan Murad - Papyan Karen,58,36,22,-14,14,26,14,18,0,0,-2,-8,-4,0,0,-14,14:12 - 11:3 - 11:7 - 0:0 - 0:0
19764478,2024-07-05 10:00:00,Gevorgyan Hayk - Diaryan Aleksandr,3:0,8:11 - 7:11 - 6:11 - 0:0 - 0:0,0,3,Gevorgyan Hayk,Diaryan Aleksandr,fiurst,Diaryan Aleksandr - Gevorgyan Hayk,54,33,21,-12,12,19,18,17,0,0,-3,-4,-5,0,0,-12,11:8 - 11:7 - 11:6 - 0:0 - 0:0
19702401,2024-07-04 15:20:00,Diaryan Aleksandr - Gevorgyan Hayk,3:0,12:10 - 11:6 - 11:3 - 0:0 - 0:0,3,0,Diaryan Aleksandr,Gevorgyan Hayk,fiurst,Diaryan Aleksandr - Gevorgyan Hayk,53,34,19,-15,15,22,17,14,0,0,-2,-5,-8,0,0,-15,12:10 - 11:6 - 11:3 - 0:0 - 0:0
19702400,2024-07-04 15:00:00,Papyan Karen - Hovhannesyan Rafik,3:1,5:11 - 10:12 - 11:8 - 10:12 - 0:0,1,3,Papyan Karen,Hovhannesyan Rafik,fiurst,Hovhannesyan Rafik - Papyan Karen,79,43,36,-7,7,16,22,19,22,0,-6,-2,3,-2,0,-7,11:5 - 12:10 - 8:11 - 12:10 - 0:0
19702366,2024-07-04 14:45:00,Nikoghosyan Narek - Diaryan Aleksandr,3:0,10:12 - 5:11 - 9:11 - 0:0 - 0:0,0,3,Nikoghosyan Narek,Diaryan Aleksandr,fiurst,Diaryan Aleksandr - Nikoghosyan Narek,58,34,24,-10,10,22,16,20,0,0,-2,-6,-2,0,0,-10,12:10 - 11:5 - 11:9 - 0:0 - 0:0
19702360,2024-07-04 14:30:00,Gevorgyan Hayk - Papyan Karen,2:3,6:11 - 9:11 - 12:10 - 11:8 - 9:11,2,3,Gevorgyan Hayk,Papyan Karen,fiurst,Gevorgyan Hayk - Papyan Karen,98,47,51,4,-4,17,20,22,19,20,5,2,-2,-3,2,4,6:11 - 9:11 - 12:10 - 11:8 - 9:11
19702349,2024-07-04 14:15:00,Nikoghosyan Narek - Hovhannesyan Rafik,1:3,11:2 - 10:12 - 11:9 - 11:5 - 0:0,3,1,Nikoghosyan Narek,Hovhannesyan Rafik,fiurst,Hovhannesyan Rafik - Nikoghosyan Narek,71,28,43,15,-15,13,22,20,16,0,9,-2,2,6,0,15,2:11 - 12:10 - 9:11 - 5:11 - 0:0
19702343,2024-07-04 14:00:00,Diaryan Aleksandr - Papyan Karen,2:3,11:8 - 7:11 - 11:4 - 9:11 - 8:11,2,3,Diaryan Aleksandr,Papyan Karen,fiurst,Diaryan Aleksandr - Papyan Karen,91,46,45,-1,1,19,18,15,20,19,-3,4,-7,2,3,-1,11:8 - 7:11 - 11:4 - 9:11 - 8:11
19702337,2024-07-04 13:50:00,Gevorgyan Hayk - Nikoghosyan Narek,0:3,6:11 - 7:11 - 6:11 - 0:0 - 0:0,0,3,Gevorgyan Hayk,Nikoghosyan Narek,fiurst,Gevorgyan Hayk - Nikoghosyan Narek,52,19,33,14,-14,17,18,17,0,0,5,4,5,0,0,14,6:11 - 7:11 - 6:11 - 0:0 - 0:0
19702293,2024-07-04 13:40:00,Hovhannesyan Rafik - Diaryan Aleksandr,3:0,6:11 - 6:11 - 6:11 - 0:0 - 0:0,0,3,Hovhannesyan Rafik,Diaryan Aleksandr,fiurst,Diaryan Aleksandr - Hovhannesyan Rafik,51,33,18,-15,15,17,17,17,0,0,-5,-5,-5,0,0,-15,11:6 - 11:6 - 11:6 - 0:0 - 0:0
19702287,2024-07-04 13:15:00,Papyan Karen - Nikoghosyan Narek,2:3,11:9 - 11:8 - 9:11 - 5:11 - 11:8,3,2,Papyan Karen,Nikoghosyan Narek,fiurst,Nikoghosyan Narek - Papyan Karen,94,47,47,0,0,20,19,20,16,19,2,3,-2,-6,3,0,9:11 - 8:11 - 11:9 - 11:5 - 8:11
19702267,2024-07-04 13:00:00,Hovhannesyan Rafik - Gevorgyan Hayk,0:3,12:10 - 11:7 - 11:7 - 0:0 - 0:0,3,0,Hovhannesyan Rafik,Gevorgyan Hayk,fiurst,Gevorgyan Hayk - Hovhannesyan Rafik,58,24,34,10,-10,22,18,18,0,0,2,4,4,0,0,10,10:12 - 7:11 - 7:11 - 0:0 - 0:0
19702250,2024-07-04 12:25:00,Diaryan Aleksandr - Nikoghosyan Narek,3:2,11:8 - 9:11 - 11:4 - 6:11 - 11:5,3,2,Diaryan Aleksandr,Nikoghosyan Narek,fiurst,Diaryan Aleksandr - Nikoghosyan Narek,87,48,39,-9,9,19,20,15,17,16,-3,2,-7,5,-6,-9,11:8 - 9:11 - 11:4 - 6:11 - 11:5
19702243,2024-07-04 12:05:00,Hovhannesyan Rafik - Papyan Karen,3:2,9:11 - 11:5 - 9:11 - 11:2 - 11:6,3,2,Hovhannesyan Rafik,Papyan Karen,fiurst,Hovhannesyan Rafik - Papyan Karen,86,51,35,-16,16,20,16,20,13,17,2,-6,2,-9,-5,-16,9:11 - 11:5 - 9:11 - 11:2 - 11:6
19702228,2024-07-04 11:55:00,Gevorgyan Hayk - Diaryan Aleksandr,2:3,11:9 - 7:11 - 14:16 - 11:5 - 11:4,3,2,Gevorgyan Hayk,Diaryan Aleksandr,fiurst,Diaryan Aleksandr - Gevorgyan Hayk,99,45,54,9,-9,20,18,30,16,15,2,-4,-2,6,7,9,9:11 - 11:7 - 16:14 - 5:11 - 4:11
19702214,2024-07-04 11:30:00,Hovhannesyan Rafik - Nikoghosyan Narek,3:1,11:7 - 11:9 - 5:11 - 11:4 - 0:0,3,1,Hovhannesyan Rafik,Nikoghosyan Narek,fiurst,Hovhannesyan Rafik - Nikoghosyan Narek,69,38,31,-7,7,18,20,16,15,0,-4,-2,6,-7,0,-7,11:7 - 11:9 - 5:11 - 11:4 - 0:0
19702210,2024-07-04 11:20:00,Papyan Karen - Gevorgyan Hayk,1:3,11:8 - 5:11 - 14:12 - 11:6 - 0:0,3,1,Papyan Karen,Gevorgyan Hayk,fiurst,Gevorgyan Hayk - Papyan Karen,78,37,41,4,-4,19,16,26,17,0,3,-6,2,5,0,4,8:11 - 11:5 - 12:14 - 6:11 - 0:0
19702186,2024-07-04 11:00:00,Diaryan Aleksandr - Hovhannesyan Rafik,3:1,13:11 - 8:11 - 11:6 - 11:5 - 0:0,3,1,Diaryan Aleksandr,Hovhannesyan Rafik,fiurst,Diaryan Aleksandr - Hovhannesyan Rafik,76,43,33,-10,10,24,19,17,16,0,-2,3,-5,-6,0,-10,13:11 - 8:11 - 11:6 - 11:5 - 0:0
19702166,2024-07-04 10:45:00,Nikoghosyan Narek - Gevorgyan Hayk,2:3,7:11 - 11:13 - 11:4 - 11:3 - 11:5,3,2,Nikoghosyan Narek,Gevorgyan Hayk,fiurst,Gevorgyan Hayk - Nikoghosyan Narek,87,36,51,15,-15,18,24,15,14,16,-4,-2,7,8,6,15,11:7 - 13:11 - 4:11 - 3:11 - 5:11
19702156,2024-07-04 10:30:00,Papyan Karen - Diaryan Aleksandr,3:0,6:11 - 11:13 - 6:11 - 0:0 - 0:0,0,3,Papyan Karen,Diaryan Aleksandr,fiurst,Diaryan Aleksandr - Papyan Karen,58,35,23,-12,12,17,24,17,0,0,-5,-2,-5,0,0,-12,11:6 - 13:11 - 11:6 - 0:0 - 0:0
19702150,2024-07-04 10:15:00,Gevorgyan Hayk - Hovhannesyan Rafik,0:3,9:11 - 5:11 - 7:11 - 0:0 - 0:0,0,3,Gevorgyan Hayk,Hovhannesyan Rafik,fiurst,Gevorgyan Hayk - Hovhannesyan Rafik,54,21,33,12,-12,20,16,18,0,0,2,6,4,0,0,12,9:11 - 5:11 - 7:11 - 0:0 - 0:0
19702137,2024-07-04 10:00:00,Nikoghosyan Narek - Papyan Karen,1:3,8:11 - 8:11 - 11:3 - 6:11 - 0:0,1,3,Nikoghosyan Narek,Papyan Karen,fiurst,Nikoghosyan Narek - Papyan Karen,69,33,36,3,-3,19,19,14,17,0,3,3,-8,5,0,3,8:11 - 8:11 - 11:3 - 6:11 - 0:0
19627918,2024-07-03 15:15:00,Hovhannesyan Rafik - Papyan Karen,3:1,11:3 - 11:6 - 10:12 - 11:6 - 0:0,3,1,Hovhannesyan Rafik,Papyan Karen,fiurst,Hovhannesyan Rafik - Papyan Karen,70,43,27,-16,16,14,17,22,17,0,-8,-5,2,-5,0,-16,11:3 - 11:6 - 10:12 - 11:6 - 0:0
19627914,2024-07-03 15:00:00,Nazaryan Mushegh - Asatryan Murad,3:0,8:11 - 8:11 - 8:11 - 0:0 - 0:0,0,3,Nazaryan Mushegh,Asatryan Murad,fiurst,Asatryan Murad - Nazaryan Mushegh,57,33,24,-9,9,19,19,19,0,0,-3,-3,-3,0,0,-9,11:8 - 11:8 - 11:8 - 0:0 - 0:0
19627902,2024-07-03 14:45:00,Diaryan Aleksandr - Hovhannesyan Rafik,3:0,11:7 - 11:7 - 11:3 - 0:0 - 0:0,3,0,Diaryan Aleksandr,Hovhannesyan Rafik,fiurst,Diaryan Aleksandr - Hovhannesyan Rafik,50,33,17,-16,16,18,18,14,0,0,-4,-4,-8,0,0,-16,11:7 - 11:7 - 11:3 - 0:0 - 0:0
19627900,2024-07-03 14:30:00,Papyan Karen - Nazaryan Mushegh,3:0,10:12 - 9:11 - 12:14 - 0:0 - 0:0,0,3,Papyan Karen,Nazaryan Mushegh,fiurst,Nazaryan Mushegh - Papyan Karen,68,37,31,-6,6,22,20,26,0,0,-2,-2,-2,0,0,-6,12:10 - 11:9 - 14:12 - 0:0 - 0:0
19627883,2024-07-03 14:15:00,Diaryan Aleksandr - Asatryan Murad,3:1,9:11 - 11:9 - 4:11 - 6:11 - 0:0,1,3,Diaryan Aleksandr,Asatryan Murad,fiurst,Asatryan Murad - Diaryan Aleksandr,72,42,30,-12,12,20,20,15,17,0,-2,2,-7,-5,0,-12,11:9 - 9:11 - 11:4 - 11:6 - 0:0
19627880,2024-07-03 14:00:00,Hovhannesyan Rafik - Nazaryan Mushegh,0:3,8:11 - 3:11 - 9:11 - 0:0 - 0:0,0,3,Hovhannesyan Rafik,Nazaryan Mushegh,fiurst,Hovhannesyan Rafik - Nazaryan Mushegh,53,20,33,13,-13,19,14,20,0,0,3,8,2,0,0,13,8:11 - 3:11 - 9:11 - 0:0 - 0:0
19627868,2024-07-03 13:45:00,Papyan Karen - Diaryan Aleksandr,3:0,8:11 - 4:11 - 11:13 - 0:0 - 0:0,0,3,Papyan Karen,Diaryan Aleksandr,fiurst,Diaryan Aleksandr - Papyan Karen,58,35,23,-12,12,19,15,24,0,0,-3,-7,-2,0,0,-12,11:8 - 11:4 - 13:11 - 0:0 - 0:0
19627857,2024-07-03 13:30:00,Asatryan Murad - Hovhannesyan Rafik,3:0,11:6 - 11:3 - 11:8 - 0:0 - 0:0,3,0,Asatryan Murad,Hovhannesyan Rafik,fiurst,Asatryan Murad - Hovhannesyan Rafik,50,33,17,-16,16,17,14,19,0,0,-5,-8,-3,0,0,-16,11:6 - 11:3 - 11:8 - 0:0 - 0:0
19627855,2024-07-03 13:15:00,Nazaryan Mushegh - Diaryan Aleksandr,3:0,5:11 - 6:11 - 10:12 - 0:0 - 0:0,0,3,Nazaryan Mushegh,Diaryan Aleksandr,fiurst,Diaryan Aleksandr - Nazaryan Mushegh,55,34,21,-13,13,16,17,22,0,0,-6,-5,-2,0,0,-13,11:5 - 11:6 - 12:10 - 0:0 - 0:0
19627817,2024-07-03 13:00:00,Asatryan Murad - Papyan Karen,3:0,11:7 - 11:4 - 11:8 - 0:0 - 0:0,3,0,Asatryan Murad,Papyan Karen,fiurst,Asatryan Murad - Papyan Karen,52,33,19,-14,14,18,15,19,0,0,-4,-7,-3,0,0,-14,11:7 - 11:4 - 11:8 - 0:0 - 0:0
19627810,2024-07-03 12:15:00,Hovhannesyan Rafik - Diaryan Aleksandr,3:2,5:11 - 11:8 - 9:11 - 11:6 - 8:11,2,3,Hovhannesyan Rafik,Diaryan Aleksandr,fiurst,Diaryan Aleksandr - Hovhannesyan Rafik,91,47,44,-3,3,16,19,20,17,19,-6,3,-2,5,-3,-3,11:5 - 8:11 - 11:9 - 6:11 - 11:8
19627797,2024-07-03 12:00:00,Asatryan Murad - Nazaryan Mushegh,3:0,11:5 - 11:8 - 11:5 - 0:0 - 0:0,3,0,Asatryan Murad,Nazaryan Mushegh,fiurst,Asatryan Murad - Nazaryan Mushegh,51,33,18,-15,15,16,19,16,0,0,-6,-3,-6,0,0,-15,11:5 - 11:8 - 11:5 - 0:0 - 0:0
19627754,2024-07-03 11:45:00,Papyan Karen - Hovhannesyan Rafik,0:3,14:12 - 11:7 - 11:6 - 0:0 - 0:0,3,0,Papyan Karen,Hovhannesyan Rafik,fiurst,Hovhannesyan Rafik - Papyan Karen,61,25,36,11,-11,26,18,17,0,0,2,4,5,0,0,11,12:14 - 7:11 - 6:11 - 0:0 - 0:0
19627733,2024-07-03 11:30:00,Asatryan Murad - Diaryan Aleksandr,3:2,12:10 - 4:11 - 7:11 - 11:9 - 11:6,3,2,Asatryan Murad,Diaryan Aleksandr,fiurst,Asatryan Murad - Diaryan Aleksandr,92,45,47,2,-2,22,15,18,20,17,-2,7,4,-2,-5,2,12:10 - 4:11 - 7:11 - 11:9 - 11:6
19627721,2024-07-03 11:15:00,Nazaryan Mushegh - Papyan Karen,2:3,11:9 - 8:11 - 11:7 - 4:11 - 3:11,2,3,Nazaryan Mushegh,Papyan Karen,fiurst,Nazaryan Mushegh - Papyan Karen,86,37,49,12,-12,20,19,18,15,14,-2,3,-4,7,8,12,11:9 - 8:11 - 11:7 - 4:11 - 3:11
19627714,2024-07-03 11:00:00,Hovhannesyan Rafik - Asatryan Murad,3:0,3:11 - 7:11 - 8:11 - 0:0 - 0:0,0,3,Hovhannesyan Rafik,Asatryan Murad,fiurst,Asatryan Murad - Hovhannesyan Rafik,51,33,18,-15,15,14,18,19,0,0,-8,-4,-3,0,0,-15,11:3 - 11:7 - 11:8 - 0:0 - 0:0
19627677,2024-07-03 10:45:00,Diaryan Aleksandr - Papyan Karen,0:3,7:11 - 9:11 - 9:11 - 0:0 - 0:0,0,3,Diaryan Aleksandr,Papyan Karen,fiurst,Diaryan Aleksandr - Papyan Karen,58,25,33,8,-8,18,20,20,0,0,4,2,2,0,0,8,7:11 - 9:11 - 9:11 - 0:0 - 0:0
19627663,2024-07-03 10:30:00,Nazaryan Mushegh - Hovhannesyan Rafik,3:1,11:7 - 5:11 - 10:12 - 10:12 - 0:0,1,3,Nazaryan Mushegh,Hovhannesyan Rafik,fiurst,Hovhannesyan Rafik - Nazaryan Mushegh,78,42,36,-6,6,18,16,22,22,0,4,-6,-2,-2,0,-6,7:11 - 11:5 - 12:10 - 12:10 - 0:0
19627661,2024-07-03 10:15:00,Papyan Karen - Asatryan Murad,3:0,2:11 - 13:15 - 9:11 - 0:0 - 0:0,0,3,Papyan Karen,Asatryan Murad,fiurst,Asatryan Murad - Papyan Karen,61,37,24,-13,13,13,28,20,0,0,-9,-2,-2,0,0,-13,11:2 - 15:13 - 11:9 - 0:0 - 0:0
19627624,2024-07-03 10:00:00,Diaryan Aleksandr - Nazaryan Mushegh,3:0,11:3 - 11:8 - 11:3 - 0:0 - 0:0,3,0,Diaryan Aleksandr,Nazaryan Mushegh,fiurst,Diaryan Aleksandr - Nazaryan Mushegh,47,33,14,-19,19,14,19,14,0,0,-8,-3,-8,0,0,-19,11:3 - 11:8 - 11:3 - 0:0 - 0:0
19591670,2024-07-02 17:45:00,Hakobyan Eduard - Petrosyan Davit,1:3,6:11 - 8:11 - 11:9 - 1:11 - 0:0,1,3,Hakobyan Eduard,Petrosyan Davit,fiurst,Hakobyan Eduard - Petrosyan Davit,68,26,42,16,-16,17,19,20,12,0,5,3,-2,10,0,16,6:11 - 8:11 - 11:9 - 1:11 - 0:0
19591649,2024-07-02 17:30:00,Gevorgyan Gegham - Arutyunov Ruben,3:0,10:12 - 6:11 - 8:11 - 0:0 - 0:0,0,3,Gevorgyan Gegham,Arutyunov Ruben,fiurst,Arutyunov Ruben - Gevorgyan Gegham,58,34,24,-10,10,22,17,19,0,0,-2,-5,-3,0,0,-10,12:10 - 11:6 - 11:8 - 0:0 - 0:0
19591648,2024-07-02 17:15:00,Soghomonyan Hrayr - Hakobyan Eduard,1:3,11:6 - 11:6 - 7:11 - 11:5 - 0:0,3,1,Soghomonyan Hrayr,Hakobyan Eduard,fiurst,Hakobyan Eduard - Soghomonyan Hrayr,68,28,40,12,-12,17,17,18,16,0,5,5,-4,6,0,12,6:11 - 6:11 - 11:7 - 5:11 - 0:0
19591647,2024-07-02 17:00:00,Gevorgyan Gegham - Petrosyan Davit,0:3,8:11 - 4:11 - 8:11 - 0:0 - 0:0,0,3,Gevorgyan Gegham,Petrosyan Davit,fiurst,Gevorgyan Gegham - Petrosyan Davit,53,20,33,13,-13,19,15,19,0,0,3,7,3,0,0,13,8:11 - 4:11 - 8:11 - 0:0 - 0:0
19591646,2024-07-02 16:45:00,Arutyunov Ruben - Soghomonyan Hrayr,3:0,11:8 - 11:6 - 11:7 - 0:0 - 0:0,3,0,Arutyunov Ruben,Soghomonyan Hrayr,fiurst,Arutyunov Ruben - Soghomonyan Hrayr,54,33,21,-12,12,19,17,18,0,0,-3,-5,-4,0,0,-12,11:8 - 11:6 - 11:7 - 0:0 - 0:0
19591642,2024-07-02 16:30:00,Hakobyan Eduard - Gevorgyan Gegham,0:3,11:8 - 11:8 - 11:8 - 0:0 - 0:0,3,0,Hakobyan Eduard,Gevorgyan Gegham,fiurst,Gevorgyan Gegham - Hakobyan Eduard,57,24,33,9,-9,19,19,19,0,0,3,3,3,0,0,9,8:11 - 8:11 - 8:11 - 0:0 - 0:0
19591597,2024-07-02 16:15:00,Petrosyan Davit - Soghomonyan Hrayr,1:3,10:12 - 12:10 - 5:11 - 8:11 - 0:0,1,3,Petrosyan Davit,Soghomonyan Hrayr,fiurst,Petrosyan Davit - Soghomonyan Hrayr,79,35,44,9,-9,22,22,16,19,0,2,-2,6,3,0,9,10:12 - 12:10 - 5:11 - 8:11 - 0:0
19591596,2024-07-02 16:10:00,Arutyunov Ruben - Hakobyan Eduard,3:0,11:7 - 14:12 - 11:7 - 0:0 - 0:0,3,0,Arutyunov Ruben,Hakobyan Eduard,fiurst,Arutyunov Ruben - Hakobyan Eduard,62,36,26,-10,10,18,26,18,0,0,-4,-2,-4,0,0,-10,11:7 - 14:12 - 11:7 - 0:0 - 0:0
19591595,2024-07-02 15:45:00,Soghomonyan Hrayr - Gevorgyan Gegham,1:3,11:13 - 11:4 - 11:8 - 11:8 - 0:0,3,1,Soghomonyan Hrayr,Gevorgyan Gegham,fiurst,Gevorgyan Gegham - Soghomonyan Hrayr,77,33,44,11,-11,24,15,19,19,0,-2,7,3,3,0,11,13:11 - 4:11 - 8:11 - 8:11 - 0:0
19591592,2024-07-02 15:30:00,Petrosyan Davit - Arutyunov Ruben,2:3,11:6 - 11:4 - 9:11 - 11:13 - 11:9,3,2,Petrosyan Davit,Arutyunov Ruben,fiurst,Arutyunov Ruben - Petrosyan Davit,96,43,53,10,-10,17,15,20,24,20,5,7,-2,-2,2,10,6:11 - 4:11 - 11:9 - 13:11 - 9:11
19591590,2024-07-02 15:25:00,Hovhannesyan Rafik - Nazaryan Mushegh,3:0,11:5 - 11:5 - 11:6 - 0:0 - 0:0,3,0,Hovhannesyan Rafik,Nazaryan Mushegh,fiurst,Hovhannesyan Rafik - Nazaryan Mushegh,49,33,16,-17,17,16,16,17,0,0,-6,-6,-5,0,0,-17,11:5 - 11:5 - 11:6 - 0:0 - 0:0
19591588,2024-07-02 15:05:00,Diaryan Aleksandr - Gevorgyan Hayk,3:0,11:8 - 11:9 - 11:4 - 0:0 - 0:0,3,0,Diaryan Aleksandr,Gevorgyan Hayk,fiurst,Diaryan Aleksandr - Gevorgyan Hayk,54,33,21,-12,12,19,20,15,0,0,-3,-2,-7,0,0,-12,11:8 - 11:9 - 11:4 - 0:0 - 0:0
19591576,2024-07-02 14:50:00,Asatryan Murad - Hovhannesyan Rafik,3:0,11:4 - 11:7 - 11:5 - 0:0 - 0:0,3,0,Asatryan Murad,Hovhannesyan Rafik,fiurst,Asatryan Murad - Hovhannesyan Rafik,49,33,16,-17,17,15,18,16,0,0,-7,-4,-6,0,0,-17,11:4 - 11:7 - 11:5 - 0:0 - 0:0
19591570,2024-07-02 14:30:00,Nazaryan Mushegh - Diaryan Aleksandr,3:0,7:11 - 8:11 - 4:11 - 0:0 - 0:0,0,3,Nazaryan Mushegh,Diaryan Aleksandr,fiurst,Diaryan Aleksandr - Nazaryan Mushegh,52,33,19,-14,14,18,19,15,0,0,-4,-3,-7,0,0,-14,11:7 - 11:8 - 11:4 - 0:0 - 0:0
19591568,2024-07-02 14:15:00,Asatryan Murad - Gevorgyan Hayk,3:2,11:7 - 11:2 - 8:11 - 9:11 - 11:9,3,2,Asatryan Murad,Gevorgyan Hayk,fiurst,Asatryan Murad - Gevorgyan Hayk,90,50,40,-10,10,18,13,19,20,20,-4,-9,3,2,-2,-10,11:7 - 11:2 - 8:11 - 9:11 - 11:9
19591565,2024-07-02 14:10:00,Hovhannesyan Rafik - Diaryan Aleksandr,3:1,11:7 - 2:11 - 0:11 - 3:11 - 0:0,1,3,Hovhannesyan Rafik,Diaryan Aleksandr,fiurst,Diaryan Aleksandr - Hovhannesyan Rafik,56,40,16,-24,24,18,13,11,14,0,4,-9,-11,-8,0,-24,7:11 - 11:2 - 11:0 - 11:3 - 0:0
19591562,2024-07-02 13:45:00,Nazaryan Mushegh - Asatryan Murad,3:0,4:11 - 2:11 - 3:11 - 0:0 - 0:0,0,3,Nazaryan Mushegh,Asatryan Murad,fiurst,Asatryan Murad - Nazaryan Mushegh,42,33,9,-24,24,15,13,14,0,0,-7,-9,-8,0,0,-24,11:4 - 11:2 - 11:3 - 0:0 - 0:0
19591558,2024-07-02 13:35:00,Gevorgyan Hayk - Hovhannesyan Rafik,3:1,17:15 - 13:11 - 9:11 - 11:6 - 0:0,3,1,Gevorgyan Hayk,Hovhannesyan Rafik,fiurst,Gevorgyan Hayk - Hovhannesyan Rafik,93,50,43,-7,7,32,24,20,17,0,-2,-2,2,-5,0,-7,17:15 - 13:11 - 9:11 - 11:6 - 0:0
19591556,2024-07-02 13:15:00,Diaryan Aleksandr - Asatryan Murad,3:1,5:11 - 11:8 - 6:11 - 5:11 - 0:0,1,3,Diaryan Aleksandr,Asatryan Murad,fiurst,Asatryan Murad - Diaryan Aleksandr,68,41,27,-14,14,16,19,17,16,0,-6,3,-5,-6,0,-14,11:5 - 8:11 - 11:6 - 11:5 - 0:0
19591543,2024-07-02 13:00:00,Gevorgyan Hayk - Nazaryan Mushegh,3:1,11:6 - 6:11 - 11:8 - 11:6 - 0:0,3,1,Gevorgyan Hayk,Nazaryan Mushegh,fiurst,Gevorgyan Hayk - Nazaryan Mushegh,70,39,31,-8,8,17,17,19,17,0,-5,5,-3,-5,0,-8,11:6 - 6:11 - 11:8 - 11:6 - 0:0
19591542,2024-07-02 12:15:00,Hovhannesyan Rafik - Asatryan Murad,3:0,3:11 - 2:11 - 8:11 - 0:0 - 0:0,0,3,Hovhannesyan Rafik,Asatryan Murad,fiurst,Asatryan Murad - Hovhannesyan Rafik,46,33,13,-20,20,14,13,19,0,0,-8,-9,-3,0,0,-20,11:3 - 11:2 - 11:8 - 0:0 - 0:0
19591539,2024-07-02 12:00:00,Gevorgyan Hayk - Diaryan Aleksandr,3:1,11:4 - 6:11 - 4:11 - 3:11 - 0:0,1,3,Gevorgyan Hayk,Diaryan Aleksandr,fiurst,Diaryan Aleksandr - Gevorgyan Hayk,61,37,24,-13,13,15,17,15,14,0,7,-5,-7,-8,0,-13,4:11 - 11:6 - 11:4 - 11:3 - 0:0
19591534,2024-07-02 11:45:00,Nazaryan Mushegh - Hovhannesyan Rafik,3:0,7:11 - 7:11 - 7:11 - 0:0 - 0:0,0,3,Nazaryan Mushegh,Hovhannesyan Rafik,fiurst,Hovhannesyan Rafik - Nazaryan Mushegh,54,33,21,-12,12,18,18,18,0,0,-4,-4,-4,0,0,-12,11:7 - 11:7 - 11:7 - 0:0 - 0:0
19591524,2024-07-02 11:30:00,Gevorgyan Hayk - Asatryan Murad,3:0,3:11 - 8:11 - 5:11 - 0:0 - 0:0,0,3,Gevorgyan Hayk,Asatryan Murad,fiurst,Asatryan Murad - Gevorgyan Hayk,49,33,16,-17,17,14,19,16,0,0,-8,-3,-6,0,0,-17,11:3 - 11:8 - 11:5 - 0:0 - 0:0
19591522,2024-07-02 11:15:00,Diaryan Aleksandr - Nazaryan Mushegh,3:0,11:2 - 11:3 - 11:4 - 0:0 - 0:0,3,0,Diaryan Aleksandr,Nazaryan Mushegh,fiurst,Diaryan Aleksandr - Nazaryan Mushegh,42,33,9,-24,24,13,14,15,0,0,-9,-8,-7,0,0,-24,11:2 - 11:3 - 11:4 - 0:0 - 0:0
19591518,2024-07-02 11:00:00,Hovhannesyan Rafik - Gevorgyan Hayk,3:2,11:8 - 11:3 - 10:12 - 8:11 - 5:11,2,3,Hovhannesyan Rafik,Gevorgyan Hayk,fiurst,Gevorgyan Hayk - Hovhannesyan Rafik,90,45,45,0,0,19,14,22,19,16,3,8,-2,-3,-6,0,8:11 - 3:11 - 12:10 - 11:8 - 11:5
19591516,2024-07-02 10:45:00,Asatryan Murad - Nazaryan Mushegh,3:0,11:8 - 11:7 - 11:8 - 0:0 - 0:0,3,0,Asatryan Murad,Nazaryan Mushegh,fiurst,Asatryan Murad - Nazaryan Mushegh,56,33,23,-10,10,19,18,19,0,0,-3,-4,-3,0,0,-10,11:8 - 11:7 - 11:8 - 0:0 - 0:0
19591515,2024-07-02 10:30:00,Diaryan Aleksandr - Hovhannesyan Rafik,3:0,11:4 - 11:2 - 11:3 - 0:0 - 0:0,3,0,Diaryan Aleksandr,Hovhannesyan Rafik,fiurst,Diaryan Aleksandr - Hovhannesyan Rafik,42,33,9,-24,24,15,13,14,0,0,-7,-9,-8,0,0,-24,11:4 - 11:2 - 11:3 - 0:0 - 0:0
19591514,2024-07-02 10:15:00,Nazaryan Mushegh - Gevorgyan Hayk,3:0,8:11 - 8:11 - 8:11 - 0:0 - 0:0,0,3,Nazaryan Mushegh,Gevorgyan Hayk,fiurst,Gevorgyan Hayk - Nazaryan Mushegh,57,33,24,-9,9,19,19,19,0,0,-3,-3,-3,0,0,-9,11:8 - 11:8 - 11:8 - 0:0 - 0:0
19591512,2024-07-02 10:00:00,Asatryan Murad - Diaryan Aleksandr,3:0,13:11 - 14:12 - 11:9 - 0:0 - 0:0,3,0,Asatryan Murad,Diaryan Aleksandr,fiurst,Asatryan Murad - Diaryan Aleksandr,70,38,32,-6,6,24,26,20,0,0,-2,-2,-2,0,0,-6,13:11 - 14:12 - 11:9 - 0:0 - 0:0
19577600,2024-07-01 17:55:00,Mkrtchyan Andranik - Gevorgyan Gegham,3:0,4:11 - 10:12 - 10:12 - 0:0 - 0:0,0,3,Mkrtchyan Andranik,Gevorgyan Gegham,fiurst,Gevorgyan Gegham - Mkrtchyan Andranik,59,35,24,-11,11,15,22,22,0,0,-7,-2,-2,0,0,-11,11:4 - 12:10 - 12:10 - 0:0 - 0:0
19577597,2024-07-01 17:35:00,Avakimyan Davit - Soghomonyan Hrayr,0:3,7:11 - 8:11 - 5:11 - 0:0 - 0:0,0,3,Avakimyan Davit,Soghomonyan Hrayr,fiurst,Avakimyan Davit - Soghomonyan Hrayr,53,20,33,13,-13,18,19,16,0,0,4,3,6,0,0,13,7:11 - 8:11 - 5:11 - 0:0 - 0:0
19577594,2024-07-01 17:30:00,Arutyunov Ruben - Mkrtchyan Andranik,3:0,11:9 - 11:7 - 11:8 - 0:0 - 0:0,3,0,Arutyunov Ruben,Mkrtchyan Andranik,fiurst,Arutyunov Ruben - Mkrtchyan Andranik,57,33,24,-9,9,20,18,19,0,0,-2,-4,-3,0,0,-9,11:9 - 11:7 - 11:8 - 0:0 - 0:0
19577591,2024-07-01 17:10:00,Avakimyan Davit - Gevorgyan Gegham,3:2,11:8 - 7:11 - 12:10 - 9:11 - 11:6,3,2,Avakimyan Davit,Gevorgyan Gegham,fiurst,Avakimyan Davit - Gevorgyan Gegham,96,50,46,-4,4,19,18,22,20,17,-3,4,-2,2,-5,-4,11:8 - 7:11 - 12:10 - 9:11 - 11:6
19577590,2024-07-01 16:45:00,Soghomonyan Hrayr - Arutyunov Ruben,3:2,7:11 - 4:11 - 11:4 - 13:11 - 5:11,2,3,Soghomonyan Hrayr,Arutyunov Ruben,fiurst,Arutyunov Ruben - Soghomonyan Hrayr,88,48,40,-8,8,18,15,15,24,16,-4,-7,7,2,-6,-8,11:7 - 11:4 - 4:11 - 11:13 - 11:5
19577588,2024-07-01 16:40:00,Mkrtchyan Andranik - Avakimyan Davit,2:3,10:12 - 10:12 - 12:10 - 11:7 - 11:8,3,2,Mkrtchyan Andranik,Avakimyan Davit,fiurst,Avakimyan Davit - Mkrtchyan Andranik,103,49,54,5,-5,22,22,22,18,19,-2,-2,2,4,3,5,12:10 - 12:10 - 10:12 - 7:11 - 8:11
19577586,2024-07-01 16:15:00,Gevorgyan Gegham - Arutyunov Ruben,3:0,2:11 - 4:11 - 3:11 - 0:0 - 0:0,0,3,Gevorgyan Gegham,Arutyunov Ruben,fiurst,Arutyunov Ruben - Gevorgyan Gegham,42,33,9,-24,24,13,15,14,0,0,-9,-7,-8,0,0,-24,11:2 - 11:4 - 11:3 - 0:0 - 0:0
19577565,2024-07-01 16:00:00,Soghomonyan Hrayr - Mkrtchyan Andranik,3:2,11:9 - 7:11 - 6:11 - 11:9 - 9:11,2,3,Soghomonyan Hrayr,Mkrtchyan Andranik,fiurst,Mkrtchyan Andranik - Soghomonyan Hrayr,95,51,44,-7,7,20,18,17,20,20,2,-4,-5,2,-2,-7,9:11 - 11:7 - 11:6 - 9:11 - 11:9
19577564,2024-07-01 15:45:00,Arutyunov Ruben - Avakimyan Davit,3:1,11:8 - 8:11 - 11:3 - 11:8 - 0:0,3,1,Arutyunov Ruben,Avakimyan Davit,fiurst,Arutyunov Ruben - Avakimyan Davit,71,41,30,-11,11,19,19,14,19,0,-3,3,-8,-3,0,-11,11:8 - 8:11 - 11:3 - 11:8 - 0:0
19577561,2024-07-01 15:35:00,Gevorgyan Gegham - Soghomonyan Hrayr,0:3,4:11 - 6:11 - 5:11 - 0:0 - 0:0,0,3,Gevorgyan Gegham,Soghomonyan Hrayr,fiurst,Gevorgyan Gegham - Soghomonyan Hrayr,48,15,33,18,-18,15,17,16,0,0,7,5,6,0,0,18,4:11 - 6:11 - 5:11 - 0:0 - 0:0
19577556,2024-07-01 15:15:00,Diaryan Aleksandr - Asatryan Murad,2:3,11:9 - 8:11 - 3:11 - 11:7 - 11:9,3,2,Diaryan Aleksandr,Asatryan Murad,fiurst,Asatryan Murad - Diaryan Aleksandr,91,47,44,-3,3,20,19,14,18,20,2,-3,-8,4,2,-3,9:11 - 11:8 - 11:3 - 7:11 - 9:11
19577553,2024-07-01 15:00:00,Nazaryan Mushegh - Hovhannesyan Rafik,3:0,6:11 - 9:11 - 5:11 - 0:0 - 0:0,0,3,Nazaryan Mushegh,Hovhannesyan Rafik,fiurst,Hovhannesyan Rafik - Nazaryan Mushegh,53,33,20,-13,13,17,20,16,0,0,-5,-2,-6,0,0,-13,11:6 - 11:9 - 11:5 - 0:0 - 0:0
19577533,2024-07-01 14:45:00,Gevorgyan Hayk - Diaryan Aleksandr,3:2,4:11 - 11:8 - 3:11 - 11:4 - 4:11,2,3,Gevorgyan Hayk,Diaryan Aleksandr,fiurst,Diaryan Aleksandr - Gevorgyan Hayk,78,45,33,-12,12,15,19,14,15,15,-7,3,-8,7,-7,-12,11:4 - 8:11 - 11:3 - 4:11 - 11:4
19577531,2024-07-01 14:30:00,Asatryan Murad - Nazaryan Mushegh,3:0,11:7 - 11:6 - 11:9 - 0:0 - 0:0,3,0,Asatryan Murad,Nazaryan Mushegh,fiurst,Asatryan Murad - Nazaryan Mushegh,55,33,22,-11,11,18,17,20,0,0,-4,-5,-2,0,0,-11,11:7 - 11:6 - 11:9 - 0:0 - 0:0
19577530,2024-07-01 14:15:00,Gevorgyan Hayk - Hovhannesyan Rafik,3:1,5:11 - 11:6 - 11:9 - 11:8 - 0:0,3,1,Gevorgyan Hayk,Hovhannesyan Rafik,fiurst,Gevorgyan Hayk - Hovhannesyan Rafik,72,38,34,-4,4,16,17,20,19,0,6,-5,-2,-3,0,-4,5:11 - 11:6 - 11:9 - 11:8 - 0:0
19577529,2024-07-01 14:00:00,Diaryan Aleksandr - Nazaryan Mushegh,3:0,11:8 - 11:6 - 11:6 - 0:0 - 0:0,3,0,Diaryan Aleksandr,Nazaryan Mushegh,fiurst,Diaryan Aleksandr - Nazaryan Mushegh,53,33,20,-13,13,19,17,17,0,0,-3,-5,-5,0,0,-13,11:8 - 11:6 - 11:6 - 0:0 - 0:0
19577528,2024-07-01 13:45:00,Asatryan Murad - Gevorgyan Hayk,3:0,11:5 - 11:7 - 11:8 - 0:0 - 0:0,3,0,Asatryan Murad,Gevorgyan Hayk,fiurst,Asatryan Murad - Gevorgyan Hayk,53,33,20,-13,13,16,18,19,0,0,-6,-4,-3,0,0,-13,11:5 - 11:7 - 11:8 - 0:0 - 0:0
19577527,2024-07-01 13:30:00,Hovhannesyan Rafik - Diaryan Aleksandr,3:1,5:11 - 17:15 - 10:12 - 5:11 - 0:0,1,3,Hovhannesyan Rafik,Diaryan Aleksandr,fiurst,Diaryan Aleksandr - Hovhannesyan Rafik,86,49,37,-12,12,16,32,22,16,0,-6,2,-2,-6,0,-12,11:5 - 15:17 - 12:10 - 11:5 - 0:0
19577526,2024-07-01 13:15:00,Nazaryan Mushegh - Gevorgyan Hayk,0:3,11:5 - 11:7 - 11:5 - 0:0 - 0:0,3,0,Nazaryan Mushegh,Gevorgyan Hayk,fiurst,Gevorgyan Hayk - Nazaryan Mushegh,50,17,33,16,-16,16,18,16,0,0,6,4,6,0,0,16,5:11 - 7:11 - 5:11 - 0:0 - 0:0
19577515,2024-07-01 13:00:00,Hovhannesyan Rafik - Asatryan Murad,3:0,9:11 - 3:11 - 5:11 - 0:0 - 0:0,0,3,Hovhannesyan Rafik,Asatryan Murad,fiurst,Asatryan Murad - Hovhannesyan Rafik,50,33,17,-16,16,20,14,16,0,0,-2,-8,-6,0,0,-16,11:9 - 11:3 - 11:5 - 0:0 - 0:0
19577501,2024-07-01 12:15:00,Diaryan Aleksandr - Gevorgyan Hayk,3:0,11:6 - 11:2 - 11:5 - 0:0 - 0:0,3,0,Diaryan Aleksandr,Gevorgyan Hayk,fiurst,Diaryan Aleksandr - Gevorgyan Hayk,46,33,13,-20,20,17,13,16,0,0,-5,-9,-6,0,0,-20,11:6 - 11:2 - 11:5 - 0:0 - 0:0
19577500,2024-07-01 12:00:00,Hovhannesyan Rafik - Nazaryan Mushegh,3:1,11:6 - 8:11 - 11:7 - 11:7 - 0:0,3,1,Hovhannesyan Rafik,Nazaryan Mushegh,fiurst,Hovhannesyan Rafik - Nazaryan Mushegh,72,41,31,-10,10,17,19,18,18,0,-5,3,-4,-4,0,-10,11:6 - 8:11 - 11:7 - 11:7 - 0:0
19577498,2024-07-01 11:45:00,Asatryan Murad - Diaryan Aleksandr,3:0,11:7 - 11:7 - 11:8 - 0:0 - 0:0,3,0,Asatryan Murad,Diaryan Aleksandr,fiurst,Asatryan Murad - Diaryan Aleksandr,55,33,22,-11,11,18,18,19,0,0,-4,-4,-3,0,0,-11,11:7 - 11:7 - 11:8 - 0:0 - 0:0
19577495,2024-07-01 11:30:00,Hovhannesyan Rafik - Gevorgyan Hayk,2:3,11:5 - 11:5 - 8:11 - 4:11 - 11:4,3,2,Hovhannesyan Rafik,Gevorgyan Hayk,fiurst,Gevorgyan Hayk - Hovhannesyan Rafik,81,36,45,9,-9,16,16,19,15,15,6,6,-3,-7,7,9,5:11 - 5:11 - 11:8 - 11:4 - 4:11
19577494,2024-07-01 11:15:00,Nazaryan Mushegh - Asatryan Murad,3:0,6:11 - 7:11 - 7:11 - 0:0 - 0:0,0,3,Nazaryan Mushegh,Asatryan Murad,fiurst,Asatryan Murad - Nazaryan Mushegh,53,33,20,-13,13,17,18,18,0,0,-5,-4,-4,0,0,-13,11:6 - 11:7 - 11:7 - 0:0 - 0:0
19577489,2024-07-01 11:00:00,Diaryan Aleksandr - Hovhannesyan Rafik,3:0,11:2 - 11:7 - 11:2 - 0:0 - 0:0,3,0,Diaryan Aleksandr,Hovhannesyan Rafik,fiurst,Diaryan Aleksandr - Hovhannesyan Rafik,44,33,11,-22,22,13,18,13,0,0,-9,-4,-9,0,0,-22,11:2 - 11:7 - 11:2 - 0:0 - 0:0
19577488,2024-07-01 10:45:00,Gevorgyan Hayk - Asatryan Murad,3:1,11:9 - 2:11 - 6:11 - 5:11 - 0:0,1,3,Gevorgyan Hayk,Asatryan Murad,fiurst,Asatryan Murad - Gevorgyan Hayk,66,42,24,-18,18,20,13,17,16,0,2,-9,-5,-6,0,-18,9:11 - 11:2 - 11:6 - 11:5 - 0:0
19577487,2024-07-01 10:30:00,Nazaryan Mushegh - Diaryan Aleksandr,3:0,8:11 - 6:11 - 7:11 - 0:0 - 0:0,0,3,Nazaryan Mushegh,Diaryan Aleksandr,fiurst,Diaryan Aleksandr - Nazaryan Mushegh,54,33,21,-12,12,19,17,18,0,0,-3,-5,-4,0,0,-12,11:8 - 11:6 - 11:7 - 0:0 - 0:0
19577485,2024-07-01 10:15:00,Asatryan Murad - Hovhannesyan Rafik,3:0,11:8 - 11:1 - 11:6 - 0:0 - 0:0,3,0,Asatryan Murad,Hovhannesyan Rafik,fiurst,Asatryan Murad - Hovhannesyan Rafik,48,33,15,-18,18,19,12,17,0,0,-3,-10,-5,0,0,-18,11:8 - 11:1 - 11:6 - 0:0 - 0:0
19577484,2024-07-01 10:00:00,Gevorgyan Hayk - Nazaryan Mushegh,1:3,7:11 - 11:9 - 7:11 - 3:11 - 0:0,1,3,Gevorgyan Hayk,Nazaryan Mushegh,fiurst,Gevorgyan Hayk - Nazaryan Mushegh,70,28,42,14,-14,18,20,18,14,0,4,-2,4,8,0,14,7:11 - 11:9 - 7:11 - 3:11 - 0:0
19553512,2024-06-30 17:45:00,Hakobyan Eduard - Avakimyan Davit,0:3,11:9 - 11:3 - 11:8 - 0:0 - 0:0,3,0,Hakobyan Eduard,Avakimyan Davit,fiurst,Avakimyan Davit - Hakobyan Eduard,53,20,33,13,-13,20,14,19,0,0,2,8,3,0,0,13,9:11 - 3:11 - 8:11 - 0:0 - 0:0
19553511,2024-06-30 17:40:00,Mkrtchyan Andranik - Gevorgyan Gegham,1:3,12:10 - 11:8 - 9:11 - 12:10 - 0:0,3,1,Mkrtchyan Andranik,Gevorgyan Gegham,fiurst,Gevorgyan Gegham - Mkrtchyan Andranik,83,39,44,5,-5,22,19,20,22,0,2,3,-2,2,0,5,10:12 - 8:11 - 11:9 - 10:12 - 0:0
19553510,2024-06-30 17:25:00,Petrosyan Davit - Hakobyan Eduard,1:3,10:12 - 13:11 - 11:6 - 11:6 - 0:0,3,1,Petrosyan Davit,Hakobyan Eduard,fiurst,Hakobyan Eduard - Petrosyan Davit,80,35,45,10,-10,22,24,17,17,0,-2,2,5,5,0,10,12:10 - 11:13 - 6:11 - 6:11 - 0:0
19553509,2024-06-30 17:05:00,Mkrtchyan Andranik - Avakimyan Davit,0:3,11:8 - 12:10 - 11:7 - 0:0 - 0:0,3,0,Mkrtchyan Andranik,Avakimyan Davit,fiurst,Avakimyan Davit - Mkrtchyan Andranik,59,25,34,9,-9,19,22,18,0,0,3,2,4,0,0,9,8:11 - 10:12 - 7:11 - 0:0 - 0:0
19553505,2024-06-30 16:45:00,Gevorgyan Gegham - Petrosyan Davit,1:3,17:15 - 8:11 - 6:11 - 6:11 - 0:0,1,3,Gevorgyan Gegham,Petrosyan Davit,fiurst,Gevorgyan Gegham - Petrosyan Davit,85,37,48,11,-11,32,19,17,17,0,-2,3,5,5,0,11,17:15 - 8:11 - 6:11 - 6:11 - 0:0
19553492,2024-06-30 16:30:00,Hakobyan Eduard - Mkrtchyan Andranik,3:2,7:11 - 11:7 - 11:8 - 8:11 - 11:9,3,2,Hakobyan Eduard,Mkrtchyan Andranik,fiurst,Hakobyan Eduard - Mkrtchyan Andranik,94,48,46,-2,2,18,18,19,19,20,4,-4,-3,3,-2,-2,7:11 - 11:7 - 11:8 - 8:11 - 11:9
19553489,2024-06-30 16:20:00,Avakimyan Davit - Petrosyan Davit,0:3,7:11 - 10:12 - 9:11 - 0:0 - 0:0,0,3,Avakimyan Davit,Petrosyan Davit,fiurst,Avakimyan Davit - Petrosyan Davit,60,26,34,8,-8,18,22,20,0,0,4,2,2,0,0,8,7:11 - 10:12 - 9:11 - 0:0 - 0:0
19553488,2024-06-30 16:00:00,Gevorgyan Gegham - Hakobyan Eduard,1:3,6:11 - 6:11 - 12:10 - 2:11 - 0:0,1,3,Gevorgyan Gegham,Hakobyan Eduard,fiurst,Gevorgyan Gegham - Hakobyan Eduard,69,26,43,17,-17,17,17,22,13,0,5,5,-2,9,0,17,6:11 - 6:11 - 12:10 - 2:11 - 0:0
19553487,2024-06-30 15:45:00,Petrosyan Davit - Mkrtchyan Andranik,1:3,11:4 - 11:9 - 7:11 - 16:14 - 0:0,3,1,Petrosyan Davit,Mkrtchyan Andranik,fiurst,Mkrtchyan Andranik - Petrosyan Davit,83,38,45,7,-7,15,20,18,30,0,7,2,-4,2,0,7,4:11 - 9:11 - 11:7 - 14:16 - 0:0
19553486,2024-06-30 15:30:00,Avakimyan Davit - Gevorgyan Gegham,1:3,8:11 - 8:11 - 11:8 - 8:11 - 0:0,1,3,Avakimyan Davit,Gevorgyan Gegham,fiurst,Avakimyan Davit - Gevorgyan Gegham,76,35,41,6,-6,19,19,19,19,0,3,3,-3,3,0,6,8:11 - 8:11 - 11:8 - 8:11 - 0:0
19553482,2024-06-30 15:15:00,Gevorgyan Hayk - Nazaryan Mushegh,3:1,11:6 - 3:11 - 12:10 - 11:7 - 0:0,3,1,Gevorgyan Hayk,Nazaryan Mushegh,fiurst,Gevorgyan Hayk - Nazaryan Mushegh,71,37,34,-3,3,17,14,22,18,0,-5,8,-2,-4,0,-3,11:6 - 3:11 - 12:10 - 11:7 - 0:0
19553481,2024-06-30 15:00:00,Diaryan Aleksandr - Nikoghosyan Narek,3:2,12:10 - 5:11 - 11:2 - 8:11 - 11:6,3,2,Diaryan Aleksandr,Nikoghosyan Narek,fiurst,Diaryan Aleksandr - Nikoghosyan Narek,87,47,40,-7,7,22,16,13,19,17,-2,6,-9,3,-5,-7,12:10 - 5:11 - 11:2 - 8:11 - 11:6
19553467,2024-06-30 14:45:00,Papyan Karen - Gevorgyan Hayk,3:0,2:11 - 3:11 - 4:11 - 0:0 - 0:0,0,3,Papyan Karen,Gevorgyan Hayk,fiurst,Gevorgyan Hayk - Papyan Karen,42,33,9,-24,24,13,14,15,0,0,-9,-8,-7,0,0,-24,11:2 - 11:3 - 11:4 - 0:0 - 0:0
19553464,2024-06-30 14:30:00,Nazaryan Mushegh - Diaryan Aleksandr,3:0,3:11 - 3:11 - 5:11 - 0:0 - 0:0,0,3,Nazaryan Mushegh,Diaryan Aleksandr,fiurst,Diaryan Aleksandr - Nazaryan Mushegh,44,33,11,-22,22,14,14,16,0,0,-8,-8,-6,0,0,-22,11:3 - 11:3 - 11:5 - 0:0 - 0:0
19553463,2024-06-30 14:15:00,Papyan Karen - Nikoghosyan Narek,3:0,8:11 - 10:12 - 7:11 - 0:0 - 0:0,0,3,Papyan Karen,Nikoghosyan Narek,fiurst,Nikoghosyan Narek - Papyan Karen,59,34,25,-9,9,19,22,18,0,0,-3,-2,-4,0,0,-9,11:8 - 12:10 - 11:7 - 0:0 - 0:0
19553462,2024-06-30 14:05:00,Gevorgyan Hayk - Diaryan Aleksandr,3:0,6:11 - 5:11 - 9:11 - 0:0 - 0:0,0,3,Gevorgyan Hayk,Diaryan Aleksandr,fiurst,Diaryan Aleksandr - Gevorgyan Hayk,53,33,20,-13,13,17,16,20,0,0,-5,-6,-2,0,0,-13,11:6 - 11:5 - 11:9 - 0:0 - 0:0
19553461,2024-06-30 13:45:00,Nazaryan Mushegh - Papyan Karen,3:2,11:4 - 9:11 - 7:11 - 11:4 - 11:9,3,2,Nazaryan Mushegh,Papyan Karen,fiurst,Nazaryan Mushegh - Papyan Karen,88,49,39,-10,10,15,20,18,15,20,-7,2,4,-7,-2,-10,11:4 - 9:11 - 7:11 - 11:4 - 11:9
19553460,2024-06-30 13:35:00,Nikoghosyan Narek - Gevorgyan Hayk,1:3,12:10 - 10:12 - 12:10 - 11:8 - 0:0,3,1,Nikoghosyan Narek,Gevorgyan Hayk,fiurst,Gevorgyan Hayk - Nikoghosyan Narek,85,40,45,5,-5,22,22,22,19,0,2,-2,2,3,0,5,10:12 - 12:10 - 10:12 - 8:11 - 0:0
19553458,2024-06-30 13:15:00,Diaryan Aleksandr - Papyan Karen,3:0,11:7 - 11:5 - 11:8 - 0:0 - 0:0,3,0,Diaryan Aleksandr,Papyan Karen,fiurst,Diaryan Aleksandr - Papyan Karen,53,33,20,-13,13,18,16,19,0,0,-4,-6,-3,0,0,-13,11:7 - 11:5 - 11:8 - 0:0 - 0:0
19553457,2024-06-30 13:00:00,Nikoghosyan Narek - Nazaryan Mushegh,3:1,6:11 - 11:3 - 8:11 - 4:11 - 0:0,1,3,Nikoghosyan Narek,Nazaryan Mushegh,fiurst,Nazaryan Mushegh - Nikoghosyan Narek,65,36,29,-7,7,17,14,19,15,0,-5,8,-3,-7,0,-7,11:6 - 3:11 - 11:8 - 11:4 - 0:0
19553453,2024-06-30 12:15:00,Gevorgyan Hayk - Papyan Karen,0:3,11:13 - 5:11 - 7:11 - 0:0 - 0:0,0,3,Gevorgyan Hayk,Papyan Karen,fiurst,Gevorgyan Hayk - Papyan Karen,58,23,35,12,-12,24,16,18,0,0,2,6,4,0,0,12,11:13 - 5:11 - 7:11 - 0:0 - 0:0
19553439,2024-06-30 12:10:00,Nikoghosyan Narek - Diaryan Aleksandr,3:0,4:11 - 7:11 - 11:13 - 0:0 - 0:0,0,3,Nikoghosyan Narek,Diaryan Aleksandr,fiurst,Diaryan Aleksandr - Nikoghosyan Narek,57,35,22,-13,13,15,18,24,0,0,-7,-4,-2,0,0,-13,11:4 - 11:7 - 13:11 - 0:0 - 0:0
19553436,2024-06-30 11:50:00,Nazaryan Mushegh - Gevorgyan Hayk,0:3,11:7 - 11:7 - 11:6 - 0:0 - 0:0,3,0,Nazaryan Mushegh,Gevorgyan Hayk,fiurst,Gevorgyan Hayk - Nazaryan Mushegh,53,20,33,13,-13,18,18,17,0,0,4,4,5,0,0,13,7:11 - 7:11 - 6:11 - 0:0 - 0:0
19553433,2024-06-30 11:35:00,Nikoghosyan Narek - Papyan Karen,2:3,11:7 - 9:11 - 11:5 - 8:11 - 6:11,2,3,Nikoghosyan Narek,Papyan Karen,fiurst,Nikoghosyan Narek - Papyan Karen,90,45,45,0,0,18,20,16,19,17,-4,2,-6,3,5,0,11:7 - 9:11 - 11:5 - 8:11 - 6:11
19553430,2024-06-30 11:25:00,Diaryan Aleksandr - Nazaryan Mushegh,3:1,7:11 - 11:8 - 11:7 - 11:5 - 0:0,3,1,Diaryan Aleksandr,Nazaryan Mushegh,fiurst,Diaryan Aleksandr - Nazaryan Mushegh,71,40,31,-9,9,18,19,18,16,0,4,-3,-4,-6,0,-9,7:11 - 11:8 - 11:7 - 11:5 - 0:0
19553426,2024-06-30 11:00:00,Gevorgyan Hayk - Nikoghosyan Narek,2:3,11:7 - 6:11 - 11:9 - 6:11 - 7:11,2,3,Gevorgyan Hayk,Nikoghosyan Narek,fiurst,Gevorgyan Hayk - Nikoghosyan Narek,90,41,49,8,-8,18,17,20,17,18,-4,5,-2,5,4,8,11:7 - 6:11 - 11:9 - 6:11 - 7:11
19553424,2024-06-30 10:45:00,Papyan Karen - Nazaryan Mushegh,2:3,17:15 - 8:11 - 11:9 - 9:11 - 11:7,3,2,Papyan Karen,Nazaryan Mushegh,fiurst,Nazaryan Mushegh - Papyan Karen,109,53,56,3,-3,32,19,20,20,18,2,-3,2,-2,4,3,15:17 - 11:8 - 9:11 - 11:9 - 7:11
19553410,2024-06-30 10:30:00,Diaryan Aleksandr - Gevorgyan Hayk,3:0,11:8 - 11:6 - 11:9 - 0:0 - 0:0,3,0,Diaryan Aleksandr,Gevorgyan Hayk,fiurst,Diaryan Aleksandr - Gevorgyan Hayk,56,33,23,-10,10,19,17,20,0,0,-3,-5,-2,0,0,-10,11:8 - 11:6 - 11:9 - 0:0 - 0:0
19553397,2024-06-30 10:15:00,Nazaryan Mushegh - Nikoghosyan Narek,3:0,11:9 - 11:4 - 11:6 - 0:0 - 0:0,3,0,Nazaryan Mushegh,Nikoghosyan Narek,fiurst,Nazaryan Mushegh - Nikoghosyan Narek,52,33,19,-14,14,20,15,17,0,0,-2,-7,-5,0,0,-14,11:9 - 11:4 - 11:6 - 0:0 - 0:0
19553390,2024-06-30 10:00:00,Papyan Karen - Diaryan Aleksandr,3:1,2:11 - 11:7 - 1:11 - 3:11 - 0:0,1,3,Papyan Karen,Diaryan Aleksandr,fiurst,Diaryan Aleksandr - Papyan Karen,57,40,17,-23,23,13,18,12,14,0,-9,4,-10,-8,0,-23,11:2 - 7:11 - 11:1 - 11:3 - 0:0
19539540,2024-06-29 17:45:00,Hakobyan Eduard - Arutyunov Ruben,2:3,8:11 - 11:8 - 8:11 - 11:6 - 11:2,3,2,Hakobyan Eduard,Arutyunov Ruben,fiurst,Arutyunov Ruben - Hakobyan Eduard,87,38,49,11,-11,19,19,19,17,13,-3,3,-3,5,9,11,11:8 - 8:11 - 11:8 - 6:11 - 2:11
19539539,2024-06-29 17:30:00,Gevorgyan Gegham - Petrosyan Davit,2:3,11:6 - 11:9 - 4:11 - 4:11 - 7:11,2,3,Gevorgyan Gegham,Petrosyan Davit,fiurst,Gevorgyan Gegham - Petrosyan Davit,85,37,48,11,-11,17,20,15,15,18,-5,-2,7,7,4,11,11:6 - 11:9 - 4:11 - 4:11 - 7:11
19539538,2024-06-29 17:15:00,Avakimyan Davit - Hakobyan Eduard,0:3,6:11 - 9:11 - 6:11 - 0:0 - 0:0,0,3,Avakimyan Davit,Hakobyan Eduard,fiurst,Avakimyan Davit - Hakobyan Eduard,54,21,33,12,-12,17,20,17,0,0,5,2,5,0,0,12,6:11 - 9:11 - 6:11 - 0:0 - 0:0
19539536,2024-06-29 17:00:00,Gevorgyan Gegham - Arutyunov Ruben,3:0,6:11 - 7:11 - 8:11 - 0:0 - 0:0,0,3,Gevorgyan Gegham,Arutyunov Ruben,fiurst,Arutyunov Ruben - Gevorgyan Gegham,54,33,21,-12,12,17,18,19,0,0,-5,-4,-3,0,0,-12,11:6 - 11:7 - 11:8 - 0:0 - 0:0
19539526,2024-06-29 16:45:00,Petrosyan Davit - Avakimyan Davit,3:2,10:12 - 12:10 - 9:11 - 11:5 - 8:11,2,3,Petrosyan Davit,Avakimyan Davit,fiurst,Avakimyan Davit - Petrosyan Davit,99,49,50,1,-1,22,22,20,16,19,-2,2,-2,6,-3,1,12:10 - 10:12 - 11:9 - 5:11 - 11:8
19539519,2024-06-29 16:30:00,Hakobyan Eduard - Gevorgyan Gegham,1:3,11:6 - 6:11 - 11:9 - 11:5 - 0:0,3,1,Hakobyan Eduard,Gevorgyan Gegham,fiurst,Gevorgyan Gegham - Hakobyan Eduard,70,31,39,8,-8,17,17,20,16,0,5,-5,2,6,0,8,6:11 - 11:6 - 9:11 - 5:11 - 0:0
19539512,2024-06-29 16:15:00,Arutyunov Ruben - Avakimyan Davit,3:0,11:6 - 11:2 - 11:6 - 0:0 - 0:0,3,0,Arutyunov Ruben,Avakimyan Davit,fiurst,Arutyunov Ruben - Avakimyan Davit,47,33,14,-19,19,17,13,17,0,0,-5,-9,-5,0,0,-19,11:6 - 11:2 - 11:6 - 0:0 - 0:0
19539511,2024-06-29 16:00:00,Petrosyan Davit - Hakobyan Eduard,3:2,11:6 - 11:13 - 11:9 - 9:11 - 8:11,2,3,Petrosyan Davit,Hakobyan Eduard,fiurst,Hakobyan Eduard - Petrosyan Davit,100,50,50,0,0,17,24,20,20,19,5,-2,2,-2,-3,0,6:11 - 13:11 - 9:11 - 11:9 - 11:8
19539510,2024-06-29 15:45:00,Avakimyan Davit - Gevorgyan Gegham,0:3,3:11 - 4:11 - 7:11 - 0:0 - 0:0,0,3,Avakimyan Davit,Gevorgyan Gegham,fiurst,Avakimyan Davit - Gevorgyan Gegham,47,14,33,19,-19,14,15,18,0,0,8,7,4,0,0,19,3:11 - 4:11 - 7:11 - 0:0 - 0:0
19539509,2024-06-29 15:30:00,Arutyunov Ruben - Petrosyan Davit,3:1,11:5 - 8:11 - 11:6 - 11:8 - 0:0,3,1,Arutyunov Ruben,Petrosyan Davit,fiurst,Arutyunov Ruben - Petrosyan Davit,71,41,30,-11,11,16,19,17,19,0,-6,3,-5,-3,0,-11,11:5 - 8:11 - 11:6 - 11:8 - 0:0
19539507,2024-06-29 15:15:00,Nikoghosyan Narek - Papyan Karen,3:1,4:11 - 11:6 - 11:6 - 11:3 - 0:0,3,1,Nikoghosyan Narek,Papyan Karen,fiurst,Nikoghosyan Narek - Papyan Karen,63,37,26,-11,11,15,17,17,14,0,7,-5,-5,-8,0,-11,4:11 - 11:6 - 11:6 - 11:3 - 0:0
19539504,2024-06-29 15:00:00,Asatryan Murad - Nazaryan Mushegh,3:0,11:6 - 11:4 - 11:4 - 0:0 - 0:0,3,0,Asatryan Murad,Nazaryan Mushegh,fiurst,Asatryan Murad - Nazaryan Mushegh,47,33,14,-19,19,17,15,15,0,0,-5,-7,-7,0,0,-19,11:6 - 11:4 - 11:4 - 0:0 - 0:0
19539502,2024-06-29 14:45:00,Hovhannesyan Rafik - Nikoghosyan Narek,0:3,11:13 - 9:11 - 3:11 - 0:0 - 0:0,0,3,Hovhannesyan Rafik,Nikoghosyan Narek,fiurst,Hovhannesyan Rafik - Nikoghosyan Narek,58,23,35,12,-12,24,20,14,0,0,2,2,8,0,0,12,11:13 - 9:11 - 3:11 - 0:0 - 0:0
19539500,2024-06-29 14:30:00,Papyan Karen - Asatryan Murad,3:1,4:11 - 11:7 - 8:11 - 6:11 - 0:0,1,3,Papyan Karen,Asatryan Murad,fiurst,Asatryan Murad - Papyan Karen,69,40,29,-11,11,15,18,19,17,0,-7,4,-3,-5,0,-11,11:4 - 7:11 - 11:8 - 11:6 - 0:0
19539498,2024-06-29 14:15:00,Hovhannesyan Rafik - Nazaryan Mushegh,3:0,11:9 - 12:10 - 11:8 - 0:0 - 0:0,3,0,Hovhannesyan Rafik,Nazaryan Mushegh,fiurst,Hovhannesyan Rafik - Nazaryan Mushegh,61,34,27,-7,7,20,22,19,0,0,-2,-2,-3,0,0,-7,11:9 - 12:10 - 11:8 - 0:0 - 0:0
19539496,2024-06-29 14:00:00,Nikoghosyan Narek - Asatryan Murad,3:0,5:11 - 4:11 - 4:11 - 0:0 - 0:0,0,3,Nikoghosyan Narek,Asatryan Murad,fiurst,Asatryan Murad - Nikoghosyan Narek,46,33,13,-20,20,16,15,15,0,0,-6,-7,-7,0,0,-20,11:5 - 11:4 - 11:4 - 0:0 - 0:0
19539484,2024-06-29 13:45:00,Papyan Karen - Hovhannesyan Rafik,3:0,7:11 - 5:11 - 4:11 - 0:0 - 0:0,0,3,Papyan Karen,Hovhannesyan Rafik,fiurst,Hovhannesyan Rafik - Papyan Karen,49,33,16,-17,17,18,16,15,0,0,-4,-6,-7,0,0,-17,11:7 - 11:5 - 11:4 - 0:0 - 0:0
19539483,2024-06-29 13:30:00,Nazaryan Mushegh - Nikoghosyan Narek,3:1,11:4 - 6:11 - 11:9 - 11:6 - 0:0,3,1,Nazaryan Mushegh,Nikoghosyan Narek,fiurst,Nazaryan Mushegh - Nikoghosyan Narek,69,39,30,-9,9,15,17,20,17,0,-7,5,-2,-5,0,-9,11:4 - 6:11 - 11:9 - 11:6 - 0:0
19539480,2024-06-29 13:15:00,Asatryan Murad - Hovhannesyan Rafik,3:0,11:2 - 11:7 - 11:8 - 0:0 - 0:0,3,0,Asatryan Murad,Hovhannesyan Rafik,fiurst,Asatryan Murad - Hovhannesyan Rafik,50,33,17,-16,16,13,18,19,0,0,-9,-4,-3,0,0,-16,11:2 - 11:7 - 11:8 - 0:0 - 0:0
19539479,2024-06-29 13:00:00,Nazaryan Mushegh - Papyan Karen,0:3,8:11 - 6:11 - 10:12 - 0:0 - 0:0,0,3,Nazaryan Mushegh,Papyan Karen,fiurst,Nazaryan Mushegh - Papyan Karen,58,24,34,10,-10,19,17,22,0,0,3,5,2,0,0,10,8:11 - 6:11 - 10:12 - 0:0 - 0:0
19539478,2024-06-29 12:30:00,Nikoghosyan Narek - Hovhannesyan Rafik,1:3,7:11 - 11:5 - 13:11 - 11:9 - 0:0,3,1,Nikoghosyan Narek,Hovhannesyan Rafik,fiurst,Hovhannesyan Rafik - Nikoghosyan Narek,78,36,42,6,-6,18,16,24,20,0,-4,6,2,2,0,6,11:7 - 5:11 - 11:13 - 9:11 - 0:0
19539477,2024-06-29 12:00:00,Nazaryan Mushegh - Asatryan Murad,3:0,7:11 - 3:11 - 8:11 - 0:0 - 0:0,0,3,Nazaryan Mushegh,Asatryan Murad,fiurst,Asatryan Murad - Nazaryan Mushegh,51,33,18,-15,15,18,14,19,0,0,-4,-8,-3,0,0,-15,11:7 - 11:3 - 11:8 - 0:0 - 0:0
19539476,2024-06-29 11:45:00,Papyan Karen - Nikoghosyan Narek,2:3,9:11 - 11:4 - 7:11 - 11:9 - 11:8,3,2,Papyan Karen,Nikoghosyan Narek,fiurst,Nikoghosyan Narek - Papyan Karen,92,43,49,6,-6,20,15,18,20,19,-2,7,-4,2,3,6,11:9 - 4:11 - 11:7 - 9:11 - 8:11
19539475,2024-06-29 11:30:00,Nazaryan Mushegh - Hovhannesyan Rafik,0:3,11:9 - 11:7 - 11:8 - 0:0 - 0:0,3,0,Nazaryan Mushegh,Hovhannesyan Rafik,fiurst,Hovhannesyan Rafik - Nazaryan Mushegh,57,24,33,9,-9,20,18,19,0,0,2,4,3,0,0,9,9:11 - 7:11 - 8:11 - 0:0 - 0:0
19539473,2024-06-29 11:15:00,Asatryan Murad - Papyan Karen,3:1,11:5 - 10:12 - 11:5 - 11:8 - 0:0,3,1,Asatryan Murad,Papyan Karen,fiurst,Asatryan Murad - Papyan Karen,73,43,30,-13,13,16,22,16,19,0,-6,2,-6,-3,0,-13,11:5 - 10:12 - 11:5 - 11:8 - 0:0
19539463,2024-06-29 11:00:00,Nikoghosyan Narek - Nazaryan Mushegh,0:3,11:6 - 11:4 - 11:7 - 0:0 - 0:0,3,0,Nikoghosyan Narek,Nazaryan Mushegh,fiurst,Nazaryan Mushegh - Nikoghosyan Narek,50,17,33,16,-16,17,15,18,0,0,5,7,4,0,0,16,6:11 - 4:11 - 7:11 - 0:0 - 0:0
19539459,2024-06-29 10:45:00,Hovhannesyan Rafik - Papyan Karen,0:3,10:12 - 10:12 - 3:11 - 0:0 - 0:0,0,3,Hovhannesyan Rafik,Papyan Karen,fiurst,Hovhannesyan Rafik - Papyan Karen,58,23,35,12,-12,22,22,14,0,0,2,2,8,0,0,12,10:12 - 10:12 - 3:11 - 0:0 - 0:0
19539457,2024-06-29 10:40:00,Asatryan Murad - Nikoghosyan Narek,3:0,11:9 - 13:11 - 11:4 - 0:0 - 0:0,3,0,Asatryan Murad,Nikoghosyan Narek,fiurst,Asatryan Murad - Nikoghosyan Narek,59,35,24,-11,11,20,24,15,0,0,-2,-2,-7,0,0,-11,11:9 - 13:11 - 11:4 - 0:0 - 0:0
19539456,2024-06-29 10:15:00,Papyan Karen - Nazaryan Mushegh,3:1,7:11 - 14:12 - 17:19 - 7:11 - 0:0,1,3,Papyan Karen,Nazaryan Mushegh,fiurst,Nazaryan Mushegh - Papyan Karen,98,53,45,-8,8,18,26,36,18,0,-4,2,-2,-4,0,-8,11:7 - 12:14 - 19:17 - 11:7 - 0:0
19539455,2024-06-29 10:10:00,Hovhannesyan Rafik - Asatryan Murad,3:1,8:11 - 11:5 - 6:11 - 4:11 - 0:0,1,3,Hovhannesyan Rafik,Asatryan Murad,fiurst,Asatryan Murad - Hovhannesyan Rafik,67,38,29,-9,9,19,16,17,15,0,-3,6,-5,-7,0,-9,11:8 - 5:11 - 11:6 - 11:4 - 0:0
19521057,2024-06-28 17:55:00,Hakobyan Eduard - Petrosyan Davit,1:3,12:14 - 13:15 - 11:8 - 2:11 - 0:0,1,3,Hakobyan Eduard,Petrosyan Davit,fiurst,Hakobyan Eduard - Petrosyan Davit,86,38,48,10,-10,26,28,19,13,0,2,2,-3,9,0,10,12:14 - 13:15 - 11:8 - 2:11 - 0:0
19521056,2024-06-28 17:30:00,Mkrtchyan Andranik - Arutyunov Ruben,3:0,4:11 - 3:11 - 3:11 - 0:0 - 0:0,0,3,Mkrtchyan Andranik,Arutyunov Ruben,fiurst,Arutyunov Ruben - Mkrtchyan Andranik,43,33,10,-23,23,15,14,14,0,0,-7,-8,-8,0,0,-23,11:4 - 11:3 - 11:3 - 0:0 - 0:0
19521055,2024-06-28 17:20:00,Soghomonyan Hrayr - Hakobyan Eduard,1:3,8:11 - 14:12 - 11:9 - 11:7 - 0:0,3,1,Soghomonyan Hrayr,Hakobyan Eduard,fiurst,Hakobyan Eduard - Soghomonyan Hrayr,83,39,44,5,-5,19,26,20,18,0,-3,2,2,4,0,5,11:8 - 12:14 - 9:11 - 7:11 - 0:0
19521045,2024-06-28 17:00:00,Arutyunov Ruben - Soghomonyan Hrayr,1:3,11:7 - 8:11 - 3:11 - 7:11 - 0:0,1,3,Arutyunov Ruben,Soghomonyan Hrayr,fiurst,Arutyunov Ruben - Soghomonyan Hrayr,69,29,40,11,-11,18,19,14,18,0,-4,3,8,4,0,11,11:7 - 8:11 - 3:11 - 7:11 - 0:0
19521054,2024-06-28 17:00:00,Mkrtchyan Andranik - Petrosyan Davit,1:3,11:4 - 8:11 - 7:11 - 8:11 - 0:0,1,3,Mkrtchyan Andranik,Petrosyan Davit,fiurst,Mkrtchyan Andranik - Petrosyan Davit,71,34,37,3,-3,15,19,18,19,0,-7,3,4,3,0,3,11:4 - 8:11 - 7:11 - 8:11 - 0:0
19521042,2024-06-28 16:35:00,Hakobyan Eduard - Mkrtchyan Andranik,3:0,11:6 - 11:5 - 11:4 - 0:0 - 0:0,3,0,Hakobyan Eduard,Mkrtchyan Andranik,fiurst,Hakobyan Eduard - Mkrtchyan Andranik,48,33,15,-18,18,17,16,15,0,0,-5,-6,-7,0,0,-18,11:6 - 11:5 - 11:4 - 0:0 - 0:0
19521041,2024-06-28 16:15:00,Petrosyan Davit - Soghomonyan Hrayr,2:3,11:8 - 8:11 - 12:10 - 8:11 - 5:11,2,3,Petrosyan Davit,Soghomonyan Hrayr,fiurst,Petrosyan Davit - Soghomonyan Hrayr,95,44,51,7,-7,19,19,22,19,16,-3,3,-2,3,6,7,11:8 - 8:11 - 12:10 - 8:11 - 5:11
19521040,2024-06-28 16:00:00,Arutyunov Ruben - Hakobyan Eduard,3:1,11:5 - 9:11 - 11:8 - 13:11 - 0:0,3,1,Arutyunov Ruben,Hakobyan Eduard,fiurst,Arutyunov Ruben - Hakobyan Eduard,79,44,35,-9,9,16,20,19,24,0,-6,2,-3,-2,0,-9,11:5 - 9:11 - 11:8 - 13:11 - 0:0
19521038,2024-06-28 15:45:00,Soghomonyan Hrayr - Mkrtchyan Andranik,2:3,5:11 - 11:8 - 7:11 - 11:3 - 11:8,3,2,Soghomonyan Hrayr,Mkrtchyan Andranik,fiurst,Mkrtchyan Andranik - Soghomonyan Hrayr,86,41,45,4,-4,16,19,18,14,19,-6,3,-4,8,3,4,11:5 - 8:11 - 11:7 - 3:11 - 8:11
19521037,2024-06-28 15:35:00,Petrosyan Davit - Arutyunov Ruben,0:3,11:7 - 11:7 - 11:5 - 0:0 - 0:0,3,0,Petrosyan Davit,Arutyunov Ruben,fiurst,Arutyunov Ruben - Petrosyan Davit,52,19,33,14,-14,18,18,16,0,0,4,4,6,0,0,14,7:11 - 7:11 - 5:11 - 0:0 - 0:0
19521034,2024-06-28 15:20:00,Papyan Karen - Hovhannesyan Rafik,0:3,11:9 - 15:13 - 11:8 - 0:0 - 0:0,3,0,Papyan Karen,Hovhannesyan Rafik,fiurst,Hovhannesyan Rafik - Papyan Karen,67,30,37,7,-7,20,28,19,0,0,2,2,3,0,0,7,9:11 - 13:15 - 8:11 - 0:0 - 0:0
19521035,2024-06-28 15:15:00,Asatryan Murad - Gevorgyan Hayk,3:1,12:14 - 11:9 - 11:3 - 12:10 - 0:0,3,1,Asatryan Murad,Gevorgyan Hayk,fiurst,Asatryan Murad - Gevorgyan Hayk,82,46,36,-10,10,26,20,14,22,0,2,-2,-8,-2,0,-10,12:14 - 11:9 - 11:3 - 12:10 - 0:0
19521032,2024-06-28 14:55:00,Nikoghosyan Narek - Asatryan Murad,3:1,5:11 - 11:3 - 6:11 - 5:11 - 0:0,1,3,Nikoghosyan Narek,Asatryan Murad,fiurst,Asatryan Murad - Nikoghosyan Narek,63,36,27,-9,9,16,14,17,16,0,-6,8,-5,-6,0,-9,11:5 - 3:11 - 11:6 - 11:5 - 0:0
19521029,2024-06-28 14:50:00,Gevorgyan Hayk - Papyan Karen,3:1,11:8 - 16:18 - 11:7 - 11:8 - 0:0,3,1,Gevorgyan Hayk,Papyan Karen,fiurst,Gevorgyan Hayk - Papyan Karen,90,49,41,-8,8,19,34,18,19,0,-3,2,-4,-3,0,-8,11:8 - 16:18 - 11:7 - 11:8 - 0:0
19521018,2024-06-28 14:20:00,Nikoghosyan Narek - Hovhannesyan Rafik,0:3,11:4 - 11:2 - 11:3 - 0:0 - 0:0,3,0,Nikoghosyan Narek,Hovhannesyan Rafik,fiurst,Hovhannesyan Rafik - Nikoghosyan Narek,42,9,33,24,-24,15,13,14,0,0,7,9,8,0,0,24,4:11 - 2:11 - 3:11 - 0:0 - 0:0
19521017,2024-06-28 14:05:00,Asatryan Murad - Papyan Karen,3:2,11:7 - 9:11 - 8:11 - 13:11 - 11:1,3,2,Asatryan Murad,Papyan Karen,fiurst,Asatryan Murad - Papyan Karen,93,52,41,-11,11,18,20,19,24,12,-4,2,3,-2,-10,-11,11:7 - 9:11 - 8:11 - 13:11 - 11:1
19521016,2024-06-28 13:55:00,Gevorgyan Hayk - Nikoghosyan Narek,3:1,11:5 - 11:7 - 12:14 - 11:5 - 0:0,3,1,Gevorgyan Hayk,Nikoghosyan Narek,fiurst,Gevorgyan Hayk - Nikoghosyan Narek,76,45,31,-14,14,16,18,26,16,0,-6,-4,2,-6,0,-14,11:5 - 11:7 - 12:14 - 11:5 - 0:0
19521015,2024-06-28 13:45:00,Hovhannesyan Rafik - Asatryan Murad,3:0,11:13 - 11:13 - 11:13 - 0:0 - 0:0,0,3,Hovhannesyan Rafik,Asatryan Murad,fiurst,Asatryan Murad - Hovhannesyan Rafik,72,39,33,-6,6,24,24,24,0,0,-2,-2,-2,0,0,-6,13:11 - 13:11 - 13:11 - 0:0 - 0:0
19521014,2024-06-28 13:15:00,Papyan Karen - Nikoghosyan Narek,3:2,11:9 - 10:12 - 9:11 - 11:8 - 8:11,2,3,Papyan Karen,Nikoghosyan Narek,fiurst,Nikoghosyan Narek - Papyan Karen,100,51,49,-2,2,20,22,20,19,19,2,-2,-2,3,-3,-2,9:11 - 12:10 - 11:9 - 8:11 - 11:8
19521013,2024-06-28 13:10:00,Hovhannesyan Rafik - Gevorgyan Hayk,2:3,11:8 - 9:11 - 5:11 - 11:6 - 11:9,3,2,Hovhannesyan Rafik,Gevorgyan Hayk,fiurst,Gevorgyan Hayk - Hovhannesyan Rafik,92,45,47,2,-2,19,20,16,17,20,3,-2,-6,5,2,2,8:11 - 11:9 - 11:5 - 6:11 - 9:11
19520999,2024-06-28 12:15:00,Hovhannesyan Rafik - Papyan Karen,1:3,11:9 - 9:11 - 10:12 - 14:16 - 0:0,1,3,Hovhannesyan Rafik,Papyan Karen,fiurst,Hovhannesyan Rafik - Papyan Karen,92,44,48,4,-4,20,20,22,30,0,-2,2,2,2,0,4,11:9 - 9:11 - 10:12 - 14:16 - 0:0
19521012,2024-06-28 12:15:00,Asatryan Murad - Nikoghosyan Narek,3:1,14:12 - 11:9 - 8:11 - 11:7 - 0:0,3,1,Asatryan Murad,Nikoghosyan Narek,fiurst,Asatryan Murad - Nikoghosyan Narek,83,44,39,-5,5,26,20,19,18,0,-2,-2,3,-4,0,-5,14:12 - 11:9 - 8:11 - 11:7 - 0:0
19520995,2024-06-28 11:45:00,Gevorgyan Hayk - Asatryan Murad,3:2,12:10 - 14:12 - 9:11 - 5:11 - 4:11,2,3,Gevorgyan Hayk,Asatryan Murad,fiurst,Asatryan Murad - Gevorgyan Hayk,99,55,44,-11,11,22,26,20,16,15,2,2,-2,-6,-7,-11,10:12 - 12:14 - 11:9 - 11:5 - 11:4
19520992,2024-06-28 11:30:00,Hovhannesyan Rafik - Nikoghosyan Narek,3:2,11:7 - 7:11 - 11:9 - 3:11 - 13:11,3,2,Hovhannesyan Rafik,Nikoghosyan Narek,fiurst,Hovhannesyan Rafik - Nikoghosyan Narek,94,45,49,4,-4,18,18,20,14,24,-4,4,-2,8,-2,4,11:7 - 7:11 - 11:9 - 3:11 - 13:11
19520991,2024-06-28 11:15:00,Papyan Karen - Gevorgyan Hayk,1:3,6:11 - 12:10 - 12:10 - 11:8 - 0:0,3,1,Papyan Karen,Gevorgyan Hayk,fiurst,Gevorgyan Hayk - Papyan Karen,80,39,41,2,-2,17,22,22,19,0,-5,2,2,3,0,2,11:6 - 10:12 - 10:12 - 8:11 - 0:0
19520990,2024-06-28 11:00:00,Asatryan Murad - Hovhannesyan Rafik,3:0,11:9 - 11:7 - 11:6 - 0:0 - 0:0,3,0,Asatryan Murad,Hovhannesyan Rafik,fiurst,Asatryan Murad - Hovhannesyan Rafik,55,33,22,-11,11,20,18,17,0,0,-2,-4,-5,0,0,-11,11:9 - 11:7 - 11:6 - 0:0 - 0:0
19520989,2024-06-28 10:45:00,Nikoghosyan Narek - Gevorgyan Hayk,3:0,10:12 - 9:11 - 9:11 - 0:0 - 0:0,0,3,Nikoghosyan Narek,Gevorgyan Hayk,fiurst,Gevorgyan Hayk - Nikoghosyan Narek,62,34,28,-6,6,22,20,20,0,0,-2,-2,-2,0,0,-6,12:10 - 11:9 - 11:9 - 0:0 - 0:0
19520988,2024-06-28 10:30:00,Papyan Karen - Asatryan Murad,3:2,11:4 - 9:11 - 7:11 - 13:11 - 7:11,2,3,Papyan Karen,Asatryan Murad,fiurst,Asatryan Murad - Papyan Karen,95,48,47,-1,1,15,20,18,24,18,7,-2,-4,2,-4,-1,4:11 - 11:9 - 11:7 - 11:13 - 11:7
19520987,2024-06-28 10:15:00,Gevorgyan Hayk - Hovhannesyan Rafik,0:3,6:11 - 9:11 - 4:11 - 0:0 - 0:0,0,3,Gevorgyan Hayk,Hovhannesyan Rafik,fiurst,Gevorgyan Hayk - Hovhannesyan Rafik,52,19,33,14,-14,17,20,15,0,0,5,2,7,0,0,14,6:11 - 9:11 - 4:11 - 0:0 - 0:0
19520984,2024-06-28 10:05:00,Nikoghosyan Narek - Papyan Karen,0:3,3:11 - 7:11 - 6:11 - 0:0 - 0:0,0,3,Nikoghosyan Narek,Papyan Karen,fiurst,Nikoghosyan Narek - Papyan Karen,49,16,33,17,-17,14,18,17,0,0,8,4,5,0,0,17,3:11 - 7:11 - 6:11 - 0:0 - 0:0
19503584,2024-06-27 18:05:00,Hakobyan Eduard - Soghomonyan Hrayr,0:3,7:11 - 4:11 - 8:11 - 0:0 - 0:0,0,3,Hakobyan Eduard,Soghomonyan Hrayr,fiurst,Hakobyan Eduard - Soghomonyan Hrayr,52,19,33,14,-14,18,15,19,0,0,4,7,3,0,0,14,7:11 - 4:11 - 8:11 - 0:0 - 0:0
19503583,2024-06-27 17:35:00,Petrosyan Davit - Gevorgyan Gegham,0:3,11:4 - 11:9 - 11:9 - 0:0 - 0:0,3,0,Petrosyan Davit,Gevorgyan Gegham,fiurst,Gevorgyan Gegham - Petrosyan Davit,55,22,33,11,-11,15,20,20,0,0,7,2,2,0,0,11,4:11 - 9:11 - 9:11 - 0:0 - 0:0
19503578,2024-06-27 17:30:00,Mkrtchyan Andranik - Hakobyan Eduard,3:2,11:7 - 11:3 - 14:16 - 7:11 - 8:11,2,3,Mkrtchyan Andranik,Hakobyan Eduard,fiurst,Hakobyan Eduard - Mkrtchyan Andranik,99,48,51,3,-3,18,14,30,18,19,4,8,-2,-4,-3,3,7:11 - 3:11 - 16:14 - 11:7 - 11:8
19503560,2024-06-27 17:00:00,Petrosyan Davit - Soghomonyan Hrayr,3:2,12:14 - 11:5 - 11:7 - 6:11 - 11:9,3,2,Petrosyan Davit,Soghomonyan Hrayr,fiurst,Petrosyan Davit - Soghomonyan Hrayr,97,51,46,-5,5,26,16,18,17,20,2,-6,-4,5,-2,-5,12:14 - 11:5 - 11:7 - 6:11 - 11:9
19503558,2024-06-27 16:50:00,Gevorgyan Gegham - Mkrtchyan Andranik,3:2,15:13 - 9:11 - 11:13 - 11:7 - 11:9,3,2,Gevorgyan Gegham,Mkrtchyan Andranik,fiurst,Gevorgyan Gegham - Mkrtchyan Andranik,110,57,53,-4,4,28,20,24,18,20,-2,2,2,-4,-2,-4,15:13 - 9:11 - 11:13 - 11:7 - 11:9
19503555,2024-06-27 16:35:00,Hakobyan Eduard - Petrosyan Davit,0:3,4:11 - 5:11 - 6:11 - 0:0 - 0:0,0,3,Hakobyan Eduard,Petrosyan Davit,fiurst,Hakobyan Eduard - Petrosyan Davit,48,15,33,18,-18,15,16,17,0,0,7,6,5,0,0,18,4:11 - 5:11 - 6:11 - 0:0 - 0:0
19503554,2024-06-27 16:20:00,Soghomonyan Hrayr - Mkrtchyan Andranik,3:1,11:7 - 6:11 - 7:11 - 5:11 - 0:0,1,3,Soghomonyan Hrayr,Mkrtchyan Andranik,fiurst,Mkrtchyan Andranik - Soghomonyan Hrayr,69,40,29,-11,11,18,17,18,16,0,4,-5,-4,-6,0,-11,7:11 - 11:6 - 11:7 - 11:5 - 0:0
19503542,2024-06-27 16:10:00,Gevorgyan Gegham - Hakobyan Eduard,3:2,11:9 - 11:8 - 6:11 - 9:11 - 11:6,3,2,Gevorgyan Gegham,Hakobyan Eduard,fiurst,Gevorgyan Gegham - Hakobyan Eduard,93,48,45,-3,3,20,19,17,20,17,-2,-3,5,2,-5,-3,11:9 - 11:8 - 6:11 - 9:11 - 11:6
19503539,2024-06-27 15:50:00,Mkrtchyan Andranik - Petrosyan Davit,3:1,6:11 - 11:8 - 11:7 - 11:9 - 0:0,3,1,Mkrtchyan Andranik,Petrosyan Davit,fiurst,Mkrtchyan Andranik - Petrosyan Davit,74,39,35,-4,4,17,19,18,20,0,5,-3,-4,-2,0,-4,6:11 - 11:8 - 11:7 - 11:9 - 0:0
19503536,2024-06-27 15:30:00,Soghomonyan Hrayr - Gevorgyan Gegham,2:3,8:11 - 11:5 - 9:11 - 11:8 - 11:5,3,2,Soghomonyan Hrayr,Gevorgyan Gegham,fiurst,Gevorgyan Gegham - Soghomonyan Hrayr,90,40,50,10,-10,19,16,20,19,16,-3,6,-2,3,6,10,11:8 - 5:11 - 11:9 - 8:11 - 5:11
19503535,2024-06-27 15:15:00,Hakobyan Eduard - Mkrtchyan Andranik,3:2,11:6 - 5:11 - 6:11 - 11:8 - 11:3,3,2,Hakobyan Eduard,Mkrtchyan Andranik,fiurst,Hakobyan Eduard - Mkrtchyan Andranik,83,44,39,-5,5,17,16,17,19,14,-5,6,5,-3,-8,-5,11:6 - 5:11 - 6:11 - 11:8 - 11:3
19503533,2024-06-27 15:00:00,Gevorgyan Hayk - Diaryan Aleksandr,2:3,11:9 - 5:11 - 3:11 - 11:6 - 12:10,3,2,Gevorgyan Hayk,Diaryan Aleksandr,fiurst,Diaryan Aleksandr - Gevorgyan Hayk,89,47,42,-5,5,20,16,14,17,22,2,-6,-8,5,2,-5,9:11 - 11:5 - 11:3 - 6:11 - 10:12
19503528,2024-06-27 14:50:00,Nikoghosyan Narek - Hovhannesyan Rafik,3:2,7:11 - 11:7 - 11:7 - 5:11 - 7:11,2,3,Nikoghosyan Narek,Hovhannesyan Rafik,fiurst,Hovhannesyan Rafik - Nikoghosyan Narek,88,47,41,-6,6,18,18,18,16,18,-4,4,4,-6,-4,-6,11:7 - 7:11 - 7:11 - 11:5 - 11:7
19503517,2024-06-27 14:35:00,Gevorgyan Gegham - Petrosyan Davit,1:3,5:11 - 6:11 - 11:6 - 9:11 - 0:0,1,3,Gevorgyan Gegham,Petrosyan Davit,fiurst,Gevorgyan Gegham - Petrosyan Davit,70,31,39,8,-8,16,17,17,20,0,6,5,-5,2,0,8,5:11 - 6:11 - 11:6 - 9:11 - 0:0
19503514,2024-06-27 14:15:00,Hovhannesyan Rafik - Gevorgyan Hayk,2:3,9:11 - 11:3 - 5:11 - 11:5 - 11:3,3,2,Hovhannesyan Rafik,Gevorgyan Hayk,fiurst,Gevorgyan Hayk - Hovhannesyan Rafik,80,33,47,14,-14,20,14,16,16,14,-2,8,-6,6,8,14,11:9 - 3:11 - 11:5 - 5:11 - 3:11
19503515,2024-06-27 14:15:00,Nikoghosyan Narek - Diaryan Aleksandr,0:3,11:7 - 11:9 - 11:7 - 0:0 - 0:0,3,0,Nikoghosyan Narek,Diaryan Aleksandr,fiurst,Diaryan Aleksandr - Nikoghosyan Narek,56,23,33,10,-10,18,20,18,0,0,4,2,4,0,0,10,7:11 - 9:11 - 7:11 - 0:0 - 0:0
19503512,2024-06-27 13:45:00,Soghomonyan Hrayr - Hakobyan Eduard,3:0,12:14 - 8:11 - 9:11 - 0:0 - 0:0,0,3,Soghomonyan Hrayr,Hakobyan Eduard,fiurst,Hakobyan Eduard - Soghomonyan Hrayr,65,36,29,-7,7,26,19,20,0,0,-2,-3,-2,0,0,-7,14:12 - 11:8 - 11:9 - 0:0 - 0:0
19503511,2024-06-27 13:30:00,Diaryan Aleksandr - Hovhannesyan Rafik,3:2,6:11 - 11:6 - 9:11 - 11:7 - 11:7,3,2,Diaryan Aleksandr,Hovhannesyan Rafik,fiurst,Diaryan Aleksandr - Hovhannesyan Rafik,90,48,42,-6,6,17,17,20,18,18,5,-5,2,-4,-4,-6,6:11 - 11:6 - 9:11 - 11:7 - 11:7
19503509,2024-06-27 13:15:00,Gevorgyan Hayk - Nikoghosyan Narek,2:3,6:11 - 13:11 - 11:9 - 6:11 - 3:11,2,3,Gevorgyan Hayk,Nikoghosyan Narek,fiurst,Gevorgyan Hayk - Nikoghosyan Narek,92,39,53,14,-14,17,24,20,17,14,5,-2,-2,5,8,14,6:11 - 13:11 - 11:9 - 6:11 - 3:11
19503504,2024-06-27 13:05:00,Petrosyan Davit - Hakobyan Eduard,2:3,11:8 - 11:5 - 8:11 - 9:11 - 11:5,3,2,Petrosyan Davit,Hakobyan Eduard,fiurst,Hakobyan Eduard - Petrosyan Davit,90,40,50,10,-10,19,16,19,20,16,3,6,-3,-2,6,10,8:11 - 5:11 - 11:8 - 11:9 - 5:11
19503494,2024-06-27 12:15:00,Hovhannesyan Rafik - Nikoghosyan Narek,1:3,11:9 - 8:11 - 9:11 - 8:11 - 0:0,1,3,Hovhannesyan Rafik,Nikoghosyan Narek,fiurst,Hovhannesyan Rafik - Nikoghosyan Narek,78,36,42,6,-6,20,19,20,19,0,-2,3,2,3,0,6,11:9 - 8:11 - 9:11 - 8:11 - 0:0
19503492,2024-06-27 12:00:00,Diaryan Aleksandr - Gevorgyan Hayk,3:0,11:7 - 11:2 - 11:5 - 0:0 - 0:0,3,0,Diaryan Aleksandr,Gevorgyan Hayk,fiurst,Diaryan Aleksandr - Gevorgyan Hayk,47,33,14,-19,19,18,13,16,0,0,-4,-9,-6,0,0,-19,11:7 - 11:2 - 11:5 - 0:0 - 0:0
19503491,2024-06-27 11:45:00,Nazaryan Mushegh - Hovhannesyan Rafik,3:0,5:11 - 4:11 - 3:11 - 0:0 - 0:0,0,3,Nazaryan Mushegh,Hovhannesyan Rafik,fiurst,Hovhannesyan Rafik - Nazaryan Mushegh,45,33,12,-21,21,16,15,14,0,0,-6,-7,-8,0,0,-21,11:5 - 11:4 - 11:3 - 0:0 - 0:0
19503489,2024-06-27 11:35:00,Diaryan Aleksandr - Nikoghosyan Narek,1:3,11:4 - 7:11 - 10:12 - 10:12 - 0:0,1,3,Diaryan Aleksandr,Nikoghosyan Narek,fiurst,Diaryan Aleksandr - Nikoghosyan Narek,77,38,39,1,-1,15,18,22,22,0,-7,4,2,2,0,1,11:4 - 7:11 - 10:12 - 10:12 - 0:0
19503487,2024-06-27 11:15:00,Gevorgyan Hayk - Nazaryan Mushegh,3:0,11:4 - 11:9 - 11:8 - 0:0 - 0:0,3,0,Gevorgyan Hayk,Nazaryan Mushegh,fiurst,Gevorgyan Hayk - Nazaryan Mushegh,54,33,21,-12,12,15,20,19,0,0,-7,-2,-3,0,0,-12,11:4 - 11:9 - 11:8 - 0:0 - 0:0
19503485,2024-06-27 11:00:00,Hovhannesyan Rafik - Diaryan Aleksandr,3:1,8:11 - 14:12 - 5:11 - 9:11 - 0:0,1,3,Hovhannesyan Rafik,Diaryan Aleksandr,fiurst,Diaryan Aleksandr - Hovhannesyan Rafik,81,45,36,-9,9,19,26,16,20,0,-3,2,-6,-2,0,-9,11:8 - 12:14 - 11:5 - 11:9 - 0:0
19503460,2024-06-27 10:45:00,Nikoghosyan Narek - Nazaryan Mushegh,0:3,11:9 - 11:5 - 11:4 - 0:0 - 0:0,3,0,Nikoghosyan Narek,Nazaryan Mushegh,fiurst,Nazaryan Mushegh - Nikoghosyan Narek,51,18,33,15,-15,20,16,15,0,0,2,6,7,0,0,15,9:11 - 5:11 - 4:11 - 0:0 - 0:0
19501058,2024-06-27 10:30:00,Gevorgyan Hayk - Hovhannesyan Rafik,0:3,7:11 - 7:11 - 4:11 - 0:0 - 0:0,0,3,Gevorgyan Hayk,Hovhannesyan Rafik,fiurst,Gevorgyan Hayk - Hovhannesyan Rafik,51,18,33,15,-15,18,18,15,0,0,4,4,7,0,0,15,7:11 - 7:11 - 4:11 - 0:0 - 0:0
19501044,2024-06-27 10:15:00,Nazaryan Mushegh - Diaryan Aleksandr,3:0,9:11 - 8:11 - 6:11 - 0:0 - 0:0,0,3,Nazaryan Mushegh,Diaryan Aleksandr,fiurst,Diaryan Aleksandr - Nazaryan Mushegh,56,33,23,-10,10,20,19,17,0,0,-2,-3,-5,0,0,-10,11:9 - 11:8 - 11:6 - 0:0 - 0:0
19501040,2024-06-27 10:00:00,Nikoghosyan Narek - Gevorgyan Hayk,0:3,11:8 - 11:7 - 12:10 - 0:0 - 0:0,3,0,Nikoghosyan Narek,Gevorgyan Hayk,fiurst,Gevorgyan Hayk - Nikoghosyan Narek,59,25,34,9,-9,19,18,22,0,0,3,4,2,0,0,9,8:11 - 7:11 - 10:12 - 0:0 - 0:0
19479296,2024-06-26 17:45:00,Hakobyan Eduard - Mkrtchyan Andranik,3:1,11:7 - 11:3 - 6:11 - 11:6 - 0:0,3,1,Hakobyan Eduard,Mkrtchyan Andranik,fiurst,Hakobyan Eduard - Mkrtchyan Andranik,66,39,27,-12,12,18,14,17,17,0,-4,-8,5,-5,0,-12,11:7 - 11:3 - 6:11 - 11:6 - 0:0
19479286,2024-06-26 17:35:00,Petrosyan Davit - Soghomonyan Hrayr,2:3,9:11 - 11:5 - 11:3 - 9:11 - 4:11,2,3,Petrosyan Davit,Soghomonyan Hrayr,fiurst,Petrosyan Davit - Soghomonyan Hrayr,85,44,41,-3,3,20,16,14,20,15,2,-6,-8,2,7,-3,9:11 - 11:5 - 11:3 - 9:11 - 4:11
19479267,2024-06-26 17:30:00,Arutyunov Ruben - Hakobyan Eduard,3:0,11:5 - 11:9 - 11:8 - 0:0 - 0:0,3,0,Arutyunov Ruben,Hakobyan Eduard,fiurst,Arutyunov Ruben - Hakobyan Eduard,55,33,22,-11,11,16,20,19,0,0,-6,-2,-3,0,0,-11,11:5 - 11:9 - 11:8 - 0:0 - 0:0
19479265,2024-06-26 17:05:00,Petrosyan Davit - Mkrtchyan Andranik,1:3,11:5 - 11:9 - 8:11 - 11:4 - 0:0,3,1,Petrosyan Davit,Mkrtchyan Andranik,fiurst,Mkrtchyan Andranik - Petrosyan Davit,70,29,41,12,-12,16,20,19,15,0,6,2,-3,7,0,12,5:11 - 9:11 - 11:8 - 4:11 - 0:0
19479262,2024-06-26 16:55:00,Soghomonyan Hrayr - Arutyunov Ruben,2:3,4:11 - 5:11 - 11:8 - 11:4 - 11:5,3,2,Soghomonyan Hrayr,Arutyunov Ruben,fiurst,Arutyunov Ruben - Soghomonyan Hrayr,81,39,42,3,-3,15,16,19,15,16,-7,-6,3,7,6,3,11:4 - 11:5 - 8:11 - 4:11 - 5:11
19479260,2024-06-26 16:30:00,Hakobyan Eduard - Petrosyan Davit,1:3,5:11 - 11:8 - 11:13 - 7:11 - 0:0,1,3,Hakobyan Eduard,Petrosyan Davit,fiurst,Hakobyan Eduard - Petrosyan Davit,77,34,43,9,-9,16,19,24,18,0,6,-3,2,4,0,9,5:11 - 11:8 - 11:13 - 7:11 - 0:0
19479258,2024-06-26 16:20:00,Mkrtchyan Andranik - Arutyunov Ruben,2:3,11:3 - 11:9 - 9:11 - 4:11 - 11:6,3,2,Mkrtchyan Andranik,Arutyunov Ruben,fiurst,Arutyunov Ruben - Mkrtchyan Andranik,86,40,46,6,-6,14,20,20,15,17,8,2,-2,-7,5,6,3:11 - 9:11 - 11:9 - 11:4 - 6:11
19479257,2024-06-26 16:00:00,Soghomonyan Hrayr - Hakobyan Eduard,0:3,11:9 - 12:10 - 11:6 - 0:0 - 0:0,3,0,Soghomonyan Hrayr,Hakobyan Eduard,fiurst,Hakobyan Eduard - Soghomonyan Hrayr,59,25,34,9,-9,20,22,17,0,0,2,2,5,0,0,9,9:11 - 10:12 - 6:11 - 0:0 - 0:0
19479252,2024-06-26 15:45:00,Arutyunov Ruben - Petrosyan Davit,3:1,5:11 - 11:5 - 13:11 - 11:9 - 0:0,3,1,Arutyunov Ruben,Petrosyan Davit,fiurst,Arutyunov Ruben - Petrosyan Davit,76,40,36,-4,4,16,16,24,20,0,6,-6,-2,-2,0,-4,5:11 - 11:5 - 13:11 - 11:9 - 0:0
19479248,2024-06-26 15:30:00,Mkrtchyan Andranik - Soghomonyan Hrayr,0:3,6:11 - 9:11 - 9:11 - 0:0 - 0:0,0,3,Mkrtchyan Andranik,Soghomonyan Hrayr,fiurst,Mkrtchyan Andranik - Soghomonyan Hrayr,57,24,33,9,-9,17,20,20,0,0,5,2,2,0,0,9,6:11 - 9:11 - 9:11 - 0:0 - 0:0
19479243,2024-06-26 15:15:00,Diaryan Aleksandr - Nikoghosyan Narek,3:0,12:10 - 12:10 - 11:5 - 0:0 - 0:0,3,0,Diaryan Aleksandr,Nikoghosyan Narek,fiurst,Diaryan Aleksandr - Nikoghosyan Narek,60,35,25,-10,10,22,22,16,0,0,-2,-2,-6,0,0,-10,12:10 - 12:10 - 11:5 - 0:0 - 0:0
19479241,2024-06-26 15:00:00,Nazaryan Mushegh - Asatryan Murad,3:0,2:11 - 5:11 - 5:11 - 0:0 - 0:0,0,3,Nazaryan Mushegh,Asatryan Murad,fiurst,Asatryan Murad - Nazaryan Mushegh,45,33,12,-21,21,13,16,16,0,0,-9,-6,-6,0,0,-21,11:2 - 11:5 - 11:5 - 0:0 - 0:0
19479239,2024-06-26 14:45:00,Papyan Karen - Diaryan Aleksandr,3:0,8:11 - 6:11 - 9:11 - 0:0 - 0:0,0,3,Papyan Karen,Diaryan Aleksandr,fiurst,Diaryan Aleksandr - Papyan Karen,56,33,23,-10,10,19,17,20,0,0,-3,-5,-2,0,0,-10,11:8 - 11:6 - 11:9 - 0:0 - 0:0
19479213,2024-06-26 14:30:00,Nikoghosyan Narek - Nazaryan Mushegh,0:3,12:10 - 11:9 - 11:7 - 0:0 - 0:0,3,0,Nikoghosyan Narek,Nazaryan Mushegh,fiurst,Nazaryan Mushegh - Nikoghosyan Narek,60,26,34,8,-8,22,20,18,0,0,2,2,4,0,0,8,10:12 - 9:11 - 7:11 - 0:0 - 0:0
19479210,2024-06-26 14:25:00,Papyan Karen - Asatryan Murad,3:0,8:11 - 8:11 - 3:11 - 0:0 - 0:0,0,3,Papyan Karen,Asatryan Murad,fiurst,Asatryan Murad - Papyan Karen,52,33,19,-14,14,19,19,14,0,0,-3,-3,-8,0,0,-14,11:8 - 11:8 - 11:3 - 0:0 - 0:0
19479207,2024-06-26 14:00:00,Diaryan Aleksandr - Nazaryan Mushegh,3:0,11:6 - 11:3 - 11:5 - 0:0 - 0:0,3,0,Diaryan Aleksandr,Nazaryan Mushegh,fiurst,Diaryan Aleksandr - Nazaryan Mushegh,47,33,14,-19,19,17,14,16,0,0,-5,-8,-6,0,0,-19,11:6 - 11:3 - 11:5 - 0:0 - 0:0
19479195,2024-06-26 13:45:00,Nikoghosyan Narek - Papyan Karen,3:2,11:8 - 11:2 - 4:11 - 9:11 - 11:9,3,2,Nikoghosyan Narek,Papyan Karen,fiurst,Nikoghosyan Narek - Papyan Karen,87,46,41,-5,5,19,13,15,20,20,-3,-9,7,2,-2,-5,11:8 - 11:2 - 4:11 - 9:11 - 11:9
19479192,2024-06-26 13:35:00,Asatryan Murad - Diaryan Aleksandr,3:0,11:5 - 11:5 - 11:6 - 0:0 - 0:0,3,0,Asatryan Murad,Diaryan Aleksandr,fiurst,Asatryan Murad - Diaryan Aleksandr,49,33,16,-17,17,16,16,17,0,0,-6,-6,-5,0,0,-17,11:5 - 11:5 - 11:6 - 0:0 - 0:0
19479188,2024-06-26 13:15:00,Nazaryan Mushegh - Papyan Karen,1:3,9:11 - 12:10 - 9:11 - 7:11 - 0:0,1,3,Nazaryan Mushegh,Papyan Karen,fiurst,Nazaryan Mushegh - Papyan Karen,80,37,43,6,-6,20,22,20,18,0,2,-2,2,4,0,6,9:11 - 12:10 - 9:11 - 7:11 - 0:0
19479184,2024-06-26 13:00:00,Asatryan Murad - Nikoghosyan Narek,3:1,11:9 - 10:12 - 11:6 - 11:4 - 0:0,3,1,Asatryan Murad,Nikoghosyan Narek,fiurst,Asatryan Murad - Nikoghosyan Narek,74,43,31,-12,12,20,22,17,15,0,-2,2,-5,-7,0,-12,11:9 - 10:12 - 11:6 - 11:4 - 0:0
19479180,2024-06-26 12:20:00,Diaryan Aleksandr - Papyan Karen,3:1,11:7 - 8:11 - 11:5 - 11:3 - 0:0,3,1,Diaryan Aleksandr,Papyan Karen,fiurst,Diaryan Aleksandr - Papyan Karen,67,41,26,-15,15,18,19,16,14,0,-4,3,-6,-8,0,-15,11:7 - 8:11 - 11:5 - 11:3 - 0:0
19479179,2024-06-26 12:00:00,Asatryan Murad - Nazaryan Mushegh,3:0,11:6 - 11:4 - 11:4 - 0:0 - 0:0,3,0,Asatryan Murad,Nazaryan Mushegh,fiurst,Asatryan Murad - Nazaryan Mushegh,47,33,14,-19,19,17,15,15,0,0,-5,-7,-7,0,0,-19,11:6 - 11:4 - 11:4 - 0:0 - 0:0
19479177,2024-06-26 11:45:00,Nikoghosyan Narek - Diaryan Aleksandr,2:3,12:10 - 3:11 - 8:11 - 11:9 - 11:4,3,2,Nikoghosyan Narek,Diaryan Aleksandr,fiurst,Diaryan Aleksandr - Nikoghosyan Narek,90,45,45,0,0,22,14,19,20,15,2,-8,-3,2,7,0,10:12 - 11:3 - 11:8 - 9:11 - 4:11
19479175,2024-06-26 11:30:00,Asatryan Murad - Papyan Karen,3:0,11:5 - 11:9 - 11:5 - 0:0 - 0:0,3,0,Asatryan Murad,Papyan Karen,fiurst,Asatryan Murad - Papyan Karen,52,33,19,-14,14,16,20,16,0,0,-6,-2,-6,0,0,-14,11:5 - 11:9 - 11:5 - 0:0 - 0:0
19479173,2024-06-26 11:15:00,Nazaryan Mushegh - Nikoghosyan Narek,0:3,7:11 - 8:11 - 8:11 - 0:0 - 0:0,0,3,Nazaryan Mushegh,Nikoghosyan Narek,fiurst,Nazaryan Mushegh - Nikoghosyan Narek,56,23,33,10,-10,18,19,19,0,0,4,3,3,0,0,10,7:11 - 8:11 - 8:11 - 0:0 - 0:0
19479161,2024-06-26 11:00:00,Diaryan Aleksandr - Asatryan Murad,3:0,6:11 - 5:11 - 7:11 - 0:0 - 0:0,0,3,Diaryan Aleksandr,Asatryan Murad,fiurst,Asatryan Murad - Diaryan Aleksandr,51,33,18,-15,15,17,16,18,0,0,-5,-6,-4,0,0,-15,11:6 - 11:5 - 11:7 - 0:0 - 0:0
19479156,2024-06-26 10:45:00,Papyan Karen - Nikoghosyan Narek,3:1,3:11 - 10:12 - 11:8 - 3:11 - 0:0,1,3,Papyan Karen,Nikoghosyan Narek,fiurst,Nikoghosyan Narek - Papyan Karen,69,42,27,-15,15,14,22,19,14,0,-8,-2,3,-8,0,-15,11:3 - 12:10 - 8:11 - 11:3 - 0:0
19479155,2024-06-26 10:35:00,Nazaryan Mushegh - Diaryan Aleksandr,0:3,11:9 - 11:6 - 11:4 - 0:0 - 0:0,3,0,Nazaryan Mushegh,Diaryan Aleksandr,fiurst,Diaryan Aleksandr - Nazaryan Mushegh,52,19,33,14,-14,20,17,15,0,0,2,5,7,0,0,14,9:11 - 6:11 - 4:11 - 0:0 - 0:0
19479153,2024-06-26 10:15:00,Nikoghosyan Narek - Asatryan Murad,3:0,6:11 - 8:11 - 11:13 - 0:0 - 0:0,0,3,Nikoghosyan Narek,Asatryan Murad,fiurst,Asatryan Murad - Nikoghosyan Narek,60,35,25,-10,10,17,19,24,0,0,-5,-3,-2,0,0,-10,11:6 - 11:8 - 13:11 - 0:0 - 0:0
19479152,2024-06-26 10:00:00,Papyan Karen - Nazaryan Mushegh,2:3,12:10 - 3:11 - 11:8 - 4:11 - 11:8,3,2,Papyan Karen,Nazaryan Mushegh,fiurst,Nazaryan Mushegh - Papyan Karen,89,48,41,-7,7,22,14,19,15,19,2,-8,3,-7,3,-7,10:12 - 11:3 - 8:11 - 11:4 - 8:11
19460894,2024-06-25 17:45:00,Petrosyan Davit - Arutyunov Ruben,3:0,9:11 - 7:11 - 2:11 - 0:0 - 0:0,0,3,Petrosyan Davit,Arutyunov Ruben,fiurst,Arutyunov Ruben - Petrosyan Davit,51,33,18,-15,15,20,18,13,0,0,-2,-4,-9,0,0,-15,11:9 - 11:7 - 11:2 - 0:0 - 0:0
19460893,2024-06-25 17:30:00,Avakimyan Davit - Gevorgyan Gegham,0:3,6:11 - 7:11 - 2:11 - 0:0 - 0:0,0,3,Avakimyan Davit,Gevorgyan Gegham,fiurst,Avakimyan Davit - Gevorgyan Gegham,48,15,33,18,-18,17,18,13,0,0,5,4,9,0,0,18,6:11 - 7:11 - 2:11 - 0:0 - 0:0
19460891,2024-06-25 17:15:00,Soghomonyan Hrayr - Petrosyan Davit,1:3,12:10 - 11:4 - 8:11 - 11:6 - 0:0,3,1,Soghomonyan Hrayr,Petrosyan Davit,fiurst,Petrosyan Davit - Soghomonyan Hrayr,73,31,42,11,-11,22,15,19,17,0,2,7,-3,5,0,11,10:12 - 4:11 - 11:8 - 6:11 - 0:0
19460888,2024-06-25 17:00:00,Avakimyan Davit - Arutyunov Ruben,3:0,8:11 - 8:11 - 5:11 - 0:0 - 0:0,0,3,Avakimyan Davit,Arutyunov Ruben,fiurst,Arutyunov Ruben - Avakimyan Davit,54,33,21,-12,12,19,19,16,0,0,-3,-3,-6,0,0,-12,11:8 - 11:8 - 11:5 - 0:0 - 0:0
19460887,2024-06-25 16:45:00,Gevorgyan Gegham - Soghomonyan Hrayr,0:3,6:11 - 4:11 - 4:11 - 0:0 - 0:0,0,3,Gevorgyan Gegham,Soghomonyan Hrayr,fiurst,Gevorgyan Gegham - Soghomonyan Hrayr,47,14,33,19,-19,17,15,15,0,0,5,7,7,0,0,19,6:11 - 4:11 - 4:11 - 0:0 - 0:0
19460885,2024-06-25 16:30:00,Petrosyan Davit - Avakimyan Davit,0:1,11:6 - 3:1 - 0:0 - 0:0 - 0:0,1,0,Petrosyan Davit,Avakimyan Davit,fiurst,Avakimyan Davit - Petrosyan Davit,21,7,14,7,-7,17,4,0,0,0,5,2,0,0,0,7,6:11 - 1:3 - 0:0 - 0:0 - 0:0
19460883,2024-06-25 16:15:00,Arutyunov Ruben - Soghomonyan Hrayr,2:3,2:11 - 11:6 - 14:16 - 11:6 - 4:11,2,3,Arutyunov Ruben,Soghomonyan Hrayr,fiurst,Arutyunov Ruben - Soghomonyan Hrayr,92,42,50,8,-8,13,17,30,17,15,9,-5,2,-5,7,8,2:11 - 11:6 - 14:16 - 11:6 - 4:11
19460872,2024-06-25 16:00:00,Gevorgyan Gegham - Petrosyan Davit,3:1,11:6 - 11:8 - 4:11 - 11:3 - 0:0,3,1,Gevorgyan Gegham,Petrosyan Davit,fiurst,Gevorgyan Gegham - Petrosyan Davit,65,37,28,-9,9,17,19,15,14,0,-5,-3,7,-8,0,-9,11:6 - 11:8 - 4:11 - 11:3 - 0:0
19460859,2024-06-25 15:45:00,Soghomonyan Hrayr - Avakimyan Davit,0:3,11:6 - 12:10 - 11:5 - 0:0 - 0:0,3,0,Soghomonyan Hrayr,Avakimyan Davit,fiurst,Avakimyan Davit - Soghomonyan Hrayr,55,21,34,13,-13,17,22,16,0,0,5,2,6,0,0,13,6:11 - 10:12 - 5:11 - 0:0 - 0:0
19460858,2024-06-25 15:30:00,Arutyunov Ruben - Gevorgyan Gegham,3:0,11:4 - 11:2 - 11:7 - 0:0 - 0:0,3,0,Arutyunov Ruben,Gevorgyan Gegham,fiurst,Arutyunov Ruben - Gevorgyan Gegham,46,33,13,-20,20,15,13,18,0,0,-7,-9,-4,0,0,-20,11:4 - 11:2 - 11:7 - 0:0 - 0:0
19460856,2024-06-25 15:15:00,Papyan Karen - Gevorgyan Hayk,2:3,11:8 - 8:11 - 8:11 - 11:6 - 12:10,3,2,Papyan Karen,Gevorgyan Hayk,fiurst,Gevorgyan Hayk - Papyan Karen,96,46,50,4,-4,19,19,19,17,22,3,-3,-3,5,2,4,8:11 - 11:8 - 11:8 - 6:11 - 10:12
19460854,2024-06-25 15:00:00,Asatryan Murad - Nikoghosyan Narek,3:1,11:9 - 2:11 - 11:9 - 11:9 - 0:0,3,1,Asatryan Murad,Nikoghosyan Narek,fiurst,Asatryan Murad - Nikoghosyan Narek,73,35,38,3,-3,20,13,20,20,0,-2,9,-2,-2,0,3,11:9 - 2:11 - 11:9 - 11:9 - 0:0
19460850,2024-06-25 14:50:00,Hovhannesyan Rafik - Papyan Karen,3:1,15:13 - 5:11 - 11:4 - 11:3 - 0:0,3,1,Hovhannesyan Rafik,Papyan Karen,fiurst,Hovhannesyan Rafik - Papyan Karen,73,42,31,-11,11,28,16,15,14,0,-2,6,-7,-8,0,-11,15:13 - 5:11 - 11:4 - 11:3 - 0:0
19460836,2024-06-25 14:30:00,Gevorgyan Hayk - Asatryan Murad,3:0,3:11 - 9:11 - 4:11 - 0:0 - 0:0,0,3,Gevorgyan Hayk,Asatryan Murad,fiurst,Asatryan Murad - Gevorgyan Hayk,49,33,16,-17,17,14,20,15,0,0,-8,-2,-7,0,0,-17,11:3 - 11:9 - 11:4 - 0:0 - 0:0
19460831,2024-06-25 14:15:00,Hovhannesyan Rafik - Nikoghosyan Narek,3:2,11:9 - 10:12 - 11:5 - 9:11 - 11:8,3,2,Hovhannesyan Rafik,Nikoghosyan Narek,fiurst,Hovhannesyan Rafik - Nikoghosyan Narek,97,52,45,-7,7,20,22,16,20,19,-2,2,-6,2,-3,-7,11:9 - 10:12 - 11:5 - 9:11 - 11:8
19460830,2024-06-25 14:10:00,Papyan Karen - Asatryan Murad,3:0,7:11 - 4:11 - 9:11 - 0:0 - 0:0,0,3,Papyan Karen,Asatryan Murad,fiurst,Asatryan Murad - Papyan Karen,53,33,20,-13,13,18,15,20,0,0,-4,-7,-2,0,0,-13,11:7 - 11:4 - 11:9 - 0:0 - 0:0
19460828,2024-06-25 13:45:00,Gevorgyan Hayk - Hovhannesyan Rafik,0:3,4:11 - 8:11 - 13:15 - 0:0 - 0:0,0,3,Gevorgyan Hayk,Hovhannesyan Rafik,fiurst,Gevorgyan Hayk - Hovhannesyan Rafik,62,25,37,12,-12,15,19,28,0,0,7,3,2,0,0,12,4:11 - 8:11 - 13:15 - 0:0 - 0:0
19460826,2024-06-25 13:30:00,Nikoghosyan Narek - Papyan Karen,3:2,10:12 - 11:13 - 11:9 - 11:6 - 11:6,3,2,Nikoghosyan Narek,Papyan Karen,fiurst,Nikoghosyan Narek - Papyan Karen,100,54,46,-8,8,22,24,20,17,17,2,2,-2,-5,-5,-8,10:12 - 11:13 - 11:9 - 11:6 - 11:6
19460824,2024-06-25 13:15:00,Asatryan Murad - Hovhannesyan Rafik,3:0,13:11 - 11:8 - 11:6 - 0:0 - 0:0,3,0,Asatryan Murad,Hovhannesyan Rafik,fiurst,Asatryan Murad - Hovhannesyan Rafik,60,35,25,-10,10,24,19,17,0,0,-2,-3,-5,0,0,-10,13:11 - 11:8 - 11:6 - 0:0 - 0:0
19460823,2024-06-25 13:00:00,Nikoghosyan Narek - Gevorgyan Hayk,0:3,11:8 - 11:6 - 11:9 - 0:0 - 0:0,3,0,Nikoghosyan Narek,Gevorgyan Hayk,fiurst,Gevorgyan Hayk - Nikoghosyan Narek,56,23,33,10,-10,19,17,20,0,0,3,5,2,0,0,10,8:11 - 6:11 - 9:11 - 0:0 - 0:0
19460777,2024-06-25 12:15:00,Papyan Karen - Hovhannesyan Rafik,2:3,8:11 - 2:11 - 11:8 - 12:10 - 11:8,3,2,Papyan Karen,Hovhannesyan Rafik,fiurst,Hovhannesyan Rafik - Papyan Karen,92,48,44,-4,4,19,13,19,22,19,-3,-9,3,2,3,-4,11:8 - 11:2 - 8:11 - 10:12 - 8:11
19460774,2024-06-25 12:10:00,Nikoghosyan Narek - Asatryan Murad,3:0,6:11 - 7:11 - 2:11 - 0:0 - 0:0,0,3,Nikoghosyan Narek,Asatryan Murad,fiurst,Asatryan Murad - Nikoghosyan Narek,48,33,15,-18,18,17,18,13,0,0,-5,-4,-9,0,0,-18,11:6 - 11:7 - 11:2 - 0:0 - 0:0
19460770,2024-06-25 11:45:00,Nikoghosyan Narek - Hovhannesyan Rafik,0:3,12:10 - 11:9 - 11:7 - 0:0 - 0:0,3,0,Nikoghosyan Narek,Hovhannesyan Rafik,fiurst,Hovhannesyan Rafik - Nikoghosyan Narek,60,26,34,8,-8,22,20,18,0,0,2,2,4,0,0,8,10:12 - 9:11 - 7:11 - 0:0 - 0:0
19460772,2024-06-25 11:45:00,Gevorgyan Hayk - Papyan Karen,3:1,11:3 - 14:12 - 4:11 - 11:7 - 0:0,3,1,Gevorgyan Hayk,Papyan Karen,fiurst,Gevorgyan Hayk - Papyan Karen,73,40,33,-7,7,14,26,15,18,0,-8,-2,7,-4,0,-7,11:3 - 14:12 - 4:11 - 11:7 - 0:0
19460769,2024-06-25 11:15:00,Asatryan Murad - Gevorgyan Hayk,3:0,11:6 - 11:9 - 11:8 - 0:0 - 0:0,3,0,Asatryan Murad,Gevorgyan Hayk,fiurst,Asatryan Murad - Gevorgyan Hayk,56,33,23,-10,10,17,20,19,0,0,-5,-2,-3,0,0,-10,11:6 - 11:9 - 11:8 - 0:0 - 0:0
19460767,2024-06-25 11:00:00,Papyan Karen - Nikoghosyan Narek,2:3,11:2 - 7:11 - 9:11 - 14:12 - 14:12,3,2,Papyan Karen,Nikoghosyan Narek,fiurst,Nikoghosyan Narek - Papyan Karen,103,48,55,7,-7,13,18,20,26,26,9,-4,-2,2,2,7,2:11 - 11:7 - 11:9 - 12:14 - 12:14
19460766,2024-06-25 10:50:00,Hovhannesyan Rafik - Gevorgyan Hayk,0:3,11:8 - 12:10 - 11:2 - 0:0 - 0:0,3,0,Hovhannesyan Rafik,Gevorgyan Hayk,fiurst,Gevorgyan Hayk - Hovhannesyan Rafik,54,20,34,14,-14,19,22,13,0,0,3,2,9,0,0,14,8:11 - 10:12 - 2:11 - 0:0 - 0:0
19460762,2024-06-25 10:30:00,Asatryan Murad - Papyan Karen,3:1,11:5 - 5:11 - 11:6 - 11:8 - 0:0,3,1,Asatryan Murad,Papyan Karen,fiurst,Asatryan Murad - Papyan Karen,68,38,30,-8,8,16,16,17,19,0,-6,6,-5,-3,0,-8,11:5 - 5:11 - 11:6 - 11:8 - 0:0
19460758,2024-06-25 10:15:00,Gevorgyan Hayk - Nikoghosyan Narek,3:2,2:11 - 7:11 - 11:3 - 13:11 - 12:10,3,2,Gevorgyan Hayk,Nikoghosyan Narek,fiurst,Gevorgyan Hayk - Nikoghosyan Narek,91,45,46,1,-1,13,18,14,24,22,9,4,-8,-2,-2,1,2:11 - 7:11 - 11:3 - 13:11 - 12:10
19460755,2024-06-25 10:00:00,Hovhannesyan Rafik - Asatryan Murad,3:0,7:11 - 9:11 - 8:11 - 0:0 - 0:0,0,3,Hovhannesyan Rafik,Asatryan Murad,fiurst,Asatryan Murad - Hovhannesyan Rafik,57,33,24,-9,9,18,20,19,0,0,-4,-2,-3,0,0,-9,11:7 - 11:9 - 11:8 - 0:0 - 0:0
19442781,2024-06-24 17:45:00,Hakobyan Eduard - Avakimyan Davit,1:3,7:11 - 11:5 - 11:4 - 11:7 - 0:0,3,1,Hakobyan Eduard,Avakimyan Davit,fiurst,Avakimyan Davit - Hakobyan Eduard,67,27,40,13,-13,18,16,15,18,0,-4,6,7,4,0,13,11:7 - 5:11 - 4:11 - 7:11 - 0:0
19442779,2024-06-24 17:30:00,Arutyunov Ruben - Gevorgyan Gegham,3:0,11:8 - 11:3 - 12:10 - 0:0 - 0:0,3,0,Arutyunov Ruben,Gevorgyan Gegham,fiurst,Arutyunov Ruben - Gevorgyan Gegham,55,34,21,-13,13,19,14,22,0,0,-3,-8,-2,0,0,-13,11:8 - 11:3 - 12:10 - 0:0 - 0:0
19442778,2024-06-24 17:20:00,Mkrtchyan Andranik - Hakobyan Eduard,3:1,4:11 - 3:11 - 11:7 - 8:11 - 0:0,1,3,Mkrtchyan Andranik,Hakobyan Eduard,fiurst,Hakobyan Eduard - Mkrtchyan Andranik,66,40,26,-14,14,15,14,18,19,0,-7,-8,4,-3,0,-14,11:4 - 11:3 - 7:11 - 11:8 - 0:0
19442777,2024-06-24 17:10:00,Arutyunov Ruben - Avakimyan Davit,3:0,11:1 - 11:7 - 11:8 - 0:0 - 0:0,3,0,Arutyunov Ruben,Avakimyan Davit,fiurst,Arutyunov Ruben - Avakimyan Davit,49,33,16,-17,17,12,18,19,0,0,-10,-4,-3,0,0,-17,11:1 - 11:7 - 11:8 - 0:0 - 0:0
19442775,2024-06-24 16:45:00,Gevorgyan Gegham - Mkrtchyan Andranik,2:3,11:9 - 5:11 - 11:9 - 6:11 - 7:11,2,3,Gevorgyan Gegham,Mkrtchyan Andranik,fiurst,Gevorgyan Gegham - Mkrtchyan Andranik,91,40,51,11,-11,20,16,20,17,18,-2,6,-2,5,4,11,11:9 - 5:11 - 11:9 - 6:11 - 7:11
19442763,2024-06-24 16:30:00,Hakobyan Eduard - Arutyunov Ruben,1:3,8:11 - 13:11 - 11:7 - 11:9 - 0:0,3,1,Hakobyan Eduard,Arutyunov Ruben,fiurst,Arutyunov Ruben - Hakobyan Eduard,81,38,43,5,-5,19,24,18,20,0,-3,2,4,2,0,5,11:8 - 11:13 - 7:11 - 9:11 - 0:0
19442759,2024-06-24 16:15:00,Avakimyan Davit - Mkrtchyan Andranik,0:3,10:12 - 10:12 - 8:11 - 0:0 - 0:0,0,3,Avakimyan Davit,Mkrtchyan Andranik,fiurst,Avakimyan Davit - Mkrtchyan Andranik,63,28,35,7,-7,22,22,19,0,0,2,2,3,0,0,7,10:12 - 10:12 - 8:11 - 0:0 - 0:0
19442755,2024-06-24 16:00:00,Gevorgyan Gegham - Hakobyan Eduard,2:3,11:6 - 11:5 - 7:11 - 8:11 - 9:11,2,3,Gevorgyan Gegham,Hakobyan Eduard,fiurst,Gevorgyan Gegham - Hakobyan Eduard,90,46,44,-2,2,17,16,18,19,20,-5,-6,4,3,2,-2,11:6 - 11:5 - 7:11 - 8:11 - 9:11
19442753,2024-06-24 15:45:00,Mkrtchyan Andranik - Arutyunov Ruben,1:3,11:5 - 11:9 - 3:11 - 11:6 - 0:0,3,1,Mkrtchyan Andranik,Arutyunov Ruben,fiurst,Arutyunov Ruben - Mkrtchyan Andranik,67,31,36,5,-5,16,20,14,17,0,6,2,-8,5,0,5,5:11 - 9:11 - 11:3 - 6:11 - 0:0
19442751,2024-06-24 15:30:00,Avakimyan Davit - Gevorgyan Gegham,2:3,11:9 - 10:12 - 11:9 - 11:13 - 10:12,2,3,Avakimyan Davit,Gevorgyan Gegham,fiurst,Avakimyan Davit - Gevorgyan Gegham,108,53,55,2,-2,20,22,20,24,22,-2,2,-2,2,2,2,11:9 - 10:12 - 11:9 - 11:13 - 10:12
19442747,2024-06-24 15:00:00,Diaryan Aleksandr - Nazaryan Mushegh,3:0,11:5 - 11:7 - 11:6 - 0:0 - 0:0,3,0,Diaryan Aleksandr,Nazaryan Mushegh,fiurst,Diaryan Aleksandr - Nazaryan Mushegh,51,33,18,-15,15,16,18,17,0,0,-6,-4,-5,0,0,-15,11:5 - 11:7 - 11:6 - 0:0 - 0:0
19442746,2024-06-24 14:55:00,Gevorgyan Hayk - Asatryan Murad,3:0,5:11 - 5:11 - 10:12 - 0:0 - 0:0,0,3,Gevorgyan Hayk,Asatryan Murad,fiurst,Asatryan Murad - Gevorgyan Hayk,54,34,20,-14,14,16,16,22,0,0,-6,-6,-2,0,0,-14,11:5 - 11:5 - 12:10 - 0:0 - 0:0
19442730,2024-06-24 14:15:00,Gevorgyan Hayk - Nazaryan Mushegh,2:3,11:7 - 6:11 - 5:11 - 11:4 - 8:11,2,3,Gevorgyan Hayk,Nazaryan Mushegh,fiurst,Gevorgyan Hayk - Nazaryan Mushegh,85,41,44,3,-3,18,17,16,15,19,-4,5,6,-7,3,3,11:7 - 6:11 - 5:11 - 11:4 - 8:11
19442729,2024-06-24 14:00:00,Asatryan Murad - Diaryan Aleksandr,3:0,11:6 - 11:9 - 11:5 - 0:0 - 0:0,3,0,Asatryan Murad,Diaryan Aleksandr,fiurst,Asatryan Murad - Diaryan Aleksandr,53,33,20,-13,13,17,20,16,0,0,-5,-2,-6,0,0,-13,11:6 - 11:9 - 11:5 - 0:0 - 0:0
19442726,2024-06-24 13:30:00,Nazaryan Mushegh - Asatryan Murad,3:0,6:11 - 4:11 - 4:11 - 0:0 - 0:0,0,3,Nazaryan Mushegh,Asatryan Murad,fiurst,Asatryan Murad - Nazaryan Mushegh,47,33,14,-19,19,17,15,15,0,0,-5,-7,-7,0,0,-19,11:6 - 11:4 - 11:4 - 0:0 - 0:0
19442722,2024-06-24 13:15:00,Diaryan Aleksandr - Gevorgyan Hayk,3:0,11:6 - 11:6 - 11:7 - 0:0 - 0:0,3,0,Diaryan Aleksandr,Gevorgyan Hayk,fiurst,Diaryan Aleksandr - Gevorgyan Hayk,52,33,19,-14,14,17,17,18,0,0,-5,-5,-4,0,0,-14,11:6 - 11:6 - 11:7 - 0:0 - 0:0
19442707,2024-06-24 12:15:00,Asatryan Murad - Gevorgyan Hayk,3:2,11:2 - 7:11 - 12:14 - 11:6 - 11:5,3,2,Asatryan Murad,Gevorgyan Hayk,fiurst,Asatryan Murad - Gevorgyan Hayk,90,52,38,-14,14,13,18,26,17,16,-9,4,2,-5,-6,-14,11:2 - 7:11 - 12:14 - 11:6 - 11:5
19442705,2024-06-24 12:00:00,Nazaryan Mushegh - Diaryan Aleksandr,3:0,4:11 - 5:11 - 2:11 - 0:0 - 0:0,0,3,Nazaryan Mushegh,Diaryan Aleksandr,fiurst,Diaryan Aleksandr - Nazaryan Mushegh,44,33,11,-22,22,15,16,13,0,0,-7,-6,-9,0,0,-22,11:4 - 11:5 - 11:2 - 0:0 - 0:0
19442704,2024-06-24 11:45:00,Hovhannesyan Rafik - Asatryan Murad,1:0,10:12 - 3:6 - 0:0 - 0:0 - 0:0,0,1,Hovhannesyan Rafik,Asatryan Murad,fiurst,Asatryan Murad - Hovhannesyan Rafik,31,18,13,-5,5,22,9,0,0,0,-2,-3,0,0,0,-5,12:10 - 6:3 - 0:0 - 0:0 - 0:0
19442702,2024-06-24 11:30:00,Nazaryan Mushegh - Gevorgyan Hayk,0:3,11:9 - 11:5 - 11:7 - 0:0 - 0:0,3,0,Nazaryan Mushegh,Gevorgyan Hayk,fiurst,Gevorgyan Hayk - Nazaryan Mushegh,54,21,33,12,-12,20,16,18,0,0,2,6,4,0,0,12,9:11 - 5:11 - 7:11 - 0:0 - 0:0
19442700,2024-06-24 11:20:00,Diaryan Aleksandr - Hovhannesyan Rafik,3:1,11:2 - 11:6 - 9:11 - 11:8 - 0:0,3,1,Diaryan Aleksandr,Hovhannesyan Rafik,fiurst,Diaryan Aleksandr - Hovhannesyan Rafik,69,42,27,-15,15,13,17,20,19,0,-9,-5,2,-3,0,-15,11:2 - 11:6 - 9:11 - 11:8 - 0:0
19442699,2024-06-24 11:05:00,Asatryan Murad - Nazaryan Mushegh,3:0,11:6 - 11:7 - 11:4 - 0:0 - 0:0,3,0,Asatryan Murad,Nazaryan Mushegh,fiurst,Asatryan Murad - Nazaryan Mushegh,50,33,17,-16,16,17,18,15,0,0,-5,-4,-7,0,0,-16,11:6 - 11:7 - 11:4 - 0:0 - 0:0
19442695,2024-06-24 10:45:00,Gevorgyan Hayk - Hovhannesyan Rafik,0:3,9:11 - 11:13 - 5:11 - 0:0 - 0:0,0,3,Gevorgyan Hayk,Hovhannesyan Rafik,fiurst,Gevorgyan Hayk - Hovhannesyan Rafik,60,25,35,10,-10,20,24,16,0,0,2,2,6,0,0,10,9:11 - 11:13 - 5:11 - 0:0 - 0:0
19442690,2024-06-24 10:30:00,Diaryan Aleksandr - Asatryan Murad,3:2,12:14 - 7:11 - 11:5 - 11:9 - 7:11,2,3,Diaryan Aleksandr,Asatryan Murad,fiurst,Asatryan Murad - Diaryan Aleksandr,98,50,48,-2,2,26,18,16,20,18,-2,-4,6,2,-4,-2,14:12 - 11:7 - 5:11 - 9:11 - 11:7
19442677,2024-06-24 10:15:00,Hovhannesyan Rafik - Nazaryan Mushegh,3:1,11:7 - 8:11 - 12:10 - 11:7 - 0:0,3,1,Hovhannesyan Rafik,Nazaryan Mushegh,fiurst,Hovhannesyan Rafik - Nazaryan Mushegh,77,42,35,-7,7,18,19,22,18,0,-4,3,-2,-4,0,-7,11:7 - 8:11 - 12:10 - 11:7 - 0:0
19442676,2024-06-24 10:00:00,Gevorgyan Hayk - Diaryan Aleksandr,3:0,4:11 - 6:11 - 1:11 - 0:0 - 0:0,0,3,Gevorgyan Hayk,Diaryan Aleksandr,fiurst,Diaryan Aleksandr - Gevorgyan Hayk,44,33,11,-22,22,15,17,12,0,0,-7,-5,-10,0,0,-22,11:4 - 11:6 - 11:1 - 0:0 - 0:0
19424728,2024-06-23 17:45:00,Hakobyan Eduard - Mkrtchyan Andranik,0:3,9:11 - 6:11 - 8:11 - 0:0 - 0:0,0,3,Hakobyan Eduard,Mkrtchyan Andranik,fiurst,Hakobyan Eduard - Mkrtchyan Andranik,56,23,33,10,-10,20,17,19,0,0,2,5,3,0,0,10,9:11 - 6:11 - 8:11 - 0:0 - 0:0
19424726,2024-06-23 17:30:00,Petrosyan Davit - Avakimyan Davit,3:2,11:8 - 7:11 - 10:12 - 11:7 - 4:11,2,3,Petrosyan Davit,Avakimyan Davit,fiurst,Avakimyan Davit - Petrosyan Davit,92,49,43,-6,6,19,18,22,18,15,3,-4,-2,4,-7,-6,8:11 - 11:7 - 12:10 - 7:11 - 11:4
19424721,2024-06-23 17:15:00,Gevorgyan Gegham - Hakobyan Eduard,1:3,11:9 - 6:11 - 9:11 - 6:11 - 0:0,1,3,Gevorgyan Gegham,Hakobyan Eduard,fiurst,Gevorgyan Gegham - Hakobyan Eduard,74,32,42,10,-10,20,17,20,17,0,-2,5,2,5,0,10,11:9 - 6:11 - 9:11 - 6:11 - 0:0
19424709,2024-06-23 17:00:00,Petrosyan Davit - Mkrtchyan Andranik,1:3,11:5 - 11:9 - 10:12 - 12:10 - 0:0,3,1,Petrosyan Davit,Mkrtchyan Andranik,fiurst,Mkrtchyan Andranik - Petrosyan Davit,80,36,44,8,-8,16,20,22,22,0,6,2,-2,2,0,8,5:11 - 9:11 - 12:10 - 10:12 - 0:0
19424707,2024-06-23 16:45:00,Avakimyan Davit - Gevorgyan Gegham,3:1,11:8 - 13:11 - 6:11 - 11:9 - 0:0,3,1,Avakimyan Davit,Gevorgyan Gegham,fiurst,Avakimyan Davit - Gevorgyan Gegham,80,41,39,-2,2,19,24,17,20,0,-3,-2,5,-2,0,-2,11:8 - 13:11 - 6:11 - 11:9 - 0:0
19424703,2024-06-23 16:30:00,Hakobyan Eduard - Petrosyan Davit,1:3,6:11 - 9:11 - 11:7 - 3:11 - 0:0,1,3,Hakobyan Eduard,Petrosyan Davit,fiurst,Hakobyan Eduard - Petrosyan Davit,69,29,40,11,-11,17,20,18,14,0,5,2,-4,8,0,11,6:11 - 9:11 - 11:7 - 3:11 - 0:0
19424700,2024-06-23 16:15:00,Mkrtchyan Andranik - Gevorgyan Gegham,0:3,11:5 - 11:8 - 12:10 - 0:0 - 0:0,3,0,Mkrtchyan Andranik,Gevorgyan Gegham,fiurst,Gevorgyan Gegham - Mkrtchyan Andranik,57,23,34,11,-11,16,19,22,0,0,6,3,2,0,0,11,5:11 - 8:11 - 10:12 - 0:0 - 0:0
19424691,2024-06-23 16:00:00,Avakimyan Davit - Hakobyan Eduard,1:3,6:11 - 12:10 - 9:11 - 8:11 - 0:0,1,3,Avakimyan Davit,Hakobyan Eduard,fiurst,Avakimyan Davit - Hakobyan Eduard,78,35,43,8,-8,17,22,20,19,0,5,-2,2,3,0,8,6:11 - 12:10 - 9:11 - 8:11 - 0:0
19424690,2024-06-23 15:45:00,Gevorgyan Gegham - Petrosyan Davit,0:3,13:15 - 6:11 - 6:11 - 0:0 - 0:0,0,3,Gevorgyan Gegham,Petrosyan Davit,fiurst,Gevorgyan Gegham - Petrosyan Davit,62,25,37,12,-12,28,17,17,0,0,2,5,5,0,0,12,13:15 - 6:11 - 6:11 - 0:0 - 0:0
19424686,2024-06-23 15:35:00,Mkrtchyan Andranik - Avakimyan Davit,1:3,9:11 - 11:8 - 11:8 - 11:6 - 0:0,3,1,Mkrtchyan Andranik,Avakimyan Davit,fiurst,Avakimyan Davit - Mkrtchyan Andranik,75,33,42,9,-9,20,19,19,17,0,-2,3,3,5,0,9,11:9 - 8:11 - 8:11 - 6:11 - 0:0
19424670,2024-06-23 15:15:00,Diaryan Aleksandr - Papyan Karen,3:1,11:6 - 11:3 - 7:11 - 11:8 - 0:0,3,1,Diaryan Aleksandr,Papyan Karen,fiurst,Diaryan Aleksandr - Papyan Karen,68,40,28,-12,12,17,14,18,19,0,-5,-8,4,-3,0,-12,11:6 - 11:3 - 7:11 - 11:8 - 0:0
19424668,2024-06-23 15:10:00,Gevorgyan Hayk - Nikoghosyan Narek,1:3,4:11 - 11:7 - 6:11 - 4:11 - 0:0,1,3,Gevorgyan Hayk,Nikoghosyan Narek,fiurst,Gevorgyan Hayk - Nikoghosyan Narek,65,25,40,15,-15,15,18,17,15,0,7,-4,5,7,0,15,4:11 - 11:7 - 6:11 - 4:11 - 0:0
19424667,2024-06-23 14:50:00,Nazaryan Mushegh - Diaryan Aleksandr,3:0,7:11 - 6:11 - 6:11 - 0:0 - 0:0,0,3,Nazaryan Mushegh,Diaryan Aleksandr,fiurst,Diaryan Aleksandr - Nazaryan Mushegh,52,33,19,-14,14,18,17,17,0,0,-4,-5,-5,0,0,-14,11:7 - 11:6 - 11:6 - 0:0 - 0:0
19424665,2024-06-23 14:40:00,Papyan Karen - Gevorgyan Hayk,3:1,12:10 - 3:11 - 8:11 - 11:13 - 0:0,1,3,Papyan Karen,Gevorgyan Hayk,fiurst,Gevorgyan Hayk - Papyan Karen,79,45,34,-11,11,22,14,19,24,0,2,-8,-3,-2,0,-11,10:12 - 11:3 - 11:8 - 13:11 - 0:0
19424664,2024-06-23 14:20:00,Nazaryan Mushegh - Nikoghosyan Narek,0:3,4:11 - 9:11 - 6:11 - 0:0 - 0:0,0,3,Nazaryan Mushegh,Nikoghosyan Narek,fiurst,Nazaryan Mushegh - Nikoghosyan Narek,52,19,33,14,-14,15,20,17,0,0,7,2,5,0,0,14,4:11 - 9:11 - 6:11 - 0:0 - 0:0
19424663,2024-06-23 14:10:00,Diaryan Aleksandr - Gevorgyan Hayk,1:3,6:11 - 9:11 - 11:7 - 12:14 - 0:0,1,3,Diaryan Aleksandr,Gevorgyan Hayk,fiurst,Diaryan Aleksandr - Gevorgyan Hayk,81,38,43,5,-5,17,20,18,26,0,5,2,-4,2,0,5,6:11 - 9:11 - 11:7 - 12:14 - 0:0
19424662,2024-06-23 13:45:00,Papyan Karen - Nazaryan Mushegh,3:0,6:11 - 10:12 - 6:11 - 0:0 - 0:0,0,3,Papyan Karen,Nazaryan Mushegh,fiurst,Nazaryan Mushegh - Papyan Karen,56,34,22,-12,12,17,22,17,0,0,-5,-2,-5,0,0,-12,11:6 - 12:10 - 11:6 - 0:0 - 0:0
19424647,2024-06-23 13:30:00,Nikoghosyan Narek - Diaryan Aleksandr,2:3,16:14 - 5:11 - 8:11 - 11:3 - 12:10,3,2,Nikoghosyan Narek,Diaryan Aleksandr,fiurst,Diaryan Aleksandr - Nikoghosyan Narek,101,49,52,3,-3,30,16,19,14,22,2,-6,-3,8,2,3,14:16 - 11:5 - 11:8 - 3:11 - 10:12
19424645,2024-06-23 13:15:00,Gevorgyan Hayk - Nazaryan Mushegh,0:3,8:11 - 9:11 - 9:11 - 0:0 - 0:0,0,3,Gevorgyan Hayk,Nazaryan Mushegh,fiurst,Gevorgyan Hayk - Nazaryan Mushegh,59,26,33,7,-7,19,20,20,0,0,3,2,2,0,0,7,8:11 - 9:11 - 9:11 - 0:0 - 0:0
19424641,2024-06-23 13:00:00,Nikoghosyan Narek - Papyan Karen,3:0,11:6 - 12:10 - 11:6 - 0:0 - 0:0,3,0,Nikoghosyan Narek,Papyan Karen,fiurst,Nikoghosyan Narek - Papyan Karen,56,34,22,-12,12,17,22,17,0,0,-5,-2,-5,0,0,-12,11:6 - 12:10 - 11:6 - 0:0 - 0:0
19424638,2024-06-23 12:15:00,Diaryan Aleksandr - Nazaryan Mushegh,3:0,11:5 - 11:6 - 11:3 - 0:0 - 0:0,3,0,Diaryan Aleksandr,Nazaryan Mushegh,fiurst,Diaryan Aleksandr - Nazaryan Mushegh,47,33,14,-19,19,16,17,14,0,0,-6,-5,-8,0,0,-19,11:5 - 11:6 - 11:3 - 0:0 - 0:0
19424637,2024-06-23 12:10:00,Nikoghosyan Narek - Gevorgyan Hayk,0:3,11:6 - 12:10 - 11:7 - 0:0 - 0:0,3,0,Nikoghosyan Narek,Gevorgyan Hayk,fiurst,Gevorgyan Hayk - Nikoghosyan Narek,57,23,34,11,-11,17,22,18,0,0,5,2,4,0,0,11,6:11 - 10:12 - 7:11 - 0:0 - 0:0
19424605,2024-06-23 11:55:00,Papyan Karen - Diaryan Aleksandr,3:0,6:11 - 7:11 - 3:11 - 0:0 - 0:0,0,3,Papyan Karen,Diaryan Aleksandr,fiurst,Diaryan Aleksandr - Papyan Karen,49,33,16,-17,17,17,18,14,0,0,-5,-4,-8,0,0,-17,11:6 - 11:7 - 11:3 - 0:0 - 0:0
19424604,2024-06-23 11:35:00,Nikoghosyan Narek - Nazaryan Mushegh,1:3,11:2 - 11:4 - 9:11 - 11:6 - 0:0,3,1,Nikoghosyan Narek,Nazaryan Mushegh,fiurst,Nazaryan Mushegh - Nikoghosyan Narek,65,23,42,19,-19,13,15,20,17,0,9,7,-2,5,0,19,2:11 - 4:11 - 11:9 - 6:11 - 0:0
19424599,2024-06-23 11:20:00,Gevorgyan Hayk - Papyan Karen,3:2,12:14 - 11:5 - 12:10 - 6:11 - 11:7,3,2,Gevorgyan Hayk,Papyan Karen,fiurst,Gevorgyan Hayk - Papyan Karen,99,52,47,-5,5,26,16,22,17,18,2,-6,-2,5,-4,-5,12:14 - 11:5 - 12:10 - 6:11 - 11:7
19424597,2024-06-23 11:00:00,Diaryan Aleksandr - Nikoghosyan Narek,0:3,9:11 - 13:15 - 9:11 - 0:0 - 0:0,0,3,Diaryan Aleksandr,Nikoghosyan Narek,fiurst,Diaryan Aleksandr - Nikoghosyan Narek,68,31,37,6,-6,20,28,20,0,0,2,2,2,0,0,6,9:11 - 13:15 - 9:11 - 0:0 - 0:0
19424596,2024-06-23 10:45:00,Nazaryan Mushegh - Papyan Karen,3:1,11:8 - 8:11 - 11:7 - 11:8 - 0:0,3,1,Nazaryan Mushegh,Papyan Karen,fiurst,Nazaryan Mushegh - Papyan Karen,75,41,34,-7,7,19,19,18,19,0,-3,3,-4,-3,0,-7,11:8 - 8:11 - 11:7 - 11:8 - 0:0
19424595,2024-06-23 10:30:00,Gevorgyan Hayk - Diaryan Aleksandr,3:0,4:11 - 9:11 - 5:11 - 0:0 - 0:0,0,3,Gevorgyan Hayk,Diaryan Aleksandr,fiurst,Diaryan Aleksandr - Gevorgyan Hayk,51,33,18,-15,15,15,20,16,0,0,-7,-2,-6,0,0,-15,11:4 - 11:9 - 11:5 - 0:0 - 0:0
19424594,2024-06-23 10:15:00,Papyan Karen - Nikoghosyan Narek,1:3,11:5 - 11:8 - 9:11 - 11:6 - 0:0,3,1,Papyan Karen,Nikoghosyan Narek,fiurst,Nikoghosyan Narek - Papyan Karen,72,30,42,12,-12,16,19,20,17,0,6,3,-2,5,0,12,5:11 - 8:11 - 11:9 - 6:11 - 0:0
19424582,2024-06-23 10:00:00,Nazaryan Mushegh - Gevorgyan Hayk,0:3,11:8 - 11:7 - 11:8 - 0:0 - 0:0,3,0,Nazaryan Mushegh,Gevorgyan Hayk,fiurst,Gevorgyan Hayk - Nazaryan Mushegh,56,23,33,10,-10,19,18,19,0,0,3,4,3,0,0,10,8:11 - 7:11 - 8:11 - 0:0 - 0:0
19406521,2024-06-22 17:45:00,Hakobyan Eduard - Petrosyan Davit,3:2,11:4 - 9:11 - 10:12 - 12:10 - 11:9,3,2,Hakobyan Eduard,Petrosyan Davit,fiurst,Hakobyan Eduard - Petrosyan Davit,99,53,46,-7,7,15,20,22,22,20,-7,2,2,-2,-2,-7,11:4 - 9:11 - 10:12 - 12:10 - 11:9
19406507,2024-06-22 17:30:00,Soghomonyan Hrayr - Arutyunov Ruben,2:3,11:9 - 11:9 - 9:11 - 7:11 - 11:4,3,2,Soghomonyan Hrayr,Arutyunov Ruben,fiurst,Arutyunov Ruben - Soghomonyan Hrayr,93,44,49,5,-5,20,20,20,18,15,2,2,-2,-4,7,5,9:11 - 9:11 - 11:9 - 11:7 - 4:11
19406503,2024-06-22 17:15:00,Avakimyan Davit - Hakobyan Eduard,0:3,5:11 - 6:11 - 6:11 - 0:0 - 0:0,0,3,Avakimyan Davit,Hakobyan Eduard,fiurst,Avakimyan Davit - Hakobyan Eduard,50,17,33,16,-16,16,17,17,0,0,6,5,5,0,0,16,5:11 - 6:11 - 6:11 - 0:0 - 0:0
19406501,2024-06-22 17:00:00,Soghomonyan Hrayr - Petrosyan Davit,1:3,9:11 - 11:3 - 11:8 - 11:9 - 0:0,3,1,Soghomonyan Hrayr,Petrosyan Davit,fiurst,Petrosyan Davit - Soghomonyan Hrayr,73,31,42,11,-11,20,14,19,20,0,-2,8,3,2,0,11,11:9 - 3:11 - 8:11 - 9:11 - 0:0
19406499,2024-06-22 16:45:00,Arutyunov Ruben - Avakimyan Davit,3:0,11:5 - 11:5 - 11:6 - 0:0 - 0:0,3,0,Arutyunov Ruben,Avakimyan Davit,fiurst,Arutyunov Ruben - Avakimyan Davit,49,33,16,-17,17,16,16,17,0,0,-6,-6,-5,0,0,-17,11:5 - 11:5 - 11:6 - 0:0 - 0:0
19406498,2024-06-22 16:30:00,Hakobyan Eduard - Soghomonyan Hrayr,0:3,11:13 - 4:11 - 7:11 - 0:0 - 0:0,0,3,Hakobyan Eduard,Soghomonyan Hrayr,fiurst,Hakobyan Eduard - Soghomonyan Hrayr,57,22,35,13,-13,24,15,18,0,0,2,7,4,0,0,13,11:13 - 4:11 - 7:11 - 0:0 - 0:0
19406496,2024-06-22 16:15:00,Petrosyan Davit - Avakimyan Davit,3:0,9:11 - 5:11 - 7:11 - 0:0 - 0:0,0,3,Petrosyan Davit,Avakimyan Davit,fiurst,Avakimyan Davit - Petrosyan Davit,54,33,21,-12,12,20,16,18,0,0,-2,-6,-4,0,0,-12,11:9 - 11:5 - 11:7 - 0:0 - 0:0
19406495,2024-06-22 16:00:00,Arutyunov Ruben - Hakobyan Eduard,3:2,12:10 - 4:11 - 11:7 - 10:12 - 14:12,3,2,Arutyunov Ruben,Hakobyan Eduard,fiurst,Arutyunov Ruben - Hakobyan Eduard,103,51,52,1,-1,22,15,18,22,26,-2,7,-4,2,-2,1,12:10 - 4:11 - 11:7 - 10:12 - 14:12
19406492,2024-06-22 15:45:00,Avakimyan Davit - Soghomonyan Hrayr,0:3,9:11 - 10:12 - 5:11 - 0:0 - 0:0,0,3,Avakimyan Davit,Soghomonyan Hrayr,fiurst,Avakimyan Davit - Soghomonyan Hrayr,58,24,34,10,-10,20,22,16,0,0,2,2,6,0,0,10,9:11 - 10:12 - 5:11 - 0:0 - 0:0
19406477,2024-06-22 15:30:00,Petrosyan Davit - Arutyunov Ruben,3:0,6:11 - 7:11 - 3:11 - 0:0 - 0:0,0,3,Petrosyan Davit,Arutyunov Ruben,fiurst,Arutyunov Ruben - Petrosyan Davit,49,33,16,-17,17,17,18,14,0,0,-5,-4,-8,0,0,-17,11:6 - 11:7 - 11:3 - 0:0 - 0:0
19406474,2024-06-22 15:25:00,Nikoghosyan Narek - Nazaryan Mushegh,3:0,6:11 - 4:11 - 5:11 - 0:0 - 0:0,0,3,Nikoghosyan Narek,Nazaryan Mushegh,fiurst,Nazaryan Mushegh - Nikoghosyan Narek,48,33,15,-18,18,17,15,16,0,0,-5,-7,-6,0,0,-18,11:6 - 11:4 - 11:5 - 0:0 - 0:0
19406473,2024-06-22 15:05:00,Asatryan Murad - Papyan Karen,3:1,9:11 - 11:6 - 11:4 - 13:11 - 0:0,3,1,Asatryan Murad,Papyan Karen,fiurst,Asatryan Murad - Papyan Karen,76,44,32,-12,12,20,17,15,24,0,2,-5,-7,-2,0,-12,9:11 - 11:6 - 11:4 - 13:11 - 0:0
19406471,2024-06-22 14:55:00,Diaryan Aleksandr - Nikoghosyan Narek,3:2,6:11 - 11:7 - 7:11 - 11:6 - 12:10,3,2,Diaryan Aleksandr,Nikoghosyan Narek,fiurst,Diaryan Aleksandr - Nikoghosyan Narek,92,47,45,-2,2,17,18,18,17,22,5,-4,4,-5,-2,-2,6:11 - 11:7 - 7:11 - 11:6 - 12:10
19406470,2024-06-22 14:40:00,Nazaryan Mushegh - Asatryan Murad,3:0,3:11 - 7:11 - 5:11 - 0:0 - 0:0,0,3,Nazaryan Mushegh,Asatryan Murad,fiurst,Asatryan Murad - Nazaryan Mushegh,48,33,15,-18,18,14,18,16,0,0,-8,-4,-6,0,0,-18,11:3 - 11:7 - 11:5 - 0:0 - 0:0
19406469,2024-06-22 14:25:00,Diaryan Aleksandr - Papyan Karen,3:1,9:11 - 11:5 - 11:7 - 11:1 - 0:0,3,1,Diaryan Aleksandr,Papyan Karen,fiurst,Diaryan Aleksandr - Papyan Karen,66,42,24,-18,18,20,16,18,12,0,2,-6,-4,-10,0,-18,9:11 - 11:5 - 11:7 - 11:1 - 0:0
19406455,2024-06-22 14:20:00,Nikoghosyan Narek - Asatryan Murad,3:1,8:11 - 7:11 - 11:7 - 2:11 - 0:0,1,3,Nikoghosyan Narek,Asatryan Murad,fiurst,Asatryan Murad - Nikoghosyan Narek,68,40,28,-12,12,19,18,18,13,0,-3,-4,4,-9,0,-12,11:8 - 11:7 - 7:11 - 11:2 - 0:0
19406453,2024-06-22 13:45:00,Nazaryan Mushegh - Diaryan Aleksandr,3:2,11:4 - 5:11 - 7:11 - 11:9 - 9:11,2,3,Nazaryan Mushegh,Diaryan Aleksandr,fiurst,Diaryan Aleksandr - Nazaryan Mushegh,89,46,43,-3,3,15,16,18,20,20,7,-6,-4,2,-2,-3,4:11 - 11:5 - 11:7 - 9:11 - 11:9
19406451,2024-06-22 13:35:00,Papyan Karen - Nikoghosyan Narek,2:3,9:11 - 7:11 - 14:12 - 11:9 - 14:12,3,2,Papyan Karen,Nikoghosyan Narek,fiurst,Nikoghosyan Narek - Papyan Karen,110,55,55,0,0,20,18,26,20,26,-2,-4,2,2,2,0,11:9 - 11:7 - 12:14 - 9:11 - 12:14
19406448,2024-06-22 13:15:00,Asatryan Murad - Diaryan Aleksandr,3:1,11:6 - 7:11 - 11:4 - 11:3 - 0:0,3,1,Asatryan Murad,Diaryan Aleksandr,fiurst,Asatryan Murad - Diaryan Aleksandr,64,40,24,-16,16,17,18,15,14,0,-5,4,-7,-8,0,-16,11:6 - 7:11 - 11:4 - 11:3 - 0:0
19406447,2024-06-22 13:00:00,Papyan Karen - Nazaryan Mushegh,3:2,11:7 - 9:11 - 14:12 - 3:11 - 5:11,2,3,Papyan Karen,Nazaryan Mushegh,fiurst,Nazaryan Mushegh - Papyan Karen,94,52,42,-10,10,18,20,26,14,16,4,-2,2,-8,-6,-10,7:11 - 11:9 - 12:14 - 11:3 - 11:5
19406445,2024-06-22 12:15:00,Nikoghosyan Narek - Diaryan Aleksandr,3:2,9:11 - 8:11 - 11:8 - 11:7 - 9:11,2,3,Nikoghosyan Narek,Diaryan Aleksandr,fiurst,Diaryan Aleksandr - Nikoghosyan Narek,96,48,48,0,0,20,19,19,18,20,-2,-3,3,4,-2,0,11:9 - 11:8 - 8:11 - 7:11 - 11:9
19406444,2024-06-22 12:00:00,Papyan Karen - Asatryan Murad,3:1,11:8 - 5:11 - 2:11 - 12:14 - 0:0,1,3,Papyan Karen,Asatryan Murad,fiurst,Asatryan Murad - Papyan Karen,74,44,30,-14,14,19,16,13,26,0,3,-6,-9,-2,0,-14,8:11 - 11:5 - 11:2 - 14:12 - 0:0
19406443,2024-06-22 11:45:00,Nazaryan Mushegh - Nikoghosyan Narek,2:3,9:11 - 5:11 - 11:2 - 11:4 - 4:11,2,3,Nazaryan Mushegh,Nikoghosyan Narek,fiurst,Nazaryan Mushegh - Nikoghosyan Narek,79,40,39,-1,1,20,16,13,15,15,2,6,-9,-7,7,-1,9:11 - 5:11 - 11:2 - 11:4 - 4:11
19406440,2024-06-22 11:30:00,Papyan Karen - Diaryan Aleksandr,1:3,7:11 - 11:9 - 14:12 - 11:7 - 0:0,3,1,Papyan Karen,Diaryan Aleksandr,fiurst,Diaryan Aleksandr - Papyan Karen,82,39,43,4,-4,18,20,26,18,0,-4,2,2,4,0,4,11:7 - 9:11 - 12:14 - 7:11 - 0:0
19406418,2024-06-22 11:15:00,Asatryan Murad - Nazaryan Mushegh,3:0,11:7 - 11:2 - 11:5 - 0:0 - 0:0,3,0,Asatryan Murad,Nazaryan Mushegh,fiurst,Asatryan Murad - Nazaryan Mushegh,47,33,14,-19,19,18,13,16,0,0,-4,-9,-6,0,0,-19,11:7 - 11:2 - 11:5 - 0:0 - 0:0
19406414,2024-06-22 11:00:00,Nikoghosyan Narek - Papyan Karen,0:3,10:12 - 10:12 - 6:11 - 0:0 - 0:0,0,3,Nikoghosyan Narek,Papyan Karen,fiurst,Nikoghosyan Narek - Papyan Karen,61,26,35,9,-9,22,22,17,0,0,2,2,5,0,0,9,10:12 - 10:12 - 6:11 - 0:0 - 0:0
19406411,2024-06-22 10:45:00,Diaryan Aleksandr - Nazaryan Mushegh,3:0,11:5 - 11:8 - 11:2 - 0:0 - 0:0,3,0,Diaryan Aleksandr,Nazaryan Mushegh,fiurst,Diaryan Aleksandr - Nazaryan Mushegh,48,33,15,-18,18,16,19,13,0,0,-6,-3,-9,0,0,-18,11:5 - 11:8 - 11:2 - 0:0 - 0:0
19406410,2024-06-22 10:30:00,Asatryan Murad - Nikoghosyan Narek,3:0,11:7 - 11:6 - 11:7 - 0:0 - 0:0,3,0,Asatryan Murad,Nikoghosyan Narek,fiurst,Asatryan Murad - Nikoghosyan Narek,53,33,20,-13,13,18,17,18,0,0,-4,-5,-4,0,0,-13,11:7 - 11:6 - 11:7 - 0:0 - 0:0
19406407,2024-06-22 10:15:00,Nazaryan Mushegh - Papyan Karen,1:3,11:7 - 11:13 - 5:11 - 10:12 - 0:0,1,3,Nazaryan Mushegh,Papyan Karen,fiurst,Nazaryan Mushegh - Papyan Karen,80,37,43,6,-6,18,24,16,22,0,-4,2,6,2,0,6,11:7 - 11:13 - 5:11 - 10:12 - 0:0
19406393,2024-06-22 10:00:00,Diaryan Aleksandr - Asatryan Murad,3:0,5:11 - 7:11 - 9:11 - 0:0 - 0:0,0,3,Diaryan Aleksandr,Asatryan Murad,fiurst,Asatryan Murad - Diaryan Aleksandr,54,33,21,-12,12,16,18,20,0,0,-6,-4,-2,0,0,-12,11:5 - 11:7 - 11:9 - 0:0 - 0:0
19388954,2024-06-21 18:00:00,Mkrtchyan Andranik - Soghomonyan Hrayr,1:3,11:3 - 15:17 - 9:11 - 6:11 - 0:0,1,3,Mkrtchyan Andranik,Soghomonyan Hrayr,fiurst,Mkrtchyan Andranik - Soghomonyan Hrayr,83,41,42,1,-1,14,32,20,17,0,-8,2,2,5,0,1,11:3 - 15:17 - 9:11 - 6:11 - 0:0
19388950,2024-06-21 17:30:00,Petrosyan Davit - Gevorgyan Gegham,1:3,11:7 - 5:11 - 11:5 - 11:2 - 0:0,3,1,Petrosyan Davit,Gevorgyan Gegham,fiurst,Gevorgyan Gegham - Petrosyan Davit,63,25,38,13,-13,18,16,16,13,0,4,-6,6,9,0,13,7:11 - 11:5 - 5:11 - 2:11 - 0:0
19388936,2024-06-21 17:20:00,Arutyunov Ruben - Mkrtchyan Andranik,3:2,11:9 - 9:11 - 11:5 - 18:20 - 11:6,3,2,Arutyunov Ruben,Mkrtchyan Andranik,fiurst,Arutyunov Ruben - Mkrtchyan Andranik,111,60,51,-9,9,20,20,16,38,17,-2,2,-6,2,-5,-9,11:9 - 9:11 - 11:5 - 18:20 - 11:6
19388933,2024-06-21 17:00:00,Petrosyan Davit - Soghomonyan Hrayr,3:1,5:11 - 11:6 - 11:6 - 13:11 - 0:0,3,1,Petrosyan Davit,Soghomonyan Hrayr,fiurst,Petrosyan Davit - Soghomonyan Hrayr,74,40,34,-6,6,16,17,17,24,0,6,-5,-5,-2,0,-6,5:11 - 11:6 - 11:6 - 13:11 - 0:0
19388929,2024-06-21 16:50:00,Gevorgyan Gegham - Arutyunov Ruben,3:0,7:11 - 10:12 - 7:11 - 0:0 - 0:0,0,3,Gevorgyan Gegham,Arutyunov Ruben,fiurst,Arutyunov Ruben - Gevorgyan Gegham,58,34,24,-10,10,18,22,18,0,0,-4,-2,-4,0,0,-10,11:7 - 12:10 - 11:7 - 0:0 - 0:0
19388926,2024-06-21 16:35:00,Mkrtchyan Andranik - Petrosyan Davit,3:0,11:7 - 11:4 - 11:8 - 0:0 - 0:0,3,0,Mkrtchyan Andranik,Petrosyan Davit,fiurst,Mkrtchyan Andranik - Petrosyan Davit,52,33,19,-14,14,18,15,19,0,0,-4,-7,-3,0,0,-14,11:7 - 11:4 - 11:8 - 0:0 - 0:0
19388924,2024-06-21 16:20:00,Soghomonyan Hrayr - Arutyunov Ruben,3:0,7:11 - 8:11 - 5:11 - 0:0 - 0:0,0,3,Soghomonyan Hrayr,Arutyunov Ruben,fiurst,Arutyunov Ruben - Soghomonyan Hrayr,53,33,20,-13,13,18,19,16,0,0,-4,-3,-6,0,0,-13,11:7 - 11:8 - 11:5 - 0:0 - 0:0
19388921,2024-06-21 16:00:00,Gevorgyan Gegham - Mkrtchyan Andranik,3:2,11:9 - 11:7 - 6:11 - 11:13 - 11:6,3,2,Gevorgyan Gegham,Mkrtchyan Andranik,fiurst,Gevorgyan Gegham - Mkrtchyan Andranik,96,50,46,-4,4,20,18,17,24,17,-2,-4,5,2,-5,-4,11:9 - 11:7 - 6:11 - 11:13 - 11:6
19388917,2024-06-21 15:50:00,Arutyunov Ruben - Petrosyan Davit,3:0,11:9 - 11:4 - 11:9 - 0:0 - 0:0,3,0,Arutyunov Ruben,Petrosyan Davit,fiurst,Arutyunov Ruben - Petrosyan Davit,55,33,22,-11,11,20,15,20,0,0,-2,-7,-2,0,0,-11,11:9 - 11:4 - 11:9 - 0:0 - 0:0
19388904,2024-06-21 15:30:00,Soghomonyan Hrayr - Gevorgyan Gegham,3:1,8:11 - 9:11 - 11:9 - 9:11 - 0:0,1,3,Soghomonyan Hrayr,Gevorgyan Gegham,fiurst,Gevorgyan Gegham - Soghomonyan Hrayr,79,42,37,-5,5,19,20,20,20,0,-3,-2,2,-2,0,-5,11:8 - 11:9 - 9:11 - 11:9 - 0:0
19388878,2024-06-21 15:15:00,Asatryan Murad - Rafayelyan Edgar,3:2,11:8 - 12:10 - 6:11 - 10:12 - 11:8,3,2,Asatryan Murad,Rafayelyan Edgar,fiurst,Asatryan Murad - Rafayelyan Edgar,99,50,49,-1,1,19,22,17,22,19,-3,-2,5,2,-3,-1,11:8 - 12:10 - 6:11 - 10:12 - 11:8
19388876,2024-06-21 15:05:00,Nazaryan Mushegh - Hovhannesyan Rafik,0:3,11:5 - 11:9 - 11:6 - 0:0 - 0:0,3,0,Nazaryan Mushegh,Hovhannesyan Rafik,fiurst,Hovhannesyan Rafik - Nazaryan Mushegh,53,20,33,13,-13,16,20,17,0,0,6,2,5,0,0,13,5:11 - 9:11 - 6:11 - 0:0 - 0:0
19388875,2024-06-21 14:45:00,Papyan Karen - Asatryan Murad,3:0,7:11 - 7:11 - 5:11 - 0:0 - 0:0,0,3,Papyan Karen,Asatryan Murad,fiurst,Asatryan Murad - Papyan Karen,52,33,19,-14,14,18,18,16,0,0,-4,-4,-6,0,0,-14,11:7 - 11:7 - 11:5 - 0:0 - 0:0
19388874,2024-06-21 14:30:00,Rafayelyan Edgar - Nazaryan Mushegh,2:3,11:7 - 8:11 - 12:14 - 11:7 - 11:5,3,2,Rafayelyan Edgar,Nazaryan Mushegh,fiurst,Nazaryan Mushegh - Rafayelyan Edgar,97,44,53,9,-9,18,19,26,18,16,4,-3,-2,4,6,9,7:11 - 11:8 - 14:12 - 7:11 - 5:11
19388865,2024-06-21 14:15:00,Papyan Karen - Hovhannesyan Rafik,3:0,6:11 - 4:11 - 7:11 - 0:0 - 0:0,0,3,Papyan Karen,Hovhannesyan Rafik,fiurst,Hovhannesyan Rafik - Papyan Karen,50,33,17,-16,16,17,15,18,0,0,-5,-7,-4,0,0,-16,11:6 - 11:4 - 11:7 - 0:0 - 0:0
19388864,2024-06-21 14:00:00,Asatryan Murad - Nazaryan Mushegh,3:0,11:9 - 11:5 - 11:6 - 0:0 - 0:0,3,0,Asatryan Murad,Nazaryan Mushegh,fiurst,Asatryan Murad - Nazaryan Mushegh,53,33,20,-13,13,20,16,17,0,0,-2,-6,-5,0,0,-13,11:9 - 11:5 - 11:6 - 0:0 - 0:0
19388863,2024-06-21 13:45:00,Rafayelyan Edgar - Papyan Karen,0:3,11:4 - 11:6 - 11:4 - 0:0 - 0:0,3,0,Rafayelyan Edgar,Papyan Karen,fiurst,Papyan Karen - Rafayelyan Edgar,47,14,33,19,-19,15,17,15,0,0,7,5,7,0,0,19,4:11 - 6:11 - 4:11 - 0:0 - 0:0
19388840,2024-06-21 13:30:00,Hovhannesyan Rafik - Asatryan Murad,3:0,10:12 - 9:11 - 3:11 - 0:0 - 0:0,0,3,Hovhannesyan Rafik,Asatryan Murad,fiurst,Asatryan Murad - Hovhannesyan Rafik,56,34,22,-12,12,22,20,14,0,0,-2,-2,-8,0,0,-12,12:10 - 11:9 - 11:3 - 0:0 - 0:0
19388837,2024-06-21 13:20:00,Nazaryan Mushegh - Papyan Karen,3:1,8:11 - 11:6 - 11:6 - 11:5 - 0:0,3,1,Nazaryan Mushegh,Papyan Karen,fiurst,Nazaryan Mushegh - Papyan Karen,69,41,28,-13,13,19,17,17,16,0,3,-5,-5,-6,0,-13,8:11 - 11:6 - 11:6 - 11:5 - 0:0
19388587,2024-06-21 13:00:00,Hovhannesyan Rafik - Rafayelyan Edgar,0:3,7:11 - 8:11 - 10:12 - 0:0 - 0:0,0,3,Hovhannesyan Rafik,Rafayelyan Edgar,fiurst,Hovhannesyan Rafik - Rafayelyan Edgar,59,25,34,9,-9,18,19,22,0,0,4,3,2,0,0,9,7:11 - 8:11 - 10:12 - 0:0 - 0:0
19388583,2024-06-21 12:20:00,Asatryan Murad - Papyan Karen,3:2,9:11 - 9:11 - 11:8 - 11:4 - 11:2,3,2,Asatryan Murad,Papyan Karen,fiurst,Asatryan Murad - Papyan Karen,87,51,36,-15,15,20,20,19,15,13,2,2,-3,-7,-9,-15,9:11 - 9:11 - 11:8 - 11:4 - 11:2
19388581,2024-06-21 12:00:00,Hovhannesyan Rafik - Nazaryan Mushegh,3:1,11:6 - 8:11 - 11:8 - 11:5 - 0:0,3,1,Hovhannesyan Rafik,Nazaryan Mushegh,fiurst,Hovhannesyan Rafik - Nazaryan Mushegh,71,41,30,-11,11,17,19,19,16,0,-5,3,-3,-6,0,-11,11:6 - 8:11 - 11:8 - 11:5 - 0:0
19388566,2024-06-21 11:45:00,Rafayelyan Edgar - Asatryan Murad,2:3,11:9 - 4:11 - 11:8 - 5:11 - 11:7,3,2,Rafayelyan Edgar,Asatryan Murad,fiurst,Asatryan Murad - Rafayelyan Edgar,88,46,42,-4,4,20,15,19,16,18,2,-7,3,-6,4,-4,9:11 - 11:4 - 8:11 - 11:5 - 7:11
19388561,2024-06-21 11:30:00,Hovhannesyan Rafik - Papyan Karen,0:3,7:11 - 8:11 - 7:11 - 0:0 - 0:0,0,3,Hovhannesyan Rafik,Papyan Karen,fiurst,Hovhannesyan Rafik - Papyan Karen,55,22,33,11,-11,18,19,18,0,0,4,3,4,0,0,11,7:11 - 8:11 - 7:11 - 0:0 - 0:0
19388540,2024-06-21 11:15:00,Nazaryan Mushegh - Rafayelyan Edgar,0:3,10:12 - 7:11 - 4:11 - 0:0 - 0:0,0,3,Nazaryan Mushegh,Rafayelyan Edgar,fiurst,Nazaryan Mushegh - Rafayelyan Edgar,55,21,34,13,-13,22,18,15,0,0,2,4,7,0,0,13,10:12 - 7:11 - 4:11 - 0:0 - 0:0
19388537,2024-06-21 11:00:00,Asatryan Murad - Hovhannesyan Rafik,3:0,11:7 - 11:9 - 11:6 - 0:0 - 0:0,3,0,Asatryan Murad,Hovhannesyan Rafik,fiurst,Asatryan Murad - Hovhannesyan Rafik,55,33,22,-11,11,18,20,17,0,0,-4,-2,-5,0,0,-11,11:7 - 11:9 - 11:6 - 0:0 - 0:0
19388531,2024-06-21 10:45:00,Papyan Karen - Rafayelyan Edgar,3:2,13:11 - 4:11 - 12:10 - 4:11 - 13:11,3,2,Papyan Karen,Rafayelyan Edgar,fiurst,Papyan Karen - Rafayelyan Edgar,100,46,54,8,-8,24,15,22,15,24,-2,7,-2,7,-2,8,13:11 - 4:11 - 12:10 - 4:11 - 13:11
19388528,2024-06-21 10:35:00,Nazaryan Mushegh - Asatryan Murad,3:0,6:11 - 7:11 - 9:11 - 0:0 - 0:0,0,3,Nazaryan Mushegh,Asatryan Murad,fiurst,Asatryan Murad - Nazaryan Mushegh,55,33,22,-11,11,17,18,20,0,0,-5,-4,-2,0,0,-11,11:6 - 11:7 - 11:9 - 0:0 - 0:0
19388514,2024-06-21 10:15:00,Rafayelyan Edgar - Hovhannesyan Rafik,1:3,5:11 - 11:6 - 11:5 - 11:7 - 0:0,3,1,Rafayelyan Edgar,Hovhannesyan Rafik,fiurst,Hovhannesyan Rafik - Rafayelyan Edgar,67,29,38,9,-9,16,17,16,18,0,-6,5,6,4,0,9,11:5 - 6:11 - 5:11 - 7:11 - 0:0
19388508,2024-06-21 10:00:00,Papyan Karen - Nazaryan Mushegh,2:3,5:11 - 6:11 - 11:7 - 11:9 - 11:8,3,2,Papyan Karen,Nazaryan Mushegh,fiurst,Nazaryan Mushegh - Papyan Karen,90,46,44,-2,2,16,17,18,20,19,-6,-5,4,2,3,-2,11:5 - 11:6 - 7:11 - 9:11 - 8:11
19367519,2024-06-20 17:45:00,Hakobyan Eduard - Gevorgyan Gegham,2:3,11:9 - 9:11 - 11:8 - 9:11 - 11:7,3,2,Hakobyan Eduard,Gevorgyan Gegham,fiurst,Gevorgyan Gegham - Hakobyan Eduard,97,46,51,5,-5,20,20,19,20,18,2,-2,3,-2,4,5,9:11 - 11:9 - 8:11 - 11:9 - 7:11
19367516,2024-06-20 17:30:00,Avakimyan Davit - Mkrtchyan Andranik,0:3,9:11 - 9:11 - 6:11 - 0:0 - 0:0,0,3,Avakimyan Davit,Mkrtchyan Andranik,fiurst,Avakimyan Davit - Mkrtchyan Andranik,57,24,33,9,-9,20,20,17,0,0,2,2,5,0,0,9,9:11 - 9:11 - 6:11 - 0:0 - 0:0
19367514,2024-06-20 17:15:00,Soghomonyan Hrayr - Hakobyan Eduard,0:3,11:7 - 12:10 - 11:8 - 0:0 - 0:0,3,0,Soghomonyan Hrayr,Hakobyan Eduard,fiurst,Hakobyan Eduard - Soghomonyan Hrayr,59,25,34,9,-9,18,22,19,0,0,4,2,3,0,0,9,7:11 - 10:12 - 8:11 - 0:0 - 0:0
19367502,2024-06-20 17:00:00,Avakimyan Davit - Gevorgyan Gegham,3:1,11:8 - 6:11 - 11:9 - 12:10 - 0:0,3,1,Avakimyan Davit,Gevorgyan Gegham,fiurst,Avakimyan Davit - Gevorgyan Gegham,78,40,38,-2,2,19,17,20,22,0,-3,5,-2,-2,0,-2,11:8 - 6:11 - 11:9 - 12:10 - 0:0
19367490,2024-06-20 16:45:00,Mkrtchyan Andranik - Soghomonyan Hrayr,1:3,4:11 - 6:11 - 11:8 - 6:11 - 0:0,1,3,Mkrtchyan Andranik,Soghomonyan Hrayr,fiurst,Mkrtchyan Andranik - Soghomonyan Hrayr,68,27,41,14,-14,15,17,19,17,0,7,5,-3,5,0,14,4:11 - 6:11 - 11:8 - 6:11 - 0:0
19367489,2024-06-20 16:30:00,Hakobyan Eduard - Avakimyan Davit,0:3,11:3 - 11:3 - 11:6 - 0:0 - 0:0,3,0,Hakobyan Eduard,Avakimyan Davit,fiurst,Avakimyan Davit - Hakobyan Eduard,45,12,33,21,-21,14,14,17,0,0,8,8,5,0,0,21,3:11 - 3:11 - 6:11 - 0:0 - 0:0
19367488,2024-06-20 16:15:00,Gevorgyan Gegham - Soghomonyan Hrayr,1:3,5:11 - 8:11 - 12:10 - 7:11 - 0:0,1,3,Gevorgyan Gegham,Soghomonyan Hrayr,fiurst,Gevorgyan Gegham - Soghomonyan Hrayr,75,32,43,11,-11,16,19,22,18,0,6,3,-2,4,0,11,5:11 - 8:11 - 12:10 - 7:11 - 0:0
19367467,2024-06-20 16:10:00,Mkrtchyan Andranik - Hakobyan Eduard,3:1,8:11 - 11:6 - 5:11 - 10:12 - 0:0,1,3,Mkrtchyan Andranik,Hakobyan Eduard,fiurst,Hakobyan Eduard - Mkrtchyan Andranik,74,40,34,-6,6,19,17,16,22,0,-3,5,-6,-2,0,-6,11:8 - 6:11 - 11:5 - 12:10 - 0:0
19367462,2024-06-20 15:45:00,Soghomonyan Hrayr - Avakimyan Davit,3:0,9:11 - 5:11 - 4:11 - 0:0 - 0:0,0,3,Soghomonyan Hrayr,Avakimyan Davit,fiurst,Avakimyan Davit - Soghomonyan Hrayr,51,33,18,-15,15,20,16,15,0,0,-2,-6,-7,0,0,-15,11:9 - 11:5 - 11:4 - 0:0 - 0:0
19367458,2024-06-20 15:30:00,Gevorgyan Gegham - Mkrtchyan Andranik,1:3,5:11 - 11:4 - 9:11 - 9:11 - 0:0,1,3,Gevorgyan Gegham,Mkrtchyan Andranik,fiurst,Gevorgyan Gegham - Mkrtchyan Andranik,71,34,37,3,-3,16,15,20,20,0,6,-7,2,2,0,3,5:11 - 11:4 - 9:11 - 9:11 - 0:0
19367456,2024-06-20 15:15:00,Hovhannesyan Rafik - Diaryan Aleksandr,3:2,11:8 - 5:11 - 12:14 - 11:9 - 3:11,2,3,Hovhannesyan Rafik,Diaryan Aleksandr,fiurst,Diaryan Aleksandr - Hovhannesyan Rafik,95,53,42,-11,11,19,16,26,20,14,3,-6,-2,2,-8,-11,8:11 - 11:5 - 14:12 - 9:11 - 11:3
19367452,2024-06-20 15:05:00,Gevorgyan Hayk - Rafayelyan Edgar,3:2,11:9 - 11:4 - 7:11 - 8:11 - 11:4,3,2,Gevorgyan Hayk,Rafayelyan Edgar,fiurst,Gevorgyan Hayk - Rafayelyan Edgar,87,48,39,-9,9,20,15,18,19,15,-2,-7,4,3,-7,-9,11:9 - 11:4 - 7:11 - 8:11 - 11:4
19367451,2024-06-20 14:45:00,Nikoghosyan Narek - Hovhannesyan Rafik,3:1,11:9 - 6:11 - 7:11 - 3:11 - 0:0,1,3,Nikoghosyan Narek,Hovhannesyan Rafik,fiurst,Hovhannesyan Rafik - Nikoghosyan Narek,69,42,27,-15,15,20,17,18,14,0,2,-5,-4,-8,0,-15,9:11 - 11:6 - 11:7 - 11:3 - 0:0
19367449,2024-06-20 14:40:00,Diaryan Aleksandr - Gevorgyan Hayk,3:0,11:9 - 11:7 - 11:8 - 0:0 - 0:0,3,0,Diaryan Aleksandr,Gevorgyan Hayk,fiurst,Diaryan Aleksandr - Gevorgyan Hayk,57,33,24,-9,9,20,18,19,0,0,-2,-4,-3,0,0,-9,11:9 - 11:7 - 11:8 - 0:0 - 0:0
19367446,2024-06-20 14:15:00,Nikoghosyan Narek - Rafayelyan Edgar,0:3,10:12 - 7:11 - 5:11 - 0:0 - 0:0,0,3,Nikoghosyan Narek,Rafayelyan Edgar,fiurst,Nikoghosyan Narek - Rafayelyan Edgar,56,22,34,12,-12,22,18,16,0,0,2,4,6,0,0,12,10:12 - 7:11 - 5:11 - 0:0 - 0:0
19367426,2024-06-20 14:10:00,Hovhannesyan Rafik - Gevorgyan Hayk,1:3,11:3 - 5:11 - 11:2 - 11:8 - 0:0,3,1,Hovhannesyan Rafik,Gevorgyan Hayk,fiurst,Gevorgyan Hayk - Hovhannesyan Rafik,62,24,38,14,-14,14,16,13,19,0,8,-6,9,3,0,14,3:11 - 11:5 - 2:11 - 8:11 - 0:0
19367423,2024-06-20 13:45:00,Diaryan Aleksandr - Nikoghosyan Narek,3:0,11:5 - 11:6 - 11:2 - 0:0 - 0:0,3,0,Diaryan Aleksandr,Nikoghosyan Narek,fiurst,Diaryan Aleksandr - Nikoghosyan Narek,46,33,13,-20,20,16,17,13,0,0,-6,-5,-9,0,0,-20,11:5 - 11:6 - 11:2 - 0:0 - 0:0
19367420,2024-06-20 13:30:00,Rafayelyan Edgar - Hovhannesyan Rafik,2:3,11:9 - 5:11 - 11:2 - 6:11 - 11:8,3,2,Rafayelyan Edgar,Hovhannesyan Rafik,fiurst,Hovhannesyan Rafik - Rafayelyan Edgar,85,41,44,3,-3,20,16,13,17,19,2,-6,9,-5,3,3,9:11 - 11:5 - 2:11 - 11:6 - 8:11
19367418,2024-06-20 13:15:00,Gevorgyan Hayk - Nikoghosyan Narek,0:3,5:11 - 9:11 - 9:11 - 0:0 - 0:0,0,3,Gevorgyan Hayk,Nikoghosyan Narek,fiurst,Gevorgyan Hayk - Nikoghosyan Narek,56,23,33,10,-10,16,20,20,0,0,6,2,2,0,0,10,5:11 - 9:11 - 9:11 - 0:0 - 0:0
19367415,2024-06-20 13:00:00,Rafayelyan Edgar - Diaryan Aleksandr,1:3,11:9 - 8:11 - 11:3 - 11:3 - 0:0,3,1,Rafayelyan Edgar,Diaryan Aleksandr,fiurst,Diaryan Aleksandr - Rafayelyan Edgar,67,26,41,15,-15,20,19,14,14,0,2,-3,8,8,0,15,9:11 - 11:8 - 3:11 - 3:11 - 0:0
19367414,2024-06-20 12:25:00,Hovhannesyan Rafik - Nikoghosyan Narek,3:1,11:9 - 11:7 - 7:11 - 17:15 - 0:0,3,1,Hovhannesyan Rafik,Nikoghosyan Narek,fiurst,Hovhannesyan Rafik - Nikoghosyan Narek,88,46,42,-4,4,20,18,18,32,0,-2,-4,4,-2,0,-4,11:9 - 11:7 - 7:11 - 17:15 - 0:0
19367400,2024-06-20 12:00:00,Rafayelyan Edgar - Gevorgyan Hayk,0:3,11:6 - 11:6 - 11:7 - 0:0 - 0:0,3,0,Rafayelyan Edgar,Gevorgyan Hayk,fiurst,Gevorgyan Hayk - Rafayelyan Edgar,52,19,33,14,-14,17,17,18,0,0,5,5,4,0,0,14,6:11 - 6:11 - 7:11 - 0:0 - 0:0
19367398,2024-06-20 11:45:00,Diaryan Aleksandr - Hovhannesyan Rafik,2:3,13:15 - 13:11 - 6:11 - 11:7 - 7:11,2,3,Diaryan Aleksandr,Hovhannesyan Rafik,fiurst,Diaryan Aleksandr - Hovhannesyan Rafik,105,50,55,5,-5,28,24,17,18,18,2,-2,5,-4,4,5,13:15 - 13:11 - 6:11 - 11:7 - 7:11
19367396,2024-06-20 11:30:00,Rafayelyan Edgar - Nikoghosyan Narek,0:3,11:8 - 17:15 - 11:4 - 0:0 - 0:0,3,0,Rafayelyan Edgar,Nikoghosyan Narek,fiurst,Nikoghosyan Narek - Rafayelyan Edgar,66,27,39,12,-12,19,32,15,0,0,3,2,7,0,0,12,8:11 - 15:17 - 4:11 - 0:0 - 0:0
19367394,2024-06-20 11:15:00,Gevorgyan Hayk - Diaryan Aleksandr,3:0,5:11 - 6:11 - 6:11 - 0:0 - 0:0,0,3,Gevorgyan Hayk,Diaryan Aleksandr,fiurst,Diaryan Aleksandr - Gevorgyan Hayk,50,33,17,-16,16,16,17,17,0,0,-6,-5,-5,0,0,-16,11:5 - 11:6 - 11:6 - 0:0 - 0:0
19367391,2024-06-20 11:10:00,Hovhannesyan Rafik - Rafayelyan Edgar,1:3,11:5 - 7:11 - 4:11 - 4:11 - 0:0,1,3,Hovhannesyan Rafik,Rafayelyan Edgar,fiurst,Hovhannesyan Rafik - Rafayelyan Edgar,64,26,38,12,-12,16,18,15,15,0,-6,4,7,7,0,12,11:5 - 7:11 - 4:11 - 4:11 - 0:0
19367386,2024-06-20 10:45:00,Nikoghosyan Narek - Diaryan Aleksandr,2:3,7:11 - 6:11 - 11:6 - 11:9 - 11:4,3,2,Nikoghosyan Narek,Diaryan Aleksandr,fiurst,Diaryan Aleksandr - Nikoghosyan Narek,87,41,46,5,-5,18,17,17,20,15,-4,-5,5,2,7,5,11:7 - 11:6 - 6:11 - 9:11 - 4:11
19367384,2024-06-20 10:40:00,Gevorgyan Hayk - Hovhannesyan Rafik,3:2,10:12 - 7:11 - 13:11 - 11:5 - 11:6,3,2,Gevorgyan Hayk,Hovhannesyan Rafik,fiurst,Gevorgyan Hayk - Hovhannesyan Rafik,97,52,45,-7,7,22,18,24,16,17,2,4,-2,-6,-5,-7,10:12 - 7:11 - 13:11 - 11:5 - 11:6
19367380,2024-06-20 10:15:00,Diaryan Aleksandr - Rafayelyan Edgar,0:3,7:11 - 8:11 - 10:12 - 0:0 - 0:0,0,3,Diaryan Aleksandr,Rafayelyan Edgar,fiurst,Diaryan Aleksandr - Rafayelyan Edgar,59,25,34,9,-9,18,19,22,0,0,4,3,2,0,0,9,7:11 - 8:11 - 10:12 - 0:0 - 0:0
19367377,2024-06-20 10:10:00,Nikoghosyan Narek - Gevorgyan Hayk,1:3,11:4 - 11:9 - 8:11 - 11:5 - 0:0,3,1,Nikoghosyan Narek,Gevorgyan Hayk,fiurst,Gevorgyan Hayk - Nikoghosyan Narek,70,29,41,12,-12,15,20,19,16,0,7,2,-3,6,0,12,4:11 - 9:11 - 11:8 - 5:11 - 0:0
19352469,2024-06-19 17:45:00,Hakobyan Eduard - Soghomonyan Hrayr,1:3,11:9 - 9:11 - 5:11 - 5:11 - 0:0,1,3,Hakobyan Eduard,Soghomonyan Hrayr,fiurst,Hakobyan Eduard - Soghomonyan Hrayr,72,30,42,12,-12,20,20,16,16,0,-2,2,6,6,0,12,11:9 - 9:11 - 5:11 - 5:11 - 0:0
19352467,2024-06-19 17:30:00,Petrosyan Davit - Arutyunov Ruben,0:3,11:4 - 11:8 - 11:2 - 0:0 - 0:0,3,0,Petrosyan Davit,Arutyunov Ruben,fiurst,Arutyunov Ruben - Petrosyan Davit,47,14,33,19,-19,15,19,13,0,0,7,3,9,0,0,19,4:11 - 8:11 - 2:11 - 0:0 - 0:0
19352452,2024-06-19 17:15:00,Mkrtchyan Andranik - Hakobyan Eduard,1:3,11:4 - 11:9 - 7:11 - 11:9 - 0:0,3,1,Mkrtchyan Andranik,Hakobyan Eduard,fiurst,Hakobyan Eduard - Mkrtchyan Andranik,73,33,40,7,-7,15,20,18,20,0,7,2,-4,2,0,7,4:11 - 9:11 - 11:7 - 9:11 - 0:0
19352449,2024-06-19 17:05:00,Petrosyan Davit - Soghomonyan Hrayr,3:0,11:1 - 11:6 - 11:6 - 0:0 - 0:0,3,0,Petrosyan Davit,Soghomonyan Hrayr,fiurst,Petrosyan Davit - Soghomonyan Hrayr,46,33,13,-20,20,12,17,17,0,0,-10,-5,-5,0,0,-20,11:1 - 11:6 - 11:6 - 0:0 - 0:0
19352444,2024-06-19 16:45:00,Arutyunov Ruben - Mkrtchyan Andranik,1:3,9:11 - 8:11 - 11:3 - 6:11 - 0:0,1,3,Arutyunov Ruben,Mkrtchyan Andranik,fiurst,Arutyunov Ruben - Mkrtchyan Andranik,70,34,36,2,-2,20,19,14,17,0,2,3,-8,5,0,2,9:11 - 8:11 - 11:3 - 6:11 - 0:0
19352443,2024-06-19 16:30:00,Hakobyan Eduard - Petrosyan Davit,2:3,11:13 - 11:5 - 15:13 - 11:13 - 3:11,2,3,Hakobyan Eduard,Petrosyan Davit,fiurst,Hakobyan Eduard - Petrosyan Davit,106,51,55,4,-4,24,16,28,24,14,2,-6,-2,2,8,4,11:13 - 11:5 - 15:13 - 11:13 - 3:11
19352429,2024-06-19 16:15:00,Soghomonyan Hrayr - Mkrtchyan Andranik,0:3,11:8 - 12:10 - 11:8 - 0:0 - 0:0,3,0,Soghomonyan Hrayr,Mkrtchyan Andranik,fiurst,Mkrtchyan Andranik - Soghomonyan Hrayr,60,26,34,8,-8,19,22,19,0,0,3,2,3,0,0,8,8:11 - 10:12 - 8:11 - 0:0 - 0:0
19352422,2024-06-19 16:05:00,Arutyunov Ruben - Hakobyan Eduard,3:1,12:14 - 11:3 - 11:5 - 11:5 - 0:0,3,1,Arutyunov Ruben,Hakobyan Eduard,fiurst,Arutyunov Ruben - Hakobyan Eduard,72,45,27,-18,18,26,14,16,16,0,2,-8,-6,-6,0,-18,12:14 - 11:3 - 11:5 - 11:5 - 0:0
19352414,2024-06-19 15:45:00,Mkrtchyan Andranik - Petrosyan Davit,1:3,8:11 - 7:11 - 11:7 - 10:12 - 0:0,1,3,Mkrtchyan Andranik,Petrosyan Davit,fiurst,Mkrtchyan Andranik - Petrosyan Davit,77,36,41,5,-5,19,18,18,22,0,3,4,-4,2,0,5,8:11 - 7:11 - 11:7 - 10:12 - 0:0
19352412,2024-06-19 15:40:00,Soghomonyan Hrayr - Arutyunov Ruben,3:0,9:11 - 5:11 - 7:11 - 0:0 - 0:0,0,3,Soghomonyan Hrayr,Arutyunov Ruben,fiurst,Arutyunov Ruben - Soghomonyan Hrayr,54,33,21,-12,12,20,16,18,0,0,-2,-6,-4,0,0,-12,11:9 - 11:5 - 11:7 - 0:0 - 0:0
19352409,2024-06-19 15:15:00,Papyan Karen - Gevorgyan Hayk,3:0,9:11 - 7:11 - 4:11 - 0:0 - 0:0,0,3,Papyan Karen,Gevorgyan Hayk,fiurst,Gevorgyan Hayk - Papyan Karen,53,33,20,-13,13,20,18,15,0,0,-2,-4,-7,0,0,-13,11:9 - 11:7 - 11:4 - 0:0 - 0:0
19352406,2024-06-19 15:00:00,Hovhannesyan Rafik - Asatryan Murad,3:1,6:11 - 7:11 - 11:9 - 9:11 - 0:0,1,3,Hovhannesyan Rafik,Asatryan Murad,fiurst,Asatryan Murad - Hovhannesyan Rafik,75,42,33,-9,9,17,18,20,20,0,-5,-4,2,-2,0,-9,11:6 - 11:7 - 9:11 - 11:9 - 0:0
19352405,2024-06-19 14:45:00,Rafayelyan Edgar - Papyan Karen,0:3,11:8 - 18:16 - 11:3 - 0:0 - 0:0,3,0,Rafayelyan Edgar,Papyan Karen,fiurst,Papyan Karen - Rafayelyan Edgar,67,27,40,13,-13,19,34,14,0,0,3,2,8,0,0,13,8:11 - 16:18 - 3:11 - 0:0 - 0:0
19352404,2024-06-19 14:30:00,Gevorgyan Hayk - Hovhannesyan Rafik,0:3,8:11 - 6:11 - 4:11 - 0:0 - 0:0,0,3,Gevorgyan Hayk,Hovhannesyan Rafik,fiurst,Gevorgyan Hayk - Hovhannesyan Rafik,51,18,33,15,-15,19,17,15,0,0,3,5,7,0,0,15,8:11 - 6:11 - 4:11 - 0:0 - 0:0
19352391,2024-06-19 14:15:00,Rafayelyan Edgar - Asatryan Murad,3:1,11:6 - 7:11 - 2:11 - 10:12 - 0:0,1,3,Rafayelyan Edgar,Asatryan Murad,fiurst,Asatryan Murad - Rafayelyan Edgar,70,40,30,-10,10,17,18,13,22,0,5,-4,-9,-2,0,-10,6:11 - 11:7 - 11:2 - 12:10 - 0:0
19352384,2024-06-19 14:00:00,Papyan Karen - Hovhannesyan Rafik,0:3,12:10 - 11:8 - 11:9 - 0:0 - 0:0,3,0,Papyan Karen,Hovhannesyan Rafik,fiurst,Hovhannesyan Rafik - Papyan Karen,61,27,34,7,-7,22,19,20,0,0,2,3,2,0,0,7,10:12 - 8:11 - 9:11 - 0:0 - 0:0
19352381,2024-06-19 13:45:00,Gevorgyan Hayk - Rafayelyan Edgar,3:2,11:5 - 10:12 - 8:11 - 11:9 - 11:6,3,2,Gevorgyan Hayk,Rafayelyan Edgar,fiurst,Gevorgyan Hayk - Rafayelyan Edgar,94,51,43,-8,8,16,22,19,20,17,-6,2,3,-2,-5,-8,11:5 - 10:12 - 8:11 - 11:9 - 11:6
19352380,2024-06-19 13:30:00,Asatryan Murad - Papyan Karen,3:0,11:5 - 11:4 - 11:5 - 0:0 - 0:0,3,0,Asatryan Murad,Papyan Karen,fiurst,Asatryan Murad - Papyan Karen,47,33,14,-19,19,16,15,16,0,0,-6,-7,-6,0,0,-19,11:5 - 11:4 - 11:5 - 0:0 - 0:0
19352377,2024-06-19 13:15:00,Hovhannesyan Rafik - Rafayelyan Edgar,0:3,10:12 - 7:11 - 11:13 - 0:0 - 0:0,0,3,Hovhannesyan Rafik,Rafayelyan Edgar,fiurst,Hovhannesyan Rafik - Rafayelyan Edgar,64,28,36,8,-8,22,18,24,0,0,2,4,2,0,0,8,10:12 - 7:11 - 11:13 - 0:0 - 0:0
19352376,2024-06-19 13:00:00,Asatryan Murad - Gevorgyan Hayk,3:2,9:11 - 11:5 - 5:11 - 11:6 - 11:7,3,2,Asatryan Murad,Gevorgyan Hayk,fiurst,Asatryan Murad - Gevorgyan Hayk,87,47,40,-7,7,20,16,16,17,18,2,-6,6,-5,-4,-7,9:11 - 11:5 - 5:11 - 11:6 - 11:7
19352374,2024-06-19 12:15:00,Papyan Karen - Rafayelyan Edgar,2:3,13:11 - 9:11 - 11:6 - 6:11 - 9:11,2,3,Papyan Karen,Rafayelyan Edgar,fiurst,Papyan Karen - Rafayelyan Edgar,98,48,50,2,-2,24,20,17,17,20,-2,2,-5,5,2,2,13:11 - 9:11 - 11:6 - 6:11 - 9:11
19352368,2024-06-19 12:10:00,Asatryan Murad - Hovhannesyan Rafik,3:0,11:1 - 11:5 - 11:2 - 0:0 - 0:0,3,0,Asatryan Murad,Hovhannesyan Rafik,fiurst,Asatryan Murad - Hovhannesyan Rafik,41,33,8,-25,25,12,16,13,0,0,-10,-6,-9,0,0,-25,11:1 - 11:5 - 11:2 - 0:0 - 0:0
19352366,2024-06-19 11:50:00,Gevorgyan Hayk - Papyan Karen,3:0,11:9 - 11:8 - 11:5 - 0:0 - 0:0,3,0,Gevorgyan Hayk,Papyan Karen,fiurst,Gevorgyan Hayk - Papyan Karen,55,33,22,-11,11,20,19,16,0,0,-2,-3,-6,0,0,-11,11:9 - 11:8 - 11:5 - 0:0 - 0:0
19352364,2024-06-19 11:30:00,Asatryan Murad - Rafayelyan Edgar,2:3,6:11 - 9:11 - 11:5 - 11:8 - 3:11,2,3,Asatryan Murad,Rafayelyan Edgar,fiurst,Asatryan Murad - Rafayelyan Edgar,86,40,46,6,-6,17,20,16,19,14,5,2,-6,-3,8,6,6:11 - 9:11 - 11:5 - 11:8 - 3:11
19352360,2024-06-19 11:15:00,Hovhannesyan Rafik - Gevorgyan Hayk,3:2,4:11 - 12:10 - 6:11 - 11:7 - 14:16,2,3,Hovhannesyan Rafik,Gevorgyan Hayk,fiurst,Gevorgyan Hayk - Hovhannesyan Rafik,102,55,47,-8,8,15,22,17,18,30,-7,2,-5,4,-2,-8,11:4 - 10:12 - 11:6 - 7:11 - 16:14
19352348,2024-06-19 11:00:00,Papyan Karen - Asatryan Murad,3:2,12:10 - 8:11 - 11:6 - 8:11 - 4:11,2,3,Papyan Karen,Asatryan Murad,fiurst,Asatryan Murad - Papyan Karen,92,49,43,-6,6,22,19,17,19,15,2,-3,5,-3,-7,-6,10:12 - 11:8 - 6:11 - 11:8 - 11:4
19352344,2024-06-19 10:45:00,Rafayelyan Edgar - Gevorgyan Hayk,0:3,11:7 - 12:10 - 11:6 - 0:0 - 0:0,3,0,Rafayelyan Edgar,Gevorgyan Hayk,fiurst,Gevorgyan Hayk - Rafayelyan Edgar,57,23,34,11,-11,18,22,17,0,0,4,2,5,0,0,11,7:11 - 10:12 - 6:11 - 0:0 - 0:0
19352311,2024-06-19 10:30:00,Hovhannesyan Rafik - Papyan Karen,3:1,11:7 - 9:11 - 11:8 - 11:7 - 0:0,3,1,Hovhannesyan Rafik,Papyan Karen,fiurst,Hovhannesyan Rafik - Papyan Karen,75,42,33,-9,9,18,20,19,18,0,-4,2,-3,-4,0,-9,11:7 - 9:11 - 11:8 - 11:7 - 0:0
19352304,2024-06-19 10:15:00,Rafayelyan Edgar - Hovhannesyan Rafik,0:3,11:6 - 11:6 - 12:10 - 0:0 - 0:0,3,0,Rafayelyan Edgar,Hovhannesyan Rafik,fiurst,Hovhannesyan Rafik - Rafayelyan Edgar,56,22,34,12,-12,17,17,22,0,0,5,5,2,0,0,12,6:11 - 6:11 - 10:12 - 0:0 - 0:0
19352307,2024-06-19 10:15:00,Gevorgyan Hayk - Asatryan Murad,3:0,12:14 - 5:11 - 6:11 - 0:0 - 0:0,0,3,Gevorgyan Hayk,Asatryan Murad,fiurst,Asatryan Murad - Gevorgyan Hayk,59,36,23,-13,13,26,16,17,0,0,-2,-6,-5,0,0,-13,14:12 - 11:5 - 11:6 - 0:0 - 0:0
19330290,2024-06-18 17:55:00,Hakobyan Eduard - Arutyunov Ruben,3:1,11:7 - 7:11 - 8:11 - 10:12 - 0:0,1,3,Hakobyan Eduard,Arutyunov Ruben,fiurst,Arutyunov Ruben - Hakobyan Eduard,77,41,36,-5,5,18,18,19,22,0,4,-4,-3,-2,0,-5,7:11 - 11:7 - 11:8 - 12:10 - 0:0
19330289,2024-06-18 17:35:00,Gevorgyan Gegham - Avakimyan Davit,1:3,3:11 - 11:7 - 11:9 - 11:3 - 0:0,3,1,Gevorgyan Gegham,Avakimyan Davit,fiurst,Avakimyan Davit - Gevorgyan Gegham,66,30,36,6,-6,14,18,20,14,0,-8,4,2,8,0,6,11:3 - 7:11 - 9:11 - 3:11 - 0:0
19330288,2024-06-18 17:30:00,Petrosyan Davit - Hakobyan Eduard,3:2,11:7 - 9:11 - 11:9 - 9:11 - 10:12,2,3,Petrosyan Davit,Hakobyan Eduard,fiurst,Hakobyan Eduard - Petrosyan Davit,100,50,50,0,0,18,20,20,20,22,4,-2,2,-2,-2,0,7:11 - 11:9 - 9:11 - 11:9 - 12:10
19330287,2024-06-18 17:10:00,Gevorgyan Gegham - Arutyunov Ruben,3:0,8:11 - 8:11 - 8:11 - 0:0 - 0:0,0,3,Gevorgyan Gegham,Arutyunov Ruben,fiurst,Arutyunov Ruben - Gevorgyan Gegham,57,33,24,-9,9,19,19,19,0,0,-3,-3,-3,0,0,-9,11:8 - 11:8 - 11:8 - 0:0 - 0:0
19330283,2024-06-18 17:05:00,Avakimyan Davit - Petrosyan Davit,1:3,10:12 - 11:7 - 9:11 - 6:11 - 0:0,1,3,Avakimyan Davit,Petrosyan Davit,fiurst,Avakimyan Davit - Petrosyan Davit,77,36,41,5,-5,22,18,20,17,0,2,-4,2,5,0,5,10:12 - 11:7 - 9:11 - 6:11 - 0:0
19330281,2024-06-18 16:40:00,Hakobyan Eduard - Gevorgyan Gegham,2:3,6:11 - 11:3 - 11:6 - 6:11 - 11:9,3,2,Hakobyan Eduard,Gevorgyan Gegham,fiurst,Gevorgyan Gegham - Hakobyan Eduard,85,40,45,5,-5,17,14,17,17,20,-5,8,5,-5,2,5,11:6 - 3:11 - 6:11 - 11:6 - 9:11
19330268,2024-06-18 16:30:00,Arutyunov Ruben - Petrosyan Davit,2:3,3:11 - 8:11 - 14:12 - 11:3 - 8:11,2,3,Arutyunov Ruben,Petrosyan Davit,fiurst,Arutyunov Ruben - Petrosyan Davit,92,44,48,4,-4,14,19,26,14,19,8,3,-2,-8,3,4,3:11 - 8:11 - 14:12 - 11:3 - 8:11
19330267,2024-06-18 16:00:00,Avakimyan Davit - Hakobyan Eduard,0:3,8:11 - 6:11 - 4:11 - 0:0 - 0:0,0,3,Avakimyan Davit,Hakobyan Eduard,fiurst,Avakimyan Davit - Hakobyan Eduard,51,18,33,15,-15,19,17,15,0,0,3,5,7,0,0,15,8:11 - 6:11 - 4:11 - 0:0 - 0:0
19330266,2024-06-18 15:50:00,Petrosyan Davit - Gevorgyan Gegham,1:3,15:13 - 13:15 - 11:6 - 11:5 - 0:0,3,1,Petrosyan Davit,Gevorgyan Gegham,fiurst,Gevorgyan Gegham - Petrosyan Davit,89,39,50,11,-11,28,28,17,16,0,2,-2,5,6,0,11,13:15 - 15:13 - 6:11 - 5:11 - 0:0
19330265,2024-06-18 15:30:00,Arutyunov Ruben - Avakimyan Davit,3:0,11:5 - 11:5 - 11:4 - 0:0 - 0:0,3,0,Arutyunov Ruben,Avakimyan Davit,fiurst,Arutyunov Ruben - Avakimyan Davit,47,33,14,-19,19,16,16,15,0,0,-6,-6,-7,0,0,-19,11:5 - 11:5 - 11:4 - 0:0 - 0:0
19330221,2024-06-18 15:15:00,Asatryan Murad - Rafayelyan Edgar,3:2,7:11 - 11:6 - 11:13 - 11:5 - 12:10,3,2,Asatryan Murad,Rafayelyan Edgar,fiurst,Asatryan Murad - Rafayelyan Edgar,97,52,45,-7,7,18,17,24,16,22,4,-5,2,-6,-2,-7,7:11 - 11:6 - 11:13 - 11:5 - 12:10
19330220,2024-06-18 15:05:00,Papyan Karen - Hovhannesyan Rafik,3:1,13:15 - 11:8 - 6:11 - 7:11 - 0:0,1,3,Papyan Karen,Hovhannesyan Rafik,fiurst,Hovhannesyan Rafik - Papyan Karen,82,45,37,-8,8,28,19,17,18,0,-2,3,-5,-4,0,-8,15:13 - 8:11 - 11:6 - 11:7 - 0:0
19330218,2024-06-18 14:45:00,Nazaryan Mushegh - Asatryan Murad,3:0,4:11 - 6:11 - 9:11 - 0:0 - 0:0,0,3,Nazaryan Mushegh,Asatryan Murad,fiurst,Asatryan Murad - Nazaryan Mushegh,52,33,19,-14,14,15,17,20,0,0,-7,-5,-2,0,0,-14,11:4 - 11:6 - 11:9 - 0:0 - 0:0
19330217,2024-06-18 14:40:00,Rafayelyan Edgar - Papyan Karen,2:3,9:11 - 12:10 - 10:12 - 11:6 - 15:13,3,2,Rafayelyan Edgar,Papyan Karen,fiurst,Papyan Karen - Rafayelyan Edgar,109,52,57,5,-5,20,22,22,17,28,-2,2,-2,5,2,5,11:9 - 10:12 - 12:10 - 6:11 - 13:15
19330216,2024-06-18 14:15:00,Nazaryan Mushegh - Hovhannesyan Rafik,3:0,9:11 - 5:11 - 7:11 - 0:0 - 0:0,0,3,Nazaryan Mushegh,Hovhannesyan Rafik,fiurst,Hovhannesyan Rafik - Nazaryan Mushegh,54,33,21,-12,12,20,16,18,0,0,-2,-6,-4,0,0,-12,11:9 - 11:5 - 11:7 - 0:0 - 0:0
19330215,2024-06-18 14:00:00,Asatryan Murad - Papyan Karen,3:1,11:1 - 12:14 - 12:10 - 11:9 - 0:0,3,1,Asatryan Murad,Papyan Karen,fiurst,Asatryan Murad - Papyan Karen,80,46,34,-12,12,12,26,22,20,0,-10,2,-2,-2,0,-12,11:1 - 12:14 - 12:10 - 11:9 - 0:0
19330213,2024-06-18 13:45:00,Rafayelyan Edgar - Nazaryan Mushegh,0:3,11:4 - 11:9 - 11:6 - 0:0 - 0:0,3,0,Rafayelyan Edgar,Nazaryan Mushegh,fiurst,Nazaryan Mushegh - Rafayelyan Edgar,52,19,33,14,-14,15,20,17,0,0,7,2,5,0,0,14,4:11 - 9:11 - 6:11 - 0:0 - 0:0
19330212,2024-06-18 13:30:00,Hovhannesyan Rafik - Asatryan Murad,3:0,10:12 - 9:11 - 9:11 - 0:0 - 0:0,0,3,Hovhannesyan Rafik,Asatryan Murad,fiurst,Asatryan Murad - Hovhannesyan Rafik,62,34,28,-6,6,22,20,20,0,0,-2,-2,-2,0,0,-6,12:10 - 11:9 - 11:9 - 0:0 - 0:0
19330209,2024-06-18 13:15:00,Papyan Karen - Nazaryan Mushegh,1:3,7:11 - 11:8 - 11:8 - 11:5 - 0:0,3,1,Papyan Karen,Nazaryan Mushegh,fiurst,Nazaryan Mushegh - Papyan Karen,72,32,40,8,-8,18,19,19,16,0,-4,3,3,6,0,8,11:7 - 8:11 - 8:11 - 5:11 - 0:0
19330206,2024-06-18 13:00:00,Hovhannesyan Rafik - Rafayelyan Edgar,0:3,9:11 - 3:11 - 9:11 - 0:0 - 0:0,0,3,Hovhannesyan Rafik,Rafayelyan Edgar,fiurst,Hovhannesyan Rafik - Rafayelyan Edgar,54,21,33,12,-12,20,14,20,0,0,2,8,2,0,0,12,9:11 - 3:11 - 9:11 - 0:0 - 0:0
19330195,2024-06-18 12:15:00,Asatryan Murad - Nazaryan Mushegh,3:0,11:6 - 11:9 - 11:8 - 0:0 - 0:0,3,0,Asatryan Murad,Nazaryan Mushegh,fiurst,Asatryan Murad - Nazaryan Mushegh,56,33,23,-10,10,17,20,19,0,0,-5,-2,-3,0,0,-10,11:6 - 11:9 - 11:8 - 0:0 - 0:0
19330194,2024-06-18 12:00:00,Hovhannesyan Rafik - Papyan Karen,2:3,11:9 - 9:11 - 11:9 - 12:14 - 4:11,2,3,Hovhannesyan Rafik,Papyan Karen,fiurst,Hovhannesyan Rafik - Papyan Karen,101,47,54,7,-7,20,20,20,26,15,-2,2,-2,2,7,7,11:9 - 9:11 - 11:9 - 12:14 - 4:11
19330193,2024-06-18 11:45:00,Rafayelyan Edgar - Asatryan Murad,3:1,11:8 - 5:11 - 8:11 - 3:11 - 0:0,1,3,Rafayelyan Edgar,Asatryan Murad,fiurst,Asatryan Murad - Rafayelyan Edgar,68,41,27,-14,14,19,16,19,14,0,3,-6,-3,-8,0,-14,8:11 - 11:5 - 11:8 - 11:3 - 0:0
19330192,2024-06-18 11:30:00,Hovhannesyan Rafik - Nazaryan Mushegh,3:0,11:5 - 11:4 - 11:6 - 0:0 - 0:0,3,0,Hovhannesyan Rafik,Nazaryan Mushegh,fiurst,Hovhannesyan Rafik - Nazaryan Mushegh,48,33,15,-18,18,16,15,17,0,0,-6,-7,-5,0,0,-18,11:5 - 11:4 - 11:6 - 0:0 - 0:0
19330190,2024-06-18 11:20:00,Papyan Karen - Rafayelyan Edgar,1:3,11:7 - 8:11 - 3:11 - 9:11 - 0:0,1,3,Papyan Karen,Rafayelyan Edgar,fiurst,Papyan Karen - Rafayelyan Edgar,71,31,40,9,-9,18,19,14,20,0,-4,3,8,2,0,9,11:7 - 8:11 - 3:11 - 9:11 - 0:0
19330172,2024-06-18 11:05:00,Asatryan Murad - Hovhannesyan Rafik,3:1,11:8 - 11:5 - 9:11 - 13:11 - 0:0,3,1,Asatryan Murad,Hovhannesyan Rafik,fiurst,Asatryan Murad - Hovhannesyan Rafik,79,44,35,-9,9,19,16,20,24,0,-3,-6,2,-2,0,-9,11:8 - 11:5 - 9:11 - 13:11 - 0:0
19330169,2024-06-18 10:45:00,Nazaryan Mushegh - Rafayelyan Edgar,0:3,8:11 - 7:11 - 7:11 - 0:0 - 0:0,0,3,Nazaryan Mushegh,Rafayelyan Edgar,fiurst,Nazaryan Mushegh - Rafayelyan Edgar,55,22,33,11,-11,19,18,18,0,0,3,4,4,0,0,11,8:11 - 7:11 - 7:11 - 0:0 - 0:0
19330168,2024-06-18 10:35:00,Papyan Karen - Asatryan Murad,3:2,11:6 - 12:14 - 7:11 - 11:7 - 9:11,2,3,Papyan Karen,Asatryan Murad,fiurst,Asatryan Murad - Papyan Karen,99,49,50,1,-1,17,26,18,18,20,5,-2,-4,4,-2,1,6:11 - 14:12 - 11:7 - 7:11 - 11:9
19330167,2024-06-18 10:15:00,Rafayelyan Edgar - Hovhannesyan Rafik,0:3,11:6 - 11:5 - 11:3 - 0:0 - 0:0,3,0,Rafayelyan Edgar,Hovhannesyan Rafik,fiurst,Hovhannesyan Rafik - Rafayelyan Edgar,47,14,33,19,-19,17,16,14,0,0,5,6,8,0,0,19,6:11 - 5:11 - 3:11 - 0:0 - 0:0
19330152,2024-06-18 10:00:00,Nazaryan Mushegh - Papyan Karen,1:3,12:10 - 9:11 - 9:11 - 9:11 - 0:0,1,3,Nazaryan Mushegh,Papyan Karen,fiurst,Nazaryan Mushegh - Papyan Karen,82,39,43,4,-4,22,20,20,20,0,-2,2,2,2,0,4,12:10 - 9:11 - 9:11 - 9:11 - 0:0
19312177,2024-06-17 17:45:00,Soghomonyan Hrayr - Mkrtchyan Andranik,2:3,10:12 - 11:6 - 11:4 - 10:12 - 11:4,3,2,Soghomonyan Hrayr,Mkrtchyan Andranik,fiurst,Mkrtchyan Andranik - Soghomonyan Hrayr,91,38,53,15,-15,22,17,15,22,15,-2,5,7,-2,7,15,12:10 - 6:11 - 4:11 - 12:10 - 4:11
19312176,2024-06-17 17:30:00,Arutyunov Ruben - Petrosyan Davit,0:3,3:11 - 8:11 - 11:13 - 0:0 - 0:0,0,3,Arutyunov Ruben,Petrosyan Davit,fiurst,Arutyunov Ruben - Petrosyan Davit,57,22,35,13,-13,14,19,24,0,0,8,3,2,0,0,13,3:11 - 8:11 - 11:13 - 0:0 - 0:0
19312173,2024-06-17 17:15:00,Avakimyan Davit - Soghomonyan Hrayr,2:3,11:7 - 11:4 - 8:11 - 9:11 - 9:11,2,3,Avakimyan Davit,Soghomonyan Hrayr,fiurst,Avakimyan Davit - Soghomonyan Hrayr,92,48,44,-4,4,18,15,19,20,20,-4,-7,3,2,2,-4,11:7 - 11:4 - 8:11 - 9:11 - 9:11
19312169,2024-06-17 17:00:00,Arutyunov Ruben - Mkrtchyan Andranik,3:1,13:15 - 11:5 - 11:6 - 11:2 - 0:0,3,1,Arutyunov Ruben,Mkrtchyan Andranik,fiurst,Arutyunov Ruben - Mkrtchyan Andranik,74,46,28,-18,18,28,16,17,13,0,2,-6,-5,-9,0,-18,13:15 - 11:5 - 11:6 - 11:2 - 0:0
19312167,2024-06-17 16:45:00,Petrosyan Davit - Avakimyan Davit,3:0,4:11 - 9:11 - 3:11 - 0:0 - 0:0,0,3,Petrosyan Davit,Avakimyan Davit,fiurst,Avakimyan Davit - Petrosyan Davit,49,33,16,-17,17,15,20,14,0,0,-7,-2,-8,0,0,-17,11:4 - 11:9 - 11:3 - 0:0 - 0:0
19312165,2024-06-17 16:30:00,Soghomonyan Hrayr - Arutyunov Ruben,3:0,8:11 - 10:12 - 1:11 - 0:0 - 0:0,0,3,Soghomonyan Hrayr,Arutyunov Ruben,fiurst,Arutyunov Ruben - Soghomonyan Hrayr,53,34,19,-15,15,19,22,12,0,0,-3,-2,-10,0,0,-15,11:8 - 12:10 - 11:1 - 0:0 - 0:0
19312160,2024-06-17 16:15:00,Mkrtchyan Andranik - Avakimyan Davit,1:3,9:11 - 11:8 - 11:9 - 13:11 - 0:0,3,1,Mkrtchyan Andranik,Avakimyan Davit,fiurst,Avakimyan Davit - Mkrtchyan Andranik,83,39,44,5,-5,20,19,20,24,0,-2,3,2,2,0,5,11:9 - 8:11 - 9:11 - 11:13 - 0:0
19312147,2024-06-17 16:05:00,Petrosyan Davit - Soghomonyan Hrayr,3:0,11:9 - 11:7 - 11:2 - 0:0 - 0:0,3,0,Petrosyan Davit,Soghomonyan Hrayr,fiurst,Petrosyan Davit - Soghomonyan Hrayr,51,33,18,-15,15,20,18,13,0,0,-2,-4,-9,0,0,-15,11:9 - 11:7 - 11:2 - 0:0 - 0:0
19312145,2024-06-17 15:45:00,Avakimyan Davit - Arutyunov Ruben,3:1,11:8 - 8:11 - 4:11 - 8:11 - 0:0,1,3,Avakimyan Davit,Arutyunov Ruben,fiurst,Arutyunov Ruben - Avakimyan Davit,72,41,31,-10,10,19,19,15,19,0,3,-3,-7,-3,0,-10,8:11 - 11:8 - 11:4 - 11:8 - 0:0
19312143,2024-06-17 15:30:00,Mkrtchyan Andranik - Petrosyan Davit,2:3,12:10 - 11:6 - 7:11 - 10:12 - 8:11,2,3,Mkrtchyan Andranik,Petrosyan Davit,fiurst,Mkrtchyan Andranik - Petrosyan Davit,98,48,50,2,-2,22,17,18,22,19,-2,-5,4,2,3,2,12:10 - 11:6 - 7:11 - 10:12 - 8:11
19312141,2024-06-17 15:15:00,Nikoghosyan Narek - Gevorgyan Hayk,2:3,8:11 - 9:11 - 11:7 - 11:9 - 11:3,3,2,Nikoghosyan Narek,Gevorgyan Hayk,fiurst,Gevorgyan Hayk - Nikoghosyan Narek,91,41,50,9,-9,19,20,18,20,14,-3,-2,4,2,8,9,11:8 - 11:9 - 7:11 - 9:11 - 3:11
19312139,2024-06-17 15:00:00,Papyan Karen - Nazaryan Mushegh,1:3,11:8 - 11:9 - 9:11 - 11:7 - 0:0,3,1,Papyan Karen,Nazaryan Mushegh,fiurst,Nazaryan Mushegh - Papyan Karen,77,35,42,7,-7,19,20,20,18,0,3,2,-2,4,0,7,8:11 - 9:11 - 11:9 - 7:11 - 0:0
19312138,2024-06-17 14:45:00,Hovhannesyan Rafik - Nikoghosyan Narek,1:3,12:10 - 8:11 - 9:11 - 7:11 - 0:0,1,3,Hovhannesyan Rafik,Nikoghosyan Narek,fiurst,Hovhannesyan Rafik - Nikoghosyan Narek,79,36,43,7,-7,22,19,20,18,0,-2,3,2,4,0,7,12:10 - 8:11 - 9:11 - 7:11 - 0:0
19312134,2024-06-17 14:30:00,Gevorgyan Hayk - Papyan Karen,2:3,12:14 - 6:11 - 11:9 - 11:3 - 9:11,2,3,Gevorgyan Hayk,Papyan Karen,fiurst,Gevorgyan Hayk - Papyan Karen,97,49,48,-1,1,26,17,20,14,20,2,5,-2,-8,2,-1,12:14 - 6:11 - 11:9 - 11:3 - 9:11
19312131,2024-06-17 14:15:00,Hovhannesyan Rafik - Nazaryan Mushegh,0:3,8:11 - 5:11 - 6:11 - 0:0 - 0:0,0,3,Hovhannesyan Rafik,Nazaryan Mushegh,fiurst,Hovhannesyan Rafik - Nazaryan Mushegh,52,19,33,14,-14,19,16,17,0,0,3,6,5,0,0,14,8:11 - 5:11 - 6:11 - 0:0 - 0:0
19312124,2024-06-17 14:00:00,Nikoghosyan Narek - Papyan Karen,1:3,7:11 - 8:11 - 11:9 - 7:11 - 0:0,1,3,Nikoghosyan Narek,Papyan Karen,fiurst,Nikoghosyan Narek - Papyan Karen,75,33,42,9,-9,18,19,20,18,0,4,3,-2,4,0,9,7:11 - 8:11 - 11:9 - 7:11 - 0:0
19312122,2024-06-17 13:45:00,Gevorgyan Hayk - Hovhannesyan Rafik,0:3,6:11 - 5:11 - 8:11 - 0:0 - 0:0,0,3,Gevorgyan Hayk,Hovhannesyan Rafik,fiurst,Gevorgyan Hayk - Hovhannesyan Rafik,52,19,33,14,-14,17,16,19,0,0,5,6,3,0,0,14,6:11 - 5:11 - 8:11 - 0:0 - 0:0
19312110,2024-06-17 13:30:00,Nazaryan Mushegh - Nikoghosyan Narek,0:3,7:11 - 9:11 - 8:11 - 0:0 - 0:0,0,3,Nazaryan Mushegh,Nikoghosyan Narek,fiurst,Nazaryan Mushegh - Nikoghosyan Narek,57,24,33,9,-9,18,20,19,0,0,4,2,3,0,0,9,7:11 - 9:11 - 8:11 - 0:0 - 0:0
19312109,2024-06-17 13:15:00,Papyan Karen - Hovhannesyan Rafik,0:3,11:9 - 11:4 - 11:7 - 0:0 - 0:0,3,0,Papyan Karen,Hovhannesyan Rafik,fiurst,Hovhannesyan Rafik - Papyan Karen,53,20,33,13,-13,20,15,18,0,0,2,7,4,0,0,13,9:11 - 4:11 - 7:11 - 0:0 - 0:0
19312106,2024-06-17 13:00:00,Nazaryan Mushegh - Gevorgyan Hayk,1:3,11:9 - 15:13 - 6:11 - 11:9 - 0:0,3,1,Nazaryan Mushegh,Gevorgyan Hayk,fiurst,Gevorgyan Hayk - Nazaryan Mushegh,85,42,43,1,-1,20,28,17,20,0,2,2,-5,2,0,1,9:11 - 13:15 - 11:6 - 9:11 - 0:0
19312105,2024-06-17 12:15:00,Nikoghosyan Narek - Hovhannesyan Rafik,3:2,11:8 - 9:11 - 9:11 - 11:7 - 12:14,2,3,Nikoghosyan Narek,Hovhannesyan Rafik,fiurst,Hovhannesyan Rafik - Nikoghosyan Narek,103,51,52,1,-1,19,20,20,18,26,3,-2,-2,4,-2,1,8:11 - 11:9 - 11:9 - 7:11 - 14:12
19312095,2024-06-17 12:00:00,Nazaryan Mushegh - Papyan Karen,0:3,7:11 - 6:11 - 8:11 - 0:0 - 0:0,0,3,Nazaryan Mushegh,Papyan Karen,fiurst,Nazaryan Mushegh - Papyan Karen,54,21,33,12,-12,18,17,19,0,0,4,5,3,0,0,12,7:11 - 6:11 - 8:11 - 0:0 - 0:0
19312092,2024-06-17 11:45:00,Gevorgyan Hayk - Nikoghosyan Narek,0:3,2:11 - 7:11 - 7:11 - 0:0 - 0:0,0,3,Gevorgyan Hayk,Nikoghosyan Narek,fiurst,Gevorgyan Hayk - Nikoghosyan Narek,49,16,33,17,-17,13,18,18,0,0,9,4,4,0,0,17,2:11 - 7:11 - 7:11 - 0:0 - 0:0
19312084,2024-06-17 11:30:00,Nazaryan Mushegh - Hovhannesyan Rafik,3:0,7:11 - 6:11 - 5:11 - 0:0 - 0:0,0,3,Nazaryan Mushegh,Hovhannesyan Rafik,fiurst,Hovhannesyan Rafik - Nazaryan Mushegh,51,33,18,-15,15,18,17,16,0,0,-4,-5,-6,0,0,-15,11:7 - 11:6 - 11:5 - 0:0 - 0:0
19312074,2024-06-17 11:15:00,Papyan Karen - Gevorgyan Hayk,0:3,11:7 - 12:10 - 14:12 - 0:0 - 0:0,3,0,Papyan Karen,Gevorgyan Hayk,fiurst,Gevorgyan Hayk - Papyan Karen,66,29,37,8,-8,18,22,26,0,0,4,2,2,0,0,8,7:11 - 10:12 - 12:14 - 0:0 - 0:0
19312068,2024-06-17 11:00:00,Nikoghosyan Narek - Nazaryan Mushegh,0:3,11:4 - 11:4 - 11:6 - 0:0 - 0:0,3,0,Nikoghosyan Narek,Nazaryan Mushegh,fiurst,Nazaryan Mushegh - Nikoghosyan Narek,47,14,33,19,-19,15,15,17,0,0,7,7,5,0,0,19,4:11 - 4:11 - 6:11 - 0:0 - 0:0
19312064,2024-06-17 10:45:00,Hovhannesyan Rafik - Gevorgyan Hayk,0:3,11:8 - 11:5 - 11:8 - 0:0 - 0:0,3,0,Hovhannesyan Rafik,Gevorgyan Hayk,fiurst,Gevorgyan Hayk - Hovhannesyan Rafik,54,21,33,12,-12,19,16,19,0,0,3,6,3,0,0,12,8:11 - 5:11 - 8:11 - 0:0 - 0:0
19312062,2024-06-17 10:30:00,Papyan Karen - Nikoghosyan Narek,1:3,11:7 - 11:5 - 6:11 - 11:9 - 0:0,3,1,Papyan Karen,Nikoghosyan Narek,fiurst,Nikoghosyan Narek - Papyan Karen,71,32,39,7,-7,18,16,17,20,0,4,6,-5,2,0,7,7:11 - 5:11 - 11:6 - 9:11 - 0:0
19312057,2024-06-17 10:15:00,Gevorgyan Hayk - Nazaryan Mushegh,1:3,5:11 - 10:12 - 11:9 - 8:11 - 0:0,1,3,Gevorgyan Hayk,Nazaryan Mushegh,fiurst,Gevorgyan Hayk - Nazaryan Mushegh,77,34,43,9,-9,16,22,20,19,0,6,2,-2,3,0,9,5:11 - 10:12 - 11:9 - 8:11 - 0:0
19312056,2024-06-17 10:00:00,Hovhannesyan Rafik - Papyan Karen,0:3,7:11 - 8:11 - 7:11 - 0:0 - 0:0,0,3,Hovhannesyan Rafik,Papyan Karen,fiurst,Hovhannesyan Rafik - Papyan Karen,55,22,33,11,-11,18,19,18,0,0,4,3,4,0,0,11,7:11 - 8:11 - 7:11 - 0:0 - 0:0
19293510,2024-06-16 17:45:00,Hakobyan Eduard - Petrosyan Davit,1:3,6:11 - 5:11 - 11:9 - 6:11 - 0:0,1,3,Hakobyan Eduard,Petrosyan Davit,fiurst,Hakobyan Eduard - Petrosyan Davit,70,28,42,14,-14,17,16,20,17,0,5,6,-2,5,0,14,6:11 - 5:11 - 11:9 - 6:11 - 0:0
19293497,2024-06-16 17:35:00,Soghomonyan Hrayr - Mkrtchyan Andranik,3:0,9:11 - 6:11 - 4:11 - 0:0 - 0:0,0,3,Soghomonyan Hrayr,Mkrtchyan Andranik,fiurst,Mkrtchyan Andranik - Soghomonyan Hrayr,52,33,19,-14,14,20,17,15,0,0,-2,-5,-7,0,0,-14,11:9 - 11:6 - 11:4 - 0:0 - 0:0
19293495,2024-06-16 17:20:00,Gevorgyan Gegham - Hakobyan Eduard,2:3,11:7 - 15:13 - 6:11 - 9:11 - 10:12,2,3,Gevorgyan Gegham,Hakobyan Eduard,fiurst,Gevorgyan Gegham - Hakobyan Eduard,105,51,54,3,-3,18,28,17,20,22,-4,-2,5,2,2,3,11:7 - 15:13 - 6:11 - 9:11 - 10:12
19293493,2024-06-16 17:00:00,Soghomonyan Hrayr - Petrosyan Davit,0:3,11:3 - 12:10 - 11:7 - 0:0 - 0:0,3,0,Soghomonyan Hrayr,Petrosyan Davit,fiurst,Petrosyan Davit - Soghomonyan Hrayr,54,20,34,14,-14,14,22,18,0,0,8,2,4,0,0,14,3:11 - 10:12 - 7:11 - 0:0 - 0:0
19293491,2024-06-16 16:50:00,Mkrtchyan Andranik - Gevorgyan Gegham,3:1,7:11 - 7:11 - 11:9 - 10:12 - 0:0,1,3,Mkrtchyan Andranik,Gevorgyan Gegham,fiurst,Gevorgyan Gegham - Mkrtchyan Andranik,78,43,35,-8,8,18,18,20,22,0,-4,-4,2,-2,0,-8,11:7 - 11:7 - 9:11 - 12:10 - 0:0
19293489,2024-06-16 16:30:00,Hakobyan Eduard - Soghomonyan Hrayr,1:3,14:12 - 9:11 - 5:11 - 4:11 - 0:0,1,3,Hakobyan Eduard,Soghomonyan Hrayr,fiurst,Hakobyan Eduard - Soghomonyan Hrayr,77,32,45,13,-13,26,20,16,15,0,-2,2,6,7,0,13,14:12 - 9:11 - 5:11 - 4:11 - 0:0
19293462,2024-06-16 16:20:00,Petrosyan Davit - Gevorgyan Gegham,1:3,6:11 - 11:7 - 11:4 - 11:5 - 0:0,3,1,Petrosyan Davit,Gevorgyan Gegham,fiurst,Gevorgyan Gegham - Petrosyan Davit,66,27,39,12,-12,17,18,15,16,0,-5,4,7,6,0,12,11:6 - 7:11 - 4:11 - 5:11 - 0:0
19293461,2024-06-16 16:00:00,Mkrtchyan Andranik - Hakobyan Eduard,3:1,7:11 - 13:11 - 5:11 - 3:11 - 0:0,1,3,Mkrtchyan Andranik,Hakobyan Eduard,fiurst,Hakobyan Eduard - Mkrtchyan Andranik,72,44,28,-16,16,18,24,16,14,0,-4,2,-6,-8,0,-16,11:7 - 11:13 - 11:5 - 11:3 - 0:0
19293457,2024-06-16 15:45:00,Gevorgyan Gegham - Soghomonyan Hrayr,1:3,11:5 - 5:11 - 8:11 - 12:14 - 0:0,1,3,Gevorgyan Gegham,Soghomonyan Hrayr,fiurst,Gevorgyan Gegham - Soghomonyan Hrayr,77,36,41,5,-5,16,16,19,26,0,-6,6,3,2,0,5,11:5 - 5:11 - 8:11 - 12:14 - 0:0
19293444,2024-06-16 15:30:00,Petrosyan Davit - Mkrtchyan Andranik,1:3,7:11 - 11:7 - 11:8 - 11:8 - 0:0,3,1,Petrosyan Davit,Mkrtchyan Andranik,fiurst,Mkrtchyan Andranik - Petrosyan Davit,74,34,40,6,-6,18,18,19,19,0,-4,4,3,3,0,6,11:7 - 7:11 - 8:11 - 8:11 - 0:0
19293442,2024-06-16 15:15:00,Nazaryan Mushegh - Papyan Karen,1:3,11:4 - 8:11 - 8:11 - 9:11 - 0:0,1,3,Nazaryan Mushegh,Papyan Karen,fiurst,Nazaryan Mushegh - Papyan Karen,73,36,37,1,-1,15,19,19,20,0,-7,3,3,2,0,1,11:4 - 8:11 - 8:11 - 9:11 - 0:0
19293440,2024-06-16 15:05:00,Rafayelyan Edgar - Nikoghosyan Narek,1:3,14:16 - 11:9 - 11:5 - 11:4 - 0:0,3,1,Rafayelyan Edgar,Nikoghosyan Narek,fiurst,Nikoghosyan Narek - Rafayelyan Edgar,81,34,47,13,-13,30,20,16,15,0,-2,2,6,7,0,13,16:14 - 9:11 - 5:11 - 4:11 - 0:0
19293439,2024-06-16 14:55:00,Gevorgyan Hayk - Nazaryan Mushegh,3:1,10:12 - 11:5 - 11:4 - 11:8 - 0:0,3,1,Gevorgyan Hayk,Nazaryan Mushegh,fiurst,Gevorgyan Hayk - Nazaryan Mushegh,72,43,29,-14,14,22,16,15,19,0,2,-6,-7,-3,0,-14,10:12 - 11:5 - 11:4 - 11:8 - 0:0
19293425,2024-06-16 14:30:00,Papyan Karen - Rafayelyan Edgar,3:1,7:11 - 11:9 - 11:5 - 11:7 - 0:0,3,1,Papyan Karen,Rafayelyan Edgar,fiurst,Papyan Karen - Rafayelyan Edgar,72,40,32,-8,8,18,20,16,18,0,4,-2,-6,-4,0,-8,7:11 - 11:9 - 11:5 - 11:7 - 0:0
19293422,2024-06-16 14:20:00,Gevorgyan Hayk - Nikoghosyan Narek,3:2,6:11 - 7:11 - 11:8 - 12:10 - 11:8,3,2,Gevorgyan Hayk,Nikoghosyan Narek,fiurst,Gevorgyan Hayk - Nikoghosyan Narek,95,47,48,1,-1,17,18,19,22,19,5,4,-3,-2,-3,1,6:11 - 7:11 - 11:8 - 12:10 - 11:8
19293415,2024-06-16 14:05:00,Nazaryan Mushegh - Rafayelyan Edgar,0:3,7:11 - 8:11 - 8:11 - 0:0 - 0:0,0,3,Nazaryan Mushegh,Rafayelyan Edgar,fiurst,Nazaryan Mushegh - Rafayelyan Edgar,56,23,33,10,-10,18,19,19,0,0,4,3,3,0,0,10,7:11 - 8:11 - 8:11 - 0:0 - 0:0
19293413,2024-06-16 13:45:00,Papyan Karen - Gevorgyan Hayk,2:3,11:6 - 8:11 - 11:7 - 7:11 - 11:9,3,2,Papyan Karen,Gevorgyan Hayk,fiurst,Gevorgyan Hayk - Papyan Karen,92,44,48,4,-4,17,19,18,18,20,5,-3,4,-4,2,4,6:11 - 11:8 - 7:11 - 11:7 - 9:11
19293411,2024-06-16 13:35:00,Nikoghosyan Narek - Nazaryan Mushegh,2:3,7:11 - 11:5 - 2:11 - 11:7 - 11:4,3,2,Nikoghosyan Narek,Nazaryan Mushegh,fiurst,Nazaryan Mushegh - Nikoghosyan Narek,80,38,42,4,-4,18,16,13,18,15,-4,6,-9,4,7,4,11:7 - 5:11 - 11:2 - 7:11 - 4:11
19293408,2024-06-16 13:15:00,Rafayelyan Edgar - Gevorgyan Hayk,0:3,11:4 - 11:1 - 11:7 - 0:0 - 0:0,3,0,Rafayelyan Edgar,Gevorgyan Hayk,fiurst,Gevorgyan Hayk - Rafayelyan Edgar,45,12,33,21,-21,15,12,18,0,0,7,10,4,0,0,21,4:11 - 1:11 - 7:11 - 0:0 - 0:0
19293402,2024-06-16 13:00:00,Nikoghosyan Narek - Papyan Karen,3:2,11:5 - 11:5 - 8:11 - 8:11 - 11:2,3,2,Nikoghosyan Narek,Papyan Karen,fiurst,Nikoghosyan Narek - Papyan Karen,83,49,34,-15,15,16,16,19,19,13,-6,-6,3,3,-9,-15,11:5 - 11:5 - 8:11 - 8:11 - 11:2
19293386,2024-06-16 12:15:00,Nazaryan Mushegh - Gevorgyan Hayk,3:1,10:12 - 11:6 - 5:11 - 6:11 - 0:0,1,3,Nazaryan Mushegh,Gevorgyan Hayk,fiurst,Gevorgyan Hayk - Nazaryan Mushegh,72,40,32,-8,8,22,17,16,17,0,-2,5,-6,-5,0,-8,12:10 - 6:11 - 11:5 - 11:6 - 0:0
19293383,2024-06-16 12:00:00,Nikoghosyan Narek - Rafayelyan Edgar,2:3,8:11 - 13:11 - 2:11 - 11:9 - 9:11,2,3,Nikoghosyan Narek,Rafayelyan Edgar,fiurst,Nikoghosyan Narek - Rafayelyan Edgar,96,43,53,10,-10,19,24,13,20,20,3,-2,9,-2,2,10,8:11 - 13:11 - 2:11 - 11:9 - 9:11
19293381,2024-06-16 11:45:00,Papyan Karen - Nazaryan Mushegh,3:1,11:9 - 8:11 - 8:11 - 6:11 - 0:0,1,3,Papyan Karen,Nazaryan Mushegh,fiurst,Nazaryan Mushegh - Papyan Karen,75,42,33,-9,9,20,19,19,17,0,2,-3,-3,-5,0,-9,9:11 - 11:8 - 11:8 - 11:6 - 0:0
19293378,2024-06-16 11:30:00,Nikoghosyan Narek - Gevorgyan Hayk,3:0,5:11 - 9:11 - 6:11 - 0:0 - 0:0,0,3,Nikoghosyan Narek,Gevorgyan Hayk,fiurst,Gevorgyan Hayk - Nikoghosyan Narek,53,33,20,-13,13,16,20,17,0,0,-6,-2,-5,0,0,-13,11:5 - 11:9 - 11:6 - 0:0 - 0:0
19293372,2024-06-16 11:15:00,Rafayelyan Edgar - Papyan Karen,2:3,11:3 - 6:11 - 11:6 - 5:11 - 11:6,3,2,Rafayelyan Edgar,Papyan Karen,fiurst,Papyan Karen - Rafayelyan Edgar,81,37,44,7,-7,14,17,17,16,17,8,-5,5,-6,5,7,3:11 - 11:6 - 6:11 - 11:5 - 6:11
19293367,2024-06-16 11:00:00,Nazaryan Mushegh - Nikoghosyan Narek,3:0,11:4 - 11:6 - 11:7 - 0:0 - 0:0,3,0,Nazaryan Mushegh,Nikoghosyan Narek,fiurst,Nazaryan Mushegh - Nikoghosyan Narek,50,33,17,-16,16,15,17,18,0,0,-7,-5,-4,0,0,-16,11:4 - 11:6 - 11:7 - 0:0 - 0:0
19293365,2024-06-16 10:45:00,Gevorgyan Hayk - Papyan Karen,1:3,7:11 - 8:11 - 11:5 - 8:11 - 0:0,1,3,Gevorgyan Hayk,Papyan Karen,fiurst,Gevorgyan Hayk - Papyan Karen,72,34,38,4,-4,18,19,16,19,0,4,3,-6,3,0,4,7:11 - 8:11 - 11:5 - 8:11 - 0:0
19293353,2024-06-16 10:30:00,Rafayelyan Edgar - Nazaryan Mushegh,0:3,11:6 - 11:7 - 12:10 - 0:0 - 0:0,3,0,Rafayelyan Edgar,Nazaryan Mushegh,fiurst,Nazaryan Mushegh - Rafayelyan Edgar,57,23,34,11,-11,17,18,22,0,0,5,4,2,0,0,11,6:11 - 7:11 - 10:12 - 0:0 - 0:0
19293349,2024-06-16 10:15:00,Papyan Karen - Nikoghosyan Narek,0:3,12:10 - 17:15 - 11:4 - 0:0 - 0:0,3,0,Papyan Karen,Nikoghosyan Narek,fiurst,Nikoghosyan Narek - Papyan Karen,69,29,40,11,-11,22,32,15,0,0,2,2,7,0,0,11,10:12 - 15:17 - 4:11 - 0:0 - 0:0
19293346,2024-06-16 10:00:00,Gevorgyan Hayk - Rafayelyan Edgar,0:3,10:12 - 10:12 - 8:11 - 0:0 - 0:0,0,3,Gevorgyan Hayk,Rafayelyan Edgar,fiurst,Gevorgyan Hayk - Rafayelyan Edgar,63,28,35,7,-7,22,22,19,0,0,2,2,3,0,0,7,10:12 - 10:12 - 8:11 - 0:0 - 0:0
19276420,2024-06-15 17:45:00,Hakobyan Eduard - Avakimyan Davit,0:3,12:10 - 11:7 - 13:11 - 0:0 - 0:0,3,0,Hakobyan Eduard,Avakimyan Davit,fiurst,Avakimyan Davit - Hakobyan Eduard,64,28,36,8,-8,22,18,24,0,0,2,4,2,0,0,8,10:12 - 7:11 - 11:13 - 0:0 - 0:0
19276418,2024-06-15 17:30:00,Arutyunov Ruben - Gevorgyan Gegham,3:0,11:9 - 11:3 - 11:5 - 0:0 - 0:0,3,0,Arutyunov Ruben,Gevorgyan Gegham,fiurst,Arutyunov Ruben - Gevorgyan Gegham,50,33,17,-16,16,20,14,16,0,0,-2,-8,-6,0,0,-16,11:9 - 11:3 - 11:5 - 0:0 - 0:0
19276417,2024-06-15 17:15:00,Mkrtchyan Andranik - Hakobyan Eduard,3:0,5:11 - 8:11 - 9:11 - 0:0 - 0:0,0,3,Mkrtchyan Andranik,Hakobyan Eduard,fiurst,Hakobyan Eduard - Mkrtchyan Andranik,55,33,22,-11,11,16,19,20,0,0,-6,-3,-2,0,0,-11,11:5 - 11:8 - 11:9 - 0:0 - 0:0
19276416,2024-06-15 17:00:00,Arutyunov Ruben - Avakimyan Davit,3:1,11:5 - 8:11 - 12:10 - 11:5 - 0:0,3,1,Arutyunov Ruben,Avakimyan Davit,fiurst,Arutyunov Ruben - Avakimyan Davit,73,42,31,-11,11,16,19,22,16,0,-6,3,-2,-6,0,-11,11:5 - 8:11 - 12:10 - 11:5 - 0:0
19276415,2024-06-15 16:45:00,Gevorgyan Gegham - Mkrtchyan Andranik,3:0,11:5 - 11:4 - 11:9 - 0:0 - 0:0,3,0,Gevorgyan Gegham,Mkrtchyan Andranik,fiurst,Gevorgyan Gegham - Mkrtchyan Andranik,51,33,18,-15,15,16,15,20,0,0,-6,-7,-2,0,0,-15,11:5 - 11:4 - 11:9 - 0:0 - 0:0
19276414,2024-06-15 16:30:00,Hakobyan Eduard - Arutyunov Ruben,0:3,11:8 - 11:7 - 11:6 - 0:0 - 0:0,3,0,Hakobyan Eduard,Arutyunov Ruben,fiurst,Arutyunov Ruben - Hakobyan Eduard,54,21,33,12,-12,19,18,17,0,0,3,4,5,0,0,12,8:11 - 7:11 - 6:11 - 0:0 - 0:0
19276413,2024-06-15 16:15:00,Avakimyan Davit - Mkrtchyan Andranik,3:1,15:13 - 11:8 - 10:12 - 11:4 - 0:0,3,1,Avakimyan Davit,Mkrtchyan Andranik,fiurst,Avakimyan Davit - Mkrtchyan Andranik,84,47,37,-10,10,28,19,22,15,0,-2,-3,2,-7,0,-10,15:13 - 11:8 - 10:12 - 11:4 - 0:0
19276410,2024-06-15 16:00:00,Gevorgyan Gegham - Hakobyan Eduard,1:3,11:8 - 5:11 - 8:11 - 10:12 - 0:0,1,3,Gevorgyan Gegham,Hakobyan Eduard,fiurst,Gevorgyan Gegham - Hakobyan Eduard,76,34,42,8,-8,19,16,19,22,0,-3,6,3,2,0,8,11:8 - 5:11 - 8:11 - 10:12 - 0:0
19276400,2024-06-15 15:45:00,Mkrtchyan Andranik - Arutyunov Ruben,3:0,7:11 - 9:11 - 7:11 - 0:0 - 0:0,0,3,Mkrtchyan Andranik,Arutyunov Ruben,fiurst,Arutyunov Ruben - Mkrtchyan Andranik,56,33,23,-10,10,18,20,18,0,0,-4,-2,-4,0,0,-10,11:7 - 11:9 - 11:7 - 0:0 - 0:0
19276399,2024-06-15 15:30:00,Avakimyan Davit - Gevorgyan Gegham,3:0,11:7 - 11:3 - 11:5 - 0:0 - 0:0,3,0,Avakimyan Davit,Gevorgyan Gegham,fiurst,Avakimyan Davit - Gevorgyan Gegham,48,33,15,-18,18,18,14,16,0,0,-4,-8,-6,0,0,-18,11:7 - 11:3 - 11:5 - 0:0 - 0:0
19276395,2024-06-15 15:15:00,Nikoghosyan Narek - Hovhannesyan Rafik,3:0,5:11 - 1:11 - 2:11 - 0:0 - 0:0,0,3,Nikoghosyan Narek,Hovhannesyan Rafik,fiurst,Hovhannesyan Rafik - Nikoghosyan Narek,41,33,8,-25,25,16,12,13,0,0,-6,-10,-9,0,0,-25,11:5 - 11:1 - 11:2 - 0:0 - 0:0
19276394,2024-06-15 15:00:00,Rafayelyan Edgar - Nazaryan Mushegh,0:3,11:5 - 11:7 - 11:7 - 0:0 - 0:0,3,0,Rafayelyan Edgar,Nazaryan Mushegh,fiurst,Nazaryan Mushegh - Rafayelyan Edgar,52,19,33,14,-14,16,18,18,0,0,6,4,4,0,0,14,5:11 - 7:11 - 7:11 - 0:0 - 0:0
19276379,2024-06-15 14:50:00,Asatryan Murad - Nikoghosyan Narek,3:0,11:7 - 11:3 - 11:6 - 0:0 - 0:0,3,0,Asatryan Murad,Nikoghosyan Narek,fiurst,Asatryan Murad - Nikoghosyan Narek,49,33,16,-17,17,18,14,17,0,0,-4,-8,-5,0,0,-17,11:7 - 11:3 - 11:6 - 0:0 - 0:0
19276378,2024-06-15 14:40:00,Hovhannesyan Rafik - Rafayelyan Edgar,0:3,9:11 - 8:11 - 7:11 - 0:0 - 0:0,0,3,Hovhannesyan Rafik,Rafayelyan Edgar,fiurst,Hovhannesyan Rafik - Rafayelyan Edgar,57,24,33,9,-9,20,19,18,0,0,2,3,4,0,0,9,9:11 - 8:11 - 7:11 - 0:0 - 0:0
19276345,2024-06-15 14:20:00,Asatryan Murad - Nazaryan Mushegh,1:3,8:11 - 5:11 - 11:6 - 10:12 - 0:0,1,3,Asatryan Murad,Nazaryan Mushegh,fiurst,Asatryan Murad - Nazaryan Mushegh,74,34,40,6,-6,19,16,17,22,0,3,6,-5,2,0,6,8:11 - 5:11 - 11:6 - 10:12 - 0:0
19276337,2024-06-15 14:10:00,Nikoghosyan Narek - Rafayelyan Edgar,0:3,10:12 - 13:15 - 6:11 - 0:0 - 0:0,0,3,Nikoghosyan Narek,Rafayelyan Edgar,fiurst,Nikoghosyan Narek - Rafayelyan Edgar,67,29,38,9,-9,22,28,17,0,0,2,2,5,0,0,9,10:12 - 13:15 - 6:11 - 0:0 - 0:0
19276328,2024-06-15 14:05:00,Hovhannesyan Rafik - Asatryan Murad,3:0,8:11 - 1:11 - 7:11 - 0:0 - 0:0,0,3,Hovhannesyan Rafik,Asatryan Murad,fiurst,Asatryan Murad - Hovhannesyan Rafik,49,33,16,-17,17,19,12,18,0,0,-3,-10,-4,0,0,-17,11:8 - 11:1 - 11:7 - 0:0 - 0:0
19276327,2024-06-15 13:30:00,Nazaryan Mushegh - Nikoghosyan Narek,0:3,6:11 - 8:11 - 10:12 - 0:0 - 0:0,0,3,Nazaryan Mushegh,Nikoghosyan Narek,fiurst,Nazaryan Mushegh - Nikoghosyan Narek,58,24,34,10,-10,17,19,22,0,0,5,3,2,0,0,10,6:11 - 8:11 - 10:12 - 0:0 - 0:0
19276320,2024-06-15 13:15:00,Rafayelyan Edgar - Asatryan Murad,2:3,11:7 - 17:19 - 15:13 - 5:11 - 12:10,3,2,Rafayelyan Edgar,Asatryan Murad,fiurst,Asatryan Murad - Rafayelyan Edgar,120,60,60,0,0,18,36,28,16,22,4,-2,2,-6,2,0,7:11 - 19:17 - 13:15 - 11:5 - 10:12
19276318,2024-06-15 13:00:00,Nazaryan Mushegh - Hovhannesyan Rafik,3:1,5:11 - 9:11 - 11:8 - 9:11 - 0:0,1,3,Nazaryan Mushegh,Hovhannesyan Rafik,fiurst,Hovhannesyan Rafik - Nazaryan Mushegh,75,41,34,-7,7,16,20,19,20,0,-6,-2,3,-2,0,-7,11:5 - 11:9 - 8:11 - 11:9 - 0:0
19276317,2024-06-15 12:15:00,Nikoghosyan Narek - Asatryan Murad,2:3,4:11 - 11:8 - 11:6 - 7:11 - 11:6,3,2,Nikoghosyan Narek,Asatryan Murad,fiurst,Asatryan Murad - Nikoghosyan Narek,86,42,44,2,-2,15,19,17,18,17,-7,3,5,-4,5,2,11:4 - 8:11 - 6:11 - 11:7 - 6:11
19276314,2024-06-15 12:05:00,Nazaryan Mushegh - Rafayelyan Edgar,0:3,8:11 - 4:11 - 9:11 - 0:0 - 0:0,0,3,Nazaryan Mushegh,Rafayelyan Edgar,fiurst,Nazaryan Mushegh - Rafayelyan Edgar,54,21,33,12,-12,19,15,20,0,0,3,7,2,0,0,12,8:11 - 4:11 - 9:11 - 0:0 - 0:0
19276312,2024-06-15 11:45:00,Hovhannesyan Rafik - Nikoghosyan Narek,3:2,11:4 - 8:11 - 11:6 - 8:11 - 11:4,3,2,Hovhannesyan Rafik,Nikoghosyan Narek,fiurst,Hovhannesyan Rafik - Nikoghosyan Narek,85,49,36,-13,13,15,19,17,19,15,-7,3,-5,3,-7,-13,11:4 - 8:11 - 11:6 - 8:11 - 11:4
19276311,2024-06-15 11:40:00,Nazaryan Mushegh - Asatryan Murad,3:0,6:11 - 8:11 - 7:11 - 0:0 - 0:0,0,3,Nazaryan Mushegh,Asatryan Murad,fiurst,Asatryan Murad - Nazaryan Mushegh,54,33,21,-12,12,17,19,18,0,0,-5,-3,-4,0,0,-12,11:6 - 11:8 - 11:7 - 0:0 - 0:0
19276309,2024-06-15 11:15:00,Rafayelyan Edgar - Hovhannesyan Rafik,0:3,11:5 - 11:9 - 11:4 - 0:0 - 0:0,3,0,Rafayelyan Edgar,Hovhannesyan Rafik,fiurst,Hovhannesyan Rafik - Rafayelyan Edgar,51,18,33,15,-15,16,20,15,0,0,6,2,7,0,0,15,5:11 - 9:11 - 4:11 - 0:0 - 0:0
19276306,2024-06-15 11:10:00,Nikoghosyan Narek - Nazaryan Mushegh,1:3,9:11 - 11:7 - 11:6 - 11:6 - 0:0,3,1,Nikoghosyan Narek,Nazaryan Mushegh,fiurst,Nazaryan Mushegh - Nikoghosyan Narek,72,30,42,12,-12,20,18,17,17,0,-2,4,5,5,0,12,11:9 - 7:11 - 6:11 - 6:11 - 0:0
19276305,2024-06-15 10:45:00,Asatryan Murad - Hovhannesyan Rafik,3:0,11:9 - 11:3 - 11:2 - 0:0 - 0:0,3,0,Asatryan Murad,Hovhannesyan Rafik,fiurst,Asatryan Murad - Hovhannesyan Rafik,47,33,14,-19,19,20,14,13,0,0,-2,-8,-9,0,0,-19,11:9 - 11:3 - 11:2 - 0:0 - 0:0
19276304,2024-06-15 10:30:00,Rafayelyan Edgar - Nikoghosyan Narek,2:3,7:11 - 11:5 - 11:2 - 3:11 - 11:8,3,2,Rafayelyan Edgar,Nikoghosyan Narek,fiurst,Nikoghosyan Narek - Rafayelyan Edgar,80,37,43,6,-6,18,16,13,14,19,-4,6,9,-8,3,6,11:7 - 5:11 - 2:11 - 11:3 - 8:11
19276303,2024-06-15 10:15:00,Hovhannesyan Rafik - Nazaryan Mushegh,0:3,5:11 - 10:12 - 8:11 - 0:0 - 0:0,0,3,Hovhannesyan Rafik,Nazaryan Mushegh,fiurst,Hovhannesyan Rafik - Nazaryan Mushegh,57,23,34,11,-11,16,22,19,0,0,6,2,3,0,0,11,5:11 - 10:12 - 8:11 - 0:0 - 0:0
19276302,2024-06-15 10:00:00,Asatryan Murad - Rafayelyan Edgar,0:3,8:11 - 9:11 - 4:11 - 0:0 - 0:0,0,3,Asatryan Murad,Rafayelyan Edgar,fiurst,Asatryan Murad - Rafayelyan Edgar,54,21,33,12,-12,19,20,15,0,0,3,2,7,0,0,12,8:11 - 9:11 - 4:11 - 0:0 - 0:0
19262256,2024-06-14 17:45:00,Gevorgyan Gegham - Arutyunov Ruben,3:0,6:11 - 11:13 - 7:11 - 0:0 - 0:0,0,3,Gevorgyan Gegham,Arutyunov Ruben,fiurst,Arutyunov Ruben - Gevorgyan Gegham,59,35,24,-11,11,17,24,18,0,0,-5,-2,-4,0,0,-11,11:6 - 13:11 - 11:7 - 0:0 - 0:0
19262244,2024-06-14 17:30:00,Soghomonyan Hrayr - Petrosyan Davit,0:3,11:3 - 11:8 - 11:8 - 0:0 - 0:0,3,0,Soghomonyan Hrayr,Petrosyan Davit,fiurst,Petrosyan Davit - Soghomonyan Hrayr,52,19,33,14,-14,14,19,19,0,0,8,3,3,0,0,14,3:11 - 8:11 - 8:11 - 0:0 - 0:0
19262238,2024-06-14 17:15:00,Avakimyan Davit - Gevorgyan Gegham,3:1,13:11 - 10:12 - 11:5 - 13:11 - 0:0,3,1,Avakimyan Davit,Gevorgyan Gegham,fiurst,Avakimyan Davit - Gevorgyan Gegham,86,47,39,-8,8,24,22,16,24,0,-2,2,-6,-2,0,-8,13:11 - 10:12 - 11:5 - 13:11 - 0:0
19262234,2024-06-14 17:00:00,Soghomonyan Hrayr - Arutyunov Ruben,1:3,11:7 - 7:11 - 11:8 - 11:6 - 0:0,3,1,Soghomonyan Hrayr,Arutyunov Ruben,fiurst,Arutyunov Ruben - Soghomonyan Hrayr,72,32,40,8,-8,18,18,19,17,0,4,-4,3,5,0,8,7:11 - 11:7 - 8:11 - 6:11 - 0:0
19262233,2024-06-14 16:50:00,Petrosyan Davit - Avakimyan Davit,2:3,7:11 - 11:8 - 3:11 - 11:8 - 11:3,3,2,Petrosyan Davit,Avakimyan Davit,fiurst,Avakimyan Davit - Petrosyan Davit,84,41,43,2,-2,18,19,14,19,14,-4,3,-8,3,8,2,11:7 - 8:11 - 11:3 - 8:11 - 3:11
19262231,2024-06-14 16:30:00,Gevorgyan Gegham - Soghomonyan Hrayr,3:2,11:7 - 12:10 - 5:11 - 2:11 - 13:11,3,2,Gevorgyan Gegham,Soghomonyan Hrayr,fiurst,Gevorgyan Gegham - Soghomonyan Hrayr,93,43,50,7,-7,18,22,16,13,24,-4,-2,6,9,-2,7,11:7 - 12:10 - 5:11 - 2:11 - 13:11
19262228,2024-06-14 16:15:00,Arutyunov Ruben - Avakimyan Davit,3:0,11:4 - 11:4 - 11:3 - 0:0 - 0:0,3,0,Arutyunov Ruben,Avakimyan Davit,fiurst,Arutyunov Ruben - Avakimyan Davit,44,33,11,-22,22,15,15,14,0,0,-7,-7,-8,0,0,-22,11:4 - 11:4 - 11:3 - 0:0 - 0:0
19262220,2024-06-14 16:00:00,Petrosyan Davit - Gevorgyan Gegham,1:3,12:14 - 11:3 - 11:5 - 11:6 - 0:0,3,1,Petrosyan Davit,Gevorgyan Gegham,fiurst,Gevorgyan Gegham - Petrosyan Davit,73,28,45,17,-17,26,14,16,17,0,-2,8,6,5,0,17,14:12 - 3:11 - 5:11 - 6:11 - 0:0
19262211,2024-06-14 15:45:00,Avakimyan Davit - Soghomonyan Hrayr,3:1,8:11 - 11:8 - 11:6 - 11:8 - 0:0,3,1,Avakimyan Davit,Soghomonyan Hrayr,fiurst,Avakimyan Davit - Soghomonyan Hrayr,74,41,33,-8,8,19,19,17,19,0,3,-3,-5,-3,0,-8,8:11 - 11:8 - 11:6 - 11:8 - 0:0
19262201,2024-06-14 15:15:00,Gevorgyan Hayk - Rafayelyan Edgar,0:3,9:11 - 9:11 - 8:11 - 0:0 - 0:0,0,3,Gevorgyan Hayk,Rafayelyan Edgar,fiurst,Gevorgyan Hayk - Rafayelyan Edgar,59,26,33,7,-7,20,20,19,0,0,2,2,3,0,0,7,9:11 - 9:11 - 8:11 - 0:0 - 0:0
19262197,2024-06-14 15:10:00,Hovhannesyan Rafik - Asatryan Murad,0:0,0:0 - 0:0 - 0:0 - 0:0 - 0:0,0,0,Hovhannesyan Rafik,Asatryan Murad,fiurst,Asatryan Murad - Hovhannesyan Rafik,0,0,0,0,0,0,0,0,0,0,0,0,0,0,0,0,0:0 - 0:0 - 0:0 - 0:0 - 0:0
19262193,2024-06-14 14:45:00,Nikoghosyan Narek - Gevorgyan Hayk,3:0,4:11 - 8:11 - 7:11 - 0:0 - 0:0,0,3,Nikoghosyan Narek,Gevorgyan Hayk,fiurst,Gevorgyan Hayk - Nikoghosyan Narek,52,33,19,-14,14,15,19,18,0,0,-7,-3,-4,0,0,-14,11:4 - 11:8 - 11:7 - 0:0 - 0:0
19262130,2024-06-14 10:45:00,Nikoghosyan Narek - Rafayelyan Edgar,1:2,11:7 - 5:11 - 8:11 - 3:5 - 0:0,1,2,Nikoghosyan Narek,Rafayelyan Edgar,fiurst,Nikoghosyan Narek - Rafayelyan Edgar,61,27,34,7,-7,18,16,19,8,0,-4,6,3,2,0,7,11:7 - 5:11 - 8:11 - 3:5 - 0:0
19262113,2024-06-14 10:40:00,Hovhannesyan Rafik - Gevorgyan Hayk,2:2,4:11 - 8:11 - 11:5 - 11:6 - 0:0,2,2,Hovhannesyan Rafik,Gevorgyan Hayk,fiurst,Gevorgyan Hayk - Hovhannesyan Rafik,67,33,34,1,-1,15,19,16,17,0,-7,-3,6,5,0,1,11:4 - 11:8 - 5:11 - 6:11 - 0:0
19262111,2024-06-14 10:15:00,Rafayelyan Edgar - Asatryan Murad,3:1,1:11 - 6:11 - 11:5 - 8:11 - 0:0,1,3,Rafayelyan Edgar,Asatryan Murad,fiurst,Asatryan Murad - Rafayelyan Edgar,64,38,26,-12,12,12,17,16,19,0,-10,-5,6,-3,0,-12,11:1 - 11:6 - 5:11 - 11:8 - 0:0
19262108,2024-06-14 10:00:00,Nikoghosyan Narek - Hovhannesyan Rafik,2:3,12:14 - 11:8 - 11:6 - 7:11 - 11:9,3,2,Nikoghosyan Narek,Hovhannesyan Rafik,fiurst,Hovhannesyan Rafik - Nikoghosyan Narek,100,48,52,4,-4,26,19,17,18,20,-2,3,5,-4,2,4,14:12 - 8:11 - 6:11 - 11:7 - 9:11
19243906,2024-06-13 17:45:00,Hakobyan Eduard - Gevorgyan Gegham,1:3,11:9 - 11:9 - 8:11 - 11:9 - 0:0,3,1,Hakobyan Eduard,Gevorgyan Gegham,fiurst,Gevorgyan Gegham - Hakobyan Eduard,79,38,41,3,-3,20,20,19,20,0,2,2,-3,2,0,3,9:11 - 9:11 - 11:8 - 9:11 - 0:0
19243905,2024-06-13 17:30:00,Mkrtchyan Andranik - Avakimyan Davit,0:3,11:6 - 11:2 - 11:7 - 0:0 - 0:0,3,0,Mkrtchyan Andranik,Avakimyan Davit,fiurst,Avakimyan Davit - Mkrtchyan Andranik,48,15,33,18,-18,17,13,18,0,0,5,9,4,0,0,18,6:11 - 2:11 - 7:11 - 0:0 - 0:0
19243899,2024-06-13 17:15:00,Soghomonyan Hrayr - Hakobyan Eduard,1:3,11:6 - 9:11 - 11:1 - 12:10 - 0:0,3,1,Soghomonyan Hrayr,Hakobyan Eduard,fiurst,Hakobyan Eduard - Soghomonyan Hrayr,71,28,43,15,-15,17,20,12,22,0,5,-2,10,2,0,15,6:11 - 11:9 - 1:11 - 10:12 - 0:0
19243898,2024-06-13 17:00:00,Mkrtchyan Andranik - Gevorgyan Gegham,0:3,12:10 - 11:6 - 12:10 - 0:0 - 0:0,3,0,Mkrtchyan Andranik,Gevorgyan Gegham,fiurst,Gevorgyan Gegham - Mkrtchyan Andranik,61,26,35,9,-9,22,17,22,0,0,2,5,2,0,0,9,10:12 - 6:11 - 10:12 - 0:0 - 0:0
19243895,2024-06-13 16:45:00,Avakimyan Davit - Soghomonyan Hrayr,1:3,11:9 - 6:11 - 5:11 - 8:11 - 0:0,1,3,Avakimyan Davit,Soghomonyan Hrayr,fiurst,Avakimyan Davit - Soghomonyan Hrayr,72,30,42,12,-12,20,17,16,19,0,-2,5,6,3,0,12,11:9 - 6:11 - 5:11 - 8:11 - 0:0
19243863,2024-06-13 16:30:00,Hakobyan Eduard - Mkrtchyan Andranik,3:0,11:4 - 11:7 - 13:11 - 0:0 - 0:0,3,0,Hakobyan Eduard,Mkrtchyan Andranik,fiurst,Hakobyan Eduard - Mkrtchyan Andranik,57,35,22,-13,13,15,18,24,0,0,-7,-4,-2,0,0,-13,11:4 - 11:7 - 13:11 - 0:0 - 0:0
19243845,2024-06-13 16:15:00,Gevorgyan Gegham - Soghomonyan Hrayr,1:3,10:12 - 11:6 - 4:11 - 3:11 - 0:0,1,3,Gevorgyan Gegham,Soghomonyan Hrayr,fiurst,Gevorgyan Gegham - Soghomonyan Hrayr,68,28,40,12,-12,22,17,15,14,0,2,-5,7,8,0,12,10:12 - 11:6 - 4:11 - 3:11 - 0:0
19243843,2024-06-13 16:00:00,Avakimyan Davit - Hakobyan Eduard,0:3,4:11 - 5:11 - 8:11 - 0:0 - 0:0,0,3,Avakimyan Davit,Hakobyan Eduard,fiurst,Avakimyan Davit - Hakobyan Eduard,50,17,33,16,-16,15,16,19,0,0,7,6,3,0,0,16,4:11 - 5:11 - 8:11 - 0:0 - 0:0
19243841,2024-06-13 15:45:00,Soghomonyan Hrayr - Mkrtchyan Andranik,3:0,9:11 - 4:11 - 7:11 - 0:0 - 0:0,0,3,Soghomonyan Hrayr,Mkrtchyan Andranik,fiurst,Mkrtchyan Andranik - Soghomonyan Hrayr,53,33,20,-13,13,20,15,18,0,0,-2,-7,-4,0,0,-13,11:9 - 11:4 - 11:7 - 0:0 - 0:0
19243840,2024-06-13 15:30:00,Gevorgyan Gegham - Avakimyan Davit,0:3,11:5 - 11:5 - 11:8 - 0:0 - 0:0,3,0,Gevorgyan Gegham,Avakimyan Davit,fiurst,Avakimyan Davit - Gevorgyan Gegham,51,18,33,15,-15,16,16,19,0,0,6,6,3,0,0,15,5:11 - 5:11 - 8:11 - 0:0 - 0:0
19243819,2024-06-13 15:15:00,Asatryan Murad - Gevorgyan Hayk,3:0,11:9 - 11:6 - 11:7 - 0:0 - 0:0,3,0,Asatryan Murad,Gevorgyan Hayk,fiurst,Asatryan Murad - Gevorgyan Hayk,55,33,22,-11,11,20,17,18,0,0,-2,-5,-4,0,0,-11,11:9 - 11:6 - 11:7 - 0:0 - 0:0
19243818,2024-06-13 15:00:00,Nazaryan Mushegh - Nikoghosyan Narek,0:3,5:11 - 5:11 - 6:11 - 0:0 - 0:0,0,3,Nazaryan Mushegh,Nikoghosyan Narek,fiurst,Nazaryan Mushegh - Nikoghosyan Narek,49,16,33,17,-17,16,16,17,0,0,6,6,5,0,0,17,5:11 - 5:11 - 6:11 - 0:0 - 0:0
19243817,2024-06-13 14:45:00,Papyan Karen - Asatryan Murad,3:2,12:10 - 11:5 - 6:11 - 7:11 - 8:11,2,3,Papyan Karen,Asatryan Murad,fiurst,Asatryan Murad - Papyan Karen,92,48,44,-4,4,22,16,17,18,19,2,6,-5,-4,-3,-4,10:12 - 5:11 - 11:6 - 11:7 - 11:8
19243816,2024-06-13 14:30:00,Gevorgyan Hayk - Nazaryan Mushegh,3:0,13:11 - 13:11 - 11:7 - 0:0 - 0:0,3,0,Gevorgyan Hayk,Nazaryan Mushegh,fiurst,Gevorgyan Hayk - Nazaryan Mushegh,66,37,29,-8,8,24,24,18,0,0,-2,-2,-4,0,0,-8,13:11 - 13:11 - 11:7 - 0:0 - 0:0
19243814,2024-06-13 14:15:00,Papyan Karen - Nikoghosyan Narek,3:1,11:6 - 8:11 - 5:11 - 3:11 - 0:0,1,3,Papyan Karen,Nikoghosyan Narek,fiurst,Nikoghosyan Narek - Papyan Karen,66,39,27,-12,12,17,19,16,14,0,5,-3,-6,-8,0,-12,6:11 - 11:8 - 11:5 - 11:3 - 0:0
19243812,2024-06-13 14:00:00,Asatryan Murad - Nazaryan Mushegh,3:0,11:9 - 11:4 - 13:11 - 0:0 - 0:0,3,0,Asatryan Murad,Nazaryan Mushegh,fiurst,Asatryan Murad - Nazaryan Mushegh,59,35,24,-11,11,20,15,24,0,0,-2,-7,-2,0,0,-11,11:9 - 11:4 - 13:11 - 0:0 - 0:0
19243810,2024-06-13 13:45:00,Gevorgyan Hayk - Papyan Karen,3:1,11:7 - 11:4 - 7:11 - 11:6 - 0:0,3,1,Gevorgyan Hayk,Papyan Karen,fiurst,Gevorgyan Hayk - Papyan Karen,68,40,28,-12,12,18,15,18,17,0,-4,-7,4,-5,0,-12,11:7 - 11:4 - 7:11 - 11:6 - 0:0
19243780,2024-06-13 13:35:00,Nikoghosyan Narek - Asatryan Murad,3:0,6:11 - 6:11 - 6:11 - 0:0 - 0:0,0,3,Nikoghosyan Narek,Asatryan Murad,fiurst,Asatryan Murad - Nikoghosyan Narek,51,33,18,-15,15,17,17,17,0,0,-5,-5,-5,0,0,-15,11:6 - 11:6 - 11:6 - 0:0 - 0:0
19243779,2024-06-13 13:15:00,Nazaryan Mushegh - Papyan Karen,2:3,11:6 - 11:6 - 6:11 - 10:12 - 7:11,2,3,Nazaryan Mushegh,Papyan Karen,fiurst,Nazaryan Mushegh - Papyan Karen,91,45,46,1,-1,17,17,17,22,18,-5,-5,5,2,4,1,11:6 - 11:6 - 6:11 - 10:12 - 7:11
19243775,2024-06-13 13:10:00,Nikoghosyan Narek - Gevorgyan Hayk,0:3,11:4 - 11:9 - 11:6 - 0:0 - 0:0,3,0,Nikoghosyan Narek,Gevorgyan Hayk,fiurst,Gevorgyan Hayk - Nikoghosyan Narek,52,19,33,14,-14,15,20,17,0,0,7,2,5,0,0,14,4:11 - 9:11 - 6:11 - 0:0 - 0:0
19243727,2024-06-13 12:15:00,Asatryan Murad - Papyan Karen,3:1,5:11 - 15:13 - 11:7 - 12:10 - 0:0,3,1,Asatryan Murad,Papyan Karen,fiurst,Asatryan Murad - Papyan Karen,84,43,41,-2,2,16,28,18,22,0,6,-2,-4,-2,0,-2,5:11 - 15:13 - 11:7 - 12:10 - 0:0
19243680,2024-06-13 12:10:00,Nikoghosyan Narek - Nazaryan Mushegh,0:3,11:8 - 11:6 - 11:7 - 0:0 - 0:0,3,0,Nikoghosyan Narek,Nazaryan Mushegh,fiurst,Nazaryan Mushegh - Nikoghosyan Narek,54,21,33,12,-12,19,17,18,0,0,3,5,4,0,0,12,8:11 - 6:11 - 7:11 - 0:0 - 0:0
19243667,2024-06-13 11:45:00,Gevorgyan Hayk - Asatryan Murad,3:0,7:11 - 4:11 - 9:11 - 0:0 - 0:0,0,3,Gevorgyan Hayk,Asatryan Murad,fiurst,Asatryan Murad - Gevorgyan Hayk,53,33,20,-13,13,18,15,20,0,0,-4,-7,-2,0,0,-13,11:7 - 11:4 - 11:9 - 0:0 - 0:0
19243666,2024-06-13 11:30:00,Nikoghosyan Narek - Papyan Karen,2:3,9:11 - 13:11 - 6:11 - 11:5 - 11:13,2,3,Nikoghosyan Narek,Papyan Karen,fiurst,Nikoghosyan Narek - Papyan Karen,101,50,51,1,-1,20,24,17,16,24,2,-2,5,-6,2,1,9:11 - 13:11 - 6:11 - 11:5 - 11:13
19243665,2024-06-13 11:15:00,Nazaryan Mushegh - Gevorgyan Hayk,3:0,8:11 - 4:11 - 8:11 - 0:0 - 0:0,0,3,Nazaryan Mushegh,Gevorgyan Hayk,fiurst,Gevorgyan Hayk - Nazaryan Mushegh,53,33,20,-13,13,19,15,19,0,0,-3,-7,-3,0,0,-13,11:8 - 11:4 - 11:8 - 0:0 - 0:0
19243664,2024-06-13 11:00:00,Asatryan Murad - Nikoghosyan Narek,3:0,11:3 - 12:10 - 13:11 - 0:0 - 0:0,3,0,Asatryan Murad,Nikoghosyan Narek,fiurst,Asatryan Murad - Nikoghosyan Narek,60,36,24,-12,12,14,22,24,0,0,-8,-2,-2,0,0,-12,11:3 - 12:10 - 13:11 - 0:0 - 0:0
19243662,2024-06-13 10:45:00,Papyan Karen - Gevorgyan Hayk,0:3,11:7 - 11:6 - 11:9 - 0:0 - 0:0,3,0,Papyan Karen,Gevorgyan Hayk,fiurst,Gevorgyan Hayk - Papyan Karen,55,22,33,11,-11,18,17,20,0,0,4,5,2,0,0,11,7:11 - 6:11 - 9:11 - 0:0 - 0:0
19243651,2024-06-13 10:30:00,Nazaryan Mushegh - Asatryan Murad,3:0,9:11 - 6:11 - 6:11 - 0:0 - 0:0,0,3,Nazaryan Mushegh,Asatryan Murad,fiurst,Asatryan Murad - Nazaryan Mushegh,54,33,21,-12,12,20,17,17,0,0,-2,-5,-5,0,0,-12,11:9 - 11:6 - 11:6 - 0:0 - 0:0
19243646,2024-06-13 10:15:00,Gevorgyan Hayk - Nikoghosyan Narek,1:3,8:11 - 11:6 - 4:11 - 9:11 - 0:0,1,3,Gevorgyan Hayk,Nikoghosyan Narek,fiurst,Gevorgyan Hayk - Nikoghosyan Narek,71,32,39,7,-7,19,17,15,20,0,3,-5,7,2,0,7,8:11 - 11:6 - 4:11 - 9:11 - 0:0
19243644,2024-06-13 10:10:00,Papyan Karen - Nazaryan Mushegh,3:1,10:12 - 11:7 - 5:11 - 9:11 - 0:0,1,3,Papyan Karen,Nazaryan Mushegh,fiurst,Nazaryan Mushegh - Papyan Karen,76,41,35,-6,6,22,18,16,20,0,-2,4,-6,-2,0,-6,12:10 - 7:11 - 11:5 - 11:9 - 0:0
19224592,2024-06-12 17:45:00,Hakobyan Eduard - Petrosyan Davit,3:2,11:7 - 5:11 - 7:11 - 11:4 - 11:8,3,2,Hakobyan Eduard,Petrosyan Davit,fiurst,Hakobyan Eduard - Petrosyan Davit,86,45,41,-4,4,18,16,18,15,19,-4,6,4,-7,-3,-4,11:7 - 5:11 - 7:11 - 11:4 - 11:8
19224580,2024-06-12 17:30:00,Soghomonyan Hrayr - Mkrtchyan Andranik,3:2,5:11 - 11:9 - 11:13 - 11:7 - 6:11,2,3,Soghomonyan Hrayr,Mkrtchyan Andranik,fiurst,Mkrtchyan Andranik - Soghomonyan Hrayr,95,51,44,-7,7,16,20,24,18,17,-6,2,-2,4,-5,-7,11:5 - 9:11 - 13:11 - 7:11 - 11:6
19224578,2024-06-12 17:20:00,Arutyunov Ruben - Hakobyan Eduard,3:0,11:7 - 11:8 - 11:1 - 0:0 - 0:0,3,0,Arutyunov Ruben,Hakobyan Eduard,fiurst,Arutyunov Ruben - Hakobyan Eduard,49,33,16,-17,17,18,19,12,0,0,-4,-3,-10,0,0,-17,11:7 - 11:8 - 11:1 - 0:0 - 0:0
19224547,2024-06-12 17:00:00,Soghomonyan Hrayr - Petrosyan Davit,3:0,7:11 - 10:12 - 3:11 - 0:0 - 0:0,0,3,Soghomonyan Hrayr,Petrosyan Davit,fiurst,Petrosyan Davit - Soghomonyan Hrayr,54,34,20,-14,14,18,22,14,0,0,-4,-2,-8,0,0,-14,11:7 - 12:10 - 11:3 - 0:0 - 0:0
19224546,2024-06-12 16:45:00,Mkrtchyan Andranik - Arutyunov Ruben,1:3,8:11 - 11:9 - 11:9 - 11:6 - 0:0,3,1,Mkrtchyan Andranik,Arutyunov Ruben,fiurst,Arutyunov Ruben - Mkrtchyan Andranik,76,35,41,6,-6,19,20,20,17,0,-3,2,2,5,0,6,11:8 - 9:11 - 9:11 - 6:11 - 0:0
19224544,2024-06-12 16:30:00,Hakobyan Eduard - Soghomonyan Hrayr,1:3,11:9 - 6:11 - 5:11 - 6:11 - 0:0,1,3,Hakobyan Eduard,Soghomonyan Hrayr,fiurst,Hakobyan Eduard - Soghomonyan Hrayr,70,28,42,14,-14,20,17,16,17,0,-2,5,6,5,0,14,11:9 - 6:11 - 5:11 - 6:11 - 0:0
19224543,2024-06-12 16:15:00,Petrosyan Davit - Arutyunov Ruben,3:0,5:11 - 9:11 - 7:11 - 0:0 - 0:0,0,3,Petrosyan Davit,Arutyunov Ruben,fiurst,Arutyunov Ruben - Petrosyan Davit,54,33,21,-12,12,16,20,18,0,0,-6,-2,-4,0,0,-12,11:5 - 11:9 - 11:7 - 0:0 - 0:0
19224542,2024-06-12 16:00:00,Mkrtchyan Andranik - Hakobyan Eduard,3:1,10:12 - 6:11 - 12:10 - 4:11 - 0:0,1,3,Mkrtchyan Andranik,Hakobyan Eduard,fiurst,Hakobyan Eduard - Mkrtchyan Andranik,76,44,32,-12,12,22,17,22,15,0,-2,-5,2,-7,0,-12,12:10 - 11:6 - 10:12 - 11:4 - 0:0
19224528,2024-06-12 15:45:00,Arutyunov Ruben - Soghomonyan Hrayr,3:1,11:9 - 11:6 - 6:11 - 11:9 - 0:0,3,1,Arutyunov Ruben,Soghomonyan Hrayr,fiurst,Arutyunov Ruben - Soghomonyan Hrayr,74,39,35,-4,4,20,17,17,20,0,-2,-5,5,-2,0,-4,11:9 - 11:6 - 6:11 - 11:9 - 0:0
19224517,2024-06-12 15:30:00,Petrosyan Davit - Mkrtchyan Andranik,0:3,11:6 - 11:5 - 14:12 - 0:0 - 0:0,3,0,Petrosyan Davit,Mkrtchyan Andranik,fiurst,Mkrtchyan Andranik - Petrosyan Davit,59,23,36,13,-13,17,16,26,0,0,5,6,2,0,0,13,6:11 - 5:11 - 12:14 - 0:0 - 0:0
19224514,2024-06-12 15:15:00,Papyan Karen - Rafayelyan Edgar,1:3,4:11 - 6:11 - 11:7 - 7:11 - 0:0,1,3,Papyan Karen,Rafayelyan Edgar,fiurst,Papyan Karen - Rafayelyan Edgar,68,28,40,12,-12,15,17,18,18,0,7,5,-4,4,0,12,4:11 - 6:11 - 11:7 - 7:11 - 0:0
19224513,2024-06-12 15:00:00,Asatryan Murad - Gevorgyan Hayk,3:0,11:9 - 11:6 - 11:6 - 0:0 - 0:0,3,0,Asatryan Murad,Gevorgyan Hayk,fiurst,Asatryan Murad - Gevorgyan Hayk,54,33,21,-12,12,20,17,17,0,0,-2,-5,-5,0,0,-12,11:9 - 11:6 - 11:6 - 0:0 - 0:0
19224512,2024-06-12 14:55:00,Hovhannesyan Rafik - Papyan Karen,3:0,11:5 - 11:8 - 11:4 - 0:0 - 0:0,3,0,Hovhannesyan Rafik,Papyan Karen,fiurst,Hovhannesyan Rafik - Papyan Karen,50,33,17,-16,16,16,19,15,0,0,-6,-3,-7,0,0,-16,11:5 - 11:8 - 11:4 - 0:0 - 0:0
19224510,2024-06-12 14:30:00,Rafayelyan Edgar - Asatryan Murad,0:3,11:9 - 11:9 - 11:8 - 0:0 - 0:0,3,0,Rafayelyan Edgar,Asatryan Murad,fiurst,Asatryan Murad - Rafayelyan Edgar,59,26,33,7,-7,20,20,19,0,0,2,2,3,0,0,7,9:11 - 9:11 - 8:11 - 0:0 - 0:0
19224508,2024-06-12 14:25:00,Hovhannesyan Rafik - Gevorgyan Hayk,1:3,7:11 - 11:9 - 11:5 - 11:9 - 0:0,3,1,Hovhannesyan Rafik,Gevorgyan Hayk,fiurst,Gevorgyan Hayk - Hovhannesyan Rafik,74,34,40,6,-6,18,20,16,20,0,-4,2,6,2,0,6,11:7 - 9:11 - 5:11 - 9:11 - 0:0
19224505,2024-06-12 14:00:00,Papyan Karen - Asatryan Murad,3:2,7:11 - 12:14 - 11:9 - 11:8 - 5:11,2,3,Papyan Karen,Asatryan Murad,fiurst,Asatryan Murad - Papyan Karen,99,53,46,-7,7,18,26,20,19,16,-4,-2,2,3,-6,-7,11:7 - 14:12 - 9:11 - 8:11 - 11:5
19224504,2024-06-12 13:55:00,Rafayelyan Edgar - Hovhannesyan Rafik,0:3,11:6 - 11:8 - 11:5 - 0:0 - 0:0,3,0,Rafayelyan Edgar,Hovhannesyan Rafik,fiurst,Hovhannesyan Rafik - Rafayelyan Edgar,52,19,33,14,-14,17,19,16,0,0,5,3,6,0,0,14,6:11 - 8:11 - 5:11 - 0:0 - 0:0
19224503,2024-06-12 13:35:00,Gevorgyan Hayk - Papyan Karen,3:1,9:11 - 11:7 - 11:5 - 11:8 - 0:0,3,1,Gevorgyan Hayk,Papyan Karen,fiurst,Gevorgyan Hayk - Papyan Karen,73,42,31,-11,11,20,18,16,19,0,2,-4,-6,-3,0,-11,9:11 - 11:7 - 11:5 - 11:8 - 0:0
19224482,2024-06-12 13:15:00,Asatryan Murad - Hovhannesyan Rafik,3:1,11:4 - 11:3 - 9:11 - 11:8 - 0:0,3,1,Asatryan Murad,Hovhannesyan Rafik,fiurst,Asatryan Murad - Hovhannesyan Rafik,68,42,26,-16,16,15,14,20,19,0,-7,-8,2,-3,0,-16,11:4 - 11:3 - 9:11 - 11:8 - 0:0
19224481,2024-06-12 13:00:00,Gevorgyan Hayk - Rafayelyan Edgar,2:3,11:6 - 7:11 - 11:5 - 3:11 - 6:11,2,3,Gevorgyan Hayk,Rafayelyan Edgar,fiurst,Gevorgyan Hayk - Rafayelyan Edgar,82,38,44,6,-6,17,18,16,14,17,-5,4,-6,8,5,6,11:6 - 7:11 - 11:5 - 3:11 - 6:11
19224480,2024-06-12 12:20:00,Papyan Karen - Hovhannesyan Rafik,2:3,11:1 - 6:11 - 9:11 - 11:8 - 11:7,3,2,Papyan Karen,Hovhannesyan Rafik,fiurst,Hovhannesyan Rafik - Papyan Karen,86,38,48,10,-10,12,17,20,19,18,10,-5,-2,3,4,10,1:11 - 11:6 - 11:9 - 8:11 - 7:11
19224466,2024-06-12 12:05:00,Gevorgyan Hayk - Asatryan Murad,3:0,6:11 - 5:11 - 9:11 - 0:0 - 0:0,0,3,Gevorgyan Hayk,Asatryan Murad,fiurst,Asatryan Murad - Gevorgyan Hayk,53,33,20,-13,13,17,16,20,0,0,-5,-6,-2,0,0,-13,11:6 - 11:5 - 11:9 - 0:0 - 0:0
19224465,2024-06-12 11:45:00,Rafayelyan Edgar - Papyan Karen,2:3,7:11 - 11:9 - 9:11 - 11:8 - 12:10,3,2,Rafayelyan Edgar,Papyan Karen,fiurst,Papyan Karen - Rafayelyan Edgar,99,49,50,1,-1,18,20,20,19,22,-4,2,-2,3,2,1,11:7 - 9:11 - 11:9 - 8:11 - 10:12
19224464,2024-06-12 11:30:00,Gevorgyan Hayk - Hovhannesyan Rafik,2:3,11:9 - 5:11 - 7:11 - 13:11 - 10:12,2,3,Gevorgyan Hayk,Hovhannesyan Rafik,fiurst,Gevorgyan Hayk - Hovhannesyan Rafik,100,46,54,8,-8,20,16,18,24,22,-2,6,4,-2,2,8,11:9 - 5:11 - 7:11 - 13:11 - 10:12
19224463,2024-06-12 11:15:00,Asatryan Murad - Rafayelyan Edgar,3:0,11:4 - 11:7 - 11:7 - 0:0 - 0:0,3,0,Asatryan Murad,Rafayelyan Edgar,fiurst,Asatryan Murad - Rafayelyan Edgar,51,33,18,-15,15,15,18,18,0,0,-7,-4,-4,0,0,-15,11:4 - 11:7 - 11:7 - 0:0 - 0:0
19224453,2024-06-12 11:00:00,Papyan Karen - Gevorgyan Hayk,0:3,11:3 - 11:9 - 11:9 - 0:0 - 0:0,3,0,Papyan Karen,Gevorgyan Hayk,fiurst,Gevorgyan Hayk - Papyan Karen,54,21,33,12,-12,14,20,20,0,0,8,2,2,0,0,12,3:11 - 9:11 - 9:11 - 0:0 - 0:0
19224451,2024-06-12 10:45:00,Hovhannesyan Rafik - Rafayelyan Edgar,1:3,6:11 - 11:9 - 5:11 - 4:11 - 0:0,1,3,Hovhannesyan Rafik,Rafayelyan Edgar,fiurst,Hovhannesyan Rafik - Rafayelyan Edgar,68,26,42,16,-16,17,20,16,15,0,5,-2,6,7,0,16,6:11 - 11:9 - 5:11 - 4:11 - 0:0
19224437,2024-06-12 10:30:00,Asatryan Murad - Papyan Karen,3:0,11:6 - 11:4 - 11:6 - 0:0 - 0:0,3,0,Asatryan Murad,Papyan Karen,fiurst,Asatryan Murad - Papyan Karen,49,33,16,-17,17,17,15,17,0,0,-5,-7,-5,0,0,-17,11:6 - 11:4 - 11:6 - 0:0 - 0:0
19224436,2024-06-12 10:15:00,Rafayelyan Edgar - Gevorgyan Hayk,0:3,11:6 - 11:4 - 11:8 - 0:0 - 0:0,3,0,Rafayelyan Edgar,Gevorgyan Hayk,fiurst,Gevorgyan Hayk - Rafayelyan Edgar,51,18,33,15,-15,17,15,19,0,0,5,7,3,0,0,15,6:11 - 4:11 - 8:11 - 0:0 - 0:0
19224435,2024-06-12 10:00:00,Hovhannesyan Rafik - Asatryan Murad,3:0,3:11 - 5:11 - 7:11 - 0:0 - 0:0,0,3,Hovhannesyan Rafik,Asatryan Murad,fiurst,Asatryan Murad - Hovhannesyan Rafik,48,33,15,-18,18,14,16,18,0,0,-8,-6,-4,0,0,-18,11:3 - 11:5 - 11:7 - 0:0 - 0:0
19203059,2024-06-11 17:50:00,Hakobyan Eduard - Soghomonyan Hrayr,1:3,11:5 - 8:11 - 6:11 - 9:11 - 0:0,1,3,Hakobyan Eduard,Soghomonyan Hrayr,fiurst,Hakobyan Eduard - Soghomonyan Hrayr,72,34,38,4,-4,16,19,17,20,0,-6,3,5,2,0,4,11:5 - 8:11 - 6:11 - 9:11 - 0:0
19203055,2024-06-11 17:35:00,Arutyunov Ruben - Gevorgyan Gegham,3:2,11:4 - 5:11 - 11:8 - 7:11 - 11:7,3,2,Arutyunov Ruben,Gevorgyan Gegham,fiurst,Arutyunov Ruben - Gevorgyan Gegham,86,45,41,-4,4,15,16,19,18,18,-7,6,-3,4,-4,-4,11:4 - 5:11 - 11:8 - 7:11 - 11:7
19203052,2024-06-11 17:15:00,Petrosyan Davit - Hakobyan Eduard,3:1,7:11 - 11:9 - 5:11 - 11:13 - 0:0,1,3,Petrosyan Davit,Hakobyan Eduard,fiurst,Hakobyan Eduard - Petrosyan Davit,78,44,34,-10,10,18,20,16,24,0,-4,2,-6,-2,0,-10,11:7 - 9:11 - 11:5 - 13:11 - 0:0
19203050,2024-06-11 17:00:00,Arutyunov Ruben - Soghomonyan Hrayr,3:2,11:7 - 11:13 - 11:7 - 8:11 - 11:6,3,2,Arutyunov Ruben,Soghomonyan Hrayr,fiurst,Arutyunov Ruben - Soghomonyan Hrayr,96,52,44,-8,8,18,24,18,19,17,-4,2,-4,3,-5,-8,11:7 - 11:13 - 11:7 - 8:11 - 11:6
19203047,2024-06-11 16:45:00,Gevorgyan Gegham - Petrosyan Davit,1:3,10:12 - 6:11 - 11:7 - 8:11 - 0:0,1,3,Gevorgyan Gegham,Petrosyan Davit,fiurst,Gevorgyan Gegham - Petrosyan Davit,76,35,41,6,-6,22,17,18,19,0,2,5,-4,3,0,6,10:12 - 6:11 - 11:7 - 8:11 - 0:0
19203042,2024-06-11 16:30:00,Hakobyan Eduard - Arutyunov Ruben,3:0,12:14 - 5:11 - 6:11 - 0:0 - 0:0,0,3,Hakobyan Eduard,Arutyunov Ruben,fiurst,Arutyunov Ruben - Hakobyan Eduard,59,36,23,-13,13,26,16,17,0,0,-2,-6,-5,0,0,-13,14:12 - 11:5 - 11:6 - 0:0 - 0:0
19203037,2024-06-11 16:15:00,Soghomonyan Hrayr - Petrosyan Davit,0:3,11:8 - 11:7 - 11:8 - 0:0 - 0:0,3,0,Soghomonyan Hrayr,Petrosyan Davit,fiurst,Petrosyan Davit - Soghomonyan Hrayr,56,23,33,10,-10,19,18,19,0,0,3,4,3,0,0,10,8:11 - 7:11 - 8:11 - 0:0 - 0:0
19203033,2024-06-11 16:10:00,Gevorgyan Gegham - Hakobyan Eduard,0:3,11:13 - 6:11 - 7:11 - 0:0 - 0:0,0,3,Gevorgyan Gegham,Hakobyan Eduard,fiurst,Gevorgyan Gegham - Hakobyan Eduard,59,24,35,11,-11,24,17,18,0,0,2,5,4,0,0,11,11:13 - 6:11 - 7:11 - 0:0 - 0:0
19203032,2024-06-11 15:45:00,Petrosyan Davit - Arutyunov Ruben,3:2,11:7 - 13:11 - 6:11 - 3:11 - 5:11,2,3,Petrosyan Davit,Arutyunov Ruben,fiurst,Arutyunov Ruben - Petrosyan Davit,89,51,38,-13,13,18,24,17,14,16,4,2,-5,-8,-6,-13,7:11 - 11:13 - 11:6 - 11:3 - 11:5
19203030,2024-06-11 15:30:00,Soghomonyan Hrayr - Gevorgyan Gegham,2:3,11:7 - 7:11 - 11:13 - 11:6 - 11:8,3,2,Soghomonyan Hrayr,Gevorgyan Gegham,fiurst,Gevorgyan Gegham - Soghomonyan Hrayr,96,45,51,6,-6,18,18,24,17,19,4,-4,-2,5,3,6,7:11 - 11:7 - 13:11 - 6:11 - 8:11
19203029,2024-06-11 15:15:00,Hovhannesyan Rafik - Gevorgyan Hayk,0:3,11:8 - 11:8 - 11:5 - 0:0 - 0:0,3,0,Hovhannesyan Rafik,Gevorgyan Hayk,fiurst,Gevorgyan Hayk - Hovhannesyan Rafik,54,21,33,12,-12,19,19,16,0,0,3,3,6,0,0,12,8:11 - 8:11 - 5:11 - 0:0 - 0:0
19203026,2024-06-11 15:10:00,Nikoghosyan Narek - Nazaryan Mushegh,1:3,11:4 - 11:8 - 6:11 - 11:4 - 0:0,3,1,Nikoghosyan Narek,Nazaryan Mushegh,fiurst,Nazaryan Mushegh - Nikoghosyan Narek,66,27,39,12,-12,15,19,17,15,0,7,3,-5,7,0,12,4:11 - 8:11 - 11:6 - 4:11 - 0:0
19203024,2024-06-11 14:45:00,Rafayelyan Edgar - Hovhannesyan Rafik,1:3,11:9 - 5:11 - 11:7 - 11:9 - 0:0,3,1,Rafayelyan Edgar,Hovhannesyan Rafik,fiurst,Hovhannesyan Rafik - Rafayelyan Edgar,74,36,38,2,-2,20,16,18,20,0,2,-6,4,2,0,2,9:11 - 11:5 - 7:11 - 9:11 - 0:0
19203021,2024-06-11 14:40:00,Gevorgyan Hayk - Nikoghosyan Narek,2:3,9:11 - 11:4 - 11:9 - 7:11 - 7:11,2,3,Gevorgyan Hayk,Nikoghosyan Narek,fiurst,Gevorgyan Hayk - Nikoghosyan Narek,91,45,46,1,-1,20,15,20,18,18,2,-7,-2,4,4,1,9:11 - 11:4 - 11:9 - 7:11 - 7:11
19203020,2024-06-11 14:15:00,Rafayelyan Edgar - Nazaryan Mushegh,0:3,11:7 - 11:6 - 11:6 - 0:0 - 0:0,3,0,Rafayelyan Edgar,Nazaryan Mushegh,fiurst,Nazaryan Mushegh - Rafayelyan Edgar,52,19,33,14,-14,18,17,17,0,0,4,5,5,0,0,14,7:11 - 6:11 - 6:11 - 0:0 - 0:0
19203019,2024-06-11 14:00:00,Hovhannesyan Rafik - Nikoghosyan Narek,2:3,11:6 - 7:11 - 8:11 - 11:7 - 3:11,2,3,Hovhannesyan Rafik,Nikoghosyan Narek,fiurst,Hovhannesyan Rafik - Nikoghosyan Narek,86,40,46,6,-6,17,18,19,18,14,-5,4,3,-4,8,6,11:6 - 7:11 - 8:11 - 11:7 - 3:11
19203017,2024-06-11 13:45:00,Gevorgyan Hayk - Rafayelyan Edgar,1:3,7:11 - 5:11 - 11:9 - 7:11 - 0:0,1,3,Gevorgyan Hayk,Rafayelyan Edgar,fiurst,Gevorgyan Hayk - Rafayelyan Edgar,72,30,42,12,-12,18,16,20,18,0,4,6,-2,4,0,12,7:11 - 5:11 - 11:9 - 7:11 - 0:0
19203003,2024-06-11 13:40:00,Nazaryan Mushegh - Hovhannesyan Rafik,3:0,6:11 - 10:12 - 9:11 - 0:0 - 0:0,0,3,Nazaryan Mushegh,Hovhannesyan Rafik,fiurst,Hovhannesyan Rafik - Nazaryan Mushegh,59,34,25,-9,9,17,22,20,0,0,-5,-2,-2,0,0,-9,11:6 - 12:10 - 11:9 - 0:0 - 0:0
19202997,2024-06-11 13:15:00,Nikoghosyan Narek - Rafayelyan Edgar,0:3,9:11 - 4:11 - 8:11 - 0:0 - 0:0,0,3,Nikoghosyan Narek,Rafayelyan Edgar,fiurst,Nikoghosyan Narek - Rafayelyan Edgar,54,21,33,12,-12,20,15,19,0,0,2,7,3,0,0,12,9:11 - 4:11 - 8:11 - 0:0 - 0:0
19202996,2024-06-11 13:10:00,Nazaryan Mushegh - Gevorgyan Hayk,1:3,8:11 - 13:11 - 11:7 - 11:7 - 0:0,3,1,Nazaryan Mushegh,Gevorgyan Hayk,fiurst,Gevorgyan Hayk - Nazaryan Mushegh,79,36,43,7,-7,19,24,18,18,0,-3,2,4,4,0,7,11:8 - 11:13 - 7:11 - 7:11 - 0:0
19202978,2024-06-11 12:20:00,Hovhannesyan Rafik - Rafayelyan Edgar,1:3,14:12 - 7:11 - 7:11 - 6:11 - 0:0,1,3,Hovhannesyan Rafik,Rafayelyan Edgar,fiurst,Hovhannesyan Rafik - Rafayelyan Edgar,79,34,45,11,-11,26,18,18,17,0,-2,4,4,5,0,11,14:12 - 7:11 - 7:11 - 6:11 - 0:0
19202973,2024-06-11 12:10:00,Nazaryan Mushegh - Nikoghosyan Narek,1:3,8:11 - 11:5 - 7:11 - 5:11 - 0:0,1,3,Nazaryan Mushegh,Nikoghosyan Narek,fiurst,Nazaryan Mushegh - Nikoghosyan Narek,69,31,38,7,-7,19,16,18,16,0,3,-6,4,6,0,7,8:11 - 11:5 - 7:11 - 5:11 - 0:0
19202965,2024-06-11 11:50:00,Gevorgyan Hayk - Hovhannesyan Rafik,1:3,12:10 - 8:11 - 7:11 - 9:11 - 0:0,1,3,Gevorgyan Hayk,Hovhannesyan Rafik,fiurst,Gevorgyan Hayk - Hovhannesyan Rafik,79,36,43,7,-7,22,19,18,20,0,-2,3,4,2,0,7,12:10 - 8:11 - 7:11 - 9:11 - 0:0
19202964,2024-06-11 11:40:00,Nazaryan Mushegh - Rafayelyan Edgar,2:3,8:11 - 11:9 - 11:9 - 6:11 - 2:11,2,3,Nazaryan Mushegh,Rafayelyan Edgar,fiurst,Nazaryan Mushegh - Rafayelyan Edgar,89,38,51,13,-13,19,20,20,17,13,3,-2,-2,5,9,13,8:11 - 11:9 - 11:9 - 6:11 - 2:11
19202961,2024-06-11 11:20:00,Nikoghosyan Narek - Gevorgyan Hayk,0:3,11:7 - 11:8 - 11:9 - 0:0 - 0:0,3,0,Nikoghosyan Narek,Gevorgyan Hayk,fiurst,Gevorgyan Hayk - Nikoghosyan Narek,57,24,33,9,-9,18,19,20,0,0,4,3,2,0,0,9,7:11 - 8:11 - 9:11 - 0:0 - 0:0
19202960,2024-06-11 11:15:00,Hovhannesyan Rafik - Nazaryan Mushegh,2:3,11:6 - 9:11 - 11:9 - 6:11 - 9:11,2,3,Hovhannesyan Rafik,Nazaryan Mushegh,fiurst,Hovhannesyan Rafik - Nazaryan Mushegh,94,46,48,2,-2,17,20,20,17,20,-5,2,-2,5,2,2,11:6 - 9:11 - 11:9 - 6:11 - 9:11
19202958,2024-06-11 10:45:00,Rafayelyan Edgar - Gevorgyan Hayk,1:3,11:1 - 9:11 - 11:4 - 11:4 - 0:0,3,1,Rafayelyan Edgar,Gevorgyan Hayk,fiurst,Gevorgyan Hayk - Rafayelyan Edgar,62,20,42,22,-22,12,20,15,15,0,10,-2,7,7,0,22,1:11 - 11:9 - 4:11 - 4:11 - 0:0
19202954,2024-06-11 10:35:00,Nikoghosyan Narek - Hovhannesyan Rafik,3:2,11:5 - 8:11 - 11:4 - 8:11 - 12:14,2,3,Nikoghosyan Narek,Hovhannesyan Rafik,fiurst,Hovhannesyan Rafik - Nikoghosyan Narek,95,45,50,5,-5,16,19,15,19,26,6,-3,7,-3,-2,5,5:11 - 11:8 - 4:11 - 11:8 - 14:12
19202953,2024-06-11 10:15:00,Gevorgyan Hayk - Nazaryan Mushegh,1:3,5:11 - 5:11 - 11:8 - 6:11 - 0:0,1,3,Gevorgyan Hayk,Nazaryan Mushegh,fiurst,Gevorgyan Hayk - Nazaryan Mushegh,68,27,41,14,-14,16,16,19,17,0,6,6,-3,5,0,14,5:11 - 5:11 - 11:8 - 6:11 - 0:0
19202951,2024-06-11 10:00:00,Rafayelyan Edgar - Nikoghosyan Narek,2:3,11:6 - 7:11 - 9:11 - 11:9 - 11:6,3,2,Rafayelyan Edgar,Nikoghosyan Narek,fiurst,Nikoghosyan Narek - Rafayelyan Edgar,92,43,49,6,-6,17,18,20,20,17,5,-4,-2,2,5,6,6:11 - 11:7 - 11:9 - 9:11 - 6:11
19183509,2024-06-10 17:50:00,Arutyunov Ruben - Mkrtchyan Andranik,3:0,11:3 - 11:6 - 11:3 - 0:0 - 0:0,3,0,Arutyunov Ruben,Mkrtchyan Andranik,fiurst,Arutyunov Ruben - Mkrtchyan Andranik,45,33,12,-21,21,14,17,14,0,0,-8,-5,-8,0,0,-21,11:3 - 11:6 - 11:3 - 0:0 - 0:0
19183504,2024-06-10 17:30:00,Petrosyan Davit - Gevorgyan Gegham,0:3,12:10 - 11:4 - 12:10 - 0:0 - 0:0,3,0,Petrosyan Davit,Gevorgyan Gegham,fiurst,Gevorgyan Gegham - Petrosyan Davit,59,24,35,11,-11,22,15,22,0,0,2,7,2,0,0,11,10:12 - 4:11 - 10:12 - 0:0 - 0:0
19183488,2024-06-10 17:15:00,Soghomonyan Hrayr - Arutyunov Ruben,3:1,11:7 - 7:11 - 9:11 - 6:11 - 0:0,1,3,Soghomonyan Hrayr,Arutyunov Ruben,fiurst,Arutyunov Ruben - Soghomonyan Hrayr,73,40,33,-7,7,18,18,20,17,0,4,-4,-2,-5,0,-7,7:11 - 11:7 - 11:9 - 11:6 - 0:0
19183486,2024-06-10 17:00:00,Petrosyan Davit - Mkrtchyan Andranik,3:1,7:11 - 11:9 - 9:11 - 2:11 - 0:0,1,3,Petrosyan Davit,Mkrtchyan Andranik,fiurst,Mkrtchyan Andranik - Petrosyan Davit,71,42,29,-13,13,18,20,20,13,0,-4,2,-2,-9,0,-13,11:7 - 9:11 - 11:9 - 11:2 - 0:0
19183485,2024-06-10 16:45:00,Gevorgyan Gegham - Soghomonyan Hrayr,1:3,9:11 - 13:11 - 6:11 - 9:11 - 0:0,1,3,Gevorgyan Gegham,Soghomonyan Hrayr,fiurst,Gevorgyan Gegham - Soghomonyan Hrayr,81,37,44,7,-7,20,24,17,20,0,2,-2,5,2,0,7,9:11 - 13:11 - 6:11 - 9:11 - 0:0
19183483,2024-06-10 16:30:00,Arutyunov Ruben - Petrosyan Davit,3:0,11:8 - 11:6 - 11:7 - 0:0 - 0:0,3,0,Arutyunov Ruben,Petrosyan Davit,fiurst,Arutyunov Ruben - Petrosyan Davit,54,33,21,-12,12,19,17,18,0,0,-3,-5,-4,0,0,-12,11:8 - 11:6 - 11:7 - 0:0 - 0:0
19183481,2024-06-10 16:15:00,Mkrtchyan Andranik - Soghomonyan Hrayr,0:3,7:11 - 6:11 - 9:11 - 0:0 - 0:0,0,3,Mkrtchyan Andranik,Soghomonyan Hrayr,fiurst,Mkrtchyan Andranik - Soghomonyan Hrayr,55,22,33,11,-11,18,17,20,0,0,4,5,2,0,0,11,7:11 - 6:11 - 9:11 - 0:0 - 0:0
19183476,2024-06-10 16:00:00,Gevorgyan Gegham - Arutyunov Ruben,3:1,9:11 - 6:11 - 12:10 - 5:11 - 0:0,1,3,Gevorgyan Gegham,Arutyunov Ruben,fiurst,Arutyunov Ruben - Gevorgyan Gegham,75,43,32,-11,11,20,17,22,16,0,-2,-5,2,-6,0,-11,11:9 - 11:6 - 10:12 - 11:5 - 0:0
19183464,2024-06-10 15:45:00,Soghomonyan Hrayr - Petrosyan Davit,3:1,7:11 - 9:11 - 17:15 - 8:11 - 0:0,1,3,Soghomonyan Hrayr,Petrosyan Davit,fiurst,Petrosyan Davit - Soghomonyan Hrayr,89,48,41,-7,7,18,20,32,19,0,-4,-2,2,-3,0,-7,11:7 - 11:9 - 15:17 - 11:8 - 0:0
19183455,2024-06-10 15:30:00,Mkrtchyan Andranik - Gevorgyan Gegham,0:3,11:9 - 17:15 - 15:13 - 0:0 - 0:0,3,0,Mkrtchyan Andranik,Gevorgyan Gegham,fiurst,Gevorgyan Gegham - Mkrtchyan Andranik,80,37,43,6,-6,20,32,28,0,0,2,2,2,0,0,6,9:11 - 15:17 - 13:15 - 0:0 - 0:0
19183448,2024-06-10 15:15:00,Nazaryan Mushegh - Papyan Karen,3:1,11:5 - 7:11 - 12:10 - 11:7 - 0:0,3,1,Nazaryan Mushegh,Papyan Karen,fiurst,Nazaryan Mushegh - Papyan Karen,74,41,33,-8,8,16,18,22,18,0,-6,4,-2,-4,0,-8,11:5 - 7:11 - 12:10 - 11:7 - 0:0
19183447,2024-06-10 15:05:00,Hovhannesyan Rafik - Nikoghosyan Narek,3:2,8:11 - 11:7 - 11:5 - 7:11 - 11:9,3,2,Hovhannesyan Rafik,Nikoghosyan Narek,fiurst,Hovhannesyan Rafik - Nikoghosyan Narek,91,48,43,-5,5,19,18,16,18,20,3,-4,-6,4,-2,-5,8:11 - 11:7 - 11:5 - 7:11 - 11:9
19183443,2024-06-10 14:45:00,Diaryan Aleksandr - Nazaryan Mushegh,3:0,11:5 - 11:7 - 11:8 - 0:0 - 0:0,3,0,Diaryan Aleksandr,Nazaryan Mushegh,fiurst,Diaryan Aleksandr - Nazaryan Mushegh,53,33,20,-13,13,16,18,19,0,0,-6,-4,-3,0,0,-13,11:5 - 11:7 - 11:8 - 0:0 - 0:0
19183437,2024-06-10 14:30:00,Papyan Karen - Hovhannesyan Rafik,3:2,12:10 - 19:17 - 4:11 - 12:14 - 6:11,2,3,Papyan Karen,Hovhannesyan Rafik,fiurst,Hovhannesyan Rafik - Papyan Karen,116,63,53,-10,10,22,36,15,26,17,2,2,-7,-2,-5,-10,10:12 - 17:19 - 11:4 - 14:12 - 11:6
19183424,2024-06-10 14:15:00,Diaryan Aleksandr - Nikoghosyan Narek,1:3,8:11 - 5:11 - 13:11 - 11:13 - 0:0,1,3,Diaryan Aleksandr,Nikoghosyan Narek,fiurst,Diaryan Aleksandr - Nikoghosyan Narek,83,37,46,9,-9,19,16,24,24,0,3,6,-2,2,0,9,8:11 - 5:11 - 13:11 - 11:13 - 0:0
19183423,2024-06-10 14:00:00,Nazaryan Mushegh - Hovhannesyan Rafik,3:0,7:11 - 3:11 - 7:11 - 0:0 - 0:0,0,3,Nazaryan Mushegh,Hovhannesyan Rafik,fiurst,Hovhannesyan Rafik - Nazaryan Mushegh,50,33,17,-16,16,18,14,18,0,0,-4,-8,-4,0,0,-16,11:7 - 11:3 - 11:7 - 0:0 - 0:0
19183421,2024-06-10 13:45:00,Papyan Karen - Diaryan Aleksandr,3:0,6:11 - 6:11 - 6:11 - 0:0 - 0:0,0,3,Papyan Karen,Diaryan Aleksandr,fiurst,Diaryan Aleksandr - Papyan Karen,51,33,18,-15,15,17,17,17,0,0,-5,-5,-5,0,0,-15,11:6 - 11:6 - 11:6 - 0:0 - 0:0
19183420,2024-06-10 13:40:00,Nikoghosyan Narek - Nazaryan Mushegh,0:3,11:6 - 11:6 - 11:9 - 0:0 - 0:0,3,0,Nikoghosyan Narek,Nazaryan Mushegh,fiurst,Nazaryan Mushegh - Nikoghosyan Narek,54,21,33,12,-12,17,17,20,0,0,5,5,2,0,0,12,6:11 - 6:11 - 9:11 - 0:0 - 0:0
19183418,2024-06-10 13:15:00,Hovhannesyan Rafik - Diaryan Aleksandr,3:1,15:13 - 6:11 - 6:11 - 8:11 - 0:0,1,3,Hovhannesyan Rafik,Diaryan Aleksandr,fiurst,Diaryan Aleksandr - Hovhannesyan Rafik,81,46,35,-11,11,28,17,17,19,0,2,-5,-5,-3,0,-11,13:15 - 11:6 - 11:6 - 11:8 - 0:0
19183412,2024-06-10 13:00:00,Nikoghosyan Narek - Papyan Karen,2:3,7:11 - 8:11 - 11:7 - 11:8 - 10:12,2,3,Nikoghosyan Narek,Papyan Karen,fiurst,Nikoghosyan Narek - Papyan Karen,96,47,49,2,-2,18,19,18,19,22,4,3,-4,-3,2,2,7:11 - 8:11 - 11:7 - 11:8 - 10:12
19183410,2024-06-10 12:20:00,Nazaryan Mushegh - Diaryan Aleksandr,3:1,3:11 - 12:10 - 4:11 - 6:11 - 0:0,1,3,Nazaryan Mushegh,Diaryan Aleksandr,fiurst,Diaryan Aleksandr - Nazaryan Mushegh,68,43,25,-18,18,14,22,15,17,0,-8,2,-7,-5,0,-18,11:3 - 10:12 - 11:4 - 11:6 - 0:0
19183393,2024-06-10 12:05:00,Nikoghosyan Narek - Hovhannesyan Rafik,1:3,11:4 - 10:12 - 12:10 - 14:12 - 0:0,3,1,Nikoghosyan Narek,Hovhannesyan Rafik,fiurst,Hovhannesyan Rafik - Nikoghosyan Narek,85,38,47,9,-9,15,22,22,26,0,7,-2,2,2,0,9,4:11 - 12:10 - 10:12 - 12:14 - 0:0
19183388,2024-06-10 11:50:00,Papyan Karen - Nazaryan Mushegh,3:2,11:7 - 9:11 - 8:11 - 13:11 - 4:11,2,3,Papyan Karen,Nazaryan Mushegh,fiurst,Nazaryan Mushegh - Papyan Karen,96,51,45,-6,6,18,20,19,24,15,4,-2,-3,2,-7,-6,7:11 - 11:9 - 11:8 - 11:13 - 11:4
19183387,2024-06-10 11:30:00,Nikoghosyan Narek - Diaryan Aleksandr,3:0,6:11 - 6:11 - 8:11 - 0:0 - 0:0,0,3,Nikoghosyan Narek,Diaryan Aleksandr,fiurst,Diaryan Aleksandr - Nikoghosyan Narek,53,33,20,-13,13,17,17,19,0,0,-5,-5,-3,0,0,-13,11:6 - 11:6 - 11:8 - 0:0 - 0:0
19183383,2024-06-10 11:15:00,Hovhannesyan Rafik - Papyan Karen,1:3,9:11 - 8:11 - 11:7 - 9:11 - 0:0,1,3,Hovhannesyan Rafik,Papyan Karen,fiurst,Hovhannesyan Rafik - Papyan Karen,77,37,40,3,-3,20,19,18,20,0,2,3,-4,2,0,3,9:11 - 8:11 - 11:7 - 9:11 - 0:0
19183381,2024-06-10 11:00:00,Nazaryan Mushegh - Nikoghosyan Narek,0:3,7:11 - 9:11 - 5:11 - 0:0 - 0:0,0,3,Nazaryan Mushegh,Nikoghosyan Narek,fiurst,Nazaryan Mushegh - Nikoghosyan Narek,54,21,33,12,-12,18,20,16,0,0,4,2,6,0,0,12,7:11 - 9:11 - 5:11 - 0:0 - 0:0
19183379,2024-06-10 10:50:00,Diaryan Aleksandr - Papyan Karen,3:1,11:3 - 11:6 - 6:11 - 11:5 - 0:0,3,1,Diaryan Aleksandr,Papyan Karen,fiurst,Diaryan Aleksandr - Papyan Karen,64,39,25,-14,14,14,17,17,16,0,-8,-5,5,-6,0,-14,11:3 - 11:6 - 6:11 - 11:5 - 0:0
19183377,2024-06-10 10:30:00,Hovhannesyan Rafik - Nazaryan Mushegh,3:0,11:9 - 11:3 - 11:9 - 0:0 - 0:0,3,0,Hovhannesyan Rafik,Nazaryan Mushegh,fiurst,Hovhannesyan Rafik - Nazaryan Mushegh,54,33,21,-12,12,20,14,20,0,0,-2,-8,-2,0,0,-12,11:9 - 11:3 - 11:9 - 0:0 - 0:0
19183375,2024-06-10 10:15:00,Papyan Karen - Nikoghosyan Narek,3:1,11:5 - 10:12 - 9:11 - 12:14 - 0:0,1,3,Papyan Karen,Nikoghosyan Narek,fiurst,Nikoghosyan Narek - Papyan Karen,84,42,42,0,0,16,22,20,26,0,6,-2,-2,-2,0,0,5:11 - 12:10 - 11:9 - 14:12 - 0:0
19183366,2024-06-10 10:00:00,Diaryan Aleksandr - Hovhannesyan Rafik,3:0,11:5 - 11:6 - 11:4 - 0:0 - 0:0,3,0,Diaryan Aleksandr,Hovhannesyan Rafik,fiurst,Diaryan Aleksandr - Hovhannesyan Rafik,48,33,15,-18,18,16,17,15,0,0,-6,-5,-7,0,0,-18,11:5 - 11:6 - 11:4 - 0:0 - 0:0
19169112,2024-06-09 17:45:00,Hakobyan Eduard - Petrosyan Davit,3:0,11:8 - 11:4 - 12:10 - 0:0 - 0:0,3,0,Hakobyan Eduard,Petrosyan Davit,fiurst,Hakobyan Eduard - Petrosyan Davit,56,34,22,-12,12,19,15,22,0,0,-3,-7,-2,0,0,-12,11:8 - 11:4 - 12:10 - 0:0 - 0:0
19169110,2024-06-09 17:30:00,Avakimyan Davit - Mkrtchyan Andranik,0:3,7:11 - 8:11 - 8:11 - 0:0 - 0:0,0,3,Avakimyan Davit,Mkrtchyan Andranik,fiurst,Avakimyan Davit - Mkrtchyan Andranik,56,23,33,10,-10,18,19,19,0,0,4,3,3,0,0,10,7:11 - 8:11 - 8:11 - 0:0 - 0:0
19169109,2024-06-09 17:15:00,Gevorgyan Gegham - Hakobyan Eduard,2:3,8:11 - 11:7 - 11:8 - 8:11 - 8:11,2,3,Gevorgyan Gegham,Hakobyan Eduard,fiurst,Gevorgyan Gegham - Hakobyan Eduard,94,46,48,2,-2,19,18,19,19,19,3,-4,-3,3,3,2,8:11 - 11:7 - 11:8 - 8:11 - 8:11
19169105,2024-06-09 17:00:00,Avakimyan Davit - Petrosyan Davit,2:3,11:8 - 11:8 - 10:12 - 10:12 - 4:11,2,3,Avakimyan Davit,Petrosyan Davit,fiurst,Avakimyan Davit - Petrosyan Davit,97,46,51,5,-5,19,19,22,22,15,-3,-3,2,2,7,5,11:8 - 11:8 - 10:12 - 10:12 - 4:11
19169081,2024-06-09 16:50:00,Mkrtchyan Andranik - Gevorgyan Gegham,3:0,6:11 - 5:11 - 3:11 - 0:0 - 0:0,0,3,Mkrtchyan Andranik,Gevorgyan Gegham,fiurst,Gevorgyan Gegham - Mkrtchyan Andranik,47,33,14,-19,19,17,16,14,0,0,-5,-6,-8,0,0,-19,11:6 - 11:5 - 11:3 - 0:0 - 0:0
19169075,2024-06-09 16:30:00,Hakobyan Eduard - Avakimyan Davit,0:3,13:11 - 11:3 - 11:5 - 0:0 - 0:0,3,0,Hakobyan Eduard,Avakimyan Davit,fiurst,Avakimyan Davit - Hakobyan Eduard,54,19,35,16,-16,24,14,16,0,0,2,8,6,0,0,16,11:13 - 3:11 - 5:11 - 0:0 - 0:0
19169073,2024-06-09 16:20:00,Petrosyan Davit - Gevorgyan Gegham,1:3,11:9 - 11:9 - 10:12 - 11:8 - 0:0,3,1,Petrosyan Davit,Gevorgyan Gegham,fiurst,Gevorgyan Gegham - Petrosyan Davit,81,38,43,5,-5,20,20,22,19,0,2,2,-2,3,0,5,9:11 - 9:11 - 12:10 - 8:11 - 0:0
19169071,2024-06-09 16:00:00,Mkrtchyan Andranik - Hakobyan Eduard,3:1,1:11 - 9:11 - 13:11 - 9:11 - 0:0,1,3,Mkrtchyan Andranik,Hakobyan Eduard,fiurst,Hakobyan Eduard - Mkrtchyan Andranik,76,44,32,-12,12,12,20,24,20,0,-10,-2,2,-2,0,-12,11:1 - 11:9 - 11:13 - 11:9 - 0:0
19169069,2024-06-09 15:50:00,Gevorgyan Gegham - Avakimyan Davit,1:3,12:10 - 9:11 - 11:8 - 11:6 - 0:0,3,1,Gevorgyan Gegham,Avakimyan Davit,fiurst,Avakimyan Davit - Gevorgyan Gegham,78,35,43,8,-8,22,20,19,17,0,2,-2,3,5,0,8,10:12 - 11:9 - 8:11 - 6:11 - 0:0
19169067,2024-06-09 15:30:00,Petrosyan Davit - Mkrtchyan Andranik,3:1,10:12 - 11:9 - 10:12 - 11:13 - 0:0,1,3,Petrosyan Davit,Mkrtchyan Andranik,fiurst,Mkrtchyan Andranik - Petrosyan Davit,88,46,42,-4,4,22,20,22,24,0,-2,2,-2,-2,0,-4,12:10 - 9:11 - 12:10 - 13:11 - 0:0
19185315,2024-06-09 15:15:00,Hakobyan Eduard - Gevorgyan Gegham,3:1,9:11 - 12:14 - 11:7 - 4:11 - 0:0,1,3,Hakobyan Eduard,Gevorgyan Gegham,fiurst,Gevorgyan Gegham - Hakobyan Eduard,79,43,36,-7,7,20,26,18,15,0,-2,-2,4,-7,0,-7,11:9 - 14:12 - 7:11 - 11:4 - 0:0
19185314,2024-06-09 15:00:00,Petrosyan Davit - Avakimyan Davit,0:3,11:3 - 11:6 - 11:6 - 0:0 - 0:0,3,0,Petrosyan Davit,Avakimyan Davit,fiurst,Avakimyan Davit - Petrosyan Davit,48,15,33,18,-18,14,17,17,0,0,8,5,5,0,0,18,3:11 - 6:11 - 6:11 - 0:0 - 0:0
19169062,2024-06-09 14:45:00,Papyan Karen - Nikoghosyan Narek,0:3,11:8 - 12:10 - 11:6 - 0:0 - 0:0,3,0,Papyan Karen,Nikoghosyan Narek,fiurst,Nikoghosyan Narek - Papyan Karen,58,24,34,10,-10,19,22,17,0,0,3,2,5,0,0,10,8:11 - 10:12 - 6:11 - 0:0 - 0:0
19169061,2024-06-09 14:30:00,Diaryan Aleksandr - Asatryan Murad,0:3,11:7 - 11:7 - 11:6 - 0:0 - 0:0,3,0,Diaryan Aleksandr,Asatryan Murad,fiurst,Asatryan Murad - Diaryan Aleksandr,53,20,33,13,-13,18,18,17,0,0,4,4,5,0,0,13,7:11 - 7:11 - 6:11 - 0:0 - 0:0
19169055,2024-06-09 14:00:00,Nikoghosyan Narek - Asatryan Murad,3:1,11:7 - 8:11 - 14:16 - 10:12 - 0:0,1,3,Nikoghosyan Narek,Asatryan Murad,fiurst,Asatryan Murad - Nikoghosyan Narek,89,46,43,-3,3,18,19,30,22,0,4,-3,-2,-2,0,-3,7:11 - 11:8 - 16:14 - 12:10 - 0:0
19169043,2024-06-09 13:45:00,Diaryan Aleksandr - Papyan Karen,3:1,11:9 - 11:4 - 7:11 - 11:8 - 0:0,3,1,Diaryan Aleksandr,Papyan Karen,fiurst,Diaryan Aleksandr - Papyan Karen,72,40,32,-8,8,20,15,18,19,0,-2,-7,4,-3,0,-8,11:9 - 11:4 - 7:11 - 11:8 - 0:0
19169037,2024-06-09 13:15:00,Asatryan Murad - Papyan Karen,3:1,11:3 - 11:9 - 5:11 - 15:13 - 0:0,3,1,Asatryan Murad,Papyan Karen,fiurst,Asatryan Murad - Papyan Karen,78,42,36,-6,6,14,20,16,28,0,-8,-2,6,-2,0,-6,11:3 - 11:9 - 5:11 - 15:13 - 0:0
19169065,2024-06-09 13:00:00,Nikoghosyan Narek - Diaryan Aleksandr,3:0,10:12 - 7:11 - 10:12 - 0:0 - 0:0,0,3,Nikoghosyan Narek,Diaryan Aleksandr,fiurst,Diaryan Aleksandr - Nikoghosyan Narek,62,35,27,-8,8,22,18,22,0,0,-2,-4,-2,0,0,-8,12:10 - 11:7 - 12:10 - 0:0 - 0:0
19169025,2024-06-09 12:15:00,Nikoghosyan Narek - Papyan Karen,1:3,14:12 - 8:11 - 10:12 - 5:11 - 0:0,1,3,Nikoghosyan Narek,Papyan Karen,fiurst,Nikoghosyan Narek - Papyan Karen,83,37,46,9,-9,26,19,22,16,0,-2,3,2,6,0,9,14:12 - 8:11 - 10:12 - 5:11 - 0:0
19169021,2024-06-09 11:50:00,Diaryan Aleksandr - Nikoghosyan Narek,3:0,11:4 - 11:1 - 11:7 - 0:0 - 0:0,3,0,Diaryan Aleksandr,Nikoghosyan Narek,fiurst,Diaryan Aleksandr - Nikoghosyan Narek,45,33,12,-21,21,15,12,18,0,0,-7,-10,-4,0,0,-21,11:4 - 11:1 - 11:7 - 0:0 - 0:0
19169007,2024-06-09 11:25:00,Asatryan Murad - Diaryan Aleksandr,3:1,11:8 - 9:11 - 11:7 - 11:6 - 0:0,3,1,Asatryan Murad,Diaryan Aleksandr,fiurst,Asatryan Murad - Diaryan Aleksandr,74,42,32,-10,10,19,20,18,17,0,-3,2,-4,-5,0,-10,11:8 - 9:11 - 11:7 - 11:6 - 0:0
19169003,2024-06-09 10:45:00,Papyan Karen - Diaryan Aleksandr,3:2,11:8 - 9:11 - 14:12 - 7:11 - 9:11,2,3,Papyan Karen,Diaryan Aleksandr,fiurst,Diaryan Aleksandr - Papyan Karen,103,53,50,-3,3,19,20,26,18,20,3,-2,2,-4,-2,-3,8:11 - 11:9 - 12:14 - 11:7 - 11:9
19168999,2024-06-09 10:30:00,Asatryan Murad - Nikoghosyan Narek,3:1,11:4 - 11:4 - 7:11 - 11:7 - 0:0,3,1,Asatryan Murad,Nikoghosyan Narek,fiurst,Asatryan Murad - Nikoghosyan Narek,66,40,26,-14,14,15,15,18,18,0,-7,-7,4,-4,0,-14,11:4 - 11:4 - 7:11 - 11:7 - 0:0
19168993,2024-06-09 10:15:00,Diaryan Aleksandr - Gevorgyan Hayk,3:0,11:4 - 11:4 - 11:3 - 0:0 - 0:0,3,0,Diaryan Aleksandr,Gevorgyan Hayk,fiurst,Diaryan Aleksandr - Gevorgyan Hayk,44,33,11,-22,22,15,15,14,0,0,-7,-7,-8,0,0,-22,11:4 - 11:4 - 11:3 - 0:0 - 0:0
19168991,2024-06-09 10:10:00,Papyan Karen - Asatryan Murad,3:0,3:11 - 9:11 - 7:11 - 0:0 - 0:0,0,3,Papyan Karen,Asatryan Murad,fiurst,Asatryan Murad - Papyan Karen,52,33,19,-14,14,14,20,18,0,0,-8,-2,-4,0,0,-14,11:3 - 11:9 - 11:7 - 0:0 - 0:0
19148812,2024-06-08 17:55:00,Hakobyan Eduard - Avakimyan Davit,0:3,11:8 - 11:9 - 11:6 - 0:0 - 0:0,3,0,Hakobyan Eduard,Avakimyan Davit,fiurst,Avakimyan Davit - Hakobyan Eduard,56,23,33,10,-10,19,20,17,0,0,3,2,5,0,0,10,8:11 - 9:11 - 6:11 - 0:0 - 0:0
19148811,2024-06-08 17:30:00,Soghomonyan Hrayr - Petrosyan Davit,1:3,9:11 - 11:5 - 11:2 - 11:9 - 0:0,3,1,Soghomonyan Hrayr,Petrosyan Davit,fiurst,Petrosyan Davit - Soghomonyan Hrayr,69,27,42,15,-15,20,16,13,20,0,-2,6,9,2,0,15,11:9 - 5:11 - 2:11 - 9:11 - 0:0
19148809,2024-06-08 17:25:00,Arutyunov Ruben - Hakobyan Eduard,2:3,7:11 - 11:6 - 11:9 - 9:11 - 10:12,2,3,Arutyunov Ruben,Hakobyan Eduard,fiurst,Arutyunov Ruben - Hakobyan Eduard,97,48,49,1,-1,18,17,20,20,22,4,-5,-2,2,2,1,7:11 - 11:6 - 11:9 - 9:11 - 10:12
19148808,2024-06-08 17:00:00,Soghomonyan Hrayr - Avakimyan Davit,0:3,11:8 - 11:3 - 11:6 - 0:0 - 0:0,3,0,Soghomonyan Hrayr,Avakimyan Davit,fiurst,Avakimyan Davit - Soghomonyan Hrayr,50,17,33,16,-16,19,14,17,0,0,3,8,5,0,0,16,8:11 - 3:11 - 6:11 - 0:0 - 0:0
19148795,2024-06-08 16:45:00,Petrosyan Davit - Arutyunov Ruben,2:3,1:11 - 11:8 - 11:7 - 7:11 - 11:7,3,2,Petrosyan Davit,Arutyunov Ruben,fiurst,Arutyunov Ruben - Petrosyan Davit,85,44,41,-3,3,12,19,18,18,18,-10,3,4,-4,4,-3,11:1 - 8:11 - 7:11 - 11:7 - 7:11
19148789,2024-06-08 16:30:00,Hakobyan Eduard - Soghomonyan Hrayr,1:3,12:14 - 4:11 - 11:9 - 5:11 - 0:0,1,3,Hakobyan Eduard,Soghomonyan Hrayr,fiurst,Hakobyan Eduard - Soghomonyan Hrayr,77,32,45,13,-13,26,15,20,16,0,2,7,-2,6,0,13,12:14 - 4:11 - 11:9 - 5:11 - 0:0
19148785,2024-06-08 16:20:00,Avakimyan Davit - Arutyunov Ruben,3:1,6:11 - 7:11 - 11:9 - 2:11 - 0:0,1,3,Avakimyan Davit,Arutyunov Ruben,fiurst,Arutyunov Ruben - Avakimyan Davit,68,42,26,-16,16,17,18,20,13,0,-5,-4,2,-9,0,-16,11:6 - 11:7 - 9:11 - 11:2 - 0:0
19148783,2024-06-08 16:00:00,Petrosyan Davit - Hakobyan Eduard,1:3,5:11 - 12:10 - 11:6 - 11:8 - 0:0,3,1,Petrosyan Davit,Hakobyan Eduard,fiurst,Hakobyan Eduard - Petrosyan Davit,74,35,39,4,-4,16,22,17,19,0,-6,2,5,3,0,4,11:5 - 10:12 - 6:11 - 8:11 - 0:0
19148781,2024-06-08 15:45:00,Arutyunov Ruben - Soghomonyan Hrayr,3:1,12:10 - 10:12 - 11:6 - 11:5 - 0:0,3,1,Arutyunov Ruben,Soghomonyan Hrayr,fiurst,Arutyunov Ruben - Soghomonyan Hrayr,77,44,33,-11,11,22,22,17,16,0,-2,2,-5,-6,0,-11,12:10 - 10:12 - 11:6 - 11:5 - 0:0
19148780,2024-06-08 15:30:00,Avakimyan Davit - Petrosyan Davit,3:0,11:7 - 12:10 - 11:3 - 0:0 - 0:0,3,0,Avakimyan Davit,Petrosyan Davit,fiurst,Avakimyan Davit - Petrosyan Davit,54,34,20,-14,14,18,22,14,0,0,-4,-2,-8,0,0,-14,11:7 - 12:10 - 11:3 - 0:0 - 0:0
19148775,2024-06-08 15:15:00,Asatryan Murad - Papyan Karen,3:0,11:8 - 11:9 - 11:2 - 0:0 - 0:0,3,0,Asatryan Murad,Papyan Karen,fiurst,Asatryan Murad - Papyan Karen,52,33,19,-14,14,19,20,13,0,0,-3,-2,-9,0,0,-14,11:8 - 11:9 - 11:2 - 0:0 - 0:0
19148773,2024-06-08 15:00:00,Nazaryan Mushegh - Rafayelyan Edgar,1:3,11:5 - 7:11 - 7:11 - 7:11 - 0:0,1,3,Nazaryan Mushegh,Rafayelyan Edgar,fiurst,Nazaryan Mushegh - Rafayelyan Edgar,70,32,38,6,-6,16,18,18,18,0,-6,4,4,4,0,6,11:5 - 7:11 - 7:11 - 7:11 - 0:0
19148772,2024-06-08 14:45:00,Gevorgyan Hayk - Asatryan Murad,3:1,6:11 - 11:7 - 9:11 - 4:11 - 0:0,1,3,Gevorgyan Hayk,Asatryan Murad,fiurst,Asatryan Murad - Gevorgyan Hayk,70,40,30,-10,10,17,18,20,15,0,-5,4,-2,-7,0,-10,11:6 - 7:11 - 11:9 - 11:4 - 0:0
19148771,2024-06-08 14:30:00,Papyan Karen - Nazaryan Mushegh,3:0,6:11 - 6:11 - 6:11 - 0:0 - 0:0,0,3,Papyan Karen,Nazaryan Mushegh,fiurst,Nazaryan Mushegh - Papyan Karen,51,33,18,-15,15,17,17,17,0,0,-5,-5,-5,0,0,-15,11:6 - 11:6 - 11:6 - 0:0 - 0:0
19148767,2024-06-08 14:15:00,Gevorgyan Hayk - Rafayelyan Edgar,1:3,11:9 - 8:11 - 8:11 - 10:12 - 0:0,1,3,Gevorgyan Hayk,Rafayelyan Edgar,fiurst,Gevorgyan Hayk - Rafayelyan Edgar,80,37,43,6,-6,20,19,19,22,0,-2,3,3,2,0,6,11:9 - 8:11 - 8:11 - 10:12 - 0:0
19148754,2024-06-08 14:10:00,Asatryan Murad - Nazaryan Mushegh,3:0,11:3 - 11:8 - 11:7 - 0:0 - 0:0,3,0,Asatryan Murad,Nazaryan Mushegh,fiurst,Asatryan Murad - Nazaryan Mushegh,51,33,18,-15,15,14,19,18,0,0,-8,-3,-4,0,0,-15,11:3 - 11:8 - 11:7 - 0:0 - 0:0
19148743,2024-06-08 13:45:00,Papyan Karen - Gevorgyan Hayk,1:3,11:9 - 11:8 - 7:11 - 11:9 - 0:0,3,1,Papyan Karen,Gevorgyan Hayk,fiurst,Gevorgyan Hayk - Papyan Karen,77,37,40,3,-3,20,19,18,20,0,2,3,-4,2,0,3,9:11 - 8:11 - 11:7 - 9:11 - 0:0
19148741,2024-06-08 13:30:00,Rafayelyan Edgar - Asatryan Murad,3:2,3:11 - 5:11 - 11:7 - 11:9 - 7:11,2,3,Rafayelyan Edgar,Asatryan Murad,fiurst,Asatryan Murad - Rafayelyan Edgar,86,49,37,-12,12,14,16,18,20,18,-8,-6,4,2,-4,-12,11:3 - 11:5 - 7:11 - 9:11 - 11:7
19148737,2024-06-08 13:15:00,Nazaryan Mushegh - Gevorgyan Hayk,1:3,11:8 - 11:3 - 8:11 - 11:6 - 0:0,3,1,Nazaryan Mushegh,Gevorgyan Hayk,fiurst,Gevorgyan Hayk - Nazaryan Mushegh,69,28,41,13,-13,19,14,19,17,0,3,8,-3,5,0,13,8:11 - 3:11 - 11:8 - 6:11 - 0:0
19148734,2024-06-08 13:00:00,Rafayelyan Edgar - Papyan Karen,2:3,5:11 - 3:11 - 11:9 - 15:13 - 11:9,3,2,Rafayelyan Edgar,Papyan Karen,fiurst,Papyan Karen - Rafayelyan Edgar,98,53,45,-8,8,16,14,20,28,20,-6,-8,2,2,2,-8,11:5 - 11:3 - 9:11 - 13:15 - 9:11
19148718,2024-06-08 12:20:00,Asatryan Murad - Gevorgyan Hayk,3:1,5:11 - 11:4 - 11:4 - 11:8 - 0:0,3,1,Asatryan Murad,Gevorgyan Hayk,fiurst,Asatryan Murad - Gevorgyan Hayk,65,38,27,-11,11,16,15,15,19,0,6,-7,-7,-3,0,-11,5:11 - 11:4 - 11:4 - 11:8 - 0:0
19148714,2024-06-08 12:10:00,Rafayelyan Edgar - Nazaryan Mushegh,0:3,11:6 - 11:7 - 11:5 - 0:0 - 0:0,3,0,Rafayelyan Edgar,Nazaryan Mushegh,fiurst,Nazaryan Mushegh - Rafayelyan Edgar,51,18,33,15,-15,17,18,16,0,0,5,4,6,0,0,15,6:11 - 7:11 - 5:11 - 0:0 - 0:0
19148712,2024-06-08 11:55:00,Papyan Karen - Asatryan Murad,3:1,9:11 - 8:11 - 11:5 - 9:11 - 0:0,1,3,Papyan Karen,Asatryan Murad,fiurst,Asatryan Murad - Papyan Karen,75,38,37,-1,1,20,19,16,20,0,-2,-3,6,-2,0,-1,11:9 - 11:8 - 5:11 - 11:9 - 0:0
19148710,2024-06-08 11:40:00,Rafayelyan Edgar - Gevorgyan Hayk,1:3,11:6 - 11:8 - 6:11 - 11:7 - 0:0,3,1,Rafayelyan Edgar,Gevorgyan Hayk,fiurst,Gevorgyan Hayk - Rafayelyan Edgar,71,32,39,7,-7,17,19,17,18,0,5,3,-5,4,0,7,6:11 - 8:11 - 11:6 - 7:11 - 0:0
19148709,2024-06-08 11:20:00,Nazaryan Mushegh - Papyan Karen,3:1,14:12 - 6:11 - 11:6 - 11:7 - 0:0,3,1,Nazaryan Mushegh,Papyan Karen,fiurst,Nazaryan Mushegh - Papyan Karen,78,42,36,-6,6,26,17,17,18,0,-2,5,-5,-4,0,-6,14:12 - 6:11 - 11:6 - 11:7 - 0:0
19148702,2024-06-08 11:00:00,Asatryan Murad - Rafayelyan Edgar,3:2,11:9 - 7:11 - 7:11 - 11:8 - 11:9,3,2,Asatryan Murad,Rafayelyan Edgar,fiurst,Asatryan Murad - Rafayelyan Edgar,95,47,48,1,-1,20,18,18,19,20,-2,4,4,-3,-2,1,11:9 - 7:11 - 7:11 - 11:8 - 11:9
19148691,2024-06-08 10:45:00,Gevorgyan Hayk - Papyan Karen,2:3,11:5 - 9:11 - 7:11 - 11:7 - 9:11,2,3,Gevorgyan Hayk,Papyan Karen,fiurst,Gevorgyan Hayk - Papyan Karen,92,47,45,-2,2,16,20,18,18,20,-6,2,4,-4,2,-2,11:5 - 9:11 - 7:11 - 11:7 - 9:11
19148690,2024-06-08 10:30:00,Nazaryan Mushegh - Asatryan Murad,3:0,9:11 - 8:11 - 2:11 - 0:0 - 0:0,0,3,Nazaryan Mushegh,Asatryan Murad,fiurst,Asatryan Murad - Nazaryan Mushegh,52,33,19,-14,14,20,19,13,0,0,-2,-3,-9,0,0,-14,11:9 - 11:8 - 11:2 - 0:0 - 0:0
19148681,2024-06-08 10:15:00,Papyan Karen - Rafayelyan Edgar,2:3,4:11 - 8:11 - 11:4 - 16:14 - 11:13,2,3,Papyan Karen,Rafayelyan Edgar,fiurst,Papyan Karen - Rafayelyan Edgar,103,50,53,3,-3,15,19,15,30,24,7,3,-7,-2,2,3,4:11 - 8:11 - 11:4 - 16:14 - 11:13
19148675,2024-06-08 10:00:00,Gevorgyan Hayk - Nazaryan Mushegh,1:3,9:11 - 11:7 - 7:11 - 9:11 - 0:0,1,3,Gevorgyan Hayk,Nazaryan Mushegh,fiurst,Gevorgyan Hayk - Nazaryan Mushegh,76,36,40,4,-4,20,18,18,20,0,2,-4,4,2,0,4,9:11 - 11:7 - 7:11 - 9:11 - 0:0
19128148,2024-06-07 17:45:00,Petrosyan Davit - Arutyunov Ruben,2:3,9:11 - 11:9 - 10:12 - 11:7 - 12:10,3,2,Petrosyan Davit,Arutyunov Ruben,fiurst,Arutyunov Ruben - Petrosyan Davit,102,49,53,4,-4,20,20,22,18,22,-2,2,-2,4,2,4,11:9 - 9:11 - 12:10 - 7:11 - 10:12
19128145,2024-06-07 17:30:00,Gevorgyan Gegham - Mkrtchyan Andranik,3:0,11:5 - 11:2 - 11:6 - 0:0 - 0:0,3,0,Gevorgyan Gegham,Mkrtchyan Andranik,fiurst,Gevorgyan Gegham - Mkrtchyan Andranik,46,33,13,-20,20,16,13,17,0,0,-6,-9,-5,0,0,-20,11:5 - 11:2 - 11:6 - 0:0 - 0:0
19128139,2024-06-07 17:15:00,Avakimyan Davit - Petrosyan Davit,0:3,5:11 - 6:11 - 3:11 - 0:0 - 0:0,0,3,Avakimyan Davit,Petrosyan Davit,fiurst,Avakimyan Davit - Petrosyan Davit,47,14,33,19,-19,16,17,14,0,0,6,5,8,0,0,19,5:11 - 6:11 - 3:11 - 0:0 - 0:0
19128130,2024-06-07 17:05:00,Gevorgyan Gegham - Arutyunov Ruben,3:0,5:11 - 10:12 - 8:11 - 0:0 - 0:0,0,3,Gevorgyan Gegham,Arutyunov Ruben,fiurst,Arutyunov Ruben - Gevorgyan Gegham,57,34,23,-11,11,16,22,19,0,0,-6,-2,-3,0,0,-11,11:5 - 12:10 - 11:8 - 0:0 - 0:0
19128123,2024-06-07 16:45:00,Mkrtchyan Andranik - Avakimyan Davit,3:1,10:12 - 8:11 - 11:6 - 8:11 - 0:0,1,3,Mkrtchyan Andranik,Avakimyan Davit,fiurst,Avakimyan Davit - Mkrtchyan Andranik,77,40,37,-3,3,22,19,17,19,0,-2,-3,5,-3,0,-3,12:10 - 11:8 - 6:11 - 11:8 - 0:0
19128122,2024-06-07 16:30:00,Petrosyan Davit - Gevorgyan Gegham,1:3,11:5 - 8:11 - 14:12 - 13:11 - 0:0,3,1,Petrosyan Davit,Gevorgyan Gegham,fiurst,Gevorgyan Gegham - Petrosyan Davit,85,39,46,7,-7,16,19,26,24,0,6,-3,2,2,0,7,5:11 - 11:8 - 12:14 - 11:13 - 0:0
19128118,2024-06-07 16:15:00,Arutyunov Ruben - Avakimyan Davit,3:0,11:8 - 11:6 - 11:2 - 0:0 - 0:0,3,0,Arutyunov Ruben,Avakimyan Davit,fiurst,Arutyunov Ruben - Avakimyan Davit,49,33,16,-17,17,19,17,13,0,0,-3,-5,-9,0,0,-17,11:8 - 11:6 - 11:2 - 0:0 - 0:0
19128109,2024-06-07 16:00:00,Mkrtchyan Andranik - Petrosyan Davit,3:1,17:15 - 7:11 - 11:7 - 11:6 - 0:0,3,1,Mkrtchyan Andranik,Petrosyan Davit,fiurst,Mkrtchyan Andranik - Petrosyan Davit,85,46,39,-7,7,32,18,18,17,0,-2,4,-4,-5,0,-7,17:15 - 7:11 - 11:7 - 11:6 - 0:0
19128106,2024-06-07 15:45:00,Avakimyan Davit - Gevorgyan Gegham,3:1,11:7 - 11:7 - 7:11 - 11:5 - 0:0,3,1,Avakimyan Davit,Gevorgyan Gegham,fiurst,Avakimyan Davit - Gevorgyan Gegham,70,40,30,-10,10,18,18,18,16,0,-4,-4,4,-6,0,-10,11:7 - 11:7 - 7:11 - 11:5 - 0:0
19128103,2024-06-07 15:30:00,Arutyunov Ruben - Mkrtchyan Andranik,3:1,4:11 - 12:10 - 11:2 - 11:2 - 0:0,3,1,Arutyunov Ruben,Mkrtchyan Andranik,fiurst,Arutyunov Ruben - Mkrtchyan Andranik,63,38,25,-13,13,15,22,13,13,0,7,-2,-9,-9,0,-13,4:11 - 12:10 - 11:2 - 11:2 - 0:0
19128097,2024-06-07 15:15:00,Gevorgyan Hayk - Rafayelyan Edgar,1:3,7:11 - 3:11 - 14:12 - 5:11 - 0:0,1,3,Gevorgyan Hayk,Rafayelyan Edgar,fiurst,Gevorgyan Hayk - Rafayelyan Edgar,74,29,45,16,-16,18,14,26,16,0,4,8,-2,6,0,16,7:11 - 3:11 - 14:12 - 5:11 - 0:0
19128086,2024-06-07 15:00:00,Hovhannesyan Rafik - Diaryan Aleksandr,3:2,11:9 - 6:11 - 11:9 - 5:11 - 6:11,2,3,Hovhannesyan Rafik,Diaryan Aleksandr,fiurst,Diaryan Aleksandr - Hovhannesyan Rafik,90,51,39,-12,12,20,17,20,16,17,2,-5,2,-6,-5,-12,9:11 - 11:6 - 9:11 - 11:5 - 11:6
19128085,2024-06-07 14:45:00,Nazaryan Mushegh - Gevorgyan Hayk,0:3,11:4 - 15:13 - 11:1 - 0:0 - 0:0,3,0,Nazaryan Mushegh,Gevorgyan Hayk,fiurst,Gevorgyan Hayk - Nazaryan Mushegh,55,18,37,19,-19,15,28,12,0,0,7,2,10,0,0,19,4:11 - 13:15 - 1:11 - 0:0 - 0:0
19128080,2024-06-07 14:30:00,Rafayelyan Edgar - Hovhannesyan Rafik,2:3,7:11 - 11:8 - 11:6 - 9:11 - 11:4,3,2,Rafayelyan Edgar,Hovhannesyan Rafik,fiurst,Hovhannesyan Rafik - Rafayelyan Edgar,89,40,49,9,-9,18,19,17,20,15,-4,3,5,-2,7,9,11:7 - 8:11 - 6:11 - 11:9 - 4:11
19128073,2024-06-07 14:25:00,Nazaryan Mushegh - Diaryan Aleksandr,3:0,6:11 - 8:11 - 8:11 - 0:0 - 0:0,0,3,Nazaryan Mushegh,Diaryan Aleksandr,fiurst,Diaryan Aleksandr - Nazaryan Mushegh,55,33,22,-11,11,17,19,19,0,0,-5,-3,-3,0,0,-11,11:6 - 11:8 - 11:8 - 0:0 - 0:0
19128069,2024-06-07 14:00:00,Gevorgyan Hayk - Hovhannesyan Rafik,0:3,14:16 - 7:11 - 9:11 - 0:0 - 0:0,0,3,Gevorgyan Hayk,Hovhannesyan Rafik,fiurst,Gevorgyan Hayk - Hovhannesyan Rafik,68,30,38,8,-8,30,18,20,0,0,2,4,2,0,0,8,14:16 - 7:11 - 9:11 - 0:0 - 0:0
19128067,2024-06-07 13:45:00,Rafayelyan Edgar - Nazaryan Mushegh,2:3,9:11 - 13:11 - 10:12 - 11:4 - 11:5,3,2,Rafayelyan Edgar,Nazaryan Mushegh,fiurst,Nazaryan Mushegh - Rafayelyan Edgar,97,43,54,11,-11,20,24,22,15,16,-2,2,-2,7,6,11,11:9 - 11:13 - 12:10 - 4:11 - 5:11
19128063,2024-06-07 13:35:00,Diaryan Aleksandr - Gevorgyan Hayk,0:3,5:11 - 6:11 - 10:12 - 0:0 - 0:0,0,3,Diaryan Aleksandr,Gevorgyan Hayk,fiurst,Diaryan Aleksandr - Gevorgyan Hayk,55,21,34,13,-13,16,17,22,0,0,6,5,2,0,0,13,5:11 - 6:11 - 10:12 - 0:0 - 0:0
19128060,2024-06-07 13:15:00,Hovhannesyan Rafik - Nazaryan Mushegh,3:1,11:7 - 5:11 - 11:5 - 11:7 - 0:0,3,1,Hovhannesyan Rafik,Nazaryan Mushegh,fiurst,Hovhannesyan Rafik - Nazaryan Mushegh,68,38,30,-8,8,18,16,16,18,0,-4,6,-6,-4,0,-8,11:7 - 5:11 - 11:5 - 11:7 - 0:0
19128046,2024-06-07 13:00:00,Diaryan Aleksandr - Rafayelyan Edgar,3:1,11:7 - 6:11 - 11:5 - 11:7 - 0:0,3,1,Diaryan Aleksandr,Rafayelyan Edgar,fiurst,Diaryan Aleksandr - Rafayelyan Edgar,69,39,30,-9,9,18,17,16,18,0,-4,5,-6,-4,0,-9,11:7 - 6:11 - 11:5 - 11:7 - 0:0
19128045,2024-06-07 12:20:00,Gevorgyan Hayk - Nazaryan Mushegh,1:3,9:11 - 11:8 - 12:14 - 8:11 - 0:0,1,3,Gevorgyan Hayk,Nazaryan Mushegh,fiurst,Gevorgyan Hayk - Nazaryan Mushegh,84,40,44,4,-4,20,19,26,19,0,2,-3,2,3,0,4,9:11 - 11:8 - 12:14 - 8:11 - 0:0
19128043,2024-06-07 12:00:00,Diaryan Aleksandr - Hovhannesyan Rafik,3:2,9:11 - 11:4 - 11:8 - 9:11 - 11:1,3,2,Diaryan Aleksandr,Hovhannesyan Rafik,fiurst,Diaryan Aleksandr - Hovhannesyan Rafik,86,51,35,-16,16,20,15,19,20,12,2,-7,-3,2,-10,-16,9:11 - 11:4 - 11:8 - 9:11 - 11:1
19128042,2024-06-07 11:50:00,Rafayelyan Edgar - Gevorgyan Hayk,1:3,6:11 - 11:4 - 11:8 - 11:8 - 0:0,3,1,Rafayelyan Edgar,Gevorgyan Hayk,fiurst,Gevorgyan Hayk - Rafayelyan Edgar,70,31,39,8,-8,17,15,19,19,0,-5,7,3,3,0,8,11:6 - 4:11 - 8:11 - 8:11 - 0:0
19128040,2024-06-07 11:30:00,Diaryan Aleksandr - Nazaryan Mushegh,3:0,11:9 - 11:5 - 11:4 - 0:0 - 0:0,3,0,Diaryan Aleksandr,Nazaryan Mushegh,fiurst,Diaryan Aleksandr - Nazaryan Mushegh,51,33,18,-15,15,20,16,15,0,0,-2,-6,-7,0,0,-15,11:9 - 11:5 - 11:4 - 0:0 - 0:0
19128037,2024-06-07 11:15:00,Hovhannesyan Rafik - Rafayelyan Edgar,1:3,6:11 - 11:8 - 6:11 - 7:11 - 0:0,1,3,Hovhannesyan Rafik,Rafayelyan Edgar,fiurst,Hovhannesyan Rafik - Rafayelyan Edgar,71,30,41,11,-11,17,19,17,18,0,5,-3,5,4,0,11,6:11 - 11:8 - 6:11 - 7:11 - 0:0
19128035,2024-06-07 11:00:00,Gevorgyan Hayk - Diaryan Aleksandr,3:1,9:11 - 7:11 - 12:10 - 6:11 - 0:0,1,3,Gevorgyan Hayk,Diaryan Aleksandr,fiurst,Diaryan Aleksandr - Gevorgyan Hayk,77,43,34,-9,9,20,18,22,17,0,-2,-4,2,-5,0,-9,11:9 - 11:7 - 10:12 - 11:6 - 0:0
19128025,2024-06-07 10:45:00,Nazaryan Mushegh - Rafayelyan Edgar,0:3,13:15 - 3:11 - 9:11 - 0:0 - 0:0,0,3,Nazaryan Mushegh,Rafayelyan Edgar,fiurst,Nazaryan Mushegh - Rafayelyan Edgar,62,25,37,12,-12,28,14,20,0,0,2,8,2,0,0,12,13:15 - 3:11 - 9:11 - 0:0 - 0:0
19128009,2024-06-07 10:30:00,Hovhannesyan Rafik - Gevorgyan Hayk,3:2,11:6 - 10:12 - 11:7 - 6:11 - 9:11,2,3,Hovhannesyan Rafik,Gevorgyan Hayk,fiurst,Gevorgyan Hayk - Hovhannesyan Rafik,94,47,47,0,0,17,22,18,17,20,5,-2,4,-5,-2,0,6:11 - 12:10 - 7:11 - 11:6 - 11:9
19128006,2024-06-07 10:15:00,Rafayelyan Edgar - Diaryan Aleksandr,3:1,9:11 - 11:8 - 8:11 - 4:11 - 0:0,1,3,Rafayelyan Edgar,Diaryan Aleksandr,fiurst,Diaryan Aleksandr - Rafayelyan Edgar,73,41,32,-9,9,20,19,19,15,0,-2,3,-3,-7,0,-9,11:9 - 8:11 - 11:8 - 11:4 - 0:0
19128004,2024-06-07 10:00:00,Nazaryan Mushegh - Hovhannesyan Rafik,0:3,12:10 - 11:7 - 11:7 - 0:0 - 0:0,3,0,Nazaryan Mushegh,Hovhannesyan Rafik,fiurst,Hovhannesyan Rafik - Nazaryan Mushegh,58,24,34,10,-10,22,18,18,0,0,2,4,4,0,0,10,10:12 - 7:11 - 7:11 - 0:0 - 0:0
19109122,2024-06-06 17:45:00,Hakobyan Eduard - Gevorgyan Gegham,2:3,7:11 - 8:11 - 11:7 - 11:8 - 11:9,3,2,Hakobyan Eduard,Gevorgyan Gegham,fiurst,Gevorgyan Gegham - Hakobyan Eduard,94,46,48,2,-2,18,19,18,19,20,-4,-3,4,3,2,2,11:7 - 11:8 - 7:11 - 8:11 - 9:11
19109119,2024-06-06 17:30:00,Soghomonyan Hrayr - Avakimyan Davit,0:3,11:6 - 11:7 - 11:8 - 0:0 - 0:0,3,0,Soghomonyan Hrayr,Avakimyan Davit,fiurst,Avakimyan Davit - Soghomonyan Hrayr,54,21,33,12,-12,17,18,19,0,0,5,4,3,0,0,12,6:11 - 7:11 - 8:11 - 0:0 - 0:0
19109115,2024-06-06 17:15:00,Mkrtchyan Andranik - Hakobyan Eduard,0:3,11:8 - 11:6 - 11:6 - 0:0 - 0:0,3,0,Mkrtchyan Andranik,Hakobyan Eduard,fiurst,Hakobyan Eduard - Mkrtchyan Andranik,53,20,33,13,-13,19,17,17,0,0,3,5,5,0,0,13,8:11 - 6:11 - 6:11 - 0:0 - 0:0
19109112,2024-06-06 17:00:00,Soghomonyan Hrayr - Gevorgyan Gegham,2:3,11:6 - 11:13 - 5:11 - 11:6 - 11:7,3,2,Soghomonyan Hrayr,Gevorgyan Gegham,fiurst,Gevorgyan Gegham - Soghomonyan Hrayr,92,43,49,6,-6,17,24,16,17,18,5,-2,-6,5,4,6,6:11 - 13:11 - 11:5 - 6:11 - 7:11
19109103,2024-06-06 16:55:00,Avakimyan Davit - Mkrtchyan Andranik,0:3,4:11 - 8:11 - 8:11 - 0:0 - 0:0,0,3,Avakimyan Davit,Mkrtchyan Andranik,fiurst,Avakimyan Davit - Mkrtchyan Andranik,53,20,33,13,-13,15,19,19,0,0,7,3,3,0,0,13,4:11 - 8:11 - 8:11 - 0:0 - 0:0
19109095,2024-06-06 16:30:00,Hakobyan Eduard - Soghomonyan Hrayr,1:3,4:11 - 6:11 - 11:9 - 5:11 - 0:0,1,3,Hakobyan Eduard,Soghomonyan Hrayr,fiurst,Hakobyan Eduard - Soghomonyan Hrayr,68,26,42,16,-16,15,17,20,16,0,7,5,-2,6,0,16,4:11 - 6:11 - 11:9 - 5:11 - 0:0
19109091,2024-06-06 16:20:00,Gevorgyan Gegham - Mkrtchyan Andranik,2:3,11:9 - 13:11 - 8:11 - 5:11 - 3:11,2,3,Gevorgyan Gegham,Mkrtchyan Andranik,fiurst,Gevorgyan Gegham - Mkrtchyan Andranik,93,40,53,13,-13,20,24,19,16,14,-2,-2,3,6,8,13,11:9 - 13:11 - 8:11 - 5:11 - 3:11
19109088,2024-06-06 16:00:00,Avakimyan Davit - Hakobyan Eduard,0:3,8:11 - 6:11 - 7:11 - 0:0 - 0:0,0,3,Avakimyan Davit,Hakobyan Eduard,fiurst,Avakimyan Davit - Hakobyan Eduard,54,21,33,12,-12,19,17,18,0,0,3,5,4,0,0,12,8:11 - 6:11 - 7:11 - 0:0 - 0:0
19109087,2024-06-06 15:45:00,Mkrtchyan Andranik - Soghomonyan Hrayr,3:1,8:11 - 13:11 - 12:10 - 11:8 - 0:0,3,1,Mkrtchyan Andranik,Soghomonyan Hrayr,fiurst,Mkrtchyan Andranik - Soghomonyan Hrayr,84,44,40,-4,4,19,24,22,19,0,3,-2,-2,-3,0,-4,8:11 - 13:11 - 12:10 - 11:8 - 0:0
19109084,2024-06-06 15:30:00,Gevorgyan Gegham - Avakimyan Davit,0:3,11:5 - 11:8 - 11:6 - 0:0 - 0:0,3,0,Gevorgyan Gegham,Avakimyan Davit,fiurst,Avakimyan Davit - Gevorgyan Gegham,52,19,33,14,-14,16,19,17,0,0,6,3,5,0,0,14,5:11 - 8:11 - 6:11 - 0:0 - 0:0
19109081,2024-06-06 15:15:00,Nazaryan Mushegh - Diaryan Aleksandr,3:0,3:11 - 9:11 - 1:11 - 0:0 - 0:0,0,3,Nazaryan Mushegh,Diaryan Aleksandr,fiurst,Diaryan Aleksandr - Nazaryan Mushegh,46,33,13,-20,20,14,20,12,0,0,-8,-2,-10,0,0,-20,11:3 - 11:9 - 11:1 - 0:0 - 0:0
19109077,2024-06-06 15:00:00,Papyan Karen - Rafayelyan Edgar,0:3,6:11 - 5:11 - 4:11 - 0:0 - 0:0,0,3,Papyan Karen,Rafayelyan Edgar,fiurst,Papyan Karen - Rafayelyan Edgar,48,15,33,18,-18,17,16,15,0,0,5,6,7,0,0,18,6:11 - 5:11 - 4:11 - 0:0 - 0:0
19109066,2024-06-06 14:45:00,Nikoghosyan Narek - Nazaryan Mushegh,1:3,11:8 - 11:13 - 11:4 - 11:9 - 0:0,3,1,Nikoghosyan Narek,Nazaryan Mushegh,fiurst,Nazaryan Mushegh - Nikoghosyan Narek,78,34,44,10,-10,19,24,15,20,0,3,-2,7,2,0,10,8:11 - 13:11 - 4:11 - 9:11 - 0:0
19109064,2024-06-06 14:30:00,Diaryan Aleksandr - Papyan Karen,3:1,10:12 - 11:6 - 11:7 - 12:10 - 0:0,3,1,Diaryan Aleksandr,Papyan Karen,fiurst,Diaryan Aleksandr - Papyan Karen,79,44,35,-9,9,22,17,18,22,0,2,-5,-4,-2,0,-9,10:12 - 11:6 - 11:7 - 12:10 - 0:0
19109052,2024-06-06 14:25:00,Nikoghosyan Narek - Rafayelyan Edgar,0:3,7:11 - 3:11 - 6:11 - 0:0 - 0:0,0,3,Nikoghosyan Narek,Rafayelyan Edgar,fiurst,Nikoghosyan Narek - Rafayelyan Edgar,49,16,33,17,-17,18,14,17,0,0,4,8,5,0,0,17,7:11 - 3:11 - 6:11 - 0:0 - 0:0
19109050,2024-06-06 14:00:00,Nazaryan Mushegh - Papyan Karen,3:0,11:6 - 11:5 - 11:7 - 0:0 - 0:0,3,0,Nazaryan Mushegh,Papyan Karen,fiurst,Nazaryan Mushegh - Papyan Karen,51,33,18,-15,15,17,16,18,0,0,-5,-6,-4,0,0,-15,11:6 - 11:5 - 11:7 - 0:0 - 0:0
19109046,2024-06-06 13:55:00,Diaryan Aleksandr - Nikoghosyan Narek,3:1,9:11 - 11:3 - 11:6 - 11:1 - 0:0,3,1,Diaryan Aleksandr,Nikoghosyan Narek,fiurst,Diaryan Aleksandr - Nikoghosyan Narek,63,42,21,-21,21,20,14,17,12,0,2,-8,-5,-10,0,-21,9:11 - 11:3 - 11:6 - 11:1 - 0:0
19109043,2024-06-06 13:30:00,Rafayelyan Edgar - Nazaryan Mushegh,0:3,11:4 - 11:2 - 11:7 - 0:0 - 0:0,3,0,Rafayelyan Edgar,Nazaryan Mushegh,fiurst,Nazaryan Mushegh - Rafayelyan Edgar,46,13,33,20,-20,15,13,18,0,0,7,9,4,0,0,20,4:11 - 2:11 - 7:11 - 0:0 - 0:0
19109042,2024-06-06 13:15:00,Papyan Karen - Nikoghosyan Narek,3:2,11:9 - 11:8 - 4:11 - 13:15 - 8:11,2,3,Papyan Karen,Nikoghosyan Narek,fiurst,Nikoghosyan Narek - Papyan Karen,101,54,47,-7,7,20,19,15,28,19,2,3,-7,-2,-3,-7,9:11 - 8:11 - 11:4 - 15:13 - 11:8
19109040,2024-06-06 13:00:00,Rafayelyan Edgar - Diaryan Aleksandr,0:3,11:6 - 11:6 - 11:8 - 0:0 - 0:0,3,0,Rafayelyan Edgar,Diaryan Aleksandr,fiurst,Diaryan Aleksandr - Rafayelyan Edgar,53,20,33,13,-13,17,17,19,0,0,5,5,3,0,0,13,6:11 - 6:11 - 8:11 - 0:0 - 0:0
19109038,2024-06-06 12:15:00,Nazaryan Mushegh - Nikoghosyan Narek,0:3,10:12 - 9:11 - 5:11 - 0:0 - 0:0,0,3,Nazaryan Mushegh,Nikoghosyan Narek,fiurst,Nazaryan Mushegh - Nikoghosyan Narek,58,24,34,10,-10,22,20,16,0,0,2,2,6,0,0,10,10:12 - 9:11 - 5:11 - 0:0 - 0:0
19109036,2024-06-06 12:00:00,Rafayelyan Edgar - Papyan Karen,1:3,8:11 - 11:5 - 13:11 - 12:10 - 0:0,3,1,Rafayelyan Edgar,Papyan Karen,fiurst,Papyan Karen - Rafayelyan Edgar,81,37,44,7,-7,19,16,24,22,0,-3,6,2,2,0,7,11:8 - 5:11 - 11:13 - 10:12 - 0:0
19108995,2024-06-06 11:45:00,Diaryan Aleksandr - Nazaryan Mushegh,0:3,9:11 - 9:11 - 7:11 - 0:0 - 0:0,0,3,Diaryan Aleksandr,Nazaryan Mushegh,fiurst,Diaryan Aleksandr - Nazaryan Mushegh,58,25,33,8,-8,20,20,18,0,0,2,2,4,0,0,8,9:11 - 9:11 - 7:11 - 0:0 - 0:0
19108992,2024-06-06 11:30:00,Rafayelyan Edgar - Nikoghosyan Narek,0:3,11:8 - 11:2 - 11:8 - 0:0 - 0:0,3,0,Rafayelyan Edgar,Nikoghosyan Narek,fiurst,Nikoghosyan Narek - Rafayelyan Edgar,51,18,33,15,-15,19,13,19,0,0,3,9,3,0,0,15,8:11 - 2:11 - 8:11 - 0:0 - 0:0
19108990,2024-06-06 11:15:00,Papyan Karen - Diaryan Aleksandr,2:3,4:11 - 9:11 - 11:9 - 11:6 - 11:9,3,2,Papyan Karen,Diaryan Aleksandr,fiurst,Diaryan Aleksandr - Papyan Karen,92,46,46,0,0,15,20,20,17,20,-7,-2,2,5,2,0,11:4 - 11:9 - 9:11 - 6:11 - 9:11
19108988,2024-06-06 11:00:00,Nazaryan Mushegh - Rafayelyan Edgar,3:0,11:8 - 11:3 - 11:9 - 0:0 - 0:0,3,0,Nazaryan Mushegh,Rafayelyan Edgar,fiurst,Nazaryan Mushegh - Rafayelyan Edgar,53,33,20,-13,13,19,14,20,0,0,-3,-8,-2,0,0,-13,11:8 - 11:3 - 11:9 - 0:0 - 0:0
19108983,2024-06-06 10:45:00,Nikoghosyan Narek - Diaryan Aleksandr,1:3,11:9 - 8:11 - 11:9 - 11:9 - 0:0,3,1,Nikoghosyan Narek,Diaryan Aleksandr,fiurst,Diaryan Aleksandr - Nikoghosyan Narek,79,38,41,3,-3,20,19,20,20,0,2,-3,2,2,0,3,9:11 - 11:8 - 9:11 - 9:11 - 0:0
19108980,2024-06-06 10:30:00,Papyan Karen - Nazaryan Mushegh,0:3,11:9 - 11:9 - 11:7 - 0:0 - 0:0,3,0,Papyan Karen,Nazaryan Mushegh,fiurst,Nazaryan Mushegh - Papyan Karen,58,25,33,8,-8,20,20,18,0,0,2,2,4,0,0,8,9:11 - 9:11 - 7:11 - 0:0 - 0:0
19108979,2024-06-06 10:15:00,Diaryan Aleksandr - Rafayelyan Edgar,3:2,11:3 - 10:12 - 10:12 - 11:8 - 11:5,3,2,Diaryan Aleksandr,Rafayelyan Edgar,fiurst,Diaryan Aleksandr - Rafayelyan Edgar,93,53,40,-13,13,14,22,22,19,16,-8,2,2,-3,-6,-13,11:3 - 10:12 - 10:12 - 11:8 - 11:5
19108966,2024-06-06 10:00:00,Nikoghosyan Narek - Papyan Karen,3:0,11:8 - 11:9 - 11:5 - 0:0 - 0:0,3,0,Nikoghosyan Narek,Papyan Karen,fiurst,Nikoghosyan Narek - Papyan Karen,55,33,22,-11,11,19,20,16,0,0,-3,-2,-6,0,0,-11,11:8 - 11:9 - 11:5 - 0:0 - 0:0
19089228,2024-06-05 17:45:00,Hakobyan Eduard - Mkrtchyan Andranik,1:3,11:13 - 14:16 - 11:7 - 12:14 - 0:0,1,3,Hakobyan Eduard,Mkrtchyan Andranik,fiurst,Hakobyan Eduard - Mkrtchyan Andranik,98,48,50,2,-2,24,30,18,26,0,2,2,-4,2,0,2,11:13 - 14:16 - 11:7 - 12:14 - 0:0
19089226,2024-06-05 17:30:00,Petrosyan Davit - Arutyunov Ruben,3:1,12:14 - 11:8 - 4:11 - 9:11 - 0:0,1,3,Petrosyan Davit,Arutyunov Ruben,fiurst,Arutyunov Ruben - Petrosyan Davit,80,44,36,-8,8,26,19,15,20,0,-2,3,-7,-2,0,-8,14:12 - 8:11 - 11:4 - 11:9 - 0:0
19089225,2024-06-05 17:15:00,Soghomonyan Hrayr - Hakobyan Eduard,1:3,11:9 - 9:11 - 11:3 - 11:3 - 0:0,3,1,Soghomonyan Hrayr,Hakobyan Eduard,fiurst,Hakobyan Eduard - Soghomonyan Hrayr,68,26,42,16,-16,20,20,14,14,0,2,-2,8,8,0,16,9:11 - 11:9 - 3:11 - 3:11 - 0:0
19089224,2024-06-05 17:00:00,Petrosyan Davit - Mkrtchyan Andranik,0:3,11:6 - 12:10 - 11:9 - 0:0 - 0:0,3,0,Petrosyan Davit,Mkrtchyan Andranik,fiurst,Mkrtchyan Andranik - Petrosyan Davit,59,25,34,9,-9,17,22,20,0,0,5,2,2,0,0,9,6:11 - 10:12 - 9:11 - 0:0 - 0:0
19089223,2024-06-05 16:45:00,Arutyunov Ruben - Soghomonyan Hrayr,3:0,11:9 - 14:12 - 11:2 - 0:0 - 0:0,3,0,Arutyunov Ruben,Soghomonyan Hrayr,fiurst,Arutyunov Ruben - Soghomonyan Hrayr,59,36,23,-13,13,20,26,13,0,0,-2,-2,-9,0,0,-13,11:9 - 14:12 - 11:2 - 0:0 - 0:0
19089220,2024-06-05 16:30:00,Hakobyan Eduard - Petrosyan Davit,1:3,11:9 - 9:11 - 8:11 - 7:11 - 0:0,1,3,Hakobyan Eduard,Petrosyan Davit,fiurst,Hakobyan Eduard - Petrosyan Davit,77,35,42,7,-7,20,20,19,18,0,-2,2,3,4,0,7,11:9 - 9:11 - 8:11 - 7:11 - 0:0
19089219,2024-06-05 16:15:00,Mkrtchyan Andranik - Soghomonyan Hrayr,0:3,7:11 - 5:11 - 6:11 - 0:0 - 0:0,0,3,Mkrtchyan Andranik,Soghomonyan Hrayr,fiurst,Mkrtchyan Andranik - Soghomonyan Hrayr,51,18,33,15,-15,18,16,17,0,0,4,6,5,0,0,15,7:11 - 5:11 - 6:11 - 0:0 - 0:0
19089217,2024-06-05 16:00:00,Arutyunov Ruben - Hakobyan Eduard,3:1,14:12 - 10:12 - 11:9 - 11:7 - 0:0,3,1,Arutyunov Ruben,Hakobyan Eduard,fiurst,Arutyunov Ruben - Hakobyan Eduard,86,46,40,-6,6,26,22,20,18,0,-2,2,-2,-4,0,-6,14:12 - 10:12 - 11:9 - 11:7 - 0:0
19089213,2024-06-05 15:45:00,Soghomonyan Hrayr - Petrosyan Davit,0:3,12:10 - 11:5 - 11:2 - 0:0 - 0:0,3,0,Soghomonyan Hrayr,Petrosyan Davit,fiurst,Petrosyan Davit - Soghomonyan Hrayr,51,17,34,17,-17,22,16,13,0,0,2,6,9,0,0,17,10:12 - 5:11 - 2:11 - 0:0 - 0:0
19089211,2024-06-05 15:30:00,Mkrtchyan Andranik - Arutyunov Ruben,3:0,6:11 - 6:11 - 5:11 - 0:0 - 0:0,0,3,Mkrtchyan Andranik,Arutyunov Ruben,fiurst,Arutyunov Ruben - Mkrtchyan Andranik,50,33,17,-16,16,17,17,16,0,0,-5,-5,-6,0,0,-16,11:6 - 11:6 - 11:5 - 0:0 - 0:0
19089207,2024-06-05 15:15:00,Asatryan Murad - Papyan Karen,2:3,12:10 - 7:11 - 11:13 - 11:5 - 6:11,2,3,Asatryan Murad,Papyan Karen,fiurst,Asatryan Murad - Papyan Karen,97,47,50,3,-3,22,18,24,16,17,-2,4,2,-6,5,3,12:10 - 7:11 - 11:13 - 11:5 - 6:11
19089206,2024-06-05 15:00:00,Gevorgyan Hayk - Nikoghosyan Narek,1:3,8:11 - 5:11 - 11:6 - 11:13 - 0:0,1,3,Gevorgyan Hayk,Nikoghosyan Narek,fiurst,Gevorgyan Hayk - Nikoghosyan Narek,76,35,41,6,-6,19,16,17,24,0,3,6,-5,2,0,6,8:11 - 5:11 - 11:6 - 11:13 - 0:0
19089193,2024-06-05 14:45:00,Rafayelyan Edgar - Asatryan Murad,0:3,11:9 - 11:7 - 11:3 - 0:0 - 0:0,3,0,Rafayelyan Edgar,Asatryan Murad,fiurst,Asatryan Murad - Rafayelyan Edgar,52,19,33,14,-14,20,18,14,0,0,2,4,8,0,0,14,9:11 - 7:11 - 3:11 - 0:0 - 0:0
19089191,2024-06-05 14:30:00,Papyan Karen - Gevorgyan Hayk,3:2,13:11 - 4:11 - 5:11 - 11:7 - 8:11,2,3,Papyan Karen,Gevorgyan Hayk,fiurst,Gevorgyan Hayk - Papyan Karen,92,51,41,-10,10,24,15,16,18,19,2,-7,-6,4,-3,-10,11:13 - 11:4 - 11:5 - 7:11 - 11:8
19089190,2024-06-05 14:20:00,Rafayelyan Edgar - Nikoghosyan Narek,0:3,11:7 - 11:4 - 12:10 - 0:0 - 0:0,3,0,Rafayelyan Edgar,Nikoghosyan Narek,fiurst,Nikoghosyan Narek - Rafayelyan Edgar,55,21,34,13,-13,18,15,22,0,0,4,7,2,0,0,13,7:11 - 4:11 - 10:12 - 0:0 - 0:0
19089175,2024-06-05 14:00:00,Asatryan Murad - Gevorgyan Hayk,1:3,11:13 - 6:11 - 11:6 - 9:11 - 0:0,1,3,Asatryan Murad,Gevorgyan Hayk,fiurst,Asatryan Murad - Gevorgyan Hayk,78,37,41,4,-4,24,17,17,20,0,2,5,-5,2,0,4,11:13 - 6:11 - 11:6 - 9:11 - 0:0
19089165,2024-06-05 13:45:00,Papyan Karen - Rafayelyan Edgar,1:3,12:10 - 10:12 - 6:11 - 4:11 - 0:0,1,3,Papyan Karen,Rafayelyan Edgar,fiurst,Papyan Karen - Rafayelyan Edgar,76,32,44,12,-12,22,22,17,15,0,-2,2,5,7,0,12,12:10 - 10:12 - 6:11 - 4:11 - 0:0
19089162,2024-06-05 13:30:00,Nikoghosyan Narek - Asatryan Murad,3:0,1:11 - 4:11 - 9:11 - 0:0 - 0:0,0,3,Nikoghosyan Narek,Asatryan Murad,fiurst,Asatryan Murad - Nikoghosyan Narek,47,33,14,-19,19,12,15,20,0,0,-10,-7,-2,0,0,-19,11:1 - 11:4 - 11:9 - 0:0 - 0:0
19089159,2024-06-05 13:15:00,Gevorgyan Hayk - Rafayelyan Edgar,1:3,11:9 - 7:11 - 7:11 - 5:11 - 0:0,1,3,Gevorgyan Hayk,Rafayelyan Edgar,fiurst,Gevorgyan Hayk - Rafayelyan Edgar,72,30,42,12,-12,20,18,18,16,0,-2,4,4,6,0,12,11:9 - 7:11 - 7:11 - 5:11 - 0:0
19089158,2024-06-05 13:00:00,Nikoghosyan Narek - Papyan Karen,0:3,10:12 - 13:15 - 9:11 - 0:0 - 0:0,0,3,Nikoghosyan Narek,Papyan Karen,fiurst,Nikoghosyan Narek - Papyan Karen,70,32,38,6,-6,22,28,20,0,0,2,2,2,0,0,6,10:12 - 13:15 - 9:11 - 0:0 - 0:0
19089157,2024-06-05 12:15:00,Asatryan Murad - Rafayelyan Edgar,3:1,13:11 - 9:11 - 11:8 - 11:7 - 0:0,3,1,Asatryan Murad,Rafayelyan Edgar,fiurst,Asatryan Murad - Rafayelyan Edgar,81,44,37,-7,7,24,20,19,18,0,-2,2,-3,-4,0,-7,13:11 - 9:11 - 11:8 - 11:7 - 0:0
19089156,2024-06-05 12:00:00,Nikoghosyan Narek - Gevorgyan Hayk,1:3,10:12 - 11:6 - 11:8 - 11:9 - 0:0,3,1,Nikoghosyan Narek,Gevorgyan Hayk,fiurst,Gevorgyan Hayk - Nikoghosyan Narek,78,35,43,8,-8,22,17,19,20,0,-2,5,3,2,0,8,12:10 - 6:11 - 8:11 - 9:11 - 0:0
19089154,2024-06-05 11:45:00,Papyan Karen - Asatryan Murad,3:1,12:10 - 9:11 - 7:11 - 9:11 - 0:0,1,3,Papyan Karen,Asatryan Murad,fiurst,Asatryan Murad - Papyan Karen,80,43,37,-6,6,22,20,18,20,0,2,-2,-4,-2,0,-6,10:12 - 11:9 - 11:7 - 11:9 - 0:0
19089152,2024-06-05 11:30:00,Nikoghosyan Narek - Rafayelyan Edgar,1:3,4:11 - 11:8 - 8:11 - 9:11 - 0:0,1,3,Nikoghosyan Narek,Rafayelyan Edgar,fiurst,Nikoghosyan Narek - Rafayelyan Edgar,73,32,41,9,-9,15,19,19,20,0,7,-3,3,2,0,9,4:11 - 11:8 - 8:11 - 9:11 - 0:0
19089150,2024-06-05 11:15:00,Gevorgyan Hayk - Papyan Karen,0:3,8:11 - 7:11 - 8:11 - 0:0 - 0:0,0,3,Gevorgyan Hayk,Papyan Karen,fiurst,Gevorgyan Hayk - Papyan Karen,56,23,33,10,-10,19,18,19,0,0,3,4,3,0,0,10,8:11 - 7:11 - 8:11 - 0:0 - 0:0
19089148,2024-06-05 11:00:00,Asatryan Murad - Nikoghosyan Narek,3:0,11:4 - 11:1 - 11:7 - 0:0 - 0:0,3,0,Asatryan Murad,Nikoghosyan Narek,fiurst,Asatryan Murad - Nikoghosyan Narek,45,33,12,-21,21,15,12,18,0,0,-7,-10,-4,0,0,-21,11:4 - 11:1 - 11:7 - 0:0 - 0:0
19089147,2024-06-05 10:45:00,Rafayelyan Edgar - Papyan Karen,1:3,11:5 - 11:4 - 7:11 - 11:9 - 0:0,3,1,Rafayelyan Edgar,Papyan Karen,fiurst,Papyan Karen - Rafayelyan Edgar,69,29,40,11,-11,16,15,18,20,0,6,7,-4,2,0,11,5:11 - 4:11 - 11:7 - 9:11 - 0:0
19089144,2024-06-05 10:30:00,Gevorgyan Hayk - Asatryan Murad,3:0,3:11 - 6:11 - 7:11 - 0:0 - 0:0,0,3,Gevorgyan Hayk,Asatryan Murad,fiurst,Asatryan Murad - Gevorgyan Hayk,49,33,16,-17,17,14,17,18,0,0,-8,-5,-4,0,0,-17,11:3 - 11:6 - 11:7 - 0:0 - 0:0
19089143,2024-06-05 10:15:00,Papyan Karen - Nikoghosyan Narek,0:3,11:5 - 11:9 - 11:4 - 0:0 - 0:0,3,0,Papyan Karen,Nikoghosyan Narek,fiurst,Nikoghosyan Narek - Papyan Karen,51,18,33,15,-15,16,20,15,0,0,6,2,7,0,0,15,5:11 - 9:11 - 4:11 - 0:0 - 0:0
19089139,2024-06-05 10:00:00,Rafayelyan Edgar - Gevorgyan Hayk,0:3,11:5 - 11:8 - 11:8 - 0:0 - 0:0,3,0,Rafayelyan Edgar,Gevorgyan Hayk,fiurst,Gevorgyan Hayk - Rafayelyan Edgar,54,21,33,12,-12,16,19,19,0,0,6,3,3,0,0,12,5:11 - 8:11 - 8:11 - 0:0 - 0:0
19076101,2024-06-04 17:45:00,Hakobyan Eduard - Petrosyan Davit,0:3,11:13 - 8:11 - 8:11 - 0:0 - 0:0,0,3,Hakobyan Eduard,Petrosyan Davit,fiurst,Hakobyan Eduard - Petrosyan Davit,62,27,35,8,-8,24,19,19,0,0,2,3,3,0,0,8,11:13 - 8:11 - 8:11 - 0:0 - 0:0
19076098,2024-06-04 17:40:00,Arutyunov Ruben - Gevorgyan Gegham,3:0,11:4 - 11:8 - 11:2 - 0:0 - 0:0,3,0,Arutyunov Ruben,Gevorgyan Gegham,fiurst,Arutyunov Ruben - Gevorgyan Gegham,47,33,14,-19,19,15,19,13,0,0,-7,-3,-9,0,0,-19,11:4 - 11:8 - 11:2 - 0:0 - 0:0
19076097,2024-06-04 17:15:00,Avakimyan Davit - Hakobyan Eduard,3:1,11:6 - 15:13 - 8:11 - 12:10 - 0:0,3,1,Avakimyan Davit,Hakobyan Eduard,fiurst,Avakimyan Davit - Hakobyan Eduard,86,46,40,-6,6,17,28,19,22,0,-5,-2,3,-2,0,-6,11:6 - 15:13 - 8:11 - 12:10 - 0:0
19076096,2024-06-04 17:10:00,Arutyunov Ruben - Petrosyan Davit,1:3,8:11 - 8:11 - 11:7 - 11:13 - 0:0,1,3,Arutyunov Ruben,Petrosyan Davit,fiurst,Arutyunov Ruben - Petrosyan Davit,80,38,42,4,-4,19,19,18,24,0,3,3,-4,2,0,4,8:11 - 8:11 - 11:7 - 11:13 - 0:0
19076093,2024-06-04 16:45:00,Gevorgyan Gegham - Avakimyan Davit,3:1,6:11 - 8:11 - 11:7 - 10:12 - 0:0,1,3,Gevorgyan Gegham,Avakimyan Davit,fiurst,Avakimyan Davit - Gevorgyan Gegham,76,41,35,-6,6,17,19,18,22,0,-5,-3,4,-2,0,-6,11:6 - 11:8 - 7:11 - 12:10 - 0:0
19076091,2024-06-04 16:30:00,Hakobyan Eduard - Arutyunov Ruben,3:2,12:10 - 11:9 - 7:11 - 10:12 - 8:11,2,3,Hakobyan Eduard,Arutyunov Ruben,fiurst,Arutyunov Ruben - Hakobyan Eduard,101,53,48,-5,5,22,20,18,22,19,2,2,-4,-2,-3,-5,10:12 - 9:11 - 11:7 - 12:10 - 11:8
19076085,2024-06-04 16:15:00,Petrosyan Davit - Avakimyan Davit,1:3,13:11 - 9:11 - 14:12 - 11:4 - 0:0,3,1,Petrosyan Davit,Avakimyan Davit,fiurst,Avakimyan Davit - Petrosyan Davit,85,38,47,9,-9,24,20,26,15,0,2,-2,2,7,0,9,11:13 - 11:9 - 12:14 - 4:11 - 0:0
19076079,2024-06-04 16:00:00,Gevorgyan Gegham - Hakobyan Eduard,0:3,5:11 - 8:11 - 9:11 - 0:0 - 0:0,0,3,Gevorgyan Gegham,Hakobyan Eduard,fiurst,Gevorgyan Gegham - Hakobyan Eduard,55,22,33,11,-11,16,19,20,0,0,6,3,2,0,0,11,5:11 - 8:11 - 9:11 - 0:0 - 0:0
19076078,2024-06-04 15:45:00,Avakimyan Davit - Arutyunov Ruben,3:0,6:11 - 3:11 - 4:11 - 0:0 - 0:0,0,3,Avakimyan Davit,Arutyunov Ruben,fiurst,Arutyunov Ruben - Avakimyan Davit,46,33,13,-20,20,17,14,15,0,0,-5,-8,-7,0,0,-20,11:6 - 11:3 - 11:4 - 0:0 - 0:0
19076077,2024-06-04 15:30:00,Petrosyan Davit - Gevorgyan Gegham,0:3,11:8 - 11:5 - 11:8 - 0:0 - 0:0,3,0,Petrosyan Davit,Gevorgyan Gegham,fiurst,Gevorgyan Gegham - Petrosyan Davit,54,21,33,12,-12,19,16,19,0,0,3,6,3,0,0,12,8:11 - 5:11 - 8:11 - 0:0 - 0:0
19076076,2024-06-04 15:15:00,Rafayelyan Edgar - Hovhannesyan Rafik,0:3,11:5 - 13:11 - 11:9 - 0:0 - 0:0,3,0,Rafayelyan Edgar,Hovhannesyan Rafik,fiurst,Hovhannesyan Rafik - Rafayelyan Edgar,60,25,35,10,-10,16,24,20,0,0,6,2,2,0,0,10,5:11 - 11:13 - 9:11 - 0:0 - 0:0
19076071,2024-06-04 15:10:00,Nikoghosyan Narek - Papyan Karen,3:0,11:6 - 11:5 - 11:9 - 0:0 - 0:0,3,0,Nikoghosyan Narek,Papyan Karen,fiurst,Nikoghosyan Narek - Papyan Karen,53,33,20,-13,13,17,16,20,0,0,-5,-6,-2,0,0,-13,11:6 - 11:5 - 11:9 - 0:0 - 0:0
19076068,2024-06-04 14:50:00,Asatryan Murad - Rafayelyan Edgar,3:1,11:4 - 13:15 - 11:5 - 11:4 - 0:0,3,1,Asatryan Murad,Rafayelyan Edgar,fiurst,Asatryan Murad - Rafayelyan Edgar,74,46,28,-18,18,15,28,16,15,0,-7,2,-6,-7,0,-18,11:4 - 13:15 - 11:5 - 11:4 - 0:0
19076057,2024-06-04 14:30:00,Hovhannesyan Rafik - Nikoghosyan Narek,3:2,11:3 - 7:11 - 11:3 - 10:12 - 11:1,3,2,Hovhannesyan Rafik,Nikoghosyan Narek,fiurst,Hovhannesyan Rafik - Nikoghosyan Narek,80,50,30,-20,20,14,18,14,22,12,-8,4,-8,2,-10,-20,11:3 - 7:11 - 11:3 - 10:12 - 11:1
19076055,2024-06-04 14:15:00,Asatryan Murad - Papyan Karen,3:1,12:10 - 11:4 - 10:12 - 11:6 - 0:0,3,1,Asatryan Murad,Papyan Karen,fiurst,Asatryan Murad - Papyan Karen,76,44,32,-12,12,22,15,22,17,0,-2,-7,2,-5,0,-12,12:10 - 11:4 - 10:12 - 11:6 - 0:0
19076054,2024-06-04 14:00:00,Rafayelyan Edgar - Nikoghosyan Narek,2:3,5:11 - 9:11 - 11:6 - 11:8 - 11:5,3,2,Rafayelyan Edgar,Nikoghosyan Narek,fiurst,Nikoghosyan Narek - Rafayelyan Edgar,88,41,47,6,-6,16,20,17,19,16,-6,-2,5,3,6,6,11:5 - 11:9 - 6:11 - 8:11 - 5:11
19076049,2024-06-04 13:45:00,Hovhannesyan Rafik - Asatryan Murad,3:1,4:11 - 11:8 - 6:11 - 4:11 - 0:0,1,3,Hovhannesyan Rafik,Asatryan Murad,fiurst,Asatryan Murad - Hovhannesyan Rafik,66,41,25,-16,16,15,19,17,15,0,-7,3,-5,-7,0,-16,11:4 - 8:11 - 11:6 - 11:4 - 0:0
19076047,2024-06-04 13:30:00,Papyan Karen - Rafayelyan Edgar,0:3,6:11 - 9:11 - 5:11 - 0:0 - 0:0,0,3,Papyan Karen,Rafayelyan Edgar,fiurst,Papyan Karen - Rafayelyan Edgar,53,20,33,13,-13,17,20,16,0,0,5,2,6,0,0,13,6:11 - 9:11 - 5:11 - 0:0 - 0:0
19076029,2024-06-04 13:15:00,Nikoghosyan Narek - Asatryan Murad,3:0,7:11 - 5:11 - 9:11 - 0:0 - 0:0,0,3,Nikoghosyan Narek,Asatryan Murad,fiurst,Asatryan Murad - Nikoghosyan Narek,54,33,21,-12,12,18,16,20,0,0,-4,-6,-2,0,0,-12,11:7 - 11:5 - 11:9 - 0:0 - 0:0
19076017,2024-06-04 13:00:00,Papyan Karen - Hovhannesyan Rafik,3:1,9:11 - 13:11 - 3:11 - 4:11 - 0:0,1,3,Papyan Karen,Hovhannesyan Rafik,fiurst,Hovhannesyan Rafik - Papyan Karen,73,44,29,-15,15,20,24,14,15,0,-2,2,-8,-7,0,-15,11:9 - 11:13 - 11:3 - 11:4 - 0:0
19076015,2024-06-04 12:15:00,Rafayelyan Edgar - Asatryan Murad,0:3,11:7 - 11:4 - 11:7 - 0:0 - 0:0,3,0,Rafayelyan Edgar,Asatryan Murad,fiurst,Asatryan Murad - Rafayelyan Edgar,51,18,33,15,-15,18,15,18,0,0,4,7,4,0,0,15,7:11 - 4:11 - 7:11 - 0:0 - 0:0
19076012,2024-06-04 12:00:00,Papyan Karen - Nikoghosyan Narek,3:2,7:11 - 6:11 - 11:7 - 11:3 - 5:11,2,3,Papyan Karen,Nikoghosyan Narek,fiurst,Nikoghosyan Narek - Papyan Karen,83,43,40,-3,3,18,17,18,14,16,-4,-5,4,8,-6,-3,11:7 - 11:6 - 7:11 - 3:11 - 11:5
19076011,2024-06-04 11:55:00,Hovhannesyan Rafik - Rafayelyan Edgar,0:3,7:11 - 8:11 - 7:11 - 0:0 - 0:0,0,3,Hovhannesyan Rafik,Rafayelyan Edgar,fiurst,Hovhannesyan Rafik - Rafayelyan Edgar,55,22,33,11,-11,18,19,18,0,0,4,3,4,0,0,11,7:11 - 8:11 - 7:11 - 0:0 - 0:0
19076009,2024-06-04 11:30:00,Papyan Karen - Asatryan Murad,3:0,7:11 - 6:11 - 6:11 - 0:0 - 0:0,0,3,Papyan Karen,Asatryan Murad,fiurst,Asatryan Murad - Papyan Karen,52,33,19,-14,14,18,17,17,0,0,-4,-5,-5,0,0,-14,11:7 - 11:6 - 11:6 - 0:0 - 0:0
19076006,2024-06-04 11:25:00,Nikoghosyan Narek - Hovhannesyan Rafik,3:1,11:6 - 8:11 - 1:11 - 3:11 - 0:0,1,3,Nikoghosyan Narek,Hovhannesyan Rafik,fiurst,Hovhannesyan Rafik - Nikoghosyan Narek,62,39,23,-16,16,17,19,12,14,0,5,-3,-10,-8,0,-16,6:11 - 11:8 - 11:1 - 11:3 - 0:0
19076005,2024-06-04 11:00:00,Rafayelyan Edgar - Papyan Karen,3:0,7:11 - 8:11 - 8:11 - 0:0 - 0:0,0,3,Rafayelyan Edgar,Papyan Karen,fiurst,Papyan Karen - Rafayelyan Edgar,56,33,23,-10,10,18,19,19,0,0,-4,-3,-3,0,0,-10,11:7 - 11:8 - 11:8 - 0:0 - 0:0
19075993,2024-06-04 10:55:00,Asatryan Murad - Hovhannesyan Rafik,3:0,11:7 - 11:8 - 11:8 - 0:0 - 0:0,3,0,Asatryan Murad,Hovhannesyan Rafik,fiurst,Asatryan Murad - Hovhannesyan Rafik,56,33,23,-10,10,18,19,19,0,0,-4,-3,-3,0,0,-10,11:7 - 11:8 - 11:8 - 0:0 - 0:0
19075991,2024-06-04 10:40:00,Nikoghosyan Narek - Rafayelyan Edgar,0:3,12:14 - 4:11 - 4:11 - 0:0 - 0:0,0,3,Nikoghosyan Narek,Rafayelyan Edgar,fiurst,Nikoghosyan Narek - Rafayelyan Edgar,56,20,36,16,-16,26,15,15,0,0,2,7,7,0,0,16,12:14 - 4:11 - 4:11 - 0:0 - 0:0
19075981,2024-06-04 10:15:00,Hovhannesyan Rafik - Papyan Karen,3:2,11:8 - 15:17 - 11:2 - 8:11 - 12:10,3,2,Hovhannesyan Rafik,Papyan Karen,fiurst,Hovhannesyan Rafik - Papyan Karen,105,57,48,-9,9,19,32,13,19,22,-3,2,-9,3,-2,-9,11:8 - 15:17 - 11:2 - 8:11 - 12:10
19075976,2024-06-04 10:00:00,Asatryan Murad - Nikoghosyan Narek,3:2,11:7 - 11:9 - 6:11 - 6:11 - 11:6,3,2,Asatryan Murad,Nikoghosyan Narek,fiurst,Asatryan Murad - Nikoghosyan Narek,89,45,44,-1,1,18,20,17,17,17,-4,-2,5,5,-5,-1,11:7 - 11:9 - 6:11 - 6:11 - 11:6
19052886,2024-06-03 17:45:00,Petrosyan Davit - Avakimyan Davit,3:1,9:11 - 9:11 - 11:7 - 8:11 - 0:0,1,3,Petrosyan Davit,Avakimyan Davit,fiurst,Avakimyan Davit - Petrosyan Davit,77,40,37,-3,3,20,20,18,19,0,-2,-2,4,-3,0,-3,11:9 - 11:9 - 7:11 - 11:8 - 0:0
19052885,2024-06-03 17:30:00,Soghomonyan Hrayr - Mkrtchyan Andranik,0:3,11:5 - 11:6 - 11:7 - 0:0 - 0:0,3,0,Soghomonyan Hrayr,Mkrtchyan Andranik,fiurst,Mkrtchyan Andranik - Soghomonyan Hrayr,51,18,33,15,-15,16,17,18,0,0,6,5,4,0,0,15,5:11 - 6:11 - 7:11 - 0:0 - 0:0
19052882,2024-06-03 17:15:00,Gevorgyan Gegham - Petrosyan Davit,0:3,5:11 - 3:11 - 5:11 - 0:0 - 0:0,0,3,Gevorgyan Gegham,Petrosyan Davit,fiurst,Gevorgyan Gegham - Petrosyan Davit,46,13,33,20,-20,16,14,16,0,0,6,8,6,0,0,20,5:11 - 3:11 - 5:11 - 0:0 - 0:0
19052879,2024-06-03 17:00:00,Soghomonyan Hrayr - Avakimyan Davit,0:3,11:7 - 11:9 - 11:6 - 0:0 - 0:0,3,0,Soghomonyan Hrayr,Avakimyan Davit,fiurst,Avakimyan Davit - Soghomonyan Hrayr,55,22,33,11,-11,18,20,17,0,0,4,2,5,0,0,11,7:11 - 9:11 - 6:11 - 0:0 - 0:0
19052877,2024-06-03 16:45:00,Mkrtchyan Andranik - Gevorgyan Gegham,3:1,11:13 - 12:10 - 7:11 - 8:11 - 0:0,1,3,Mkrtchyan Andranik,Gevorgyan Gegham,fiurst,Gevorgyan Gegham - Mkrtchyan Andranik,83,45,38,-7,7,24,22,18,19,0,-2,2,-4,-3,0,-7,13:11 - 10:12 - 11:7 - 11:8 - 0:0
19052873,2024-06-03 16:30:00,Petrosyan Davit - Soghomonyan Hrayr,1:3,11:3 - 3:11 - 9:11 - 4:11 - 0:0,1,3,Petrosyan Davit,Soghomonyan Hrayr,fiurst,Petrosyan Davit - Soghomonyan Hrayr,63,27,36,9,-9,14,14,20,15,0,-8,8,2,7,0,9,11:3 - 3:11 - 9:11 - 4:11 - 0:0
19052870,2024-06-03 16:15:00,Avakimyan Davit - Gevorgyan Gegham,3:1,11:6 - 11:9 - 7:11 - 11:7 - 0:0,3,1,Avakimyan Davit,Gevorgyan Gegham,fiurst,Avakimyan Davit - Gevorgyan Gegham,73,40,33,-7,7,17,20,18,18,0,-5,-2,4,-4,0,-7,11:6 - 11:9 - 7:11 - 11:7 - 0:0
19052868,2024-06-03 16:00:00,Mkrtchyan Andranik - Petrosyan Davit,3:2,11:9 - 7:11 - 6:11 - 11:8 - 11:9,3,2,Mkrtchyan Andranik,Petrosyan Davit,fiurst,Mkrtchyan Andranik - Petrosyan Davit,94,46,48,2,-2,20,18,17,19,20,-2,4,5,-3,-2,2,11:9 - 7:11 - 6:11 - 11:8 - 11:9
19052857,2024-06-03 15:45:00,Gevorgyan Gegham - Soghomonyan Hrayr,0:3,3:11 - 5:11 - 6:11 - 0:0 - 0:0,0,3,Gevorgyan Gegham,Soghomonyan Hrayr,fiurst,Gevorgyan Gegham - Soghomonyan Hrayr,47,14,33,19,-19,14,16,17,0,0,8,6,5,0,0,19,3:11 - 5:11 - 6:11 - 0:0 - 0:0
19052852,2024-06-03 15:30:00,Avakimyan Davit - Mkrtchyan Andranik,0:3,5:11 - 9:11 - 8:11 - 0:0 - 0:0,0,3,Avakimyan Davit,Mkrtchyan Andranik,fiurst,Avakimyan Davit - Mkrtchyan Andranik,55,22,33,11,-11,16,20,19,0,0,6,2,3,0,0,11,5:11 - 9:11 - 8:11 - 0:0 - 0:0
19052851,2024-06-03 15:15:00,Nazaryan Mushegh - Asatryan Murad,3:0,5:11 - 5:11 - 6:11 - 0:0 - 0:0,0,3,Nazaryan Mushegh,Asatryan Murad,fiurst,Asatryan Murad - Nazaryan Mushegh,49,33,16,-17,17,16,16,17,0,0,-6,-6,-5,0,0,-17,11:5 - 11:5 - 11:6 - 0:0 - 0:0
19052849,2024-06-03 15:00:00,Rafayelyan Edgar - Hovhannesyan Rafik,1:3,8:11 - 11:9 - 11:8 - 11:3 - 0:0,3,1,Rafayelyan Edgar,Hovhannesyan Rafik,fiurst,Hovhannesyan Rafik - Rafayelyan Edgar,72,31,41,10,-10,19,20,19,14,0,-3,2,3,8,0,10,11:8 - 9:11 - 8:11 - 3:11 - 0:0
19052841,2024-06-03 14:45:00,Diaryan Aleksandr - Nazaryan Mushegh,3:0,11:6 - 11:5 - 11:3 - 0:0 - 0:0,3,0,Diaryan Aleksandr,Nazaryan Mushegh,fiurst,Diaryan Aleksandr - Nazaryan Mushegh,47,33,14,-19,19,17,16,14,0,0,-5,-6,-8,0,0,-19,11:6 - 11:5 - 11:3 - 0:0 - 0:0
19052837,2024-06-03 14:30:00,Asatryan Murad - Rafayelyan Edgar,1:3,8:11 - 8:11 - 11:9 - 8:11 - 0:0,1,3,Asatryan Murad,Rafayelyan Edgar,fiurst,Asatryan Murad - Rafayelyan Edgar,77,35,42,7,-7,19,19,20,19,0,3,3,-2,3,0,7,8:11 - 8:11 - 11:9 - 8:11 - 0:0
19052834,2024-06-03 14:15:00,Diaryan Aleksandr - Hovhannesyan Rafik,3:0,11:2 - 11:8 - 11:7 - 0:0 - 0:0,3,0,Diaryan Aleksandr,Hovhannesyan Rafik,fiurst,Diaryan Aleksandr - Hovhannesyan Rafik,50,33,17,-16,16,13,19,18,0,0,-9,-3,-4,0,0,-16,11:2 - 11:8 - 11:7 - 0:0 - 0:0
19052832,2024-06-03 14:05:00,Nazaryan Mushegh - Rafayelyan Edgar,0:3,9:11 - 7:11 - 5:11 - 0:0 - 0:0,0,3,Nazaryan Mushegh,Rafayelyan Edgar,fiurst,Nazaryan Mushegh - Rafayelyan Edgar,54,21,33,12,-12,20,18,16,0,0,2,4,6,0,0,12,9:11 - 7:11 - 5:11 - 0:0 - 0:0
19052830,2024-06-03 13:45:00,Asatryan Murad - Diaryan Aleksandr,3:0,11:7 - 13:11 - 11:5 - 0:0 - 0:0,3,0,Asatryan Murad,Diaryan Aleksandr,fiurst,Asatryan Murad - Diaryan Aleksandr,58,35,23,-12,12,18,24,16,0,0,-4,-2,-6,0,0,-12,11:7 - 13:11 - 11:5 - 0:0 - 0:0
19052828,2024-06-03 13:30:00,Hovhannesyan Rafik - Nazaryan Mushegh,2:3,8:11 - 11:9 - 11:9 - 7:11 - 7:11,2,3,Hovhannesyan Rafik,Nazaryan Mushegh,fiurst,Hovhannesyan Rafik - Nazaryan Mushegh,95,44,51,7,-7,19,20,20,18,18,3,-2,-2,4,4,7,8:11 - 11:9 - 11:9 - 7:11 - 7:11
19052816,2024-06-03 13:15:00,Rafayelyan Edgar - Diaryan Aleksandr,0:3,11:8 - 11:4 - 11:7 - 0:0 - 0:0,3,0,Rafayelyan Edgar,Diaryan Aleksandr,fiurst,Diaryan Aleksandr - Rafayelyan Edgar,52,19,33,14,-14,19,15,18,0,0,3,7,4,0,0,14,8:11 - 4:11 - 7:11 - 0:0 - 0:0
19052815,2024-06-03 13:00:00,Hovhannesyan Rafik - Asatryan Murad,3:1,12:10 - 4:11 - 10:12 - 9:11 - 0:0,1,3,Hovhannesyan Rafik,Asatryan Murad,fiurst,Asatryan Murad - Hovhannesyan Rafik,79,44,35,-9,9,22,15,22,20,0,2,-7,-2,-2,0,-9,10:12 - 11:4 - 12:10 - 11:9 - 0:0
19052813,2024-06-03 12:20:00,Nazaryan Mushegh - Diaryan Aleksandr,3:0,7:11 - 10:12 - 8:11 - 0:0 - 0:0,0,3,Nazaryan Mushegh,Diaryan Aleksandr,fiurst,Diaryan Aleksandr - Nazaryan Mushegh,59,34,25,-9,9,18,22,19,0,0,-4,-2,-3,0,0,-9,11:7 - 12:10 - 11:8 - 0:0 - 0:0
19052807,2024-06-03 12:00:00,Hovhannesyan Rafik - Rafayelyan Edgar,0:3,4:11 - 8:11 - 3:11 - 0:0 - 0:0,0,3,Hovhannesyan Rafik,Rafayelyan Edgar,fiurst,Hovhannesyan Rafik - Rafayelyan Edgar,48,15,33,18,-18,15,19,14,0,0,7,3,8,0,0,18,4:11 - 8:11 - 3:11 - 0:0 - 0:0
19052800,2024-06-03 11:50:00,Asatryan Murad - Nazaryan Mushegh,3:1,9:11 - 11:5 - 11:6 - 11:8 - 0:0,3,1,Asatryan Murad,Nazaryan Mushegh,fiurst,Asatryan Murad - Nazaryan Mushegh,72,42,30,-12,12,20,16,17,19,0,2,-6,-5,-3,0,-12,9:11 - 11:5 - 11:6 - 11:8 - 0:0
19052795,2024-06-03 11:30:00,Hovhannesyan Rafik - Diaryan Aleksandr,3:0,10:12 - 4:11 - 5:11 - 0:0 - 0:0,0,3,Hovhannesyan Rafik,Diaryan Aleksandr,fiurst,Diaryan Aleksandr - Hovhannesyan Rafik,53,34,19,-15,15,22,15,16,0,0,-2,-7,-6,0,0,-15,12:10 - 11:4 - 11:5 - 0:0 - 0:0
19052794,2024-06-03 11:25:00,Rafayelyan Edgar - Asatryan Murad,1:3,11:6 - 11:13 - 11:6 - 12:10 - 0:0,3,1,Rafayelyan Edgar,Asatryan Murad,fiurst,Asatryan Murad - Rafayelyan Edgar,80,35,45,10,-10,17,24,17,22,0,5,-2,5,2,0,10,6:11 - 13:11 - 6:11 - 10:12 - 0:0
19052781,2024-06-03 11:00:00,Nazaryan Mushegh - Hovhannesyan Rafik,0:3,11:8 - 11:7 - 11:7 - 0:0 - 0:0,3,0,Nazaryan Mushegh,Hovhannesyan Rafik,fiurst,Hovhannesyan Rafik - Nazaryan Mushegh,55,22,33,11,-11,19,18,18,0,0,3,4,4,0,0,11,8:11 - 7:11 - 7:11 - 0:0 - 0:0
19052780,2024-06-03 10:45:00,Diaryan Aleksandr - Asatryan Murad,1:3,16:14 - 11:8 - 10:12 - 11:6 - 0:0,3,1,Diaryan Aleksandr,Asatryan Murad,fiurst,Asatryan Murad - Diaryan Aleksandr,88,40,48,8,-8,30,19,22,17,0,2,3,-2,5,0,8,14:16 - 8:11 - 12:10 - 6:11 - 0:0
19052778,2024-06-03 10:40:00,Rafayelyan Edgar - Nazaryan Mushegh,0:3,11:5 - 11:7 - 11:5 - 0:0 - 0:0,3,0,Rafayelyan Edgar,Nazaryan Mushegh,fiurst,Nazaryan Mushegh - Rafayelyan Edgar,50,17,33,16,-16,16,18,16,0,0,6,4,6,0,0,16,5:11 - 7:11 - 5:11 - 0:0 - 0:0
19052776,2024-06-03 10:15:00,Asatryan Murad - Hovhannesyan Rafik,3:0,11:7 - 11:6 - 11:7 - 0:0 - 0:0,3,0,Asatryan Murad,Hovhannesyan Rafik,fiurst,Asatryan Murad - Hovhannesyan Rafik,53,33,20,-13,13,18,17,18,0,0,-4,-5,-4,0,0,-13,11:7 - 11:6 - 11:7 - 0:0 - 0:0
19052774,2024-06-03 10:00:00,Diaryan Aleksandr - Rafayelyan Edgar,2:3,11:7 - 12:14 - 9:11 - 11:9 - 9:11,2,3,Diaryan Aleksandr,Rafayelyan Edgar,fiurst,Diaryan Aleksandr - Rafayelyan Edgar,104,52,52,0,0,18,26,20,20,20,-4,2,2,-2,2,0,11:7 - 12:14 - 9:11 - 11:9 - 9:11
19033611,2024-06-02 17:45:00,Gevorgyan Hayk - Soghomonyan Hrayr,0:3,7:11 - 14:16 - 10:12 - 0:0 - 0:0,0,3,Gevorgyan Hayk,Soghomonyan Hrayr,fiurst,Gevorgyan Hayk - Soghomonyan Hrayr,70,31,39,8,-8,18,30,22,0,0,4,2,2,0,0,8,7:11 - 14:16 - 10:12 - 0:0 - 0:0
19033607,2024-06-02 17:30:00,Avakimyan Davit - Hakobyan Eduard,1:3,11:13 - 11:9 - 9:11 - 3:11 - 0:0,1,3,Avakimyan Davit,Hakobyan Eduard,fiurst,Avakimyan Davit - Hakobyan Eduard,78,34,44,10,-10,24,20,20,14,0,2,-2,2,8,0,10,11:13 - 11:9 - 9:11 - 3:11 - 0:0
19033602,2024-06-02 17:20:00,Mkrtchyan Andranik - Gevorgyan Hayk,1:3,11:3 - 11:9 - 6:11 - 11:5 - 0:0,3,1,Mkrtchyan Andranik,Gevorgyan Hayk,fiurst,Gevorgyan Hayk - Mkrtchyan Andranik,67,28,39,11,-11,14,20,17,16,0,8,2,-5,6,0,11,3:11 - 9:11 - 11:6 - 5:11 - 0:0
19033588,2024-06-02 17:00:00,Avakimyan Davit - Soghomonyan Hrayr,3:0,13:11 - 11:9 - 11:6 - 0:0 - 0:0,3,0,Avakimyan Davit,Soghomonyan Hrayr,fiurst,Avakimyan Davit - Soghomonyan Hrayr,61,35,26,-9,9,24,20,17,0,0,-2,-2,-5,0,0,-9,13:11 - 11:9 - 11:6 - 0:0 - 0:0
19033582,2024-06-02 16:45:00,Hakobyan Eduard - Mkrtchyan Andranik,3:2,11:13 - 11:6 - 11:9 - 8:11 - 11:3,3,2,Hakobyan Eduard,Mkrtchyan Andranik,fiurst,Hakobyan Eduard - Mkrtchyan Andranik,94,52,42,-10,10,24,17,20,19,14,2,-5,-2,3,-8,-10,11:13 - 11:6 - 11:9 - 8:11 - 11:3
19033578,2024-06-02 16:30:00,Gevorgyan Hayk - Avakimyan Davit,2:3,11:7 - 5:11 - 6:11 - 11:9 - 11:3,3,2,Gevorgyan Hayk,Avakimyan Davit,fiurst,Avakimyan Davit - Gevorgyan Hayk,85,41,44,3,-3,18,16,17,20,14,4,-6,-5,2,8,3,7:11 - 11:5 - 11:6 - 9:11 - 3:11
19033577,2024-06-02 16:15:00,Soghomonyan Hrayr - Mkrtchyan Andranik,3:0,12:14 - 12:14 - 8:11 - 0:0 - 0:0,0,3,Soghomonyan Hrayr,Mkrtchyan Andranik,fiurst,Mkrtchyan Andranik - Soghomonyan Hrayr,71,39,32,-7,7,26,26,19,0,0,-2,-2,-3,0,0,-7,14:12 - 14:12 - 11:8 - 0:0 - 0:0
19033558,2024-06-02 16:10:00,Hakobyan Eduard - Gevorgyan Hayk,3:0,9:11 - 5:11 - 7:11 - 0:0 - 0:0,0,3,Hakobyan Eduard,Gevorgyan Hayk,fiurst,Gevorgyan Hayk - Hakobyan Eduard,54,33,21,-12,12,20,16,18,0,0,-2,-6,-4,0,0,-12,11:9 - 11:5 - 11:7 - 0:0 - 0:0
19033545,2024-06-02 15:45:00,Mkrtchyan Andranik - Avakimyan Davit,3:0,9:11 - 2:11 - 7:11 - 0:0 - 0:0,0,3,Mkrtchyan Andranik,Avakimyan Davit,fiurst,Avakimyan Davit - Mkrtchyan Andranik,51,33,18,-15,15,20,13,18,0,0,-2,-9,-4,0,0,-15,11:9 - 11:2 - 11:7 - 0:0 - 0:0
19033531,2024-06-02 15:15:00,Diaryan Aleksandr - Rafayelyan Edgar,2:3,11:9 - 5:11 - 5:11 - 11:6 - 4:11,2,3,Diaryan Aleksandr,Rafayelyan Edgar,fiurst,Diaryan Aleksandr - Rafayelyan Edgar,84,36,48,12,-12,20,16,16,17,15,-2,6,6,-5,7,12,11:9 - 5:11 - 5:11 - 11:6 - 4:11
19033519,2024-06-02 15:00:00,Nazaryan Mushegh - Nikoghosyan Narek,1:3,11:7 - 9:11 - 4:11 - 11:13 - 0:0,1,3,Nazaryan Mushegh,Nikoghosyan Narek,fiurst,Nazaryan Mushegh - Nikoghosyan Narek,77,35,42,7,-7,18,20,15,24,0,-4,2,7,2,0,7,11:7 - 9:11 - 4:11 - 11:13 - 0:0
19033515,2024-06-02 14:45:00,Papyan Karen - Diaryan Aleksandr,1:3,11:9 - 9:11 - 11:8 - 12:10 - 0:0,3,1,Papyan Karen,Diaryan Aleksandr,fiurst,Diaryan Aleksandr - Papyan Karen,81,38,43,5,-5,20,20,19,22,0,2,-2,3,2,0,5,9:11 - 11:9 - 8:11 - 10:12 - 0:0
19033514,2024-06-02 14:35:00,Rafayelyan Edgar - Nazaryan Mushegh,3:1,4:11 - 12:14 - 11:3 - 8:11 - 0:0,1,3,Rafayelyan Edgar,Nazaryan Mushegh,fiurst,Nazaryan Mushegh - Rafayelyan Edgar,74,39,35,-4,4,15,26,14,19,0,-7,-2,8,-3,0,-4,11:4 - 14:12 - 3:11 - 11:8 - 0:0
19033508,2024-06-02 14:25:00,Papyan Karen - Nikoghosyan Narek,3:0,5:11 - 7:11 - 10:12 - 0:0 - 0:0,0,3,Papyan Karen,Nikoghosyan Narek,fiurst,Nikoghosyan Narek - Papyan Karen,56,34,22,-12,12,16,18,22,0,0,-6,-4,-2,0,0,-12,11:5 - 11:7 - 12:10 - 0:0 - 0:0
19033504,2024-06-02 14:00:00,Diaryan Aleksandr - Nazaryan Mushegh,3:1,12:10 - 9:11 - 11:6 - 11:9 - 0:0,3,1,Diaryan Aleksandr,Nazaryan Mushegh,fiurst,Diaryan Aleksandr - Nazaryan Mushegh,79,43,36,-7,7,22,20,17,20,0,-2,2,-5,-2,0,-7,12:10 - 9:11 - 11:6 - 11:9 - 0:0
19033502,2024-06-02 13:50:00,Rafayelyan Edgar - Papyan Karen,2:3,14:12 - 9:11 - 6:11 - 11:5 - 11:6,3,2,Rafayelyan Edgar,Papyan Karen,fiurst,Papyan Karen - Rafayelyan Edgar,96,45,51,6,-6,26,20,17,16,17,2,-2,-5,6,5,6,12:14 - 11:9 - 11:6 - 5:11 - 6:11
19033489,2024-06-02 13:30:00,Nikoghosyan Narek - Diaryan Aleksandr,1:3,4:11 - 11:8 - 11:8 - 11:9 - 0:0,3,1,Nikoghosyan Narek,Diaryan Aleksandr,fiurst,Diaryan Aleksandr - Nikoghosyan Narek,73,36,37,1,-1,15,19,19,20,0,-7,3,3,2,0,1,11:4 - 8:11 - 8:11 - 9:11 - 0:0
19033488,2024-06-02 13:15:00,Nazaryan Mushegh - Papyan Karen,2:3,15:13 - 8:11 - 11:7 - 5:11 - 12:14,2,3,Nazaryan Mushegh,Papyan Karen,fiurst,Nazaryan Mushegh - Papyan Karen,107,51,56,5,-5,28,19,18,16,26,-2,3,-4,6,2,5,15:13 - 8:11 - 11:7 - 5:11 - 12:14
19033482,2024-06-02 13:00:00,Nikoghosyan Narek - Rafayelyan Edgar,0:3,7:11 - 6:11 - 9:11 - 0:0 - 0:0,0,3,Nikoghosyan Narek,Rafayelyan Edgar,fiurst,Nikoghosyan Narek - Rafayelyan Edgar,55,22,33,11,-11,18,17,20,0,0,4,5,2,0,0,11,7:11 - 6:11 - 9:11 - 0:0 - 0:0
19033479,2024-06-02 12:15:00,Diaryan Aleksandr - Papyan Karen,2:3,8:11 - 4:11 - 11:7 - 11:8 - 8:11,2,3,Diaryan Aleksandr,Papyan Karen,fiurst,Diaryan Aleksandr - Papyan Karen,90,42,48,6,-6,19,15,18,19,19,3,7,-4,-3,3,6,8:11 - 4:11 - 11:7 - 11:8 - 8:11
19033476,2024-06-02 12:00:00,Nikoghosyan Narek - Nazaryan Mushegh,3:1,3:11 - 11:6 - 4:11 - 4:11 - 0:0,1,3,Nikoghosyan Narek,Nazaryan Mushegh,fiurst,Nazaryan Mushegh - Nikoghosyan Narek,61,39,22,-17,17,14,17,15,15,0,-8,5,-7,-7,0,-17,11:3 - 6:11 - 11:4 - 11:4 - 0:0
19033463,2024-06-02 11:45:00,Rafayelyan Edgar - Diaryan Aleksandr,1:3,11:1 - 6:11 - 11:4 - 12:10 - 0:0,3,1,Rafayelyan Edgar,Diaryan Aleksandr,fiurst,Diaryan Aleksandr - Rafayelyan Edgar,66,26,40,14,-14,12,17,15,22,0,10,-5,7,2,0,14,1:11 - 11:6 - 4:11 - 10:12 - 0:0
19033457,2024-06-02 11:30:00,Nikoghosyan Narek - Papyan Karen,2:3,9:11 - 11:4 - 7:11 - 11:8 - 5:11,2,3,Nikoghosyan Narek,Papyan Karen,fiurst,Nikoghosyan Narek - Papyan Karen,88,43,45,2,-2,20,15,18,19,16,2,-7,4,-3,6,2,9:11 - 11:4 - 7:11 - 11:8 - 5:11
19033452,2024-06-02 11:15:00,Nazaryan Mushegh - Rafayelyan Edgar,0:3,8:11 - 7:11 - 5:11 - 0:0 - 0:0,0,3,Nazaryan Mushegh,Rafayelyan Edgar,fiurst,Nazaryan Mushegh - Rafayelyan Edgar,53,20,33,13,-13,19,18,16,0,0,3,4,6,0,0,13,8:11 - 7:11 - 5:11 - 0:0 - 0:0
19033451,2024-06-02 11:00:00,Diaryan Aleksandr - Nikoghosyan Narek,3:0,11:3 - 11:3 - 11:5 - 0:0 - 0:0,3,0,Diaryan Aleksandr,Nikoghosyan Narek,fiurst,Diaryan Aleksandr - Nikoghosyan Narek,44,33,11,-22,22,14,14,16,0,0,-8,-8,-6,0,0,-22,11:3 - 11:3 - 11:5 - 0:0 - 0:0
19033432,2024-06-02 10:45:00,Papyan Karen - Rafayelyan Edgar,0:3,4:11 - 5:11 - 5:11 - 0:0 - 0:0,0,3,Papyan Karen,Rafayelyan Edgar,fiurst,Papyan Karen - Rafayelyan Edgar,47,14,33,19,-19,15,16,16,0,0,7,6,6,0,0,19,4:11 - 5:11 - 5:11 - 0:0 - 0:0
19033431,2024-06-02 10:30:00,Nazaryan Mushegh - Diaryan Aleksandr,3:1,14:12 - 9:11 - 5:11 - 4:11 - 0:0,1,3,Nazaryan Mushegh,Diaryan Aleksandr,fiurst,Diaryan Aleksandr - Nazaryan Mushegh,77,45,32,-13,13,26,20,16,15,0,2,-2,-6,-7,0,-13,12:14 - 11:9 - 11:5 - 11:4 - 0:0
19033430,2024-06-02 10:15:00,Rafayelyan Edgar - Nikoghosyan Narek,1:3,5:11 - 12:10 - 13:11 - 11:9 - 0:0,3,1,Rafayelyan Edgar,Nikoghosyan Narek,fiurst,Nikoghosyan Narek - Rafayelyan Edgar,82,41,41,0,0,16,22,24,20,0,-6,2,2,2,0,0,11:5 - 10:12 - 11:13 - 9:11 - 0:0
19033427,2024-06-02 10:00:00,Papyan Karen - Nazaryan Mushegh,1:3,11:9 - 10:12 - 11:7 - 11:8 - 0:0,3,1,Papyan Karen,Nazaryan Mushegh,fiurst,Nazaryan Mushegh - Papyan Karen,79,36,43,7,-7,20,22,18,19,0,2,-2,4,3,0,7,9:11 - 12:10 - 7:11 - 8:11 - 0:0
19019418,2024-06-01 18:00:00,Petrosyan Davit - Gevorgyan Hayk,3:2,6:11 - 10:12 - 11:8 - 11:4 - 8:11,2,3,Petrosyan Davit,Gevorgyan Hayk,fiurst,Gevorgyan Hayk - Petrosyan Davit,92,46,46,0,0,17,22,19,15,19,-5,-2,3,7,-3,0,11:6 - 12:10 - 8:11 - 4:11 - 11:8
19019417,2024-06-01 17:30:00,Hakobyan Eduard - Gevorgyan Gegham,1:3,12:10 - 11:9 - 9:11 - 11:6 - 0:0,3,1,Hakobyan Eduard,Gevorgyan Gegham,fiurst,Gevorgyan Gegham - Hakobyan Eduard,79,36,43,7,-7,22,20,20,17,0,2,2,-2,5,0,7,10:12 - 9:11 - 11:9 - 6:11 - 0:0
19019416,2024-06-01 17:15:00,Soghomonyan Hrayr - Petrosyan Davit,3:2,13:11 - 7:11 - 9:11 - 12:10 - 9:11,2,3,Soghomonyan Hrayr,Petrosyan Davit,fiurst,Petrosyan Davit - Soghomonyan Hrayr,104,54,50,-4,4,24,18,20,22,20,2,-4,-2,2,-2,-4,11:13 - 11:7 - 11:9 - 10:12 - 11:9
19019403,2024-06-01 17:00:00,Hakobyan Eduard - Gevorgyan Hayk,3:2,1:11 - 11:9 - 8:11 - 11:9 - 11:13,2,3,Hakobyan Eduard,Gevorgyan Hayk,fiurst,Gevorgyan Hayk - Hakobyan Eduard,95,53,42,-11,11,12,20,19,20,24,-10,2,-3,2,-2,-11,11:1 - 9:11 - 11:8 - 9:11 - 13:11
19019399,2024-06-01 16:45:00,Gevorgyan Gegham - Soghomonyan Hrayr,1:3,11:7 - 6:11 - 8:11 - 9:11 - 0:0,1,3,Gevorgyan Gegham,Soghomonyan Hrayr,fiurst,Gevorgyan Gegham - Soghomonyan Hrayr,74,34,40,6,-6,18,17,19,20,0,-4,5,3,2,0,6,11:7 - 6:11 - 8:11 - 9:11 - 0:0
19019381,2024-06-01 16:30:00,Petrosyan Davit - Hakobyan Eduard,2:3,11:3 - 10:12 - 7:11 - 11:3 - 11:9,3,2,Petrosyan Davit,Hakobyan Eduard,fiurst,Hakobyan Eduard - Petrosyan Davit,88,38,50,12,-12,14,22,18,14,20,8,-2,-4,8,2,12,3:11 - 12:10 - 11:7 - 3:11 - 9:11
19019380,2024-06-01 16:15:00,Gevorgyan Hayk - Soghomonyan Hrayr,3:2,6:11 - 11:6 - 12:14 - 11:1 - 11:5,3,2,Gevorgyan Hayk,Soghomonyan Hrayr,fiurst,Gevorgyan Hayk - Soghomonyan Hrayr,88,51,37,-14,14,17,17,26,12,16,5,-5,2,-10,-6,-14,6:11 - 11:6 - 12:14 - 11:1 - 11:5
19019378,2024-06-01 16:00:00,Gevorgyan Gegham - Petrosyan Davit,0:3,8:11 - 4:11 - 8:11 - 0:0 - 0:0,0,3,Gevorgyan Gegham,Petrosyan Davit,fiurst,Gevorgyan Gegham - Petrosyan Davit,53,20,33,13,-13,19,15,19,0,0,3,7,3,0,0,13,8:11 - 4:11 - 8:11 - 0:0 - 0:0
19019373,2024-06-01 15:45:00,Soghomonyan Hrayr - Hakobyan Eduard,1:3,4:11 - 11:9 - 11:7 - 11:5 - 0:0,3,1,Soghomonyan Hrayr,Hakobyan Eduard,fiurst,Hakobyan Eduard - Soghomonyan Hrayr,69,32,37,5,-5,15,20,18,16,0,-7,2,4,6,0,5,11:4 - 9:11 - 7:11 - 5:11 - 0:0
19019372,2024-06-01 15:30:00,Gevorgyan Hayk - Gevorgyan Gegham,0:3,11:7 - 11:4 - 11:4 - 0:0 - 0:0,3,0,Gevorgyan Hayk,Gevorgyan Gegham,fiurst,Gevorgyan Gegham - Gevorgyan Hayk,48,15,33,18,-18,18,15,15,0,0,4,7,7,0,0,18,7:11 - 4:11 - 4:11 - 0:0 - 0:0
19019370,2024-06-01 15:20:00,Papyan Karen - Nazaryan Mushegh,0:3,11:9 - 11:9 - 11:8 - 0:0 - 0:0,3,0,Papyan Karen,Nazaryan Mushegh,fiurst,Nazaryan Mushegh - Papyan Karen,59,26,33,7,-7,20,20,19,0,0,2,2,3,0,0,7,9:11 - 9:11 - 8:11 - 0:0 - 0:0
19019364,2024-06-01 15:00:00,Asatryan Murad - Diaryan Aleksandr,2:3,8:11 - 8:11 - 11:6 - 11:8 - 7:11,2,3,Asatryan Murad,Diaryan Aleksandr,fiurst,Asatryan Murad - Diaryan Aleksandr,92,45,47,2,-2,19,19,17,19,18,3,3,-5,-3,4,2,8:11 - 8:11 - 11:6 - 11:8 - 7:11
19019358,2024-06-01 14:55:00,Hovhannesyan Rafik - Papyan Karen,2:3,11:6 - 12:10 - 12:14 - 8:11 - 11:13,2,3,Hovhannesyan Rafik,Papyan Karen,fiurst,Hovhannesyan Rafik - Papyan Karen,108,54,54,0,0,17,22,26,19,24,-5,-2,2,3,2,0,11:6 - 12:10 - 12:14 - 8:11 - 11:13
19019356,2024-06-01 14:30:00,Nazaryan Mushegh - Asatryan Murad,3:0,4:11 - 5:11 - 9:11 - 0:0 - 0:0,0,3,Nazaryan Mushegh,Asatryan Murad,fiurst,Asatryan Murad - Nazaryan Mushegh,51,33,18,-15,15,15,16,20,0,0,-7,-6,-2,0,0,-15,11:4 - 11:5 - 11:9 - 0:0 - 0:0
19019355,2024-06-01 14:20:00,Hovhannesyan Rafik - Diaryan Aleksandr,3:1,11:9 - 4:11 - 4:11 - 8:11 - 0:0,1,3,Hovhannesyan Rafik,Diaryan Aleksandr,fiurst,Diaryan Aleksandr - Hovhannesyan Rafik,69,42,27,-15,15,20,15,15,19,0,2,-7,-7,-3,0,-15,9:11 - 11:4 - 11:4 - 11:8 - 0:0
19019353,2024-06-01 14:10:00,Papyan Karen - Asatryan Murad,3:0,4:11 - 9:11 - 9:11 - 0:0 - 0:0,0,3,Papyan Karen,Asatryan Murad,fiurst,Asatryan Murad - Papyan Karen,55,33,22,-11,11,15,20,20,0,0,-7,-2,-2,0,0,-11,11:4 - 11:9 - 11:9 - 0:0 - 0:0
19019346,2024-06-01 13:55:00,Nazaryan Mushegh - Hovhannesyan Rafik,3:0,5:11 - 6:11 - 5:11 - 0:0 - 0:0,0,3,Nazaryan Mushegh,Hovhannesyan Rafik,fiurst,Hovhannesyan Rafik - Nazaryan Mushegh,49,33,16,-17,17,16,17,16,0,0,-6,-5,-6,0,0,-17,11:5 - 11:6 - 11:5 - 0:0 - 0:0
19019343,2024-06-01 13:30:00,Diaryan Aleksandr - Papyan Karen,2:3,8:11 - 11:4 - 9:11 - 11:5 - 10:12,2,3,Diaryan Aleksandr,Papyan Karen,fiurst,Diaryan Aleksandr - Papyan Karen,92,49,43,-6,6,19,15,20,16,22,3,-7,2,-6,2,-6,8:11 - 11:4 - 9:11 - 11:5 - 10:12
19019341,2024-06-01 13:15:00,Asatryan Murad - Hovhannesyan Rafik,3:1,5:11 - 13:11 - 11:7 - 11:9 - 0:0,3,1,Asatryan Murad,Hovhannesyan Rafik,fiurst,Asatryan Murad - Hovhannesyan Rafik,78,40,38,-2,2,16,24,18,20,0,6,-2,-4,-2,0,-2,5:11 - 13:11 - 11:7 - 11:9 - 0:0
19019334,2024-06-01 13:00:00,Diaryan Aleksandr - Nazaryan Mushegh,3:0,11:6 - 11:6 - 11:5 - 0:0 - 0:0,3,0,Diaryan Aleksandr,Nazaryan Mushegh,fiurst,Diaryan Aleksandr - Nazaryan Mushegh,50,33,17,-16,16,17,17,16,0,0,-5,-5,-6,0,0,-16,11:6 - 11:6 - 11:5 - 0:0 - 0:0
19019329,2024-06-01 12:15:00,Papyan Karen - Hovhannesyan Rafik,0:3,11:5 - 15:13 - 11:8 - 0:0 - 0:0,3,0,Papyan Karen,Hovhannesyan Rafik,fiurst,Hovhannesyan Rafik - Papyan Karen,63,26,37,11,-11,16,28,19,0,0,6,2,3,0,0,11,5:11 - 13:15 - 8:11 - 0:0 - 0:0
19019327,2024-06-01 12:05:00,Diaryan Aleksandr - Asatryan Murad,3:1,10:12 - 13:11 - 6:11 - 7:11 - 0:0,1,3,Diaryan Aleksandr,Asatryan Murad,fiurst,Asatryan Murad - Diaryan Aleksandr,81,45,36,-9,9,22,24,17,18,0,-2,2,-5,-4,0,-9,12:10 - 11:13 - 11:6 - 11:7 - 0:0
19019325,2024-06-01 11:45:00,Nazaryan Mushegh - Papyan Karen,2:3,14:12 - 14:12 - 8:11 - 7:11 - 8:11,2,3,Nazaryan Mushegh,Papyan Karen,fiurst,Nazaryan Mushegh - Papyan Karen,108,51,57,6,-6,26,26,19,18,19,-2,-2,3,4,3,6,14:12 - 14:12 - 8:11 - 7:11 - 8:11
19019323,2024-06-01 11:30:00,Diaryan Aleksandr - Hovhannesyan Rafik,3:1,9:11 - 11:9 - 11:4 - 11:3 - 0:0,3,1,Diaryan Aleksandr,Hovhannesyan Rafik,fiurst,Diaryan Aleksandr - Hovhannesyan Rafik,69,42,27,-15,15,20,20,15,14,0,2,-2,-7,-8,0,-15,9:11 - 11:9 - 11:4 - 11:3 - 0:0
19019320,2024-06-01 11:15:00,Asatryan Murad - Nazaryan Mushegh,3:0,11:4 - 11:7 - 11:9 - 0:0 - 0:0,3,0,Asatryan Murad,Nazaryan Mushegh,fiurst,Asatryan Murad - Nazaryan Mushegh,53,33,20,-13,13,15,18,20,0,0,-7,-4,-2,0,0,-13,11:4 - 11:7 - 11:9 - 0:0 - 0:0
19019319,2024-06-01 11:00:00,Papyan Karen - Diaryan Aleksandr,1:3,11:5 - 11:9 - 13:15 - 15:13 - 0:0,3,1,Papyan Karen,Diaryan Aleksandr,fiurst,Diaryan Aleksandr - Papyan Karen,92,42,50,8,-8,16,20,28,28,0,6,2,-2,2,0,8,5:11 - 9:11 - 15:13 - 13:15 - 0:0
19019314,2024-06-01 10:45:00,Hovhannesyan Rafik - Nazaryan Mushegh,3:0,11:5 - 11:8 - 11:6 - 0:0 - 0:0,3,0,Hovhannesyan Rafik,Nazaryan Mushegh,fiurst,Hovhannesyan Rafik - Nazaryan Mushegh,52,33,19,-14,14,16,19,17,0,0,-6,-3,-5,0,0,-14,11:5 - 11:8 - 11:6 - 0:0 - 0:0
19019312,2024-06-01 10:30:00,Asatryan Murad - Papyan Karen,3:1,9:11 - 11:5 - 11:9 - 11:9 - 0:0,3,1,Asatryan Murad,Papyan Karen,fiurst,Asatryan Murad - Papyan Karen,76,42,34,-8,8,20,16,20,20,0,2,-6,-2,-2,0,-8,9:11 - 11:5 - 11:9 - 11:9 - 0:0
19019291,2024-06-01 10:15:00,Nazaryan Mushegh - Diaryan Aleksandr,3:0,9:11 - 5:11 - 8:11 - 0:0 - 0:0,0,3,Nazaryan Mushegh,Diaryan Aleksandr,fiurst,Diaryan Aleksandr - Nazaryan Mushegh,55,33,22,-11,11,20,16,19,0,0,-2,-6,-3,0,0,-11,11:9 - 11:5 - 11:8 - 0:0 - 0:0
19019290,2024-06-01 10:00:00,Hovhannesyan Rafik - Asatryan Murad,3:0,9:11 - 6:11 - 4:11 - 0:0 - 0:0,0,3,Hovhannesyan Rafik,Asatryan Murad,fiurst,Asatryan Murad - Hovhannesyan Rafik,52,33,19,-14,14,20,17,15,0,0,-2,-5,-7,0,0,-14,11:9 - 11:6 - 11:4 - 0:0 - 0:0
18999891,2024-05-31 17:45:00,Mkrtchyan Andranik - Avakimyan Davit,1:3,11:4 - 11:13 - 14:12 - 11:8 - 0:0,3,1,Mkrtchyan Andranik,Avakimyan Davit,fiurst,Avakimyan Davit - Mkrtchyan Andranik,84,37,47,10,-10,15,24,26,19,0,7,-2,2,3,0,10,4:11 - 13:11 - 12:14 - 8:11 - 0:0
18999879,2024-05-31 17:40:00,Petrosyan Davit - Gevorgyan Hayk,3:0,9:11 - 4:11 - 4:11 - 0:0 - 0:0,0,3,Petrosyan Davit,Gevorgyan Hayk,fiurst,Gevorgyan Hayk - Petrosyan Davit,50,33,17,-16,16,20,15,15,0,0,-2,-7,-7,0,0,-16,11:9 - 11:4 - 11:4 - 0:0 - 0:0
18999878,2024-05-31 17:25:00,Gevorgyan Gegham - Mkrtchyan Andranik,0:3,8:11 - 14:16 - 11:13 - 0:0 - 0:0,0,3,Gevorgyan Gegham,Mkrtchyan Andranik,fiurst,Gevorgyan Gegham - Mkrtchyan Andranik,73,33,40,7,-7,19,30,24,0,0,3,2,2,0,0,7,8:11 - 14:16 - 11:13 - 0:0 - 0:0
18999874,2024-05-31 17:10:00,Petrosyan Davit - Avakimyan Davit,3:2,9:11 - 11:8 - 12:10 - 9:11 - 6:11,2,3,Petrosyan Davit,Avakimyan Davit,fiurst,Avakimyan Davit - Petrosyan Davit,98,51,47,-4,4,20,19,22,20,17,-2,3,2,-2,-5,-4,11:9 - 8:11 - 10:12 - 11:9 - 11:6
18999871,2024-05-31 16:55:00,Gevorgyan Hayk - Gevorgyan Gegham,2:3,11:8 - 8:11 - 9:11 - 11:6 - 11:7,3,2,Gevorgyan Hayk,Gevorgyan Gegham,fiurst,Gevorgyan Gegham - Gevorgyan Hayk,93,43,50,7,-7,19,19,20,17,18,3,-3,-2,5,4,7,8:11 - 11:8 - 11:9 - 6:11 - 7:11
18999867,2024-05-31 16:40:00,Mkrtchyan Andranik - Petrosyan Davit,3:2,7:11 - 11:8 - 6:11 - 11:4 - 11:8,3,2,Mkrtchyan Andranik,Petrosyan Davit,fiurst,Mkrtchyan Andranik - Petrosyan Davit,88,46,42,-4,4,18,19,17,15,19,4,-3,5,-7,-3,-4,7:11 - 11:8 - 6:11 - 11:4 - 11:8
18999863,2024-05-31 16:20:00,Avakimyan Davit - Gevorgyan Gegham,3:2,12:10 - 3:11 - 11:8 - 8:11 - 14:12,3,2,Avakimyan Davit,Gevorgyan Gegham,fiurst,Avakimyan Davit - Gevorgyan Gegham,100,48,52,4,-4,22,14,19,19,26,-2,8,-3,3,-2,4,12:10 - 3:11 - 11:8 - 8:11 - 14:12
18999862,2024-05-31 16:00:00,Gevorgyan Hayk - Mkrtchyan Andranik,2:3,6:11 - 12:14 - 11:6 - 11:4 - 6:11,2,3,Gevorgyan Hayk,Mkrtchyan Andranik,fiurst,Gevorgyan Hayk - Mkrtchyan Andranik,92,46,46,0,0,17,26,17,15,17,5,2,-5,-7,5,0,6:11 - 12:14 - 11:6 - 11:4 - 6:11
18999860,2024-05-31 15:45:00,Gevorgyan Gegham - Petrosyan Davit,3:1,11:9 - 10:12 - 11:8 - 12:10 - 0:0,3,1,Gevorgyan Gegham,Petrosyan Davit,fiurst,Gevorgyan Gegham - Petrosyan Davit,83,44,39,-5,5,20,22,19,22,0,-2,2,-3,-2,0,-5,11:9 - 10:12 - 11:8 - 12:10 - 0:0
18999858,2024-05-31 15:30:00,Avakimyan Davit - Gevorgyan Hayk,3:1,14:12 - 11:2 - 4:11 - 12:10 - 0:0,3,1,Avakimyan Davit,Gevorgyan Hayk,fiurst,Avakimyan Davit - Gevorgyan Hayk,76,41,35,-6,6,26,13,15,22,0,-2,-9,7,-2,0,-6,14:12 - 11:2 - 4:11 - 12:10 - 0:0
18999857,2024-05-31 15:20:00,Nikoghosyan Narek - Asatryan Murad,3:0,7:11 - 6:11 - 6:11 - 0:0 - 0:0,0,3,Nikoghosyan Narek,Asatryan Murad,fiurst,Asatryan Murad - Nikoghosyan Narek,52,33,19,-14,14,18,17,17,0,0,-4,-5,-5,0,0,-14,11:7 - 11:6 - 11:6 - 0:0 - 0:0
18999854,2024-05-31 15:00:00,Papyan Karen - Hovhannesyan Rafik,3:1,9:11 - 11:3 - 9:11 - 9:11 - 0:0,1,3,Papyan Karen,Hovhannesyan Rafik,fiurst,Hovhannesyan Rafik - Papyan Karen,74,36,38,2,-2,20,14,20,20,0,-2,8,-2,-2,0,2,11:9 - 3:11 - 11:9 - 11:9 - 0:0
18999844,2024-05-31 14:45:00,Rafayelyan Edgar - Nikoghosyan Narek,0:3,11:9 - 13:11 - 11:7 - 0:0 - 0:0,3,0,Rafayelyan Edgar,Nikoghosyan Narek,fiurst,Nikoghosyan Narek - Rafayelyan Edgar,62,27,35,8,-8,20,24,18,0,0,2,2,4,0,0,8,9:11 - 11:13 - 7:11 - 0:0 - 0:0
18999842,2024-05-31 14:30:00,Asatryan Murad - Papyan Karen,3:1,11:4 - 11:3 - 8:11 - 11:6 - 0:0,3,1,Asatryan Murad,Papyan Karen,fiurst,Asatryan Murad - Papyan Karen,65,41,24,-17,17,15,14,19,17,0,-7,-8,3,-5,0,-17,11:4 - 11:3 - 8:11 - 11:6 - 0:0
18999840,2024-05-31 14:20:00,Rafayelyan Edgar - Hovhannesyan Rafik,0:3,11:3 - 11:8 - 11:9 - 0:0 - 0:0,3,0,Rafayelyan Edgar,Hovhannesyan Rafik,fiurst,Hovhannesyan Rafik - Rafayelyan Edgar,53,20,33,13,-13,14,19,20,0,0,8,3,2,0,0,13,3:11 - 8:11 - 9:11 - 0:0 - 0:0
18999835,2024-05-31 14:00:00,Nikoghosyan Narek - Papyan Karen,1:3,11:13 - 11:6 - 6:11 - 9:11 - 0:0,1,3,Nikoghosyan Narek,Papyan Karen,fiurst,Nikoghosyan Narek - Papyan Karen,78,37,41,4,-4,24,17,17,20,0,2,-5,5,2,0,4,11:13 - 11:6 - 6:11 - 9:11 - 0:0
18999834,2024-05-31 13:45:00,Asatryan Murad - Rafayelyan Edgar,3:0,12:10 - 11:5 - 11:8 - 0:0 - 0:0,3,0,Asatryan Murad,Rafayelyan Edgar,fiurst,Asatryan Murad - Rafayelyan Edgar,57,34,23,-11,11,22,16,19,0,0,-2,-6,-3,0,0,-11,12:10 - 11:5 - 11:8 - 0:0 - 0:0
18999832,2024-05-31 13:30:00,Hovhannesyan Rafik - Nikoghosyan Narek,0:3,9:11 - 1:11 - 1:11 - 0:0 - 0:0,0,3,Hovhannesyan Rafik,Nikoghosyan Narek,fiurst,Hovhannesyan Rafik - Nikoghosyan Narek,44,11,33,22,-22,20,12,12,0,0,2,10,10,0,0,22,9:11 - 1:11 - 1:11 - 0:0 - 0:0
18999829,2024-05-31 13:15:00,Papyan Karen - Rafayelyan Edgar,1:3,9:11 - 8:11 - 11:2 - 8:11 - 0:0,1,3,Papyan Karen,Rafayelyan Edgar,fiurst,Papyan Karen - Rafayelyan Edgar,71,36,35,-1,1,20,19,13,19,0,2,3,-9,3,0,-1,9:11 - 8:11 - 11:2 - 8:11 - 0:0
18999827,2024-05-31 13:00:00,Hovhannesyan Rafik - Asatryan Murad,3:0,6:11 - 6:11 - 5:11 - 0:0 - 0:0,0,3,Hovhannesyan Rafik,Asatryan Murad,fiurst,Asatryan Murad - Hovhannesyan Rafik,50,33,17,-16,16,17,17,16,0,0,-5,-5,-6,0,0,-16,11:6 - 11:6 - 11:5 - 0:0 - 0:0
18999821,2024-05-31 12:20:00,Nikoghosyan Narek - Rafayelyan Edgar,2:3,7:11 - 7:11 - 11:8 - 11:7 - 9:11,2,3,Nikoghosyan Narek,Rafayelyan Edgar,fiurst,Nikoghosyan Narek - Rafayelyan Edgar,93,45,48,3,-3,18,18,19,18,20,4,4,-3,-4,2,3,7:11 - 7:11 - 11:8 - 11:7 - 9:11
18999811,2024-05-31 12:05:00,Hovhannesyan Rafik - Papyan Karen,0:3,10:12 - 6:11 - 11:13 - 0:0 - 0:0,0,3,Hovhannesyan Rafik,Papyan Karen,fiurst,Hovhannesyan Rafik - Papyan Karen,63,27,36,9,-9,22,17,24,0,0,2,5,2,0,0,9,10:12 - 6:11 - 11:13 - 0:0 - 0:0
18999809,2024-05-31 11:45:00,Asatryan Murad - Nikoghosyan Narek,3:1,11:5 - 11:13 - 11:5 - 11:4 - 0:0,3,1,Asatryan Murad,Nikoghosyan Narek,fiurst,Asatryan Murad - Nikoghosyan Narek,71,44,27,-17,17,16,24,16,15,0,-6,2,-6,-7,0,-17,11:5 - 11:13 - 11:5 - 11:4 - 0:0
18999807,2024-05-31 11:40:00,Hovhannesyan Rafik - Rafayelyan Edgar,2:3,11:7 - 8:11 - 3:11 - 13:11 - 7:11,2,3,Hovhannesyan Rafik,Rafayelyan Edgar,fiurst,Hovhannesyan Rafik - Rafayelyan Edgar,93,42,51,9,-9,18,19,14,24,18,-4,3,8,-2,4,9,11:7 - 8:11 - 3:11 - 13:11 - 7:11
18999803,2024-05-31 11:15:00,Papyan Karen - Asatryan Murad,3:0,3:11 - 4:11 - 4:11 - 0:0 - 0:0,0,3,Papyan Karen,Asatryan Murad,fiurst,Asatryan Murad - Papyan Karen,44,33,11,-22,22,14,15,15,0,0,-8,-7,-7,0,0,-22,11:3 - 11:4 - 11:4 - 0:0 - 0:0
18999798,2024-05-31 11:05:00,Nikoghosyan Narek - Hovhannesyan Rafik,1:3,10:12 - 11:7 - 11:5 - 11:4 - 0:0,3,1,Nikoghosyan Narek,Hovhannesyan Rafik,fiurst,Hovhannesyan Rafik - Nikoghosyan Narek,71,28,43,15,-15,22,18,16,15,0,-2,4,6,7,0,15,12:10 - 7:11 - 5:11 - 4:11 - 0:0
18999797,2024-05-31 10:45:00,Rafayelyan Edgar - Asatryan Murad,3:0,3:11 - 5:11 - 9:11 - 0:0 - 0:0,0,3,Rafayelyan Edgar,Asatryan Murad,fiurst,Asatryan Murad - Rafayelyan Edgar,50,33,17,-16,16,14,16,20,0,0,-8,-6,-2,0,0,-16,11:3 - 11:5 - 11:9 - 0:0 - 0:0
18999796,2024-05-31 10:30:00,Papyan Karen - Nikoghosyan Narek,1:3,11:7 - 11:9 - 6:11 - 11:8 - 0:0,3,1,Papyan Karen,Nikoghosyan Narek,fiurst,Nikoghosyan Narek - Papyan Karen,74,35,39,4,-4,18,20,17,19,0,4,2,-5,3,0,4,7:11 - 9:11 - 11:6 - 8:11 - 0:0
18999795,2024-05-31 10:15:00,Asatryan Murad - Hovhannesyan Rafik,3:0,11:8 - 11:3 - 11:9 - 0:0 - 0:0,3,0,Asatryan Murad,Hovhannesyan Rafik,fiurst,Asatryan Murad - Hovhannesyan Rafik,53,33,20,-13,13,19,14,20,0,0,-3,-8,-2,0,0,-13,11:8 - 11:3 - 11:9 - 0:0 - 0:0
18999794,2024-05-31 10:00:00,Rafayelyan Edgar - Papyan Karen,0:3,11:7 - 11:7 - 11:5 - 0:0 - 0:0,3,0,Rafayelyan Edgar,Papyan Karen,fiurst,Papyan Karen - Rafayelyan Edgar,52,19,33,14,-14,18,18,16,0,0,4,4,6,0,0,14,7:11 - 7:11 - 5:11 - 0:0 - 0:0
18975828,2024-05-30 17:45:00,Hakobyan Eduard - Gevorgyan Gegham,0:3,11:8 - 11:5 - 11:8 - 0:0 - 0:0,3,0,Hakobyan Eduard,Gevorgyan Gegham,fiurst,Gevorgyan Gegham - Hakobyan Eduard,54,21,33,12,-12,19,16,19,0,0,3,6,3,0,0,12,8:11 - 5:11 - 8:11 - 0:0 - 0:0
18975827,2024-05-30 17:30:00,Mkrtchyan Andranik - Avakimyan Davit,3:0,6:11 - 8:11 - 9:11 - 0:0 - 0:0,0,3,Mkrtchyan Andranik,Avakimyan Davit,fiurst,Avakimyan Davit - Mkrtchyan Andranik,56,33,23,-10,10,17,19,20,0,0,-5,-3,-2,0,0,-10,11:6 - 11:8 - 11:9 - 0:0 - 0:0
18975826,2024-05-30 17:15:00,Soghomonyan Hrayr - Hakobyan Eduard,2:3,12:10 - 7:11 - 11:9 - 9:11 - 11:7,3,2,Soghomonyan Hrayr,Hakobyan Eduard,fiurst,Hakobyan Eduard - Soghomonyan Hrayr,98,48,50,2,-2,22,18,20,20,18,2,-4,2,-2,4,2,10:12 - 11:7 - 9:11 - 11:9 - 7:11
18975816,2024-05-30 17:00:00,Mkrtchyan Andranik - Gevorgyan Gegham,3:1,4:11 - 11:7 - 9:11 - 11:13 - 0:0,1,3,Mkrtchyan Andranik,Gevorgyan Gegham,fiurst,Gevorgyan Gegham - Mkrtchyan Andranik,77,42,35,-7,7,15,18,20,24,0,-7,4,-2,-2,0,-7,11:4 - 7:11 - 11:9 - 13:11 - 0:0
18975812,2024-05-30 16:50:00,Avakimyan Davit - Soghomonyan Hrayr,0:3,4:11 - 4:11 - 3:11 - 0:0 - 0:0,0,3,Avakimyan Davit,Soghomonyan Hrayr,fiurst,Avakimyan Davit - Soghomonyan Hrayr,44,11,33,22,-22,15,15,14,0,0,7,7,8,0,0,22,4:11 - 4:11 - 3:11 - 0:0 - 0:0
18975811,2024-05-30 16:30:00,Hakobyan Eduard - Mkrtchyan Andranik,3:0,11:8 - 11:7 - 11:6 - 0:0 - 0:0,3,0,Hakobyan Eduard,Mkrtchyan Andranik,fiurst,Hakobyan Eduard - Mkrtchyan Andranik,54,33,21,-12,12,19,18,17,0,0,-3,-4,-5,0,0,-12,11:8 - 11:7 - 11:6 - 0:0 - 0:0
18975807,2024-05-30 16:15:00,Gevorgyan Gegham - Soghomonyan Hrayr,1:3,10:12 - 11:9 - 6:11 - 7:11 - 0:0,1,3,Gevorgyan Gegham,Soghomonyan Hrayr,fiurst,Gevorgyan Gegham - Soghomonyan Hrayr,77,34,43,9,-9,22,20,17,18,0,2,-2,5,4,0,9,10:12 - 11:9 - 6:11 - 7:11 - 0:0
18975806,2024-05-30 16:00:00,Avakimyan Davit - Hakobyan Eduard,3:1,11:9 - 11:7 - 10:12 - 11:5 - 0:0,3,1,Avakimyan Davit,Hakobyan Eduard,fiurst,Avakimyan Davit - Hakobyan Eduard,76,43,33,-10,10,20,18,22,16,0,-2,-4,2,-6,0,-10,11:9 - 11:7 - 10:12 - 11:5 - 0:0
18975805,2024-05-30 15:45:00,Soghomonyan Hrayr - Mkrtchyan Andranik,1:3,11:6 - 12:10 - 9:11 - 11:9 - 0:0,3,1,Soghomonyan Hrayr,Mkrtchyan Andranik,fiurst,Mkrtchyan Andranik - Soghomonyan Hrayr,79,36,43,7,-7,17,22,20,20,0,5,2,-2,2,0,7,6:11 - 10:12 - 11:9 - 9:11 - 0:0
18975803,2024-05-30 15:30:00,Gevorgyan Gegham - Avakimyan Davit,1:3,11:5 - 9:11 - 11:8 - 12:10 - 0:0,3,1,Gevorgyan Gegham,Avakimyan Davit,fiurst,Avakimyan Davit - Gevorgyan Gegham,77,34,43,9,-9,16,20,19,22,0,6,-2,3,2,0,9,5:11 - 11:9 - 8:11 - 10:12 - 0:0
18975781,2024-05-30 15:20:00,Rafayelyan Edgar - Hovhannesyan Rafik,1:3,11:8 - 6:11 - 11:6 - 11:9 - 0:0,3,1,Rafayelyan Edgar,Hovhannesyan Rafik,fiurst,Hovhannesyan Rafik - Rafayelyan Edgar,73,34,39,5,-5,19,17,17,20,0,3,-5,5,2,0,5,8:11 - 11:6 - 6:11 - 9:11 - 0:0
18975768,2024-05-30 15:00:00,Diaryan Aleksandr - Papyan Karen,3:1,11:3 - 8:11 - 12:10 - 11:3 - 0:0,3,1,Diaryan Aleksandr,Papyan Karen,fiurst,Diaryan Aleksandr - Papyan Karen,69,42,27,-15,15,14,19,22,14,0,-8,3,-2,-8,0,-15,11:3 - 8:11 - 12:10 - 11:3 - 0:0
18975766,2024-05-30 14:50:00,Nikoghosyan Narek - Rafayelyan Edgar,1:3,7:11 - 9:11 - 11:8 - 4:11 - 0:0,1,3,Nikoghosyan Narek,Rafayelyan Edgar,fiurst,Nikoghosyan Narek - Rafayelyan Edgar,72,31,41,10,-10,18,20,19,15,0,4,2,-3,7,0,10,7:11 - 9:11 - 11:8 - 4:11 - 0:0
18975764,2024-05-30 14:30:00,Hovhannesyan Rafik - Diaryan Aleksandr,3:0,8:11 - 4:11 - 7:11 - 0:0 - 0:0,0,3,Hovhannesyan Rafik,Diaryan Aleksandr,fiurst,Diaryan Aleksandr - Hovhannesyan Rafik,52,33,19,-14,14,19,15,18,0,0,-3,-7,-4,0,0,-14,11:8 - 11:4 - 11:7 - 0:0 - 0:0
18975751,2024-05-30 14:20:00,Nikoghosyan Narek - Papyan Karen,2:3,11:7 - 6:11 - 11:5 - 8:11 - 3:11,2,3,Nikoghosyan Narek,Papyan Karen,fiurst,Nikoghosyan Narek - Papyan Karen,84,39,45,6,-6,18,17,16,19,14,-4,5,-6,3,8,6,11:7 - 6:11 - 11:5 - 8:11 - 3:11
18975750,2024-05-30 14:00:00,Rafayelyan Edgar - Diaryan Aleksandr,0:3,11:8 - 11:8 - 11:7 - 0:0 - 0:0,3,0,Rafayelyan Edgar,Diaryan Aleksandr,fiurst,Diaryan Aleksandr - Rafayelyan Edgar,56,23,33,10,-10,19,19,18,0,0,3,3,4,0,0,10,8:11 - 8:11 - 7:11 - 0:0 - 0:0
18975748,2024-05-30 13:45:00,Hovhannesyan Rafik - Nikoghosyan Narek,1:3,9:11 - 11:9 - 6:11 - 8:11 - 0:0,1,3,Hovhannesyan Rafik,Nikoghosyan Narek,fiurst,Hovhannesyan Rafik - Nikoghosyan Narek,76,34,42,8,-8,20,20,17,19,0,2,-2,5,3,0,8,9:11 - 11:9 - 6:11 - 8:11 - 0:0
18975746,2024-05-30 13:30:00,Papyan Karen - Rafayelyan Edgar,0:3,1:11 - 8:11 - 10:12 - 0:0 - 0:0,0,3,Papyan Karen,Rafayelyan Edgar,fiurst,Papyan Karen - Rafayelyan Edgar,53,19,34,15,-15,12,19,22,0,0,10,3,2,0,0,15,1:11 - 8:11 - 10:12 - 0:0 - 0:0
18975744,2024-05-30 13:15:00,Diaryan Aleksandr - Nikoghosyan Narek,3:2,11:4 - 10:12 - 7:11 - 11:8 - 11:6,3,2,Diaryan Aleksandr,Nikoghosyan Narek,fiurst,Diaryan Aleksandr - Nikoghosyan Narek,91,50,41,-9,9,15,22,18,19,17,-7,2,4,-3,-5,-9,11:4 - 10:12 - 7:11 - 11:8 - 11:6
18975741,2024-05-30 13:10:00,Papyan Karen - Hovhannesyan Rafik,3:0,7:11 - 13:15 - 7:11 - 0:0 - 0:0,0,3,Papyan Karen,Hovhannesyan Rafik,fiurst,Hovhannesyan Rafik - Papyan Karen,64,37,27,-10,10,18,28,18,0,0,-4,-2,-4,0,0,-10,11:7 - 15:13 - 11:7 - 0:0 - 0:0
18975739,2024-05-30 12:20:00,Rafayelyan Edgar - Nikoghosyan Narek,1:3,11:9 - 5:11 - 11:6 - 11:6 - 0:0,3,1,Rafayelyan Edgar,Nikoghosyan Narek,fiurst,Nikoghosyan Narek - Rafayelyan Edgar,70,32,38,6,-6,20,16,17,17,0,2,-6,5,5,0,6,9:11 - 11:5 - 6:11 - 6:11 - 0:0
18975725,2024-05-30 12:00:00,Hovhannesyan Rafik - Rafayelyan Edgar,0:3,10:12 - 6:11 - 7:11 - 0:0 - 0:0,0,3,Hovhannesyan Rafik,Rafayelyan Edgar,fiurst,Hovhannesyan Rafik - Rafayelyan Edgar,57,23,34,11,-11,22,17,18,0,0,2,5,4,0,0,11,10:12 - 6:11 - 7:11 - 0:0 - 0:0
18975738,2024-05-30 12:00:00,Nazaryan Mushegh - Diaryan Aleksandr,3:0,6:11 - 8:11 - 5:11 - 0:0 - 0:0,0,3,Nazaryan Mushegh,Diaryan Aleksandr,fiurst,Diaryan Aleksandr - Nazaryan Mushegh,52,33,19,-14,14,17,19,16,0,0,-5,-3,-6,0,0,-14,11:6 - 11:8 - 11:5 - 0:0 - 0:0
18975722,2024-05-30 11:40:00,Nazaryan Mushegh - Nikoghosyan Narek,0:3,6:11 - 7:11 - 4:11 - 0:0 - 0:0,0,3,Nazaryan Mushegh,Nikoghosyan Narek,fiurst,Nazaryan Mushegh - Nikoghosyan Narek,50,17,33,16,-16,17,18,15,0,0,5,4,7,0,0,16,6:11 - 7:11 - 4:11 - 0:0 - 0:0
18975718,2024-05-30 11:30:00,Diaryan Aleksandr - Hovhannesyan Rafik,3:0,11:9 - 11:9 - 12:10 - 0:0 - 0:0,3,0,Diaryan Aleksandr,Hovhannesyan Rafik,fiurst,Diaryan Aleksandr - Hovhannesyan Rafik,62,34,28,-6,6,20,20,22,0,0,-2,-2,-2,0,0,-6,11:9 - 11:9 - 12:10 - 0:0 - 0:0
18975715,2024-05-30 11:15:00,Rafayelyan Edgar - Nazaryan Mushegh,0:3,11:8 - 11:3 - 11:2 - 0:0 - 0:0,3,0,Rafayelyan Edgar,Nazaryan Mushegh,fiurst,Nazaryan Mushegh - Rafayelyan Edgar,46,13,33,20,-20,19,14,13,0,0,3,8,9,0,0,20,8:11 - 3:11 - 2:11 - 0:0 - 0:0
18975711,2024-05-30 10:50:00,Nikoghosyan Narek - Hovhannesyan Rafik,3:2,9:11 - 5:11 - 16:14 - 11:6 - 9:11,2,3,Nikoghosyan Narek,Hovhannesyan Rafik,fiurst,Hovhannesyan Rafik - Nikoghosyan Narek,103,53,50,-3,3,20,16,30,17,20,-2,-6,2,5,-2,-3,11:9 - 11:5 - 14:16 - 6:11 - 11:9
18975710,2024-05-30 10:30:00,Diaryan Aleksandr - Rafayelyan Edgar,3:2,11:6 - 7:11 - 11:2 - 10:12 - 20:18,3,2,Diaryan Aleksandr,Rafayelyan Edgar,fiurst,Diaryan Aleksandr - Rafayelyan Edgar,108,59,49,-10,10,17,18,13,22,38,-5,4,-9,2,-2,-10,11:6 - 7:11 - 11:2 - 10:12 - 20:18
18975706,2024-05-30 10:15:00,Hovhannesyan Rafik - Nazaryan Mushegh,3:1,14:12 - 4:11 - 11:9 - 11:9 - 0:0,3,1,Hovhannesyan Rafik,Nazaryan Mushegh,fiurst,Hovhannesyan Rafik - Nazaryan Mushegh,81,40,41,1,-1,26,15,20,20,0,-2,7,-2,-2,0,1,14:12 - 4:11 - 11:9 - 11:9 - 0:0
18975702,2024-05-30 10:00:00,Nikoghosyan Narek - Diaryan Aleksandr,2:3,6:11 - 10:12 - 11:9 - 11:9 - 11:7,3,2,Nikoghosyan Narek,Diaryan Aleksandr,fiurst,Diaryan Aleksandr - Nikoghosyan Narek,97,48,49,1,-1,17,22,20,20,18,-5,-2,2,2,4,1,11:6 - 12:10 - 9:11 - 9:11 - 7:11
18958749,2024-05-29 17:45:00,Hakobyan Eduard - Petrosyan Davit,1:3,11:5 - 8:11 - 8:11 - 8:11 - 0:0,1,3,Hakobyan Eduard,Petrosyan Davit,fiurst,Hakobyan Eduard - Petrosyan Davit,73,35,38,3,-3,16,19,19,19,0,-6,3,3,3,0,3,11:5 - 8:11 - 8:11 - 8:11 - 0:0
18958745,2024-05-29 17:30:00,Gevorgyan Hayk - Soghomonyan Hrayr,2:3,11:8 - 11:13 - 9:11 - 11:5 - 5:11,2,3,Gevorgyan Hayk,Soghomonyan Hrayr,fiurst,Gevorgyan Hayk - Soghomonyan Hrayr,95,47,48,1,-1,19,24,20,16,16,-3,2,2,-6,6,1,11:8 - 11:13 - 9:11 - 11:5 - 5:11
18958743,2024-05-29 17:15:00,Avakimyan Davit - Hakobyan Eduard,1:3,7:11 - 12:10 - 8:11 - 9:11 - 0:0,1,3,Avakimyan Davit,Hakobyan Eduard,fiurst,Avakimyan Davit - Hakobyan Eduard,79,36,43,7,-7,18,22,19,20,0,4,-2,3,2,0,7,7:11 - 12:10 - 8:11 - 9:11 - 0:0
18958727,2024-05-29 17:00:00,Gevorgyan Hayk - Petrosyan Davit,3:1,11:9 - 11:9 - 9:11 - 11:5 - 0:0,3,1,Gevorgyan Hayk,Petrosyan Davit,fiurst,Gevorgyan Hayk - Petrosyan Davit,76,42,34,-8,8,20,20,20,16,0,-2,-2,2,-6,0,-8,11:9 - 11:9 - 9:11 - 11:5 - 0:0
18958724,2024-05-29 16:45:00,Soghomonyan Hrayr - Avakimyan Davit,1:3,6:11 - 11:8 - 11:6 - 11:4 - 0:0,3,1,Soghomonyan Hrayr,Avakimyan Davit,fiurst,Avakimyan Davit - Soghomonyan Hrayr,68,29,39,10,-10,17,19,17,15,0,-5,3,5,7,0,10,11:6 - 8:11 - 6:11 - 4:11 - 0:0
18958718,2024-05-29 16:30:00,Hakobyan Eduard - Gevorgyan Hayk,0:3,11:6 - 11:7 - 11:5 - 0:0 - 0:0,3,0,Hakobyan Eduard,Gevorgyan Hayk,fiurst,Gevorgyan Hayk - Hakobyan Eduard,51,18,33,15,-15,17,18,16,0,0,5,4,6,0,0,15,6:11 - 7:11 - 5:11 - 0:0 - 0:0
18958717,2024-05-29 16:15:00,Petrosyan Davit - Avakimyan Davit,3:0,8:11 - 6:11 - 8:11 - 0:0 - 0:0,0,3,Petrosyan Davit,Avakimyan Davit,fiurst,Avakimyan Davit - Petrosyan Davit,55,33,22,-11,11,19,17,19,0,0,-3,-5,-3,0,0,-11,11:8 - 11:6 - 11:8 - 0:0 - 0:0
18958706,2024-05-29 16:00:00,Soghomonyan Hrayr - Hakobyan Eduard,0:3,12:10 - 11:4 - 11:6 - 0:0 - 0:0,3,0,Soghomonyan Hrayr,Hakobyan Eduard,fiurst,Hakobyan Eduard - Soghomonyan Hrayr,54,20,34,14,-14,22,15,17,0,0,2,7,5,0,0,14,10:12 - 4:11 - 6:11 - 0:0 - 0:0
18958702,2024-05-29 15:45:00,Avakimyan Davit - Gevorgyan Hayk,0:3,4:11 - 3:11 - 8:11 - 0:0 - 0:0,0,3,Avakimyan Davit,Gevorgyan Hayk,fiurst,Avakimyan Davit - Gevorgyan Hayk,48,15,33,18,-18,15,14,19,0,0,7,8,3,0,0,18,4:11 - 3:11 - 8:11 - 0:0 - 0:0
18958701,2024-05-29 15:30:00,Petrosyan Davit - Soghomonyan Hrayr,1:3,11:9 - 6:11 - 4:11 - 11:13 - 0:0,1,3,Petrosyan Davit,Soghomonyan Hrayr,fiurst,Petrosyan Davit - Soghomonyan Hrayr,76,32,44,12,-12,20,17,15,24,0,-2,5,7,2,0,12,11:9 - 6:11 - 4:11 - 11:13 - 0:0
18958699,2024-05-29 15:15:00,Nikoghosyan Narek - Diaryan Aleksandr,3:1,15:13 - 4:11 - 2:11 - 3:11 - 0:0,1,3,Nikoghosyan Narek,Diaryan Aleksandr,fiurst,Diaryan Aleksandr - Nikoghosyan Narek,70,46,24,-22,22,28,15,13,14,0,2,-7,-9,-8,0,-22,13:15 - 11:4 - 11:2 - 11:3 - 0:0
18958697,2024-05-29 15:05:00,Papyan Karen - Rafayelyan Edgar,0:3,8:11 - 8:11 - 4:11 - 0:0 - 0:0,0,3,Papyan Karen,Rafayelyan Edgar,fiurst,Papyan Karen - Rafayelyan Edgar,53,20,33,13,-13,19,19,15,0,0,3,3,7,0,0,13,8:11 - 8:11 - 4:11 - 0:0 - 0:0
18958695,2024-05-29 14:45:00,Asatryan Murad - Nikoghosyan Narek,3:1,11:8 - 6:11 - 11:9 - 11:6 - 0:0,3,1,Asatryan Murad,Nikoghosyan Narek,fiurst,Asatryan Murad - Nikoghosyan Narek,73,39,34,-5,5,19,17,20,17,0,-3,5,-2,-5,0,-5,11:8 - 6:11 - 11:9 - 11:6 - 0:0
18958682,2024-05-29 14:40:00,Diaryan Aleksandr - Papyan Karen,3:2,9:11 - 11:9 - 13:11 - 5:11 - 11:9,3,2,Diaryan Aleksandr,Papyan Karen,fiurst,Diaryan Aleksandr - Papyan Karen,100,49,51,2,-2,20,20,24,16,20,2,-2,-2,6,-2,2,9:11 - 11:9 - 13:11 - 5:11 - 11:9
18958676,2024-05-29 14:25:00,Asatryan Murad - Rafayelyan Edgar,0:3,9:11 - 6:11 - 7:11 - 0:0 - 0:0,0,3,Asatryan Murad,Rafayelyan Edgar,fiurst,Asatryan Murad - Rafayelyan Edgar,55,22,33,11,-11,20,17,18,0,0,2,5,4,0,0,11,9:11 - 6:11 - 7:11 - 0:0 - 0:0
18958674,2024-05-29 14:00:00,Nikoghosyan Narek - Papyan Karen,3:1,11:9 - 10:12 - 11:7 - 11:8 - 0:0,3,1,Nikoghosyan Narek,Papyan Karen,fiurst,Nikoghosyan Narek - Papyan Karen,79,43,36,-7,7,20,22,18,19,0,-2,2,-4,-3,0,-7,11:9 - 10:12 - 11:7 - 11:8 - 0:0
18958671,2024-05-29 13:45:00,Diaryan Aleksandr - Asatryan Murad,1:3,7:11 - 11:5 - 11:7 - 11:5 - 0:0,3,1,Diaryan Aleksandr,Asatryan Murad,fiurst,Asatryan Murad - Diaryan Aleksandr,68,28,40,12,-12,18,16,18,16,0,-4,6,4,6,0,12,11:7 - 5:11 - 7:11 - 5:11 - 0:0
18958668,2024-05-29 13:30:00,Rafayelyan Edgar - Nikoghosyan Narek,0:3,11:8 - 11:7 - 11:6 - 0:0 - 0:0,3,0,Rafayelyan Edgar,Nikoghosyan Narek,fiurst,Nikoghosyan Narek - Rafayelyan Edgar,54,21,33,12,-12,19,18,17,0,0,3,4,5,0,0,12,8:11 - 7:11 - 6:11 - 0:0 - 0:0
18958659,2024-05-29 13:15:00,Papyan Karen - Asatryan Murad,3:2,2:11 - 11:8 - 6:11 - 11:9 - 5:11,2,3,Papyan Karen,Asatryan Murad,fiurst,Asatryan Murad - Papyan Karen,85,50,35,-15,15,13,19,17,20,16,-9,3,-5,2,-6,-15,11:2 - 8:11 - 11:6 - 9:11 - 11:5
18958647,2024-05-29 13:00:00,Rafayelyan Edgar - Diaryan Aleksandr,0:3,11:8 - 11:9 - 11:8 - 0:0 - 0:0,3,0,Rafayelyan Edgar,Diaryan Aleksandr,fiurst,Diaryan Aleksandr - Rafayelyan Edgar,58,25,33,8,-8,19,20,19,0,0,3,2,3,0,0,8,8:11 - 9:11 - 8:11 - 0:0 - 0:0
18958646,2024-05-29 12:15:00,Nikoghosyan Narek - Asatryan Murad,3:0,12:14 - 5:11 - 5:11 - 0:0 - 0:0,0,3,Nikoghosyan Narek,Asatryan Murad,fiurst,Asatryan Murad - Nikoghosyan Narek,58,36,22,-14,14,26,16,16,0,0,-2,-6,-6,0,0,-14,14:12 - 11:5 - 11:5 - 0:0 - 0:0
18958644,2024-05-29 12:00:00,Rafayelyan Edgar - Papyan Karen,3:2,11:9 - 4:11 - 11:4 - 4:11 - 6:11,2,3,Rafayelyan Edgar,Papyan Karen,fiurst,Papyan Karen - Rafayelyan Edgar,82,46,36,-10,10,20,15,15,15,17,2,-7,7,-7,-5,-10,9:11 - 11:4 - 4:11 - 11:4 - 11:6
18958632,2024-05-29 11:55:00,Diaryan Aleksandr - Nikoghosyan Narek,3:0,11:5 - 11:2 - 11:3 - 0:0 - 0:0,3,0,Diaryan Aleksandr,Nikoghosyan Narek,fiurst,Diaryan Aleksandr - Nikoghosyan Narek,43,33,10,-23,23,16,13,14,0,0,-6,-9,-8,0,0,-23,11:5 - 11:2 - 11:3 - 0:0 - 0:0
18958618,2024-05-29 11:30:00,Rafayelyan Edgar - Asatryan Murad,3:0,8:11 - 5:11 - 7:11 - 0:0 - 0:0,0,3,Rafayelyan Edgar,Asatryan Murad,fiurst,Asatryan Murad - Rafayelyan Edgar,53,33,20,-13,13,19,16,18,0,0,-3,-6,-4,0,0,-13,11:8 - 11:5 - 11:7 - 0:0 - 0:0
18958617,2024-05-29 11:15:00,Papyan Karen - Diaryan Aleksandr,2:3,7:11 - 13:11 - 10:12 - 11:9 - 11:5,3,2,Papyan Karen,Diaryan Aleksandr,fiurst,Diaryan Aleksandr - Papyan Karen,100,48,52,4,-4,18,24,22,20,16,-4,2,-2,2,6,4,11:7 - 11:13 - 12:10 - 9:11 - 5:11
18958613,2024-05-29 11:05:00,Nikoghosyan Narek - Rafayelyan Edgar,1:3,6:11 - 11:9 - 7:11 - 6:11 - 0:0,1,3,Nikoghosyan Narek,Rafayelyan Edgar,fiurst,Nikoghosyan Narek - Rafayelyan Edgar,72,30,42,12,-12,17,20,18,17,0,5,-2,4,5,0,12,6:11 - 11:9 - 7:11 - 6:11 - 0:0
18958578,2024-05-29 10:45:00,Asatryan Murad - Diaryan Aleksandr,3:1,11:5 - 11:8 - 10:12 - 11:7 - 0:0,3,1,Asatryan Murad,Diaryan Aleksandr,fiurst,Asatryan Murad - Diaryan Aleksandr,75,43,32,-11,11,16,19,22,18,0,-6,-3,2,-4,0,-11,11:5 - 11:8 - 10:12 - 11:7 - 0:0
18958576,2024-05-29 10:35:00,Papyan Karen - Nikoghosyan Narek,2:3,4:11 - 11:8 - 9:11 - 12:10 - 12:10,3,2,Papyan Karen,Nikoghosyan Narek,fiurst,Nikoghosyan Narek - Papyan Karen,98,50,48,-2,2,15,19,20,22,22,-7,3,-2,2,2,-2,11:4 - 8:11 - 11:9 - 10:12 - 10:12
18958573,2024-05-29 10:15:00,Diaryan Aleksandr - Rafayelyan Edgar,3:0,11:8 - 11:8 - 11:7 - 0:0 - 0:0,3,0,Diaryan Aleksandr,Rafayelyan Edgar,fiurst,Diaryan Aleksandr - Rafayelyan Edgar,56,33,23,-10,10,19,19,18,0,0,-3,-3,-4,0,0,-10,11:8 - 11:8 - 11:7 - 0:0 - 0:0
18958561,2024-05-29 10:00:00,Asatryan Murad - Papyan Karen,3:1,11:3 - 9:11 - 11:7 - 11:8 - 0:0,3,1,Asatryan Murad,Papyan Karen,fiurst,Asatryan Murad - Papyan Karen,71,42,29,-13,13,14,20,18,19,0,-8,2,-4,-3,0,-13,11:3 - 9:11 - 11:7 - 11:8 - 0:0
18944890,2024-05-28 17:45:00,Petrosyan Davit - Gevorgyan Hayk,3:2,11:7 - 8:11 - 7:11 - 11:9 - 2:11,2,3,Petrosyan Davit,Gevorgyan Hayk,fiurst,Gevorgyan Hayk - Petrosyan Davit,88,49,39,-10,10,18,19,18,20,13,4,-3,-4,2,-9,-10,7:11 - 11:8 - 11:7 - 9:11 - 11:2
18944887,2024-05-28 17:30:00,Hakobyan Eduard - Gevorgyan Gegham,2:3,15:13 - 7:11 - 9:11 - 11:7 - 11:8,3,2,Hakobyan Eduard,Gevorgyan Gegham,fiurst,Gevorgyan Gegham - Hakobyan Eduard,103,50,53,3,-3,28,18,20,18,19,2,-4,-2,4,3,3,13:15 - 11:7 - 11:9 - 7:11 - 8:11
18944883,2024-05-28 17:15:00,Mkrtchyan Andranik - Petrosyan Davit,3:0,11:5 - 11:7 - 12:10 - 0:0 - 0:0,3,0,Mkrtchyan Andranik,Petrosyan Davit,fiurst,Mkrtchyan Andranik - Petrosyan Davit,56,34,22,-12,12,16,18,22,0,0,-6,-4,-2,0,0,-12,11:5 - 11:7 - 12:10 - 0:0 - 0:0
18944881,2024-05-28 17:00:00,Hakobyan Eduard - Gevorgyan Hayk,2:3,4:11 - 11:9 - 11:9 - 9:11 - 11:7,3,2,Hakobyan Eduard,Gevorgyan Hayk,fiurst,Gevorgyan Hayk - Hakobyan Eduard,93,47,46,-1,1,15,20,20,20,18,-7,2,2,-2,4,-1,11:4 - 9:11 - 9:11 - 11:9 - 7:11
18944880,2024-05-28 16:55:00,Gevorgyan Gegham - Mkrtchyan Andranik,3:1,10:12 - 11:7 - 12:10 - 12:10 - 0:0,3,1,Gevorgyan Gegham,Mkrtchyan Andranik,fiurst,Gevorgyan Gegham - Mkrtchyan Andranik,84,45,39,-6,6,22,18,22,22,0,2,-4,-2,-2,0,-6,10:12 - 11:7 - 12:10 - 12:10 - 0:0
18944878,2024-05-28 16:30:00,Petrosyan Davit - Hakobyan Eduard,1:3,11:3 - 5:11 - 11:2 - 11:5 - 0:0,3,1,Petrosyan Davit,Hakobyan Eduard,fiurst,Hakobyan Eduard - Petrosyan Davit,59,21,38,17,-17,14,16,13,16,0,8,-6,9,6,0,17,3:11 - 11:5 - 2:11 - 5:11 - 0:0
18944867,2024-05-28 16:25:00,Gevorgyan Hayk - Mkrtchyan Andranik,3:2,11:3 - 9:11 - 6:11 - 11:8 - 11:8,3,2,Gevorgyan Hayk,Mkrtchyan Andranik,fiurst,Gevorgyan Hayk - Mkrtchyan Andranik,89,48,41,-7,7,14,20,17,19,19,-8,2,5,-3,-3,-7,11:3 - 9:11 - 6:11 - 11:8 - 11:8
18944866,2024-05-28 16:10:00,Gevorgyan Gegham - Petrosyan Davit,0:3,5:11 - 3:11 - 9:11 - 0:0 - 0:0,0,3,Gevorgyan Gegham,Petrosyan Davit,fiurst,Gevorgyan Gegham - Petrosyan Davit,50,17,33,16,-16,16,14,20,0,0,6,8,2,0,0,16,5:11 - 3:11 - 9:11 - 0:0 - 0:0
18944862,2024-05-28 15:50:00,Mkrtchyan Andranik - Hakobyan Eduard,3:1,11:5 - 11:13 - 5:11 - 8:11 - 0:0,1,3,Mkrtchyan Andranik,Hakobyan Eduard,fiurst,Hakobyan Eduard - Mkrtchyan Andranik,75,40,35,-5,5,16,24,16,19,0,6,-2,-6,-3,0,-5,5:11 - 13:11 - 11:5 - 11:8 - 0:0
18944858,2024-05-28 15:35:00,Gevorgyan Hayk - Gevorgyan Gegham,2:3,11:5 - 11:9 - 8:11 - 7:11 - 11:7,3,2,Gevorgyan Hayk,Gevorgyan Gegham,fiurst,Gevorgyan Gegham - Gevorgyan Hayk,91,43,48,5,-5,16,20,19,18,18,6,2,-3,-4,4,5,5:11 - 9:11 - 11:8 - 11:7 - 7:11
18944857,2024-05-28 15:15:00,Asatryan Murad - Papyan Karen,3:0,13:11 - 14:12 - 13:11 - 0:0 - 0:0,3,0,Asatryan Murad,Papyan Karen,fiurst,Asatryan Murad - Papyan Karen,74,40,34,-6,6,24,26,24,0,0,-2,-2,-2,0,0,-6,13:11 - 14:12 - 13:11 - 0:0 - 0:0
18944854,2024-05-28 15:05:00,Hovhannesyan Rafik - Nikoghosyan Narek,3:2,6:11 - 13:11 - 7:11 - 11:8 - 11:6,3,2,Hovhannesyan Rafik,Nikoghosyan Narek,fiurst,Hovhannesyan Rafik - Nikoghosyan Narek,95,48,47,-1,1,17,24,18,19,17,5,-2,4,-3,-5,-1,6:11 - 13:11 - 7:11 - 11:8 - 11:6
18944844,2024-05-28 14:50:00,Nazaryan Mushegh - Asatryan Murad,3:0,8:11 - 4:11 - 3:11 - 0:0 - 0:0,0,3,Nazaryan Mushegh,Asatryan Murad,fiurst,Asatryan Murad - Nazaryan Mushegh,48,33,15,-18,18,19,15,14,0,0,-3,-7,-8,0,0,-18,11:8 - 11:4 - 11:3 - 0:0 - 0:0
18944843,2024-05-28 14:40:00,Papyan Karen - Hovhannesyan Rafik,0:3,11:7 - 11:9 - 11:9 - 0:0 - 0:0,3,0,Papyan Karen,Hovhannesyan Rafik,fiurst,Hovhannesyan Rafik - Papyan Karen,58,25,33,8,-8,18,20,20,0,0,4,2,2,0,0,8,7:11 - 9:11 - 9:11 - 0:0 - 0:0
18944842,2024-05-28 14:20:00,Nazaryan Mushegh - Nikoghosyan Narek,3:0,13:11 - 13:11 - 11:7 - 0:0 - 0:0,3,0,Nazaryan Mushegh,Nikoghosyan Narek,fiurst,Nazaryan Mushegh - Nikoghosyan Narek,66,37,29,-8,8,24,24,18,0,0,-2,-2,-4,0,0,-8,13:11 - 13:11 - 11:7 - 0:0 - 0:0
18944839,2024-05-28 14:10:00,Asatryan Murad - Hovhannesyan Rafik,3:0,11:7 - 12:10 - 11:8 - 0:0 - 0:0,3,0,Asatryan Murad,Hovhannesyan Rafik,fiurst,Asatryan Murad - Hovhannesyan Rafik,59,34,25,-9,9,18,22,19,0,0,-4,-2,-3,0,0,-9,11:7 - 12:10 - 11:8 - 0:0 - 0:0
18944837,2024-05-28 13:45:00,Papyan Karen - Nazaryan Mushegh,3:1,11:7 - 13:15 - 11:13 - 10:12 - 0:0,1,3,Papyan Karen,Nazaryan Mushegh,fiurst,Nazaryan Mushegh - Papyan Karen,92,47,45,-2,2,18,28,24,22,0,4,-2,-2,-2,0,-2,7:11 - 15:13 - 13:11 - 12:10 - 0:0
18944836,2024-05-28 13:30:00,Nikoghosyan Narek - Asatryan Murad,3:2,11:4 - 11:13 - 6:11 - 11:8 - 5:11,2,3,Nikoghosyan Narek,Asatryan Murad,fiurst,Asatryan Murad - Nikoghosyan Narek,91,47,44,-3,3,15,24,17,19,16,7,-2,-5,3,-6,-3,4:11 - 13:11 - 11:6 - 8:11 - 11:5
18944830,2024-05-28 13:15:00,Hovhannesyan Rafik - Nazaryan Mushegh,3:0,11:5 - 11:7 - 11:9 - 0:0 - 0:0,3,0,Hovhannesyan Rafik,Nazaryan Mushegh,fiurst,Hovhannesyan Rafik - Nazaryan Mushegh,54,33,21,-12,12,16,18,20,0,0,-6,-4,-2,0,0,-12,11:5 - 11:7 - 11:9 - 0:0 - 0:0
18944824,2024-05-28 13:00:00,Nikoghosyan Narek - Papyan Karen,0:3,9:11 - 10:12 - 4:11 - 0:0 - 0:0,0,3,Nikoghosyan Narek,Papyan Karen,fiurst,Nikoghosyan Narek - Papyan Karen,57,23,34,11,-11,20,22,15,0,0,2,2,7,0,0,11,9:11 - 10:12 - 4:11 - 0:0 - 0:0
18944823,2024-05-28 12:15:00,Asatryan Murad - Nazaryan Mushegh,3:0,11:5 - 11:3 - 11:4 - 0:0 - 0:0,3,0,Asatryan Murad,Nazaryan Mushegh,fiurst,Asatryan Murad - Nazaryan Mushegh,45,33,12,-21,21,16,14,15,0,0,-6,-8,-7,0,0,-21,11:5 - 11:3 - 11:4 - 0:0 - 0:0
18944821,2024-05-28 12:00:00,Nikoghosyan Narek - Hovhannesyan Rafik,3:1,7:11 - 9:11 - 11:5 - 9:11 - 0:0,1,3,Nikoghosyan Narek,Hovhannesyan Rafik,fiurst,Hovhannesyan Rafik - Nikoghosyan Narek,74,38,36,-2,2,18,20,16,20,0,-4,-2,6,-2,0,-2,11:7 - 11:9 - 5:11 - 11:9 - 0:0
18944820,2024-05-28 11:45:00,Papyan Karen - Asatryan Murad,3:0,5:11 - 9:11 - 8:11 - 0:0 - 0:0,0,3,Papyan Karen,Asatryan Murad,fiurst,Asatryan Murad - Papyan Karen,55,33,22,-11,11,16,20,19,0,0,-6,-2,-3,0,0,-11,11:5 - 11:9 - 11:8 - 0:0 - 0:0
18944819,2024-05-28 11:30:00,Nikoghosyan Narek - Nazaryan Mushegh,2:3,11:13 - 9:11 - 13:11 - 11:4 - 11:3,3,2,Nikoghosyan Narek,Nazaryan Mushegh,fiurst,Nazaryan Mushegh - Nikoghosyan Narek,97,42,55,13,-13,24,20,24,15,14,-2,-2,2,7,8,13,13:11 - 11:9 - 11:13 - 4:11 - 3:11
18944815,2024-05-28 11:15:00,Hovhannesyan Rafik - Papyan Karen,3:0,11:6 - 11:9 - 11:9 - 0:0 - 0:0,3,0,Hovhannesyan Rafik,Papyan Karen,fiurst,Hovhannesyan Rafik - Papyan Karen,57,33,24,-9,9,17,20,20,0,0,-5,-2,-2,0,0,-9,11:6 - 11:9 - 11:9 - 0:0 - 0:0
18944813,2024-05-28 11:00:00,Asatryan Murad - Nikoghosyan Narek,3:0,11:3 - 11:7 - 11:9 - 0:0 - 0:0,3,0,Asatryan Murad,Nikoghosyan Narek,fiurst,Asatryan Murad - Nikoghosyan Narek,52,33,19,-14,14,14,18,20,0,0,-8,-4,-2,0,0,-14,11:3 - 11:7 - 11:9 - 0:0 - 0:0
18944808,2024-05-28 10:45:00,Nazaryan Mushegh - Papyan Karen,1:3,7:11 - 13:11 - 9:11 - 9:11 - 0:0,1,3,Nazaryan Mushegh,Papyan Karen,fiurst,Nazaryan Mushegh - Papyan Karen,82,38,44,6,-6,18,24,20,20,0,4,-2,2,2,0,6,7:11 - 13:11 - 9:11 - 9:11 - 0:0
18944801,2024-05-28 10:30:00,Hovhannesyan Rafik - Asatryan Murad,3:0,3:11 - 8:11 - 7:11 - 0:0 - 0:0,0,3,Hovhannesyan Rafik,Asatryan Murad,fiurst,Asatryan Murad - Hovhannesyan Rafik,51,33,18,-15,15,14,19,18,0,0,-8,-3,-4,0,0,-15,11:3 - 11:8 - 11:7 - 0:0 - 0:0
18944800,2024-05-28 10:15:00,Papyan Karen - Nikoghosyan Narek,0:3,11:8 - 11:9 - 12:10 - 0:0 - 0:0,3,0,Papyan Karen,Nikoghosyan Narek,fiurst,Nikoghosyan Narek - Papyan Karen,61,27,34,7,-7,19,20,22,0,0,3,2,2,0,0,7,8:11 - 9:11 - 10:12 - 0:0 - 0:0
18944799,2024-05-28 10:00:00,Nazaryan Mushegh - Hovhannesyan Rafik,3:0,7:11 - 7:11 - 5:11 - 0:0 - 0:0,0,3,Nazaryan Mushegh,Hovhannesyan Rafik,fiurst,Hovhannesyan Rafik - Nazaryan Mushegh,52,33,19,-14,14,18,18,16,0,0,-4,-4,-6,0,0,-14,11:7 - 11:7 - 11:5 - 0:0 - 0:0
18920556,2024-05-27 17:50:00,Gevorgyan Hayk - Mkrtchyan Andranik,3:1,9:11 - 11:8 - 11:4 - 11:4 - 0:0,3,1,Gevorgyan Hayk,Mkrtchyan Andranik,fiurst,Gevorgyan Hayk - Mkrtchyan Andranik,69,42,27,-15,15,20,19,15,15,0,2,-3,-7,-7,0,-15,9:11 - 11:8 - 11:4 - 11:4 - 0:0
18920553,2024-05-27 17:30:00,Soghomonyan Hrayr - Petrosyan Davit,3:0,8:11 - 8:11 - 9:11 - 0:0 - 0:0,0,3,Soghomonyan Hrayr,Petrosyan Davit,fiurst,Petrosyan Davit - Soghomonyan Hrayr,58,33,25,-8,8,19,19,20,0,0,-3,-3,-2,0,0,-8,11:8 - 11:8 - 11:9 - 0:0 - 0:0
18920550,2024-05-27 17:15:00,Gevorgyan Gegham - Gevorgyan Hayk,0:3,1:11 - 4:11 - 5:11 - 0:0 - 0:0,0,3,Gevorgyan Gegham,Gevorgyan Hayk,fiurst,Gevorgyan Gegham - Gevorgyan Hayk,43,10,33,23,-23,12,15,16,0,0,10,7,6,0,0,23,1:11 - 4:11 - 5:11 - 0:0 - 0:0
18920549,2024-05-27 17:05:00,Soghomonyan Hrayr - Mkrtchyan Andranik,1:3,11:8 - 7:11 - 12:10 - 11:8 - 0:0,3,1,Soghomonyan Hrayr,Mkrtchyan Andranik,fiurst,Mkrtchyan Andranik - Soghomonyan Hrayr,78,37,41,4,-4,19,18,22,19,0,3,-4,2,3,0,4,8:11 - 11:7 - 10:12 - 8:11 - 0:0
18920544,2024-05-27 16:55:00,Petrosyan Davit - Gevorgyan Gegham,0:3,13:11 - 11:7 - 11:5 - 0:0 - 0:0,3,0,Petrosyan Davit,Gevorgyan Gegham,fiurst,Gevorgyan Gegham - Petrosyan Davit,58,23,35,12,-12,24,18,16,0,0,2,4,6,0,0,12,11:13 - 7:11 - 5:11 - 0:0 - 0:0
18920533,2024-05-27 16:35:00,Gevorgyan Hayk - Soghomonyan Hrayr,2:3,5:11 - 11:9 - 9:11 - 11:8 - 3:11,2,3,Gevorgyan Hayk,Soghomonyan Hrayr,fiurst,Gevorgyan Hayk - Soghomonyan Hrayr,89,39,50,11,-11,16,20,20,19,14,6,-2,2,-3,8,11,5:11 - 11:9 - 9:11 - 11:8 - 3:11
18920531,2024-05-27 16:20:00,Mkrtchyan Andranik - Gevorgyan Gegham,3:2,8:11 - 11:6 - 8:11 - 11:6 - 9:11,2,3,Mkrtchyan Andranik,Gevorgyan Gegham,fiurst,Gevorgyan Gegham - Mkrtchyan Andranik,92,45,47,2,-2,19,17,19,17,20,-3,5,-3,5,-2,2,11:8 - 6:11 - 11:8 - 6:11 - 11:9
18920528,2024-05-27 16:00:00,Petrosyan Davit - Gevorgyan Hayk,1:3,9:11 - 13:11 - 11:5 - 11:9 - 0:0,3,1,Petrosyan Davit,Gevorgyan Hayk,fiurst,Gevorgyan Hayk - Petrosyan Davit,80,36,44,8,-8,20,24,16,20,0,-2,2,6,2,0,8,11:9 - 11:13 - 5:11 - 9:11 - 0:0
18920526,2024-05-27 15:45:00,Gevorgyan Gegham - Soghomonyan Hrayr,1:3,4:11 - 14:12 - 6:11 - 9:11 - 0:0,1,3,Gevorgyan Gegham,Soghomonyan Hrayr,fiurst,Gevorgyan Gegham - Soghomonyan Hrayr,78,33,45,12,-12,15,26,17,20,0,7,-2,5,2,0,12,4:11 - 14:12 - 6:11 - 9:11 - 0:0
18920524,2024-05-27 15:30:00,Mkrtchyan Andranik - Petrosyan Davit,0:3,7:11 - 8:11 - 5:11 - 0:0 - 0:0,0,3,Mkrtchyan Andranik,Petrosyan Davit,fiurst,Mkrtchyan Andranik - Petrosyan Davit,53,20,33,13,-13,18,19,16,0,0,4,3,6,0,0,13,7:11 - 8:11 - 5:11 - 0:0 - 0:0
18920522,2024-05-27 15:20:00,Rafayelyan Edgar - Hovhannesyan Rafik,0:3,11:7 - 11:9 - 11:4 - 0:0 - 0:0,3,0,Rafayelyan Edgar,Hovhannesyan Rafik,fiurst,Hovhannesyan Rafik - Rafayelyan Edgar,53,20,33,13,-13,18,20,15,0,0,4,2,7,0,0,13,7:11 - 9:11 - 4:11 - 0:0 - 0:0
18920519,2024-05-27 15:00:00,Asatryan Murad - Nazaryan Mushegh,3:0,11:6 - 11:5 - 11:7 - 0:0 - 0:0,3,0,Asatryan Murad,Nazaryan Mushegh,fiurst,Asatryan Murad - Nazaryan Mushegh,51,33,18,-15,15,17,16,18,0,0,-5,-6,-4,0,0,-15,11:6 - 11:5 - 11:7 - 0:0 - 0:0
18920516,2024-05-27 14:50:00,Diaryan Aleksandr - Rafayelyan Edgar,1:3,11:9 - 7:11 - 8:11 - 7:11 - 0:0,1,3,Diaryan Aleksandr,Rafayelyan Edgar,fiurst,Diaryan Aleksandr - Rafayelyan Edgar,75,33,42,9,-9,20,18,19,18,0,-2,4,3,4,0,9,11:9 - 7:11 - 8:11 - 7:11 - 0:0
18920515,2024-05-27 14:30:00,Hovhannesyan Rafik - Asatryan Murad,3:1,7:11 - 11:4 - 7:11 - 2:11 - 0:0,1,3,Hovhannesyan Rafik,Asatryan Murad,fiurst,Asatryan Murad - Hovhannesyan Rafik,64,37,27,-10,10,18,15,18,13,0,-4,7,-4,-9,0,-10,11:7 - 4:11 - 11:7 - 11:2 - 0:0
18920506,2024-05-27 14:20:00,Diaryan Aleksandr - Nazaryan Mushegh,3:2,11:8 - 8:11 - 9:11 - 11:9 - 11:5,3,2,Diaryan Aleksandr,Nazaryan Mushegh,fiurst,Diaryan Aleksandr - Nazaryan Mushegh,94,50,44,-6,6,19,19,20,20,16,-3,3,2,-2,-6,-6,11:8 - 8:11 - 9:11 - 11:9 - 11:5
18920501,2024-05-27 14:00:00,Rafayelyan Edgar - Asatryan Murad,3:0,9:11 - 2:11 - 10:12 - 0:0 - 0:0,0,3,Rafayelyan Edgar,Asatryan Murad,fiurst,Asatryan Murad - Rafayelyan Edgar,55,34,21,-13,13,20,13,22,0,0,-2,-9,-2,0,0,-13,11:9 - 11:2 - 12:10 - 0:0 - 0:0
18924107,2024-05-27 13:55:00,Hovhannesyan Rafik - Diaryan Aleksandr,1:3,11:8 - 3:11 - 11:9 - 11:8 - 0:0,3,1,Hovhannesyan Rafik,Diaryan Aleksandr,fiurst,Diaryan Aleksandr - Hovhannesyan Rafik,72,36,36,0,0,19,14,20,19,0,3,-8,2,3,0,0,8:11 - 11:3 - 9:11 - 8:11 - 0:0
18924104,2024-05-27 13:30:00,Nazaryan Mushegh - Rafayelyan Edgar,2:3,11:5 - 8:11 - 11:7 - 9:11 - 4:11,2,3,Nazaryan Mushegh,Rafayelyan Edgar,fiurst,Nazaryan Mushegh - Rafayelyan Edgar,88,43,45,2,-2,16,19,18,20,15,-6,3,-4,2,7,2,11:5 - 8:11 - 11:7 - 9:11 - 4:11
18924101,2024-05-27 13:15:00,Asatryan Murad - Diaryan Aleksandr,2:3,13:11 - 11:3 - 9:11 - 3:11 - 9:11,2,3,Asatryan Murad,Diaryan Aleksandr,fiurst,Asatryan Murad - Diaryan Aleksandr,92,45,47,2,-2,24,14,20,14,20,-2,-8,2,8,2,2,13:11 - 11:3 - 9:11 - 3:11 - 9:11
18924100,2024-05-27 13:00:00,Nazaryan Mushegh - Hovhannesyan Rafik,3:1,7:11 - 9:11 - 11:6 - 9:11 - 0:0,1,3,Nazaryan Mushegh,Hovhannesyan Rafik,fiurst,Hovhannesyan Rafik - Nazaryan Mushegh,75,39,36,-3,3,18,20,17,20,0,-4,-2,5,-2,0,-3,11:7 - 11:9 - 6:11 - 11:9 - 0:0
18924095,2024-05-27 12:20:00,Rafayelyan Edgar - Diaryan Aleksandr,1:3,11:6 - 11:6 - 5:11 - 11:6 - 0:0,3,1,Rafayelyan Edgar,Diaryan Aleksandr,fiurst,Diaryan Aleksandr - Rafayelyan Edgar,67,29,38,9,-9,17,17,16,17,0,5,5,-6,5,0,9,6:11 - 6:11 - 11:5 - 6:11 - 0:0
18924092,2024-05-27 12:10:00,Nazaryan Mushegh - Asatryan Murad,3:0,7:11 - 5:11 - 9:11 - 0:0 - 0:0,0,3,Nazaryan Mushegh,Asatryan Murad,fiurst,Asatryan Murad - Nazaryan Mushegh,54,33,21,-12,12,18,16,20,0,0,-4,-6,-2,0,0,-12,11:7 - 11:5 - 11:9 - 0:0 - 0:0
18924091,2024-05-27 11:50:00,Hovhannesyan Rafik - Rafayelyan Edgar,2:3,4:11 - 11:6 - 11:7 - 7:11 - 5:11,2,3,Hovhannesyan Rafik,Rafayelyan Edgar,fiurst,Hovhannesyan Rafik - Rafayelyan Edgar,84,38,46,8,-8,15,17,18,18,16,7,-5,-4,4,6,8,4:11 - 11:6 - 11:7 - 7:11 - 5:11
18924090,2024-05-27 11:30:00,Nazaryan Mushegh - Diaryan Aleksandr,3:2,11:7 - 11:9 - 3:11 - 6:11 - 4:11,2,3,Nazaryan Mushegh,Diaryan Aleksandr,fiurst,Diaryan Aleksandr - Nazaryan Mushegh,84,49,35,-14,14,18,20,14,17,15,4,2,-8,-5,-7,-14,7:11 - 9:11 - 11:3 - 11:6 - 11:4
18924077,2024-05-27 11:25:00,Asatryan Murad - Hovhannesyan Rafik,3:0,11:9 - 12:10 - 11:6 - 0:0 - 0:0,3,0,Asatryan Murad,Hovhannesyan Rafik,fiurst,Asatryan Murad - Hovhannesyan Rafik,59,34,25,-9,9,20,22,17,0,0,-2,-2,-5,0,0,-9,11:9 - 12:10 - 11:6 - 0:0 - 0:0
18924075,2024-05-27 11:20:00,Rafayelyan Edgar - Nazaryan Mushegh,0:3,11:6 - 11:5 - 12:10 - 0:0 - 0:0,3,0,Rafayelyan Edgar,Nazaryan Mushegh,fiurst,Nazaryan Mushegh - Rafayelyan Edgar,55,21,34,13,-13,17,16,22,0,0,5,6,2,0,0,13,6:11 - 5:11 - 10:12 - 0:0 - 0:0
18924066,2024-05-27 10:45:00,Asatryan Murad - Rafayelyan Edgar,3:2,11:8 - 12:10 - 8:11 - 3:11 - 11:8,3,2,Asatryan Murad,Rafayelyan Edgar,fiurst,Asatryan Murad - Rafayelyan Edgar,93,45,48,3,-3,19,22,19,14,19,-3,-2,3,8,-3,3,11:8 - 12:10 - 8:11 - 3:11 - 11:8
18924069,2024-05-27 10:45:00,Diaryan Aleksandr - Hovhannesyan Rafik,3:0,11:8 - 13:11 - 12:10 - 0:0 - 0:0,3,0,Diaryan Aleksandr,Hovhannesyan Rafik,fiurst,Diaryan Aleksandr - Hovhannesyan Rafik,65,36,29,-7,7,19,24,22,0,0,-3,-2,-2,0,0,-7,11:8 - 13:11 - 12:10 - 0:0 - 0:0
18924061,2024-05-27 10:15:00,Hovhannesyan Rafik - Nazaryan Mushegh,1:3,9:11 - 11:9 - 7:11 - 6:11 - 0:0,1,3,Hovhannesyan Rafik,Nazaryan Mushegh,fiurst,Hovhannesyan Rafik - Nazaryan Mushegh,75,33,42,9,-9,20,20,18,17,0,2,-2,4,5,0,9,9:11 - 11:9 - 7:11 - 6:11 - 0:0
18924017,2024-05-27 10:00:00,Diaryan Aleksandr - Asatryan Murad,3:2,13:15 - 11:7 - 11:7 - 9:11 - 4:11,2,3,Diaryan Aleksandr,Asatryan Murad,fiurst,Asatryan Murad - Diaryan Aleksandr,99,51,48,-3,3,28,18,18,20,15,-2,4,4,-2,-7,-3,15:13 - 7:11 - 7:11 - 11:9 - 11:4
18902087,2024-05-26 17:50:00,Hakobyan Eduard - Soghomonyan Hrayr,0:3,8:11 - 7:11 - 9:11 - 0:0 - 0:0,0,3,Hakobyan Eduard,Soghomonyan Hrayr,fiurst,Hakobyan Eduard - Soghomonyan Hrayr,57,24,33,9,-9,19,18,20,0,0,3,4,2,0,0,9,8:11 - 7:11 - 9:11 - 0:0 - 0:0
18902086,2024-05-26 17:35:00,Gevorgyan Hayk - Gevorgyan Gegham,2:3,6:11 - 11:6 - 6:11 - 11:5 - 11:8,3,2,Gevorgyan Hayk,Gevorgyan Gegham,fiurst,Gevorgyan Gegham - Gevorgyan Hayk,86,41,45,4,-4,17,17,17,16,19,-5,5,-5,6,3,4,11:6 - 6:11 - 11:6 - 5:11 - 8:11
18902082,2024-05-26 17:15:00,Mkrtchyan Andranik - Hakobyan Eduard,3:0,8:11 - 8:11 - 7:11 - 0:0 - 0:0,0,3,Mkrtchyan Andranik,Hakobyan Eduard,fiurst,Hakobyan Eduard - Mkrtchyan Andranik,56,33,23,-10,10,19,19,18,0,0,-3,-3,-4,0,0,-10,11:8 - 11:8 - 11:7 - 0:0 - 0:0
18902074,2024-05-26 17:00:00,Gevorgyan Hayk - Soghomonyan Hrayr,2:3,11:13 - 11:6 - 7:11 - 11:6 - 9:11,2,3,Gevorgyan Hayk,Soghomonyan Hrayr,fiurst,Gevorgyan Hayk - Soghomonyan Hrayr,96,49,47,-2,2,24,17,18,17,20,2,-5,4,-5,2,-2,11:13 - 11:6 - 7:11 - 11:6 - 9:11
18902069,2024-05-26 16:45:00,Gevorgyan Gegham - Mkrtchyan Andranik,0:3,11:13 - 8:11 - 7:11 - 0:0 - 0:0,0,3,Gevorgyan Gegham,Mkrtchyan Andranik,fiurst,Gevorgyan Gegham - Mkrtchyan Andranik,61,26,35,9,-9,24,19,18,0,0,2,3,4,0,0,9,11:13 - 8:11 - 7:11 - 0:0 - 0:0
18902068,2024-05-26 16:30:00,Hakobyan Eduard - Gevorgyan Hayk,3:0,7:11 - 8:11 - 8:11 - 0:0 - 0:0,0,3,Hakobyan Eduard,Gevorgyan Hayk,fiurst,Gevorgyan Hayk - Hakobyan Eduard,56,33,23,-10,10,18,19,19,0,0,-4,-3,-3,0,0,-10,11:7 - 11:8 - 11:8 - 0:0 - 0:0
18902065,2024-05-26 16:15:00,Soghomonyan Hrayr - Mkrtchyan Andranik,0:3,11:5 - 11:6 - 11:6 - 0:0 - 0:0,3,0,Soghomonyan Hrayr,Mkrtchyan Andranik,fiurst,Mkrtchyan Andranik - Soghomonyan Hrayr,50,17,33,16,-16,16,17,17,0,0,6,5,5,0,0,16,5:11 - 6:11 - 6:11 - 0:0 - 0:0
18901720,2024-05-26 16:00:00,Gevorgyan Gegham - Hakobyan Eduard,1:3,11:8 - 9:11 - 5:11 - 4:11 - 0:0,1,3,Gevorgyan Gegham,Hakobyan Eduard,fiurst,Gevorgyan Gegham - Hakobyan Eduard,70,29,41,12,-12,19,20,16,15,0,-3,2,6,7,0,12,11:8 - 9:11 - 5:11 - 4:11 - 0:0
18901715,2024-05-26 15:45:00,Mkrtchyan Andranik - Gevorgyan Hayk,3:0,5:11 - 4:11 - 6:11 - 0:0 - 0:0,0,3,Mkrtchyan Andranik,Gevorgyan Hayk,fiurst,Gevorgyan Hayk - Mkrtchyan Andranik,48,33,15,-18,18,16,15,17,0,0,-6,-7,-5,0,0,-18,11:5 - 11:4 - 11:6 - 0:0 - 0:0
18901713,2024-05-26 15:30:00,Soghomonyan Hrayr - Gevorgyan Gegham,0:3,11:9 - 13:11 - 11:8 - 0:0 - 0:0,3,0,Soghomonyan Hrayr,Gevorgyan Gegham,fiurst,Gevorgyan Gegham - Soghomonyan Hrayr,63,28,35,7,-7,20,24,19,0,0,2,2,3,0,0,7,9:11 - 11:13 - 8:11 - 0:0 - 0:0
18901711,2024-05-26 15:15:00,Nikoghosyan Narek - Diaryan Aleksandr,3:2,11:4 - 11:9 - 6:11 - 5:11 - 4:11,2,3,Nikoghosyan Narek,Diaryan Aleksandr,fiurst,Diaryan Aleksandr - Nikoghosyan Narek,83,46,37,-9,9,15,20,17,16,15,7,2,-5,-6,-7,-9,4:11 - 9:11 - 11:6 - 11:5 - 11:4
18901700,2024-05-26 15:00:00,Nazaryan Mushegh - Papyan Karen,1:3,11:8 - 9:11 - 6:11 - 8:11 - 0:0,1,3,Nazaryan Mushegh,Papyan Karen,fiurst,Nazaryan Mushegh - Papyan Karen,75,34,41,7,-7,19,20,17,19,0,-3,2,5,3,0,7,11:8 - 9:11 - 6:11 - 8:11 - 0:0
18901699,2024-05-26 14:45:00,Rafayelyan Edgar - Nikoghosyan Narek,0:3,11:5 - 11:4 - 11:4 - 0:0 - 0:0,3,0,Rafayelyan Edgar,Nikoghosyan Narek,fiurst,Nikoghosyan Narek - Rafayelyan Edgar,46,13,33,20,-20,16,15,15,0,0,6,7,7,0,0,20,5:11 - 4:11 - 4:11 - 0:0 - 0:0
18901696,2024-05-26 14:30:00,Diaryan Aleksandr - Nazaryan Mushegh,3:0,11:6 - 11:4 - 11:6 - 0:0 - 0:0,3,0,Diaryan Aleksandr,Nazaryan Mushegh,fiurst,Diaryan Aleksandr - Nazaryan Mushegh,49,33,16,-17,17,17,15,17,0,0,-5,-7,-5,0,0,-17,11:6 - 11:4 - 11:6 - 0:0 - 0:0
18901692,2024-05-26 14:20:00,Rafayelyan Edgar - Papyan Karen,0:3,11:3 - 12:10 - 11:6 - 0:0 - 0:0,3,0,Rafayelyan Edgar,Papyan Karen,fiurst,Papyan Karen - Rafayelyan Edgar,53,19,34,15,-15,14,22,17,0,0,8,2,5,0,0,15,3:11 - 10:12 - 6:11 - 0:0 - 0:0
18901685,2024-05-26 14:00:00,Nikoghosyan Narek - Nazaryan Mushegh,0:3,11:4 - 11:5 - 11:6 - 0:0 - 0:0,3,0,Nikoghosyan Narek,Nazaryan Mushegh,fiurst,Nazaryan Mushegh - Nikoghosyan Narek,48,15,33,18,-18,15,16,17,0,0,7,6,5,0,0,18,4:11 - 5:11 - 6:11 - 0:0 - 0:0
18901682,2024-05-26 13:45:00,Diaryan Aleksandr - Rafayelyan Edgar,1:3,10:12 - 11:4 - 10:12 - 10:12 - 0:0,1,3,Diaryan Aleksandr,Rafayelyan Edgar,fiurst,Diaryan Aleksandr - Rafayelyan Edgar,81,41,40,-1,1,22,15,22,22,0,2,-7,2,2,0,-1,10:12 - 11:4 - 10:12 - 10:12 - 0:0
18901678,2024-05-26 13:30:00,Papyan Karen - Nikoghosyan Narek,3:1,13:11 - 10:12 - 6:11 - 4:11 - 0:0,1,3,Papyan Karen,Nikoghosyan Narek,fiurst,Nikoghosyan Narek - Papyan Karen,78,45,33,-12,12,24,22,17,15,0,2,-2,-5,-7,0,-12,11:13 - 12:10 - 11:6 - 11:4 - 0:0
18901666,2024-05-26 13:15:00,Nazaryan Mushegh - Rafayelyan Edgar,1:3,11:8 - 8:11 - 4:11 - 8:11 - 0:0,1,3,Nazaryan Mushegh,Rafayelyan Edgar,fiurst,Nazaryan Mushegh - Rafayelyan Edgar,72,31,41,10,-10,19,19,15,19,0,-3,3,7,3,0,10,11:8 - 8:11 - 4:11 - 8:11 - 0:0
18901660,2024-05-26 13:00:00,Papyan Karen - Diaryan Aleksandr,3:1,11:9 - 12:14 - 5:11 - 7:11 - 0:0,1,3,Papyan Karen,Diaryan Aleksandr,fiurst,Diaryan Aleksandr - Papyan Karen,80,45,35,-10,10,20,26,16,18,0,2,-2,-6,-4,0,-10,9:11 - 14:12 - 11:5 - 11:7 - 0:0
18901657,2024-05-26 12:15:00,Nikoghosyan Narek - Rafayelyan Edgar,0:3,7:11 - 7:11 - 6:11 - 0:0 - 0:0,0,3,Nikoghosyan Narek,Rafayelyan Edgar,fiurst,Nikoghosyan Narek - Rafayelyan Edgar,53,20,33,13,-13,18,18,17,0,0,4,4,5,0,0,13,7:11 - 7:11 - 6:11 - 0:0 - 0:0
18901652,2024-05-26 12:05:00,Papyan Karen - Nazaryan Mushegh,1:3,11:4 - 4:11 - 11:7 - 12:10 - 0:0,3,1,Papyan Karen,Nazaryan Mushegh,fiurst,Nazaryan Mushegh - Papyan Karen,70,32,38,6,-6,15,15,18,22,0,7,-7,4,2,0,6,4:11 - 11:4 - 7:11 - 10:12 - 0:0
18901650,2024-05-26 11:45:00,Diaryan Aleksandr - Nikoghosyan Narek,3:0,11:9 - 11:5 - 11:3 - 0:0 - 0:0,3,0,Diaryan Aleksandr,Nikoghosyan Narek,fiurst,Diaryan Aleksandr - Nikoghosyan Narek,50,33,17,-16,16,20,16,14,0,0,-2,-6,-8,0,0,-16,11:9 - 11:5 - 11:3 - 0:0 - 0:0
18901649,2024-05-26 11:30:00,Papyan Karen - Rafayelyan Edgar,3:1,11:9 - 11:9 - 9:11 - 11:8 - 0:0,3,1,Papyan Karen,Rafayelyan Edgar,fiurst,Papyan Karen - Rafayelyan Edgar,79,42,37,-5,5,20,20,20,19,0,-2,-2,2,-3,0,-5,11:9 - 11:9 - 9:11 - 11:8 - 0:0
18901648,2024-05-26 11:15:00,Nazaryan Mushegh - Diaryan Aleksandr,3:0,6:11 - 4:11 - 1:11 - 0:0 - 0:0,0,3,Nazaryan Mushegh,Diaryan Aleksandr,fiurst,Diaryan Aleksandr - Nazaryan Mushegh,44,33,11,-22,22,17,15,12,0,0,-5,-7,-10,0,0,-22,11:6 - 11:4 - 11:1 - 0:0 - 0:0
18901637,2024-05-26 11:00:00,Nikoghosyan Narek - Papyan Karen,0:3,12:14 - 9:11 - 7:11 - 0:0 - 0:0,0,3,Nikoghosyan Narek,Papyan Karen,fiurst,Nikoghosyan Narek - Papyan Karen,64,28,36,8,-8,26,20,18,0,0,2,2,4,0,0,8,12:14 - 9:11 - 7:11 - 0:0 - 0:0
18901635,2024-05-26 10:45:00,Rafayelyan Edgar - Diaryan Aleksandr,1:3,3:11 - 13:11 - 11:9 - 11:9 - 0:0,3,1,Rafayelyan Edgar,Diaryan Aleksandr,fiurst,Diaryan Aleksandr - Rafayelyan Edgar,78,40,38,-2,2,14,24,20,20,0,-8,2,2,2,0,-2,11:3 - 11:13 - 9:11 - 9:11 - 0:0
18901632,2024-05-26 10:30:00,Nazaryan Mushegh - Nikoghosyan Narek,0:3,9:11 - 8:11 - 5:11 - 0:0 - 0:0,0,3,Nazaryan Mushegh,Nikoghosyan Narek,fiurst,Nazaryan Mushegh - Nikoghosyan Narek,55,22,33,11,-11,20,19,16,0,0,2,3,6,0,0,11,9:11 - 8:11 - 5:11 - 0:0 - 0:0
18901624,2024-05-26 10:15:00,Diaryan Aleksandr - Papyan Karen,3:0,11:6 - 11:3 - 11:6 - 0:0 - 0:0,3,0,Diaryan Aleksandr,Papyan Karen,fiurst,Diaryan Aleksandr - Papyan Karen,48,33,15,-18,18,17,14,17,0,0,-5,-8,-5,0,0,-18,11:6 - 11:3 - 11:6 - 0:0 - 0:0
18901617,2024-05-26 10:00:00,Rafayelyan Edgar - Nazaryan Mushegh,0:3,11:4 - 11:3 - 11:3 - 0:0 - 0:0,3,0,Rafayelyan Edgar,Nazaryan Mushegh,fiurst,Nazaryan Mushegh - Rafayelyan Edgar,43,10,33,23,-23,15,14,14,0,0,7,8,8,0,0,23,4:11 - 3:11 - 3:11 - 0:0 - 0:0
18886604,2024-05-25 17:45:00,Avakimyan Davit - Gevorgyan Hayk,0:3,8:11 - 7:11 - 5:11 - 0:0 - 0:0,0,3,Avakimyan Davit,Gevorgyan Hayk,fiurst,Avakimyan Davit - Gevorgyan Hayk,53,20,33,13,-13,19,18,16,0,0,3,4,6,0,0,13,8:11 - 7:11 - 5:11 - 0:0 - 0:0
18886602,2024-05-25 17:30:00,Hakobyan Eduard - Petrosyan Davit,2:3,9:11 - 14:12 - 3:11 - 11:9 - 5:11,2,3,Hakobyan Eduard,Petrosyan Davit,fiurst,Hakobyan Eduard - Petrosyan Davit,96,42,54,12,-12,20,26,14,20,16,2,-2,8,-2,6,12,9:11 - 14:12 - 3:11 - 11:9 - 5:11
18886600,2024-05-25 17:20:00,Soghomonyan Hrayr - Avakimyan Davit,2:3,8:11 - 11:3 - 9:11 - 11:5 - 11:9,3,2,Soghomonyan Hrayr,Avakimyan Davit,fiurst,Avakimyan Davit - Soghomonyan Hrayr,89,39,50,11,-11,19,14,20,16,20,-3,8,-2,6,2,11,11:8 - 3:11 - 11:9 - 5:11 - 9:11
18886597,2024-05-25 17:00:00,Hakobyan Eduard - Gevorgyan Hayk,3:0,4:11 - 6:11 - 7:11 - 0:0 - 0:0,0,3,Hakobyan Eduard,Gevorgyan Hayk,fiurst,Gevorgyan Hayk - Hakobyan Eduard,50,33,17,-16,16,15,17,18,0,0,-7,-5,-4,0,0,-16,11:4 - 11:6 - 11:7 - 0:0 - 0:0
18886579,2024-05-25 16:45:00,Petrosyan Davit - Soghomonyan Hrayr,1:3,12:10 - 7:11 - 9:11 - 4:11 - 0:0,1,3,Petrosyan Davit,Soghomonyan Hrayr,fiurst,Petrosyan Davit - Soghomonyan Hrayr,75,32,43,11,-11,22,18,20,15,0,-2,4,2,7,0,11,12:10 - 7:11 - 9:11 - 4:11 - 0:0
18886566,2024-05-25 16:30:00,Avakimyan Davit - Hakobyan Eduard,1:3,13:15 - 12:10 - 9:11 - 8:11 - 0:0,1,3,Avakimyan Davit,Hakobyan Eduard,fiurst,Avakimyan Davit - Hakobyan Eduard,89,42,47,5,-5,28,22,20,19,0,2,-2,2,3,0,5,13:15 - 12:10 - 9:11 - 8:11 - 0:0
18886552,2024-05-25 16:15:00,Gevorgyan Hayk - Soghomonyan Hrayr,3:2,5:11 - 11:6 - 11:7 - 7:11 - 11:8,3,2,Gevorgyan Hayk,Soghomonyan Hrayr,fiurst,Gevorgyan Hayk - Soghomonyan Hrayr,88,45,43,-2,2,16,17,18,18,19,6,-5,-4,4,-3,-2,5:11 - 11:6 - 11:7 - 7:11 - 11:8
18886544,2024-05-25 16:00:00,Petrosyan Davit - Avakimyan Davit,0:3,11:8 - 11:9 - 11:6 - 0:0 - 0:0,3,0,Petrosyan Davit,Avakimyan Davit,fiurst,Avakimyan Davit - Petrosyan Davit,56,23,33,10,-10,19,20,17,0,0,3,2,5,0,0,10,8:11 - 9:11 - 6:11 - 0:0 - 0:0
18886530,2024-05-25 15:50:00,Soghomonyan Hrayr - Hakobyan Eduard,1:3,6:11 - 11:6 - 11:6 - 11:8 - 0:0,3,1,Soghomonyan Hrayr,Hakobyan Eduard,fiurst,Hakobyan Eduard - Soghomonyan Hrayr,70,31,39,8,-8,17,17,17,19,0,-5,5,5,3,0,8,11:6 - 6:11 - 6:11 - 8:11 - 0:0
18886527,2024-05-25 15:30:00,Gevorgyan Hayk - Petrosyan Davit,3:0,11:8 - 14:12 - 11:6 - 0:0 - 0:0,3,0,Gevorgyan Hayk,Petrosyan Davit,fiurst,Gevorgyan Hayk - Petrosyan Davit,62,36,26,-10,10,19,26,17,0,0,-3,-2,-5,0,0,-10,11:8 - 14:12 - 11:6 - 0:0 - 0:0
18886522,2024-05-25 15:25:00,Papyan Karen - Asatryan Murad,3:2,12:10 - 12:10 - 3:11 - 6:11 - 7:11,2,3,Papyan Karen,Asatryan Murad,fiurst,Asatryan Murad - Papyan Karen,93,53,40,-13,13,22,22,14,17,18,2,2,-8,-5,-4,-13,10:12 - 10:12 - 11:3 - 11:6 - 11:7
18886519,2024-05-25 15:05:00,Rafayelyan Edgar - Nikoghosyan Narek,0:3,11:7 - 11:6 - 11:8 - 0:0 - 0:0,3,0,Rafayelyan Edgar,Nikoghosyan Narek,fiurst,Nikoghosyan Narek - Rafayelyan Edgar,54,21,33,12,-12,18,17,19,0,0,4,5,3,0,0,12,7:11 - 6:11 - 8:11 - 0:0 - 0:0
18886517,2024-05-25 14:45:00,Diaryan Aleksandr - Papyan Karen,2:3,13:15 - 11:7 - 11:4 - 7:11 - 9:11,2,3,Diaryan Aleksandr,Papyan Karen,fiurst,Diaryan Aleksandr - Papyan Karen,99,51,48,-3,3,28,18,15,18,20,2,-4,-7,4,2,-3,13:15 - 11:7 - 11:4 - 7:11 - 9:11
18886513,2024-05-25 14:35:00,Asatryan Murad - Rafayelyan Edgar,0:3,7:11 - 5:11 - 6:11 - 0:0 - 0:0,0,3,Asatryan Murad,Rafayelyan Edgar,fiurst,Asatryan Murad - Rafayelyan Edgar,51,18,33,15,-15,18,16,17,0,0,4,6,5,0,0,15,7:11 - 5:11 - 6:11 - 0:0 - 0:0
18886511,2024-05-25 14:20:00,Diaryan Aleksandr - Nikoghosyan Narek,0:3,7:11 - 4:11 - 2:11 - 0:0 - 0:0,0,3,Diaryan Aleksandr,Nikoghosyan Narek,fiurst,Diaryan Aleksandr - Nikoghosyan Narek,46,13,33,20,-20,18,15,13,0,0,4,7,9,0,0,20,7:11 - 4:11 - 2:11 - 0:0 - 0:0
18886510,2024-05-25 14:05:00,Papyan Karen - Rafayelyan Edgar,0:3,7:11 - 12:14 - 6:11 - 0:0 - 0:0,0,3,Papyan Karen,Rafayelyan Edgar,fiurst,Papyan Karen - Rafayelyan Edgar,61,25,36,11,-11,18,26,17,0,0,4,2,5,0,0,11,7:11 - 12:14 - 6:11 - 0:0 - 0:0
18886507,2024-05-25 13:45:00,Asatryan Murad - Diaryan Aleksandr,1:3,11:9 - 8:11 - 6:11 - 8:11 - 0:0,1,3,Asatryan Murad,Diaryan Aleksandr,fiurst,Asatryan Murad - Diaryan Aleksandr,75,33,42,9,-9,20,19,17,19,0,-2,3,5,3,0,9,11:9 - 8:11 - 6:11 - 8:11 - 0:0
18886504,2024-05-25 13:30:00,Nikoghosyan Narek - Papyan Karen,1:3,9:11 - 11:3 - 5:11 - 9:11 - 0:0,1,3,Nikoghosyan Narek,Papyan Karen,fiurst,Nikoghosyan Narek - Papyan Karen,70,34,36,2,-2,20,14,16,20,0,2,-8,6,2,0,2,9:11 - 11:3 - 5:11 - 9:11 - 0:0
18886500,2024-05-25 13:15:00,Rafayelyan Edgar - Diaryan Aleksandr,1:3,14:12 - 11:8 - 6:11 - 11:7 - 0:0,3,1,Rafayelyan Edgar,Diaryan Aleksandr,fiurst,Diaryan Aleksandr - Rafayelyan Edgar,80,38,42,4,-4,26,19,17,18,0,2,3,-5,4,0,4,12:14 - 8:11 - 11:6 - 7:11 - 0:0
18886477,2024-05-25 13:00:00,Nikoghosyan Narek - Asatryan Murad,3:1,11:2 - 8:11 - 11:13 - 9:11 - 0:0,1,3,Nikoghosyan Narek,Asatryan Murad,fiurst,Asatryan Murad - Nikoghosyan Narek,76,37,39,2,-2,13,19,24,20,0,9,-3,-2,-2,0,2,2:11 - 11:8 - 13:11 - 11:9 - 0:0
18886464,2024-05-25 12:20:00,Papyan Karen - Diaryan Aleksandr,2:3,7:11 - 11:4 - 13:11 - 6:11 - 11:8,3,2,Papyan Karen,Diaryan Aleksandr,fiurst,Diaryan Aleksandr - Papyan Karen,93,45,48,3,-3,18,15,24,17,19,-4,7,2,-5,3,3,11:7 - 4:11 - 11:13 - 11:6 - 8:11
18886459,2024-05-25 12:05:00,Asatryan Murad - Papyan Karen,3:0,11:4 - 11:7 - 11:8 - 0:0 - 0:0,3,0,Asatryan Murad,Papyan Karen,fiurst,Asatryan Murad - Papyan Karen,52,33,19,-14,14,15,18,19,0,0,-7,-4,-3,0,0,-14,11:4 - 11:7 - 11:8 - 0:0 - 0:0
18886462,2024-05-25 12:00:00,Nikoghosyan Narek - Rafayelyan Edgar,3:1,7:11 - 11:8 - 12:10 - 11:7 - 0:0,3,1,Nikoghosyan Narek,Rafayelyan Edgar,fiurst,Nikoghosyan Narek - Rafayelyan Edgar,77,41,36,-5,5,18,19,22,18,0,4,-3,-2,-4,0,-5,7:11 - 11:8 - 12:10 - 11:7 - 0:0
18886445,2024-05-25 11:40:00,Nikoghosyan Narek - Diaryan Aleksandr,3:1,4:11 - 2:11 - 11:8 - 5:11 - 0:0,1,3,Nikoghosyan Narek,Diaryan Aleksandr,fiurst,Diaryan Aleksandr - Nikoghosyan Narek,63,41,22,-19,19,15,13,19,16,0,-7,-9,3,-6,0,-19,11:4 - 11:2 - 8:11 - 11:5 - 0:0
18886430,2024-05-25 11:25:00,Rafayelyan Edgar - Asatryan Murad,3:2,10:12 - 2:11 - 11:7 - 11:5 - 8:11,2,3,Rafayelyan Edgar,Asatryan Murad,fiurst,Asatryan Murad - Rafayelyan Edgar,88,46,42,-4,4,22,13,18,16,19,-2,-9,4,6,-3,-4,12:10 - 11:2 - 7:11 - 5:11 - 11:8
18886425,2024-05-25 11:10:00,Papyan Karen - Nikoghosyan Narek,0:3,11:9 - 11:8 - 11:5 - 0:0 - 0:0,3,0,Papyan Karen,Nikoghosyan Narek,fiurst,Nikoghosyan Narek - Papyan Karen,55,22,33,11,-11,20,19,16,0,0,2,3,6,0,0,11,9:11 - 8:11 - 5:11 - 0:0 - 0:0
18886422,2024-05-25 10:45:00,Diaryan Aleksandr - Asatryan Murad,2:3,9:11 - 11:13 - 12:10 - 11:7 - 11:4,3,2,Diaryan Aleksandr,Asatryan Murad,fiurst,Asatryan Murad - Diaryan Aleksandr,99,45,54,9,-9,20,24,22,18,15,-2,-2,2,4,7,9,11:9 - 13:11 - 10:12 - 7:11 - 4:11
18886420,2024-05-25 10:30:00,Rafayelyan Edgar - Papyan Karen,2:3,11:8 - 9:11 - 11:9 - 8:11 - 11:7,3,2,Rafayelyan Edgar,Papyan Karen,fiurst,Papyan Karen - Rafayelyan Edgar,96,46,50,4,-4,19,20,20,19,18,3,-2,2,-3,4,4,8:11 - 11:9 - 9:11 - 11:8 - 7:11
18886408,2024-05-25 10:15:00,Asatryan Murad - Nikoghosyan Narek,3:1,11:7 - 9:11 - 11:1 - 11:5 - 0:0,3,1,Asatryan Murad,Nikoghosyan Narek,fiurst,Asatryan Murad - Nikoghosyan Narek,66,42,24,-18,18,18,20,12,16,0,-4,2,-10,-6,0,-18,11:7 - 9:11 - 11:1 - 11:5 - 0:0
18886405,2024-05-25 10:00:00,Diaryan Aleksandr - Rafayelyan Edgar,3:2,10:12 - 13:11 - 3:11 - 11:6 - 11:9,3,2,Diaryan Aleksandr,Rafayelyan Edgar,fiurst,Diaryan Aleksandr - Rafayelyan Edgar,97,48,49,1,-1,22,24,14,17,20,2,-2,8,-5,-2,1,10:12 - 13:11 - 3:11 - 11:6 - 11:9
18866682,2024-05-24 17:40:00,Petrosyan Davit - Avakimyan Davit,2:3,11:9 - 8:11 - 9:11 - 11:9 - 11:8,3,2,Petrosyan Davit,Avakimyan Davit,fiurst,Avakimyan Davit - Petrosyan Davit,98,48,50,2,-2,20,19,20,20,19,2,-3,-2,2,3,2,9:11 - 11:8 - 11:9 - 9:11 - 8:11
18866679,2024-05-24 17:30:00,Hakobyan Eduard - Soghomonyan Hrayr,0:3,9:11 - 9:11 - 5:11 - 0:0 - 0:0,0,3,Hakobyan Eduard,Soghomonyan Hrayr,fiurst,Hakobyan Eduard - Soghomonyan Hrayr,56,23,33,10,-10,20,20,16,0,0,2,2,6,0,0,10,9:11 - 9:11 - 5:11 - 0:0 - 0:0
18866677,2024-05-24 17:15:00,Gevorgyan Gegham - Petrosyan Davit,0:3,5:11 - 8:11 - 8:11 - 0:0 - 0:0,0,3,Gevorgyan Gegham,Petrosyan Davit,fiurst,Gevorgyan Gegham - Petrosyan Davit,54,21,33,12,-12,16,19,19,0,0,6,3,3,0,0,12,5:11 - 8:11 - 8:11 - 0:0 - 0:0
18866673,2024-05-24 17:00:00,Hakobyan Eduard - Avakimyan Davit,2:3,11:4 - 11:9 - 9:11 - 9:11 - 11:6,3,2,Hakobyan Eduard,Avakimyan Davit,fiurst,Avakimyan Davit - Hakobyan Eduard,92,41,51,10,-10,15,20,20,20,17,7,2,-2,-2,5,10,4:11 - 9:11 - 11:9 - 11:9 - 6:11
18866664,2024-05-24 16:45:00,Soghomonyan Hrayr - Gevorgyan Gegham,0:3,11:4 - 11:6 - 11:8 - 0:0 - 0:0,3,0,Soghomonyan Hrayr,Gevorgyan Gegham,fiurst,Gevorgyan Gegham - Soghomonyan Hrayr,51,18,33,15,-15,15,17,19,0,0,7,5,3,0,0,15,4:11 - 6:11 - 8:11 - 0:0 - 0:0
18866661,2024-05-24 16:35:00,Petrosyan Davit - Hakobyan Eduard,1:3,5:11 - 11:9 - 11:3 - 11:8 - 0:0,3,1,Petrosyan Davit,Hakobyan Eduard,fiurst,Hakobyan Eduard - Petrosyan Davit,69,31,38,7,-7,16,20,14,19,0,-6,2,8,3,0,7,11:5 - 9:11 - 3:11 - 8:11 - 0:0
18866660,2024-05-24 16:20:00,Avakimyan Davit - Gevorgyan Gegham,0:3,8:11 - 5:11 - 6:11 - 0:0 - 0:0,0,3,Avakimyan Davit,Gevorgyan Gegham,fiurst,Avakimyan Davit - Gevorgyan Gegham,52,19,33,14,-14,19,16,17,0,0,3,6,5,0,0,14,8:11 - 5:11 - 6:11 - 0:0 - 0:0
18866658,2024-05-24 16:00:00,Soghomonyan Hrayr - Petrosyan Davit,3:1,9:11 - 11:9 - 3:11 - 12:14 - 0:0,1,3,Soghomonyan Hrayr,Petrosyan Davit,fiurst,Petrosyan Davit - Soghomonyan Hrayr,80,45,35,-10,10,20,20,14,26,0,-2,2,-8,-2,0,-10,11:9 - 9:11 - 11:3 - 14:12 - 0:0
18866657,2024-05-24 15:45:00,Gevorgyan Gegham - Hakobyan Eduard,2:3,9:11 - 11:9 - 10:12 - 11:5 - 8:11,2,3,Gevorgyan Gegham,Hakobyan Eduard,fiurst,Gevorgyan Gegham - Hakobyan Eduard,97,49,48,-1,1,20,20,22,16,19,2,-2,2,-6,3,-1,9:11 - 11:9 - 10:12 - 11:5 - 8:11
18866646,2024-05-24 15:30:00,Avakimyan Davit - Soghomonyan Hrayr,1:3,11:8 - 7:11 - 1:11 - 3:11 - 0:0,1,3,Avakimyan Davit,Soghomonyan Hrayr,fiurst,Avakimyan Davit - Soghomonyan Hrayr,63,22,41,19,-19,19,18,12,14,0,-3,4,10,8,0,19,11:8 - 7:11 - 1:11 - 3:11 - 0:0
18866638,2024-05-24 15:15:00,Nazaryan Mushegh - Diaryan Aleksandr,3:0,6:11 - 1:11 - 8:11 - 0:0 - 0:0,0,3,Nazaryan Mushegh,Diaryan Aleksandr,fiurst,Diaryan Aleksandr - Nazaryan Mushegh,48,33,15,-18,18,17,12,19,0,0,-5,-10,-3,0,0,-18,11:6 - 11:1 - 11:8 - 0:0 - 0:0
18866637,2024-05-24 15:00:00,Asatryan Murad - Nikoghosyan Narek,3:0,11:2 - 13:11 - 11:5 - 0:0 - 0:0,3,0,Asatryan Murad,Nikoghosyan Narek,fiurst,Asatryan Murad - Nikoghosyan Narek,53,35,18,-17,17,13,24,16,0,0,-9,-2,-6,0,0,-17,11:2 - 13:11 - 11:5 - 0:0 - 0:0
18866636,2024-05-24 14:45:00,Papyan Karen - Nazaryan Mushegh,3:0,7:11 - 4:11 - 7:11 - 0:0 - 0:0,0,3,Papyan Karen,Nazaryan Mushegh,fiurst,Nazaryan Mushegh - Papyan Karen,51,33,18,-15,15,18,15,18,0,0,-4,-7,-4,0,0,-15,11:7 - 11:4 - 11:7 - 0:0 - 0:0
18866634,2024-05-24 14:30:00,Diaryan Aleksandr - Asatryan Murad,1:3,8:11 - 11:7 - 11:2 - 11:6 - 0:0,3,1,Diaryan Aleksandr,Asatryan Murad,fiurst,Asatryan Murad - Diaryan Aleksandr,67,26,41,15,-15,19,18,13,17,0,-3,4,9,5,0,15,11:8 - 7:11 - 2:11 - 6:11 - 0:0
18866622,2024-05-24 14:15:00,Papyan Karen - Nikoghosyan Narek,2:3,11:9 - 9:11 - 8:11 - 11:7 - 11:7,3,2,Papyan Karen,Nikoghosyan Narek,fiurst,Nikoghosyan Narek - Papyan Karen,95,45,50,5,-5,20,20,19,18,18,2,-2,-3,4,4,5,9:11 - 11:9 - 11:8 - 7:11 - 7:11
18866617,2024-05-24 14:10:00,Nazaryan Mushegh - Asatryan Murad,3:1,6:11 - 5:11 - 11:8 - 0:11 - 0:0,1,3,Nazaryan Mushegh,Asatryan Murad,fiurst,Asatryan Murad - Nazaryan Mushegh,63,41,22,-19,19,17,16,19,11,0,-5,-6,3,-11,0,-19,11:6 - 11:5 - 8:11 - 11:0 - 0:0
18866614,2024-05-24 13:55:00,Diaryan Aleksandr - Papyan Karen,0:0,0:0 - 0:0 - 0:0 - 0:0 - 0:0,0,0,Diaryan Aleksandr,Papyan Karen,fiurst,Diaryan Aleksandr - Papyan Karen,0,0,0,0,0,0,0,0,0,0,0,0,0,0,0,0,0:0 - 0:0 - 0:0 - 0:0 - 0:0
18866609,2024-05-24 13:40:00,Nikoghosyan Narek - Nazaryan Mushegh,1:3,11:8 - 13:15 - 11:4 - 11:7 - 0:0,3,1,Nikoghosyan Narek,Nazaryan Mushegh,fiurst,Nazaryan Mushegh - Nikoghosyan Narek,80,34,46,12,-12,19,28,15,18,0,3,-2,7,4,0,12,8:11 - 15:13 - 4:11 - 7:11 - 0:0
18866608,2024-05-24 13:15:00,Asatryan Murad - Papyan Karen,3:2,11:7 - 4:11 - 11:5 - 9:11 - 11:8,3,2,Asatryan Murad,Papyan Karen,fiurst,Asatryan Murad - Papyan Karen,88,46,42,-4,4,18,15,16,20,19,-4,7,-6,2,-3,-4,11:7 - 4:11 - 11:5 - 9:11 - 11:8
18866606,2024-05-24 13:00:00,Nikoghosyan Narek - Diaryan Aleksandr,3:1,16:18 - 11:9 - 4:11 - 4:11 - 0:0,1,3,Nikoghosyan Narek,Diaryan Aleksandr,fiurst,Diaryan Aleksandr - Nikoghosyan Narek,84,49,35,-14,14,34,20,15,15,0,-2,2,-7,-7,0,-14,18:16 - 9:11 - 11:4 - 11:4 - 0:0
18866595,2024-05-24 12:15:00,Nazaryan Mushegh - Papyan Karen,3:0,12:10 - 11:5 - 11:8 - 0:0 - 0:0,3,0,Nazaryan Mushegh,Papyan Karen,fiurst,Nazaryan Mushegh - Papyan Karen,57,34,23,-11,11,22,16,19,0,0,-2,-6,-3,0,0,-11,12:10 - 11:5 - 11:8 - 0:0 - 0:0
18866593,2024-05-24 12:00:00,Nikoghosyan Narek - Asatryan Murad,3:0,4:11 - 12:14 - 5:11 - 0:0 - 0:0,0,3,Nikoghosyan Narek,Asatryan Murad,fiurst,Asatryan Murad - Nikoghosyan Narek,57,36,21,-15,15,15,26,16,0,0,-7,-2,-6,0,0,-15,11:4 - 14:12 - 11:5 - 0:0 - 0:0
18866588,2024-05-24 11:45:00,Diaryan Aleksandr - Nazaryan Mushegh,3:0,12:10 - 12:10 - 11:5 - 0:0 - 0:0,3,0,Diaryan Aleksandr,Nazaryan Mushegh,fiurst,Diaryan Aleksandr - Nazaryan Mushegh,60,35,25,-10,10,22,22,16,0,0,-2,-2,-6,0,0,-10,12:10 - 12:10 - 11:5 - 0:0 - 0:0
18866586,2024-05-24 11:30:00,Nikoghosyan Narek - Papyan Karen,1:3,13:11 - 9:11 - 9:11 - 10:12 - 0:0,1,3,Nikoghosyan Narek,Papyan Karen,fiurst,Nikoghosyan Narek - Papyan Karen,86,41,45,4,-4,24,20,20,22,0,-2,2,2,2,0,4,13:11 - 9:11 - 9:11 - 10:12 - 0:0
18866585,2024-05-24 11:15:00,Asatryan Murad - Diaryan Aleksandr,0:3,10:12 - 8:11 - 4:11 - 0:0 - 0:0,0,3,Asatryan Murad,Diaryan Aleksandr,fiurst,Asatryan Murad - Diaryan Aleksandr,56,22,34,12,-12,22,19,15,0,0,2,3,7,0,0,12,10:12 - 8:11 - 4:11 - 0:0 - 0:0
18866583,2024-05-24 11:00:00,Nazaryan Mushegh - Nikoghosyan Narek,3:0,11:5 - 12:10 - 11:9 - 0:0 - 0:0,3,0,Nazaryan Mushegh,Nikoghosyan Narek,fiurst,Nazaryan Mushegh - Nikoghosyan Narek,58,34,24,-10,10,16,22,20,0,0,-6,-2,-2,0,0,-10,11:5 - 12:10 - 11:9 - 0:0 - 0:0
18866575,2024-05-24 10:45:00,Papyan Karen - Diaryan Aleksandr,3:0,5:11 - 2:11 - 7:11 - 0:0 - 0:0,0,3,Papyan Karen,Diaryan Aleksandr,fiurst,Diaryan Aleksandr - Papyan Karen,47,33,14,-19,19,16,13,18,0,0,-6,-9,-4,0,0,-19,11:5 - 11:2 - 11:7 - 0:0 - 0:0
18866568,2024-05-24 10:30:00,Asatryan Murad - Nazaryan Mushegh,3:0,11:6 - 11:5 - 11:2 - 0:0 - 0:0,3,0,Asatryan Murad,Nazaryan Mushegh,fiurst,Asatryan Murad - Nazaryan Mushegh,46,33,13,-20,20,17,16,13,0,0,-5,-6,-9,0,0,-20,11:6 - 11:5 - 11:2 - 0:0 - 0:0
18866567,2024-05-24 10:15:00,Diaryan Aleksandr - Nikoghosyan Narek,1:3,12:10 - 9:11 - 8:11 - 7:11 - 0:0,1,3,Diaryan Aleksandr,Nikoghosyan Narek,fiurst,Diaryan Aleksandr - Nikoghosyan Narek,79,36,43,7,-7,22,20,19,18,0,-2,2,3,4,0,7,12:10 - 9:11 - 8:11 - 7:11 - 0:0
18866564,2024-05-24 10:00:00,Papyan Karen - Asatryan Murad,3:0,8:11 - 8:11 - 9:11 - 0:0 - 0:0,0,3,Papyan Karen,Asatryan Murad,fiurst,Asatryan Murad - Papyan Karen,58,33,25,-8,8,19,19,20,0,0,-3,-3,-2,0,0,-8,11:8 - 11:8 - 11:9 - 0:0 - 0:0
18843801,2024-05-23 17:45:00,Hakobyan Eduard - Gevorgyan Gegham,0:3,11:6 - 11:5 - 11:9 - 0:0 - 0:0,3,0,Hakobyan Eduard,Gevorgyan Gegham,fiurst,Gevorgyan Gegham - Hakobyan Eduard,53,20,33,13,-13,17,16,20,0,0,5,6,2,0,0,13,6:11 - 5:11 - 9:11 - 0:0 - 0:0
18843797,2024-05-23 17:30:00,Gevorgyan Hayk - Petrosyan Davit,3:2,9:11 - 5:11 - 11:8 - 11:4 - 11:5,3,2,Gevorgyan Hayk,Petrosyan Davit,fiurst,Gevorgyan Hayk - Petrosyan Davit,86,47,39,-8,8,20,16,19,15,16,2,6,-3,-7,-6,-8,9:11 - 5:11 - 11:8 - 11:4 - 11:5
18843795,2024-05-23 17:15:00,Avakimyan Davit - Hakobyan Eduard,3:0,17:15 - 11:7 - 11:4 - 0:0 - 0:0,3,0,Avakimyan Davit,Hakobyan Eduard,fiurst,Avakimyan Davit - Hakobyan Eduard,65,39,26,-13,13,32,18,15,0,0,-2,-4,-7,0,0,-13,17:15 - 11:7 - 11:4 - 0:0 - 0:0
18843608,2024-05-23 17:00:00,Gevorgyan Hayk - Gevorgyan Gegham,0:3,12:10 - 11:7 - 11:9 - 0:0 - 0:0,3,0,Gevorgyan Hayk,Gevorgyan Gegham,fiurst,Gevorgyan Gegham - Gevorgyan Hayk,60,26,34,8,-8,22,18,20,0,0,2,4,2,0,0,8,10:12 - 7:11 - 9:11 - 0:0 - 0:0
18843604,2024-05-23 16:45:00,Petrosyan Davit - Avakimyan Davit,3:1,4:11 - 11:9 - 14:16 - 5:11 - 0:0,1,3,Petrosyan Davit,Avakimyan Davit,fiurst,Avakimyan Davit - Petrosyan Davit,81,47,34,-13,13,15,20,30,16,0,-7,2,-2,-6,0,-13,11:4 - 9:11 - 16:14 - 11:5 - 0:0
18843601,2024-05-23 16:30:00,Hakobyan Eduard - Gevorgyan Hayk,1:3,4:11 - 11:9 - 11:8 - 11:4 - 0:0,3,1,Hakobyan Eduard,Gevorgyan Hayk,fiurst,Gevorgyan Hayk - Hakobyan Eduard,69,32,37,5,-5,15,20,19,15,0,-7,2,3,7,0,5,11:4 - 9:11 - 8:11 - 4:11 - 0:0
18843600,2024-05-23 16:15:00,Gevorgyan Gegham - Avakimyan Davit,0:3,11:8 - 11:9 - 13:11 - 0:0 - 0:0,3,0,Gevorgyan Gegham,Avakimyan Davit,fiurst,Avakimyan Davit - Gevorgyan Gegham,63,28,35,7,-7,19,20,24,0,0,3,2,2,0,0,7,8:11 - 9:11 - 11:13 - 0:0 - 0:0
18843588,2024-05-23 16:00:00,Petrosyan Davit - Hakobyan Eduard,0:3,11:5 - 11:4 - 11:3 - 0:0 - 0:0,3,0,Petrosyan Davit,Hakobyan Eduard,fiurst,Hakobyan Eduard - Petrosyan Davit,45,12,33,21,-21,16,15,14,0,0,6,7,8,0,0,21,5:11 - 4:11 - 3:11 - 0:0 - 0:0
18843572,2024-05-23 15:45:00,Avakimyan Davit - Gevorgyan Hayk,1:3,11:9 - 5:11 - 3:11 - 5:11 - 0:0,1,3,Avakimyan Davit,Gevorgyan Hayk,fiurst,Avakimyan Davit - Gevorgyan Hayk,66,24,42,18,-18,20,16,14,16,0,-2,6,8,6,0,18,11:9 - 5:11 - 3:11 - 5:11 - 0:0
18843571,2024-05-23 15:30:00,Gevorgyan Gegham - Petrosyan Davit,3:1,1:11 - 11:7 - 11:6 - 11:8 - 0:0,3,1,Gevorgyan Gegham,Petrosyan Davit,fiurst,Gevorgyan Gegham - Petrosyan Davit,66,34,32,-2,2,12,18,17,19,0,10,-4,-5,-3,0,-2,1:11 - 11:7 - 11:6 - 11:8 - 0:0
18843569,2024-05-23 15:20:00,Asatryan Murad - Rafayelyan Edgar,1:3,8:11 - 11:3 - 10:12 - 9:11 - 0:0,1,3,Asatryan Murad,Rafayelyan Edgar,fiurst,Asatryan Murad - Rafayelyan Edgar,75,38,37,-1,1,19,14,22,20,0,3,-8,2,2,0,-1,8:11 - 11:3 - 10:12 - 9:11 - 0:0
18843558,2024-05-23 15:05:00,Papyan Karen - Nazaryan Mushegh,0:3,11:8 - 11:6 - 11:4 - 0:0 - 0:0,3,0,Papyan Karen,Nazaryan Mushegh,fiurst,Nazaryan Mushegh - Papyan Karen,51,18,33,15,-15,19,17,15,0,0,3,5,7,0,0,15,8:11 - 6:11 - 4:11 - 0:0 - 0:0
18843557,2024-05-23 14:45:00,Nikoghosyan Narek - Asatryan Murad,3:2,12:10 - 6:11 - 13:11 - 3:11 - 9:11,2,3,Nikoghosyan Narek,Asatryan Murad,fiurst,Asatryan Murad - Nikoghosyan Narek,97,54,43,-11,11,22,17,24,14,20,2,-5,2,-8,-2,-11,10:12 - 11:6 - 11:13 - 11:3 - 11:9
18843550,2024-05-23 14:30:00,Rafayelyan Edgar - Papyan Karen,3:0,14:16 - 13:15 - 17:19 - 0:0 - 0:0,0,3,Rafayelyan Edgar,Papyan Karen,fiurst,Papyan Karen - Rafayelyan Edgar,94,50,44,-6,6,30,28,36,0,0,-2,-2,-2,0,0,-6,16:14 - 15:13 - 19:17 - 0:0 - 0:0
18843547,2024-05-23 14:15:00,Nikoghosyan Narek - Nazaryan Mushegh,2:3,7:11 - 12:10 - 4:11 - 11:7 - 11:8,3,2,Nikoghosyan Narek,Nazaryan Mushegh,fiurst,Nazaryan Mushegh - Nikoghosyan Narek,92,47,45,-2,2,18,22,15,18,19,-4,2,-7,4,3,-2,11:7 - 10:12 - 11:4 - 7:11 - 8:11
18843545,2024-05-23 14:00:00,Asatryan Murad - Papyan Karen,3:1,11:9 - 9:11 - 11:5 - 11:8 - 0:0,3,1,Asatryan Murad,Papyan Karen,fiurst,Asatryan Murad - Papyan Karen,75,42,33,-9,9,20,20,16,19,0,-2,2,-6,-3,0,-9,11:9 - 9:11 - 11:5 - 11:8 - 0:0
18843542,2024-05-23 13:50:00,Rafayelyan Edgar - Nikoghosyan Narek,0:3,11:7 - 11:3 - 11:9 - 0:0 - 0:0,3,0,Rafayelyan Edgar,Nikoghosyan Narek,fiurst,Nikoghosyan Narek - Rafayelyan Edgar,52,19,33,14,-14,18,14,20,0,0,4,8,2,0,0,14,7:11 - 3:11 - 9:11 - 0:0 - 0:0
18843522,2024-05-23 13:30:00,Nazaryan Mushegh - Asatryan Murad,3:0,6:11 - 3:11 - 5:11 - 0:0 - 0:0,0,3,Nazaryan Mushegh,Asatryan Murad,fiurst,Asatryan Murad - Nazaryan Mushegh,47,33,14,-19,19,17,14,16,0,0,-5,-8,-6,0,0,-19,11:6 - 11:3 - 11:5 - 0:0 - 0:0
18843489,2024-05-23 13:15:00,Papyan Karen - Nikoghosyan Narek,1:3,11:13 - 11:6 - 11:8 - 11:6 - 0:0,3,1,Papyan Karen,Nikoghosyan Narek,fiurst,Nikoghosyan Narek - Papyan Karen,77,33,44,11,-11,24,17,19,17,0,-2,5,3,5,0,11,13:11 - 6:11 - 8:11 - 6:11 - 0:0
18843487,2024-05-23 13:00:00,Nazaryan Mushegh - Rafayelyan Edgar,2:3,11:6 - 12:10 - 5:11 - 8:11 - 7:11,2,3,Nazaryan Mushegh,Rafayelyan Edgar,fiurst,Nazaryan Mushegh - Rafayelyan Edgar,92,43,49,6,-6,17,22,16,19,18,-5,-2,6,3,4,6,11:6 - 12:10 - 5:11 - 8:11 - 7:11
18843481,2024-05-23 12:15:00,Asatryan Murad - Nikoghosyan Narek,3:1,8:11 - 11:9 - 11:7 - 11:9 - 0:0,3,1,Asatryan Murad,Nikoghosyan Narek,fiurst,Asatryan Murad - Nikoghosyan Narek,77,41,36,-5,5,19,20,18,20,0,3,-2,-4,-2,0,-5,8:11 - 11:9 - 11:7 - 11:9 - 0:0
18843478,2024-05-23 12:05:00,Nazaryan Mushegh - Papyan Karen,1:3,8:11 - 9:11 - 11:9 - 4:11 - 0:0,1,3,Nazaryan Mushegh,Papyan Karen,fiurst,Nazaryan Mushegh - Papyan Karen,74,32,42,10,-10,19,20,20,15,0,3,2,-2,7,0,10,8:11 - 9:11 - 11:9 - 4:11 - 0:0
18843467,2024-05-23 11:45:00,Rafayelyan Edgar - Asatryan Murad,3:2,9:11 - 11:6 - 9:11 - 11:3 - 7:11,2,3,Rafayelyan Edgar,Asatryan Murad,fiurst,Asatryan Murad - Rafayelyan Edgar,89,42,47,5,-5,20,17,20,14,18,-2,5,-2,8,-4,5,11:9 - 6:11 - 11:9 - 3:11 - 11:7
18843466,2024-05-23 11:30:00,Nazaryan Mushegh - Nikoghosyan Narek,3:2,11:7 - 4:11 - 11:9 - 6:11 - 13:11,3,2,Nazaryan Mushegh,Nikoghosyan Narek,fiurst,Nazaryan Mushegh - Nikoghosyan Narek,94,45,49,4,-4,18,15,20,17,24,-4,7,-2,5,-2,4,11:7 - 4:11 - 11:9 - 6:11 - 13:11
18843465,2024-05-23 11:15:00,Papyan Karen - Rafayelyan Edgar,3:0,11:7 - 11:6 - 11:8 - 0:0 - 0:0,3,0,Papyan Karen,Rafayelyan Edgar,fiurst,Papyan Karen - Rafayelyan Edgar,54,33,21,-12,12,18,17,19,0,0,-4,-5,-3,0,0,-12,11:7 - 11:6 - 11:8 - 0:0 - 0:0
18843462,2024-05-23 11:00:00,Asatryan Murad - Nazaryan Mushegh,3:0,11:8 - 11:5 - 11:8 - 0:0 - 0:0,3,0,Asatryan Murad,Nazaryan Mushegh,fiurst,Asatryan Murad - Nazaryan Mushegh,54,33,21,-12,12,19,16,19,0,0,-3,-6,-3,0,0,-12,11:8 - 11:5 - 11:8 - 0:0 - 0:0
18843460,2024-05-23 10:45:00,Nikoghosyan Narek - Rafayelyan Edgar,0:3,5:11 - 9:11 - 6:11 - 0:0 - 0:0,0,3,Nikoghosyan Narek,Rafayelyan Edgar,fiurst,Nikoghosyan Narek - Rafayelyan Edgar,53,20,33,13,-13,16,20,17,0,0,6,2,5,0,0,13,5:11 - 9:11 - 6:11 - 0:0 - 0:0
18843459,2024-05-23 10:30:00,Papyan Karen - Asatryan Murad,3:1,11:9 - 10:12 - 8:11 - 7:11 - 0:0,1,3,Papyan Karen,Asatryan Murad,fiurst,Asatryan Murad - Papyan Karen,79,43,36,-7,7,20,22,19,18,0,2,-2,-3,-4,0,-7,9:11 - 12:10 - 11:8 - 11:7 - 0:0
18843448,2024-05-23 10:15:00,Rafayelyan Edgar - Nazaryan Mushegh,1:3,11:5 - 9:11 - 11:7 - 13:11 - 0:0,3,1,Rafayelyan Edgar,Nazaryan Mushegh,fiurst,Nazaryan Mushegh - Rafayelyan Edgar,78,34,44,10,-10,16,20,18,24,0,6,-2,4,2,0,10,5:11 - 11:9 - 7:11 - 11:13 - 0:0
18843447,2024-05-23 10:10:00,Nikoghosyan Narek - Papyan Karen,0:3,11:13 - 7:11 - 5:11 - 0:0 - 0:0,0,3,Nikoghosyan Narek,Papyan Karen,fiurst,Nikoghosyan Narek - Papyan Karen,58,23,35,12,-12,24,18,16,0,0,2,4,6,0,0,12,11:13 - 7:11 - 5:11 - 0:0 - 0:0
18822100,2024-05-22 18:00:00,Gevorgyan Hayk - Petrosyan Davit,3:1,10:12 - 11:6 - 11:6 - 11:4 - 0:0,3,1,Gevorgyan Hayk,Petrosyan Davit,fiurst,Gevorgyan Hayk - Petrosyan Davit,71,43,28,-15,15,22,17,17,15,0,2,-5,-5,-7,0,-15,10:12 - 11:6 - 11:6 - 11:4 - 0:0
18822099,2024-05-22 17:35:00,Avakimyan Davit - Gevorgyan Gegham,3:1,10:12 - 11:8 - 15:13 - 11:8 - 0:0,3,1,Avakimyan Davit,Gevorgyan Gegham,fiurst,Avakimyan Davit - Gevorgyan Gegham,88,47,41,-6,6,22,19,28,19,0,2,-3,-2,-3,0,-6,10:12 - 11:8 - 15:13 - 11:8 - 0:0
18822098,2024-05-22 17:30:00,Soghomonyan Hrayr - Gevorgyan Hayk,1:3,9:11 - 12:10 - 11:8 - 11:8 - 0:0,3,1,Soghomonyan Hrayr,Gevorgyan Hayk,fiurst,Gevorgyan Hayk - Soghomonyan Hrayr,80,37,43,6,-6,20,22,19,19,0,-2,2,3,3,0,6,11:9 - 10:12 - 8:11 - 8:11 - 0:0
18822092,2024-05-22 17:00:00,Avakimyan Davit - Petrosyan Davit,3:0,11:9 - 13:11 - 11:4 - 0:0 - 0:0,3,0,Avakimyan Davit,Petrosyan Davit,fiurst,Avakimyan Davit - Petrosyan Davit,59,35,24,-11,11,20,24,15,0,0,-2,-2,-7,0,0,-11,11:9 - 13:11 - 11:4 - 0:0 - 0:0
18822071,2024-05-22 16:55:00,Gevorgyan Gegham - Soghomonyan Hrayr,1:3,14:16 - 6:11 - 11:6 - 11:13 - 0:0,1,3,Gevorgyan Gegham,Soghomonyan Hrayr,fiurst,Gevorgyan Gegham - Soghomonyan Hrayr,88,42,46,4,-4,30,17,17,24,0,2,5,-5,2,0,4,14:16 - 6:11 - 11:6 - 11:13 - 0:0
18822064,2024-05-22 16:30:00,Gevorgyan Hayk - Avakimyan Davit,0:3,13:11 - 11:7 - 12:10 - 0:0 - 0:0,3,0,Gevorgyan Hayk,Avakimyan Davit,fiurst,Avakimyan Davit - Gevorgyan Hayk,64,28,36,8,-8,24,18,22,0,0,2,4,2,0,0,8,11:13 - 7:11 - 10:12 - 0:0 - 0:0
18822062,2024-05-22 16:15:00,Petrosyan Davit - Soghomonyan Hrayr,3:2,8:11 - 12:10 - 5:11 - 12:10 - 11:9,3,2,Petrosyan Davit,Soghomonyan Hrayr,fiurst,Petrosyan Davit - Soghomonyan Hrayr,99,48,51,3,-3,19,22,16,22,20,3,-2,6,-2,-2,3,8:11 - 12:10 - 5:11 - 12:10 - 11:9
18822060,2024-05-22 16:00:00,Gevorgyan Gegham - Gevorgyan Hayk,0:3,7:11 - 11:13 - 10:12 - 0:0 - 0:0,0,3,Gevorgyan Gegham,Gevorgyan Hayk,fiurst,Gevorgyan Gegham - Gevorgyan Hayk,64,28,36,8,-8,18,24,22,0,0,4,2,2,0,0,8,7:11 - 11:13 - 10:12 - 0:0 - 0:0
18822058,2024-05-22 15:45:00,Soghomonyan Hrayr - Avakimyan Davit,3:1,4:11 - 8:11 - 11:5 - 9:11 - 0:0,1,3,Soghomonyan Hrayr,Avakimyan Davit,fiurst,Avakimyan Davit - Soghomonyan Hrayr,70,38,32,-6,6,15,19,16,20,0,-7,-3,6,-2,0,-6,11:4 - 11:8 - 5:11 - 11:9 - 0:0
18822056,2024-05-22 15:30:00,Petrosyan Davit - Gevorgyan Gegham,0:3,11:6 - 11:8 - 11:2 - 0:0 - 0:0,3,0,Petrosyan Davit,Gevorgyan Gegham,fiurst,Gevorgyan Gegham - Petrosyan Davit,49,16,33,17,-17,17,19,13,0,0,5,3,9,0,0,17,6:11 - 8:11 - 2:11 - 0:0 - 0:0
18822040,2024-05-22 15:15:00,Nikoghosyan Narek - Nazaryan Mushegh,0:3,11:5 - 12:10 - 11:7 - 0:0 - 0:0,3,0,Nikoghosyan Narek,Nazaryan Mushegh,fiurst,Nazaryan Mushegh - Nikoghosyan Narek,56,22,34,12,-12,16,22,18,0,0,6,2,4,0,0,12,5:11 - 10:12 - 7:11 - 0:0 - 0:0
18822037,2024-05-22 15:00:00,Rafayelyan Edgar - Diaryan Aleksandr,2:3,11:9 - 8:11 - 12:10 - 5:11 - 11:6,3,2,Rafayelyan Edgar,Diaryan Aleksandr,fiurst,Diaryan Aleksandr - Rafayelyan Edgar,94,47,47,0,0,20,19,22,16,17,2,-3,2,-6,5,0,9:11 - 11:8 - 10:12 - 11:5 - 6:11
18822034,2024-05-22 14:45:00,Asatryan Murad - Nikoghosyan Narek,3:1,11:5 - 8:11 - 11:5 - 12:10 - 0:0,3,1,Asatryan Murad,Nikoghosyan Narek,fiurst,Asatryan Murad - Nikoghosyan Narek,73,42,31,-11,11,16,19,16,22,0,-6,3,-6,-2,0,-11,11:5 - 8:11 - 11:5 - 12:10 - 0:0
18822033,2024-05-22 14:30:00,Nazaryan Mushegh - Rafayelyan Edgar,0:3,5:11 - 6:11 - 8:11 - 0:0 - 0:0,0,3,Nazaryan Mushegh,Rafayelyan Edgar,fiurst,Nazaryan Mushegh - Rafayelyan Edgar,52,19,33,14,-14,16,17,19,0,0,6,5,3,0,0,14,5:11 - 6:11 - 8:11 - 0:0 - 0:0
18822030,2024-05-22 14:15:00,Asatryan Murad - Diaryan Aleksandr,2:3,9:11 - 11:6 - 5:11 - 11:9 - 7:11,2,3,Asatryan Murad,Diaryan Aleksandr,fiurst,Asatryan Murad - Diaryan Aleksandr,91,43,48,5,-5,20,17,16,20,18,2,-5,6,-2,4,5,9:11 - 11:6 - 5:11 - 11:9 - 7:11
18822018,2024-05-22 14:00:00,Nikoghosyan Narek - Rafayelyan Edgar,0:3,8:11 - 8:11 - 10:12 - 0:0 - 0:0,0,3,Nikoghosyan Narek,Rafayelyan Edgar,fiurst,Nikoghosyan Narek - Rafayelyan Edgar,60,26,34,8,-8,19,19,22,0,0,3,3,2,0,0,8,8:11 - 8:11 - 10:12 - 0:0 - 0:0
18822009,2024-05-22 13:45:00,Nazaryan Mushegh - Asatryan Murad,3:0,2:11 - 4:11 - 3:11 - 0:0 - 0:0,0,3,Nazaryan Mushegh,Asatryan Murad,fiurst,Asatryan Murad - Nazaryan Mushegh,42,33,9,-24,24,13,15,14,0,0,-9,-7,-8,0,0,-24,11:2 - 11:4 - 11:3 - 0:0 - 0:0
18822008,2024-05-22 13:30:00,Diaryan Aleksandr - Nikoghosyan Narek,3:0,11:6 - 11:7 - 11:7 - 0:0 - 0:0,3,0,Diaryan Aleksandr,Nikoghosyan Narek,fiurst,Diaryan Aleksandr - Nikoghosyan Narek,53,33,20,-13,13,17,18,18,0,0,-5,-4,-4,0,0,-13,11:6 - 11:7 - 11:7 - 0:0 - 0:0
18822006,2024-05-22 13:15:00,Rafayelyan Edgar - Asatryan Murad,3:0,11:13 - 4:11 - 6:11 - 0:0 - 0:0,0,3,Rafayelyan Edgar,Asatryan Murad,fiurst,Asatryan Murad - Rafayelyan Edgar,56,35,21,-14,14,24,15,17,0,0,-2,-7,-5,0,0,-14,13:11 - 11:4 - 11:6 - 0:0 - 0:0
18822004,2024-05-22 13:00:00,Diaryan Aleksandr - Nazaryan Mushegh,3:2,11:5 - 8:11 - 11:4 - 9:11 - 11:6,3,2,Diaryan Aleksandr,Nazaryan Mushegh,fiurst,Diaryan Aleksandr - Nazaryan Mushegh,87,50,37,-13,13,16,19,15,20,17,-6,3,-7,2,-5,-13,11:5 - 8:11 - 11:4 - 9:11 - 11:6
18822002,2024-05-22 12:15:00,Nikoghosyan Narek - Asatryan Murad,3:1,5:11 - 5:11 - 11:8 - 6:11 - 0:0,1,3,Nikoghosyan Narek,Asatryan Murad,fiurst,Asatryan Murad - Nikoghosyan Narek,68,41,27,-14,14,16,16,19,17,0,-6,-6,3,-5,0,-14,11:5 - 11:5 - 8:11 - 11:6 - 0:0
18821999,2024-05-22 12:00:00,Diaryan Aleksandr - Rafayelyan Edgar,1:3,11:5 - 16:18 - 6:11 - 5:11 - 0:0,1,3,Diaryan Aleksandr,Rafayelyan Edgar,fiurst,Diaryan Aleksandr - Rafayelyan Edgar,83,38,45,7,-7,16,34,17,16,0,-6,2,5,6,0,7,11:5 - 16:18 - 6:11 - 5:11 - 0:0
18821997,2024-05-22 11:45:00,Nazaryan Mushegh - Nikoghosyan Narek,0:3,5:11 - 4:11 - 9:11 - 0:0 - 0:0,0,3,Nazaryan Mushegh,Nikoghosyan Narek,fiurst,Nazaryan Mushegh - Nikoghosyan Narek,51,18,33,15,-15,16,15,20,0,0,6,7,2,0,0,15,5:11 - 4:11 - 9:11 - 0:0 - 0:0
18821993,2024-05-22 11:30:00,Diaryan Aleksandr - Asatryan Murad,3:0,8:11 - 8:11 - 9:11 - 0:0 - 0:0,0,3,Diaryan Aleksandr,Asatryan Murad,fiurst,Asatryan Murad - Diaryan Aleksandr,58,33,25,-8,8,19,19,20,0,0,-3,-3,-2,0,0,-8,11:8 - 11:8 - 11:9 - 0:0 - 0:0
18821980,2024-05-22 11:15:00,Rafayelyan Edgar - Nazaryan Mushegh,1:3,3:11 - 11:7 - 11:7 - 13:11 - 0:0,3,1,Rafayelyan Edgar,Nazaryan Mushegh,fiurst,Nazaryan Mushegh - Rafayelyan Edgar,74,36,38,2,-2,14,18,18,24,0,-8,4,4,2,0,2,11:3 - 7:11 - 7:11 - 11:13 - 0:0
18821977,2024-05-22 11:00:00,Nikoghosyan Narek - Diaryan Aleksandr,3:1,11:4 - 6:11 - 6:11 - 9:11 - 0:0,1,3,Nikoghosyan Narek,Diaryan Aleksandr,fiurst,Diaryan Aleksandr - Nikoghosyan Narek,69,37,32,-5,5,15,17,17,20,0,7,-5,-5,-2,0,-5,4:11 - 11:6 - 11:6 - 11:9 - 0:0
18821976,2024-05-22 10:45:00,Asatryan Murad - Nazaryan Mushegh,3:0,11:4 - 11:6 - 11:8 - 0:0 - 0:0,3,0,Asatryan Murad,Nazaryan Mushegh,fiurst,Asatryan Murad - Nazaryan Mushegh,51,33,18,-15,15,15,17,19,0,0,-7,-5,-3,0,0,-15,11:4 - 11:6 - 11:8 - 0:0 - 0:0
18821973,2024-05-22 10:30:00,Rafayelyan Edgar - Nikoghosyan Narek,0:3,11:4 - 11:8 - 11:9 - 0:0 - 0:0,3,0,Rafayelyan Edgar,Nikoghosyan Narek,fiurst,Nikoghosyan Narek - Rafayelyan Edgar,54,21,33,12,-12,15,19,20,0,0,7,3,2,0,0,12,4:11 - 8:11 - 9:11 - 0:0 - 0:0
18821971,2024-05-22 10:15:00,Nazaryan Mushegh - Diaryan Aleksandr,3:0,9:11 - 7:11 - 14:16 - 0:0 - 0:0,0,3,Nazaryan Mushegh,Diaryan Aleksandr,fiurst,Diaryan Aleksandr - Nazaryan Mushegh,68,38,30,-8,8,20,18,30,0,0,-2,-4,-2,0,0,-8,11:9 - 11:7 - 16:14 - 0:0 - 0:0
18821969,2024-05-22 10:00:00,Asatryan Murad - Rafayelyan Edgar,2:3,4:11 - 11:8 - 7:11 - 11:8 - 3:11,2,3,Asatryan Murad,Rafayelyan Edgar,fiurst,Asatryan Murad - Rafayelyan Edgar,85,36,49,13,-13,15,19,18,19,14,7,-3,4,-3,8,13,4:11 - 11:8 - 7:11 - 11:8 - 3:11
18803779,2024-05-21 17:45:00,Petrosyan Davit - Soghomonyan Hrayr,3:2,11:3 - 6:11 - 10:12 - 11:9 - 11:8,3,2,Petrosyan Davit,Soghomonyan Hrayr,fiurst,Petrosyan Davit - Soghomonyan Hrayr,92,49,43,-6,6,14,17,22,20,19,-8,5,2,-2,-3,-6,11:3 - 6:11 - 10:12 - 11:9 - 11:8
18803776,2024-05-21 17:30:00,Hakobyan Eduard - Gevorgyan Gegham,0:3,11:4 - 15:13 - 11:5 - 0:0 - 0:0,3,0,Hakobyan Eduard,Gevorgyan Gegham,fiurst,Gevorgyan Gegham - Hakobyan Eduard,59,22,37,15,-15,15,28,16,0,0,7,2,6,0,0,15,4:11 - 13:15 - 5:11 - 0:0 - 0:0
18803775,2024-05-21 17:15:00,Avakimyan Davit - Petrosyan Davit,3:1,11:9 - 9:11 - 11:5 - 11:7 - 0:0,3,1,Avakimyan Davit,Petrosyan Davit,fiurst,Avakimyan Davit - Petrosyan Davit,74,42,32,-10,10,20,20,16,18,0,-2,2,-6,-4,0,-10,11:9 - 9:11 - 11:5 - 11:7 - 0:0
18803773,2024-05-21 17:00:00,Hakobyan Eduard - Soghomonyan Hrayr,0:3,4:11 - 10:12 - 7:11 - 0:0 - 0:0,0,3,Hakobyan Eduard,Soghomonyan Hrayr,fiurst,Hakobyan Eduard - Soghomonyan Hrayr,55,21,34,13,-13,15,22,18,0,0,7,2,4,0,0,13,4:11 - 10:12 - 7:11 - 0:0 - 0:0
18803770,2024-05-21 16:45:00,Gevorgyan Gegham - Avakimyan Davit,3:0,6:11 - 6:11 - 7:11 - 0:0 - 0:0,0,3,Gevorgyan Gegham,Avakimyan Davit,fiurst,Avakimyan Davit - Gevorgyan Gegham,52,33,19,-14,14,17,17,18,0,0,-5,-5,-4,0,0,-14,11:6 - 11:6 - 11:7 - 0:0 - 0:0
18803768,2024-05-21 16:30:00,Petrosyan Davit - Hakobyan Eduard,1:3,11:5 - 7:11 - 11:4 - 11:7 - 0:0,3,1,Petrosyan Davit,Hakobyan Eduard,fiurst,Hakobyan Eduard - Petrosyan Davit,67,27,40,13,-13,16,18,15,18,0,6,-4,7,4,0,13,5:11 - 11:7 - 4:11 - 7:11 - 0:0
18803759,2024-05-21 16:15:00,Soghomonyan Hrayr - Avakimyan Davit,0:3,11:3 - 11:2 - 11:6 - 0:0 - 0:0,3,0,Soghomonyan Hrayr,Avakimyan Davit,fiurst,Avakimyan Davit - Soghomonyan Hrayr,44,11,33,22,-22,14,13,17,0,0,8,9,5,0,0,22,3:11 - 2:11 - 6:11 - 0:0 - 0:0
18803756,2024-05-21 16:00:00,Gevorgyan Gegham - Petrosyan Davit,0:3,6:11 - 6:11 - 7:11 - 0:0 - 0:0,0,3,Gevorgyan Gegham,Petrosyan Davit,fiurst,Gevorgyan Gegham - Petrosyan Davit,52,19,33,14,-14,17,17,18,0,0,5,5,4,0,0,14,6:11 - 6:11 - 7:11 - 0:0 - 0:0
18803753,2024-05-21 15:45:00,Avakimyan Davit - Hakobyan Eduard,3:2,7:11 - 11:7 - 11:9 - 5:11 - 11:9,3,2,Avakimyan Davit,Hakobyan Eduard,fiurst,Avakimyan Davit - Hakobyan Eduard,92,45,47,2,-2,18,18,20,16,20,4,-4,-2,6,-2,2,7:11 - 11:7 - 11:9 - 5:11 - 11:9
18803751,2024-05-21 15:30:00,Soghomonyan Hrayr - Gevorgyan Gegham,1:3,12:10 - 6:11 - 11:7 - 11:7 - 0:0,3,1,Soghomonyan Hrayr,Gevorgyan Gegham,fiurst,Gevorgyan Gegham - Soghomonyan Hrayr,75,35,40,5,-5,22,17,18,18,0,2,-5,4,4,0,5,10:12 - 11:6 - 7:11 - 7:11 - 0:0
18803748,2024-05-21 15:15:00,Asatryan Murad - Diaryan Aleksandr,3:0,11:5 - 11:8 - 12:10 - 0:0 - 0:0,3,0,Asatryan Murad,Diaryan Aleksandr,fiurst,Asatryan Murad - Diaryan Aleksandr,57,34,23,-11,11,16,19,22,0,0,-6,-3,-2,0,0,-11,11:5 - 11:8 - 12:10 - 0:0 - 0:0
18803743,2024-05-21 15:00:00,Rafayelyan Edgar - Papyan Karen,0:3,11:8 - 11:8 - 12:10 - 0:0 - 0:0,3,0,Rafayelyan Edgar,Papyan Karen,fiurst,Papyan Karen - Rafayelyan Edgar,60,26,34,8,-8,19,19,22,0,0,3,3,2,0,0,8,8:11 - 8:11 - 10:12 - 0:0 - 0:0
18803738,2024-05-21 14:45:00,Nazaryan Mushegh - Asatryan Murad,3:0,9:11 - 8:11 - 8:11 - 0:0 - 0:0,0,3,Nazaryan Mushegh,Asatryan Murad,fiurst,Asatryan Murad - Nazaryan Mushegh,58,33,25,-8,8,20,19,19,0,0,-2,-3,-3,0,0,-8,11:9 - 11:8 - 11:8 - 0:0 - 0:0
18803732,2024-05-21 14:30:00,Diaryan Aleksandr - Rafayelyan Edgar,0:3,7:11 - 7:11 - 5:11 - 0:0 - 0:0,0,3,Diaryan Aleksandr,Rafayelyan Edgar,fiurst,Diaryan Aleksandr - Rafayelyan Edgar,52,19,33,14,-14,18,18,16,0,0,4,4,6,0,0,14,7:11 - 7:11 - 5:11 - 0:0 - 0:0
18803718,2024-05-21 14:15:00,Nazaryan Mushegh - Papyan Karen,0:3,4:11 - 7:11 - 4:11 - 0:0 - 0:0,0,3,Nazaryan Mushegh,Papyan Karen,fiurst,Nazaryan Mushegh - Papyan Karen,48,15,33,18,-18,15,18,15,0,0,7,4,7,0,0,18,4:11 - 7:11 - 4:11 - 0:0 - 0:0
18803717,2024-05-21 14:00:00,Asatryan Murad - Rafayelyan Edgar,1:3,11:9 - 7:11 - 8:11 - 4:11 - 0:0,1,3,Asatryan Murad,Rafayelyan Edgar,fiurst,Asatryan Murad - Rafayelyan Edgar,72,30,42,12,-12,20,18,19,15,0,-2,4,3,7,0,12,11:9 - 7:11 - 8:11 - 4:11 - 0:0
18803713,2024-05-21 13:45:00,Diaryan Aleksandr - Nazaryan Mushegh,3:0,11:8 - 11:7 - 11:8 - 0:0 - 0:0,3,0,Diaryan Aleksandr,Nazaryan Mushegh,fiurst,Diaryan Aleksandr - Nazaryan Mushegh,56,33,23,-10,10,19,18,19,0,0,-3,-4,-3,0,0,-10,11:8 - 11:7 - 11:8 - 0:0 - 0:0
18803706,2024-05-21 13:30:00,Papyan Karen - Asatryan Murad,3:1,11:9 - 5:11 - 4:11 - 9:11 - 0:0,1,3,Papyan Karen,Asatryan Murad,fiurst,Asatryan Murad - Papyan Karen,71,42,29,-13,13,20,16,15,20,0,2,-6,-7,-2,0,-13,9:11 - 11:5 - 11:4 - 11:9 - 0:0
18803698,2024-05-21 13:15:00,Rafayelyan Edgar - Nazaryan Mushegh,0:3,13:11 - 11:8 - 11:8 - 0:0 - 0:0,3,0,Rafayelyan Edgar,Nazaryan Mushegh,fiurst,Nazaryan Mushegh - Rafayelyan Edgar,62,27,35,8,-8,24,19,19,0,0,2,3,3,0,0,8,11:13 - 8:11 - 8:11 - 0:0 - 0:0
18803694,2024-05-21 13:00:00,Papyan Karen - Diaryan Aleksandr,1:3,11:9 - 11:5 - 8:11 - 11:7 - 0:0,3,1,Papyan Karen,Diaryan Aleksandr,fiurst,Diaryan Aleksandr - Papyan Karen,73,32,41,9,-9,20,16,19,18,0,2,6,-3,4,0,9,9:11 - 5:11 - 11:8 - 7:11 - 0:0
18803690,2024-05-21 12:15:00,Asatryan Murad - Nazaryan Mushegh,3:0,11:5 - 11:6 - 11:7 - 0:0 - 0:0,3,0,Asatryan Murad,Nazaryan Mushegh,fiurst,Asatryan Murad - Nazaryan Mushegh,51,33,18,-15,15,16,17,18,0,0,-6,-5,-4,0,0,-15,11:5 - 11:6 - 11:7 - 0:0 - 0:0
18803678,2024-05-21 12:05:00,Papyan Karen - Rafayelyan Edgar,0:3,9:11 - 6:11 - 7:11 - 0:0 - 0:0,0,3,Papyan Karen,Rafayelyan Edgar,fiurst,Papyan Karen - Rafayelyan Edgar,55,22,33,11,-11,20,17,18,0,0,2,5,4,0,0,11,9:11 - 6:11 - 7:11 - 0:0 - 0:0
18803673,2024-05-21 11:45:00,Diaryan Aleksandr - Asatryan Murad,3:0,5:11 - 3:11 - 5:11 - 0:0 - 0:0,0,3,Diaryan Aleksandr,Asatryan Murad,fiurst,Asatryan Murad - Diaryan Aleksandr,46,33,13,-20,20,16,14,16,0,0,-6,-8,-6,0,0,-20,11:5 - 11:3 - 11:5 - 0:0 - 0:0
18803668,2024-05-21 11:30:00,Papyan Karen - Nazaryan Mushegh,0:3,11:9 - 11:8 - 11:9 - 0:0 - 0:0,3,0,Papyan Karen,Nazaryan Mushegh,fiurst,Nazaryan Mushegh - Papyan Karen,59,26,33,7,-7,20,19,20,0,0,2,3,2,0,0,7,9:11 - 8:11 - 9:11 - 0:0 - 0:0
18803663,2024-05-21 11:15:00,Rafayelyan Edgar - Diaryan Aleksandr,0:3,11:8 - 12:10 - 11:5 - 0:0 - 0:0,3,0,Rafayelyan Edgar,Diaryan Aleksandr,fiurst,Diaryan Aleksandr - Rafayelyan Edgar,57,23,34,11,-11,19,22,16,0,0,3,2,6,0,0,11,8:11 - 10:12 - 5:11 - 0:0 - 0:0
18803660,2024-05-21 11:00:00,Asatryan Murad - Papyan Karen,3:0,11:5 - 12:10 - 11:4 - 0:0 - 0:0,3,0,Asatryan Murad,Papyan Karen,fiurst,Asatryan Murad - Papyan Karen,53,34,19,-15,15,16,22,15,0,0,-6,-2,-7,0,0,-15,11:5 - 12:10 - 11:4 - 0:0 - 0:0
18803658,2024-05-21 10:45:00,Nazaryan Mushegh - Diaryan Aleksandr,3:0,5:11 - 10:12 - 7:11 - 0:0 - 0:0,0,3,Nazaryan Mushegh,Diaryan Aleksandr,fiurst,Diaryan Aleksandr - Nazaryan Mushegh,56,34,22,-12,12,16,22,18,0,0,-6,-2,-4,0,0,-12,11:5 - 12:10 - 11:7 - 0:0 - 0:0
18803646,2024-05-21 10:30:00,Rafayelyan Edgar - Asatryan Murad,0:3,11:7 - 11:4 - 11:7 - 0:0 - 0:0,3,0,Rafayelyan Edgar,Asatryan Murad,fiurst,Asatryan Murad - Rafayelyan Edgar,51,18,33,15,-15,18,15,18,0,0,4,7,4,0,0,15,7:11 - 4:11 - 7:11 - 0:0 - 0:0
18803645,2024-05-21 10:15:00,Diaryan Aleksandr - Papyan Karen,1:3,11:4 - 6:11 - 8:11 - 10:12 - 0:0,1,3,Diaryan Aleksandr,Papyan Karen,fiurst,Diaryan Aleksandr - Papyan Karen,73,35,38,3,-3,15,17,19,22,0,-7,5,3,2,0,3,11:4 - 6:11 - 8:11 - 10:12 - 0:0
18803643,2024-05-21 10:00:00,Nazaryan Mushegh - Rafayelyan Edgar,0:3,3:11 - 6:11 - 9:11 - 0:0 - 0:0,0,3,Nazaryan Mushegh,Rafayelyan Edgar,fiurst,Nazaryan Mushegh - Rafayelyan Edgar,51,18,33,15,-15,14,17,20,0,0,8,5,2,0,0,15,3:11 - 6:11 - 9:11 - 0:0 - 0:0
18790677,2024-05-20 17:45:00,Hakobyan Eduard - Avakimyan Davit,0:3,11:4 - 11:5 - 11:3 - 0:0 - 0:0,3,0,Hakobyan Eduard,Avakimyan Davit,fiurst,Avakimyan Davit - Hakobyan Eduard,45,12,33,21,-21,15,16,14,0,0,7,6,8,0,0,21,4:11 - 5:11 - 3:11 - 0:0 - 0:0
18790653,2024-05-20 17:25:00,Soghomonyan Hrayr - Gevorgyan Hayk,0:3,11:6 - 11:8 - 11:8 - 0:0 - 0:0,3,0,Soghomonyan Hrayr,Gevorgyan Hayk,fiurst,Gevorgyan Hayk - Soghomonyan Hrayr,55,22,33,11,-11,17,19,19,0,0,5,3,3,0,0,11,6:11 - 8:11 - 8:11 - 0:0 - 0:0
18790641,2024-05-20 17:15:00,Gevorgyan Gegham - Hakobyan Eduard,0:3,2:11 - 8:11 - 7:11 - 0:0 - 0:0,0,3,Gevorgyan Gegham,Hakobyan Eduard,fiurst,Gevorgyan Gegham - Hakobyan Eduard,50,17,33,16,-16,13,19,18,0,0,9,3,4,0,0,16,2:11 - 8:11 - 7:11 - 0:0 - 0:0
18790638,2024-05-20 17:00:00,Soghomonyan Hrayr - Avakimyan Davit,1:3,8:11 - 11:7 - 11:6 - 11:3 - 0:0,3,1,Soghomonyan Hrayr,Avakimyan Davit,fiurst,Avakimyan Davit - Soghomonyan Hrayr,68,27,41,14,-14,19,18,17,14,0,-3,4,5,8,0,14,11:8 - 7:11 - 6:11 - 3:11 - 0:0
18790636,2024-05-20 16:45:00,Gevorgyan Hayk - Gevorgyan Gegham,2:3,10:12 - 10:12 - 11:6 - 11:4 - 11:4,3,2,Gevorgyan Hayk,Gevorgyan Gegham,fiurst,Gevorgyan Gegham - Gevorgyan Hayk,91,38,53,15,-15,22,22,17,15,15,-2,-2,5,7,7,15,12:10 - 12:10 - 6:11 - 4:11 - 4:11
18790628,2024-05-20 16:30:00,Hakobyan Eduard - Soghomonyan Hrayr,1:3,4:11 - 7:11 - 11:8 - 4:11 - 0:0,1,3,Hakobyan Eduard,Soghomonyan Hrayr,fiurst,Hakobyan Eduard - Soghomonyan Hrayr,67,26,41,15,-15,15,18,19,15,0,7,4,-3,7,0,15,4:11 - 7:11 - 11:8 - 4:11 - 0:0
18790625,2024-05-20 16:15:00,Avakimyan Davit - Gevorgyan Gegham,3:0,13:11 - 11:7 - 11:8 - 0:0 - 0:0,3,0,Avakimyan Davit,Gevorgyan Gegham,fiurst,Avakimyan Davit - Gevorgyan Gegham,61,35,26,-9,9,24,18,19,0,0,-2,-4,-3,0,0,-9,13:11 - 11:7 - 11:8 - 0:0 - 0:0
18790624,2024-05-20 16:00:00,Gevorgyan Hayk - Hakobyan Eduard,3:2,14:12 - 7:11 - 15:13 - 10:12 - 12:10,3,2,Gevorgyan Hayk,Hakobyan Eduard,fiurst,Gevorgyan Hayk - Hakobyan Eduard,116,58,58,0,0,26,18,28,22,22,-2,4,-2,2,-2,0,14:12 - 7:11 - 15:13 - 10:12 - 12:10
18790613,2024-05-20 15:45:00,Gevorgyan Gegham - Soghomonyan Hrayr,0:3,8:11 - 4:11 - 4:11 - 0:0 - 0:0,0,3,Gevorgyan Gegham,Soghomonyan Hrayr,fiurst,Gevorgyan Gegham - Soghomonyan Hrayr,49,16,33,17,-17,19,15,15,0,0,3,7,7,0,0,17,8:11 - 4:11 - 4:11 - 0:0 - 0:0
18790612,2024-05-20 15:30:00,Avakimyan Davit - Gevorgyan Hayk,1:3,4:11 - 11:9 - 9:11 - 9:11 - 0:0,1,3,Avakimyan Davit,Gevorgyan Hayk,fiurst,Avakimyan Davit - Gevorgyan Hayk,75,33,42,9,-9,15,20,20,20,0,7,-2,2,2,0,9,4:11 - 11:9 - 9:11 - 9:11 - 0:0
18790608,2024-05-20 15:15:00,Papyan Karen - Rafayelyan Edgar,1:3,15:17 - 6:11 - 11:9 - 6:11 - 0:0,1,3,Papyan Karen,Rafayelyan Edgar,fiurst,Papyan Karen - Rafayelyan Edgar,86,38,48,10,-10,32,17,20,17,0,2,5,-2,5,0,10,15:17 - 6:11 - 11:9 - 6:11 - 0:0
18790604,2024-05-20 15:00:00,Nazaryan Mushegh - Nikoghosyan Narek,0:3,6:11 - 5:11 - 7:11 - 0:0 - 0:0,0,3,Nazaryan Mushegh,Nikoghosyan Narek,fiurst,Nazaryan Mushegh - Nikoghosyan Narek,51,18,33,15,-15,17,16,18,0,0,5,6,4,0,0,15,6:11 - 5:11 - 7:11 - 0:0 - 0:0
18790599,2024-05-20 14:50:00,Diaryan Aleksandr - Papyan Karen,3:0,11:3 - 13:11 - 11:2 - 0:0 - 0:0,3,0,Diaryan Aleksandr,Papyan Karen,fiurst,Diaryan Aleksandr - Papyan Karen,51,35,16,-19,19,14,24,13,0,0,-8,-2,-9,0,0,-19,11:3 - 13:11 - 11:2 - 0:0 - 0:0
18790597,2024-05-20 14:40:00,Rafayelyan Edgar - Nazaryan Mushegh,1:3,11:9 - 8:11 - 11:5 - 11:6 - 0:0,3,1,Rafayelyan Edgar,Nazaryan Mushegh,fiurst,Nazaryan Mushegh - Rafayelyan Edgar,72,31,41,10,-10,20,19,16,17,0,2,-3,6,5,0,10,9:11 - 11:8 - 5:11 - 6:11 - 0:0
18790584,2024-05-20 14:15:00,Papyan Karen - Nazaryan Mushegh,1:3,11:6 - 11:8 - 7:11 - 11:6 - 0:0,3,1,Papyan Karen,Nazaryan Mushegh,fiurst,Nazaryan Mushegh - Papyan Karen,71,31,40,9,-9,17,19,18,17,0,5,3,-4,5,0,9,6:11 - 8:11 - 11:7 - 6:11 - 0:0
18790585,2024-05-20 14:15:00,Diaryan Aleksandr - Nikoghosyan Narek,3:0,11:6 - 11:5 - 15:13 - 0:0 - 0:0,3,0,Diaryan Aleksandr,Nikoghosyan Narek,fiurst,Diaryan Aleksandr - Nikoghosyan Narek,61,37,24,-13,13,17,16,28,0,0,-5,-6,-2,0,0,-13,11:6 - 11:5 - 15:13 - 0:0 - 0:0
18790572,2024-05-20 13:45:00,Rafayelyan Edgar - Diaryan Aleksandr,2:3,8:11 - 11:4 - 14:16 - 11:7 - 11:4,3,2,Rafayelyan Edgar,Diaryan Aleksandr,fiurst,Diaryan Aleksandr - Rafayelyan Edgar,97,42,55,13,-13,19,15,30,18,15,-3,7,-2,4,7,13,11:8 - 4:11 - 16:14 - 7:11 - 4:11
18790540,2024-05-20 13:40:00,Nikoghosyan Narek - Papyan Karen,2:3,11:7 - 10:12 - 11:7 - 5:11 - 7:11,2,3,Nikoghosyan Narek,Papyan Karen,fiurst,Nikoghosyan Narek - Papyan Karen,92,44,48,4,-4,18,22,18,16,18,-4,2,-4,6,4,4,11:7 - 10:12 - 11:7 - 5:11 - 7:11
18790535,2024-05-20 13:15:00,Nazaryan Mushegh - Diaryan Aleksandr,3:0,9:11 - 4:11 - 5:11 - 0:0 - 0:0,0,3,Nazaryan Mushegh,Diaryan Aleksandr,fiurst,Diaryan Aleksandr - Nazaryan Mushegh,51,33,18,-15,15,20,15,16,0,0,-2,-7,-6,0,0,-15,11:9 - 11:4 - 11:5 - 0:0 - 0:0
18790532,2024-05-20 13:00:00,Nikoghosyan Narek - Rafayelyan Edgar,2:3,8:11 - 7:11 - 14:12 - 11:9 - 7:11,2,3,Nikoghosyan Narek,Rafayelyan Edgar,fiurst,Nikoghosyan Narek - Rafayelyan Edgar,101,47,54,7,-7,19,18,26,20,18,3,4,-2,-2,4,7,8:11 - 7:11 - 14:12 - 11:9 - 7:11
18790530,2024-05-20 12:15:00,Papyan Karen - Diaryan Aleksandr,3:1,7:11 - 10:12 - 11:9 - 9:11 - 0:0,1,3,Papyan Karen,Diaryan Aleksandr,fiurst,Diaryan Aleksandr - Papyan Karen,80,43,37,-6,6,18,22,20,20,0,-4,-2,2,-2,0,-6,11:7 - 12:10 - 9:11 - 11:9 - 0:0
18790518,2024-05-20 12:05:00,Nikoghosyan Narek - Nazaryan Mushegh,0:3,11:3 - 11:6 - 11:9 - 0:0 - 0:0,3,0,Nikoghosyan Narek,Nazaryan Mushegh,fiurst,Nazaryan Mushegh - Nikoghosyan Narek,51,18,33,15,-15,14,17,20,0,0,8,5,2,0,0,15,3:11 - 6:11 - 9:11 - 0:0 - 0:0
18790516,2024-05-20 11:45:00,Rafayelyan Edgar - Papyan Karen,3:1,11:5 - 7:11 - 9:11 - 9:11 - 0:0,1,3,Rafayelyan Edgar,Papyan Karen,fiurst,Papyan Karen - Rafayelyan Edgar,74,38,36,-2,2,16,18,20,20,0,6,-4,-2,-2,0,-2,5:11 - 11:7 - 11:9 - 11:9 - 0:0
18790515,2024-05-20 11:40:00,Nikoghosyan Narek - Diaryan Aleksandr,3:0,4:11 - 8:11 - 10:12 - 0:0 - 0:0,0,3,Nikoghosyan Narek,Diaryan Aleksandr,fiurst,Diaryan Aleksandr - Nikoghosyan Narek,56,34,22,-12,12,15,19,22,0,0,-7,-3,-2,0,0,-12,11:4 - 11:8 - 12:10 - 0:0 - 0:0
18790498,2024-05-20 11:15:00,Nazaryan Mushegh - Rafayelyan Edgar,0:3,8:11 - 6:11 - 7:11 - 0:0 - 0:0,0,3,Nazaryan Mushegh,Rafayelyan Edgar,fiurst,Nazaryan Mushegh - Rafayelyan Edgar,54,21,33,12,-12,19,17,18,0,0,3,5,4,0,0,12,8:11 - 6:11 - 7:11 - 0:0 - 0:0
18790490,2024-05-20 11:00:00,Papyan Karen - Nikoghosyan Narek,1:3,5:11 - 17:15 - 11:6 - 11:8 - 0:0,3,1,Papyan Karen,Nikoghosyan Narek,fiurst,Nikoghosyan Narek - Papyan Karen,84,40,44,4,-4,16,32,17,19,0,-6,2,5,3,0,4,11:5 - 15:17 - 6:11 - 8:11 - 0:0
18790488,2024-05-20 10:45:00,Diaryan Aleksandr - Rafayelyan Edgar,1:3,11:9 - 1:11 - 9:11 - 9:11 - 0:0,1,3,Diaryan Aleksandr,Rafayelyan Edgar,fiurst,Diaryan Aleksandr - Rafayelyan Edgar,72,30,42,12,-12,20,12,20,20,0,-2,10,2,2,0,12,11:9 - 1:11 - 9:11 - 9:11 - 0:0
18790485,2024-05-20 10:30:00,Nazaryan Mushegh - Papyan Karen,3:1,11:5 - 7:11 - 11:3 - 11:5 - 0:0,3,1,Nazaryan Mushegh,Papyan Karen,fiurst,Nazaryan Mushegh - Papyan Karen,64,40,24,-16,16,16,18,14,16,0,-6,4,-8,-6,0,-16,11:5 - 7:11 - 11:3 - 11:5 - 0:0
18790481,2024-05-20 10:15:00,Rafayelyan Edgar - Nikoghosyan Narek,2:3,11:9 - 11:9 - 7:11 - 8:11 - 11:4,3,2,Rafayelyan Edgar,Nikoghosyan Narek,fiurst,Nikoghosyan Narek - Rafayelyan Edgar,92,44,48,4,-4,20,20,18,19,15,2,2,-4,-3,7,4,9:11 - 9:11 - 11:7 - 11:8 - 4:11
18790476,2024-05-20 10:00:00,Diaryan Aleksandr - Nazaryan Mushegh,1:3,9:11 - 11:7 - 9:11 - 5:11 - 0:0,1,3,Diaryan Aleksandr,Nazaryan Mushegh,fiurst,Diaryan Aleksandr - Nazaryan Mushegh,74,34,40,6,-6,20,18,20,16,0,2,-4,2,6,0,6,9:11 - 11:7 - 9:11 - 5:11 - 0:0
18769750,2024-05-19 17:45:00,Petrosyan Davit - Gevorgyan Gegham,0:3,11:3 - 11:8 - 11:8 - 0:0 - 0:0,3,0,Petrosyan Davit,Gevorgyan Gegham,fiurst,Gevorgyan Gegham - Petrosyan Davit,52,19,33,14,-14,14,19,19,0,0,8,3,3,0,0,14,3:11 - 8:11 - 8:11 - 0:0 - 0:0
18769747,2024-05-19 17:30:00,Avakimyan Davit - Hakobyan Eduard,0:3,7:11 - 3:11 - 12:14 - 0:0 - 0:0,0,3,Avakimyan Davit,Hakobyan Eduard,fiurst,Avakimyan Davit - Hakobyan Eduard,58,22,36,14,-14,18,14,26,0,0,4,8,2,0,0,14,7:11 - 3:11 - 12:14 - 0:0 - 0:0
18769745,2024-05-19 17:20:00,Soghomonyan Hrayr - Gevorgyan Hayk,1:3,11:8 - 14:12 - 10:12 - 11:7 - 0:0,3,1,Soghomonyan Hrayr,Gevorgyan Hayk,fiurst,Gevorgyan Hayk - Soghomonyan Hrayr,85,39,46,7,-7,19,26,22,18,0,3,2,-2,4,0,7,8:11 - 12:14 - 12:10 - 7:11 - 0:0
18769729,2024-05-19 17:00:00,Petrosyan Davit - Avakimyan Davit,0:3,11:4 - 11:6 - 11:6 - 0:0 - 0:0,3,0,Petrosyan Davit,Avakimyan Davit,fiurst,Avakimyan Davit - Petrosyan Davit,49,16,33,17,-17,15,17,17,0,0,7,5,5,0,0,17,4:11 - 6:11 - 6:11 - 0:0 - 0:0
18769727,2024-05-19 16:45:00,Gevorgyan Gegham - Soghomonyan Hrayr,1:3,13:11 - 9:11 - 11:13 - 13:15 - 0:0,1,3,Gevorgyan Gegham,Soghomonyan Hrayr,fiurst,Gevorgyan Gegham - Soghomonyan Hrayr,96,46,50,4,-4,24,20,24,28,0,-2,2,2,2,0,4,13:11 - 9:11 - 11:13 - 13:15 - 0:0
18769720,2024-05-19 16:30:00,Gevorgyan Hayk - Hakobyan Eduard,2:3,11:1 - 6:11 - 6:11 - 11:8 - 9:11,2,3,Gevorgyan Hayk,Hakobyan Eduard,fiurst,Gevorgyan Hayk - Hakobyan Eduard,85,43,42,-1,1,12,17,17,19,20,-10,5,5,-3,2,-1,11:1 - 6:11 - 6:11 - 11:8 - 9:11
18769717,2024-05-19 16:15:00,Soghomonyan Hrayr - Avakimyan Davit,0:3,11:6 - 11:8 - 11:2 - 0:0 - 0:0,3,0,Soghomonyan Hrayr,Avakimyan Davit,fiurst,Avakimyan Davit - Soghomonyan Hrayr,49,16,33,17,-17,17,19,13,0,0,5,3,9,0,0,17,6:11 - 8:11 - 2:11 - 0:0 - 0:0
18769707,2024-05-19 16:00:00,Hakobyan Eduard - Petrosyan Davit,0:3,8:11 - 7:11 - 7:11 - 0:0 - 0:0,0,3,Hakobyan Eduard,Petrosyan Davit,fiurst,Hakobyan Eduard - Petrosyan Davit,55,22,33,11,-11,19,18,18,0,0,3,4,4,0,0,11,8:11 - 7:11 - 7:11 - 0:0 - 0:0
18769702,2024-05-19 15:45:00,Gevorgyan Gegham - Gevorgyan Hayk,1:3,12:10 - 7:11 - 9:11 - 5:11 - 0:0,1,3,Gevorgyan Gegham,Gevorgyan Hayk,fiurst,Gevorgyan Gegham - Gevorgyan Hayk,76,33,43,10,-10,22,18,20,16,0,-2,4,2,6,0,10,12:10 - 7:11 - 9:11 - 5:11 - 0:0
18769699,2024-05-19 15:30:00,Hakobyan Eduard - Soghomonyan Hrayr,0:3,6:11 - 15:17 - 4:11 - 0:0 - 0:0,0,3,Hakobyan Eduard,Soghomonyan Hrayr,fiurst,Hakobyan Eduard - Soghomonyan Hrayr,64,25,39,14,-14,17,32,15,0,0,5,2,7,0,0,14,6:11 - 15:17 - 4:11 - 0:0 - 0:0
18769693,2024-05-19 15:15:00,Avakimyan Davit - Gevorgyan Gegham,3:0,11:9 - 11:7 - 11:8 - 0:0 - 0:0,3,0,Avakimyan Davit,Gevorgyan Gegham,fiurst,Avakimyan Davit - Gevorgyan Gegham,57,33,24,-9,9,20,18,19,0,0,-2,-4,-3,0,0,-9,11:9 - 11:7 - 11:8 - 0:0 - 0:0
18769683,2024-05-19 15:00:00,Gevorgyan Hayk - Petrosyan Davit,3:2,8:11 - 11:9 - 11:7 - 9:11 - 11:7,3,2,Gevorgyan Hayk,Petrosyan Davit,fiurst,Gevorgyan Hayk - Petrosyan Davit,95,50,45,-5,5,19,20,18,20,18,3,-2,-4,2,-4,-5,8:11 - 11:9 - 11:7 - 9:11 - 11:7
18769680,2024-05-19 14:45:00,Gevorgyan Gegham - Hakobyan Eduard,2:3,11:9 - 9:11 - 7:11 - 11:5 - 9:11,2,3,Gevorgyan Gegham,Hakobyan Eduard,fiurst,Gevorgyan Gegham - Hakobyan Eduard,94,47,47,0,0,20,20,18,16,20,-2,2,4,-6,2,0,11:9 - 9:11 - 7:11 - 11:5 - 9:11
18769672,2024-05-19 14:30:00,Soghomonyan Hrayr - Petrosyan Davit,3:0,6:11 - 3:11 - 3:11 - 0:0 - 0:0,0,3,Soghomonyan Hrayr,Petrosyan Davit,fiurst,Petrosyan Davit - Soghomonyan Hrayr,45,33,12,-21,21,17,14,14,0,0,-5,-8,-8,0,0,-21,11:6 - 11:3 - 11:3 - 0:0 - 0:0
18769669,2024-05-19 14:15:00,Avakimyan Davit - Gevorgyan Hayk,2:3,3:11 - 11:9 - 11:5 - 6:11 - 8:11,2,3,Avakimyan Davit,Gevorgyan Hayk,fiurst,Avakimyan Davit - Gevorgyan Hayk,86,39,47,8,-8,14,20,16,17,19,8,-2,-6,5,3,8,3:11 - 11:9 - 11:5 - 6:11 - 8:11
18769647,2024-05-19 14:00:00,Gevorgyan Gegham - Petrosyan Davit,0:3,4:11 - 5:11 - 8:11 - 0:0 - 0:0,0,3,Gevorgyan Gegham,Petrosyan Davit,fiurst,Gevorgyan Gegham - Petrosyan Davit,50,17,33,16,-16,15,16,19,0,0,7,6,3,0,0,16,4:11 - 5:11 - 8:11 - 0:0 - 0:0
18729826,2024-05-19 13:45:00,Hakobyan Eduard - Avakimyan Davit,1:3,10:12 - 11:9 - 11:7 - 11:7 - 0:0,3,1,Hakobyan Eduard,Avakimyan Davit,fiurst,Avakimyan Davit - Hakobyan Eduard,78,35,43,8,-8,22,20,18,18,0,-2,2,4,4,0,8,12:10 - 9:11 - 7:11 - 7:11 - 0:0
18767339,2024-05-19 13:35:00,Gevorgyan Hayk - Soghomonyan Hrayr,3:2,9:11 - 3:11 - 11:5 - 11:6 - 11:3,3,2,Gevorgyan Hayk,Soghomonyan Hrayr,fiurst,Gevorgyan Hayk - Soghomonyan Hrayr,81,45,36,-9,9,20,14,16,17,14,2,8,-6,-5,-8,-9,9:11 - 3:11 - 11:5 - 11:6 - 11:3
18767309,2024-05-19 13:15:00,Avakimyan Davit - Petrosyan Davit,3:1,11:9 - 11:8 - 7:11 - 12:10 - 0:0,3,1,Avakimyan Davit,Petrosyan Davit,fiurst,Avakimyan Davit - Petrosyan Davit,79,41,38,-3,3,20,19,18,22,0,-2,-3,4,-2,0,-3,11:9 - 11:8 - 7:11 - 12:10 - 0:0
18767305,2024-05-19 13:00:00,Soghomonyan Hrayr - Gevorgyan Gegham,1:3,11:9 - 4:11 - 11:9 - 11:8 - 0:0,3,1,Soghomonyan Hrayr,Gevorgyan Gegham,fiurst,Gevorgyan Gegham - Soghomonyan Hrayr,74,37,37,0,0,20,15,20,19,0,2,-7,2,3,0,0,9:11 - 11:4 - 9:11 - 8:11 - 0:0
18767250,2024-05-19 12:20:00,Hakobyan Eduard - Gevorgyan Hayk,1:3,11:6 - 11:7 - 10:12 - 11:8 - 0:0,3,1,Hakobyan Eduard,Gevorgyan Hayk,fiurst,Gevorgyan Hayk - Hakobyan Eduard,76,33,43,10,-10,17,18,22,19,0,5,4,-2,3,0,10,6:11 - 7:11 - 12:10 - 8:11 - 0:0
18767245,2024-05-19 12:10:00,Avakimyan Davit - Soghomonyan Hrayr,3:1,13:11 - 11:13 - 11:7 - 12:10 - 0:0,3,1,Avakimyan Davit,Soghomonyan Hrayr,fiurst,Avakimyan Davit - Soghomonyan Hrayr,88,47,41,-6,6,24,24,18,22,0,-2,2,-4,-2,0,-6,13:11 - 11:13 - 11:7 - 12:10 - 0:0
18767238,2024-05-19 11:45:00,Petrosyan Davit - Hakobyan Eduard,0:3,11:9 - 11:4 - 11:3 - 0:0 - 0:0,3,0,Petrosyan Davit,Hakobyan Eduard,fiurst,Hakobyan Eduard - Petrosyan Davit,49,16,33,17,-17,20,15,14,0,0,2,7,8,0,0,17,9:11 - 4:11 - 3:11 - 0:0 - 0:0
18767234,2024-05-19 11:40:00,Gevorgyan Hayk - Gevorgyan Gegham,3:2,8:11 - 11:9 - 8:11 - 12:10 - 7:11,2,3,Gevorgyan Hayk,Gevorgyan Gegham,fiurst,Gevorgyan Gegham - Gevorgyan Hayk,98,52,46,-6,6,19,20,19,22,18,-3,2,-3,2,-4,-6,11:8 - 9:11 - 11:8 - 10:12 - 11:7
18767216,2024-05-19 11:15:00,Soghomonyan Hrayr - Hakobyan Eduard,0:3,11:4 - 11:6 - 11:5 - 0:0 - 0:0,3,0,Soghomonyan Hrayr,Hakobyan Eduard,fiurst,Hakobyan Eduard - Soghomonyan Hrayr,48,15,33,18,-18,15,17,16,0,0,7,5,6,0,0,18,4:11 - 6:11 - 5:11 - 0:0 - 0:0
18767213,2024-05-19 11:00:00,Gevorgyan Gegham - Avakimyan Davit,2:3,13:15 - 11:4 - 11:13 - 11:5 - 11:9,3,2,Gevorgyan Gegham,Avakimyan Davit,fiurst,Avakimyan Davit - Gevorgyan Gegham,103,46,57,11,-11,28,15,24,16,20,-2,7,-2,6,2,11,15:13 - 4:11 - 13:11 - 5:11 - 9:11
18767174,2024-05-19 10:50:00,Petrosyan Davit - Gevorgyan Hayk,3:1,10:12 - 13:15 - 11:9 - 7:11 - 0:0,1,3,Petrosyan Davit,Gevorgyan Hayk,fiurst,Gevorgyan Hayk - Petrosyan Davit,88,47,41,-6,6,22,28,20,18,0,-2,-2,2,-4,0,-6,12:10 - 15:13 - 9:11 - 11:7 - 0:0
18767168,2024-05-19 10:30:00,Hakobyan Eduard - Gevorgyan Gegham,2:3,11:8 - 8:11 - 7:11 - 11:5 - 11:8,3,2,Hakobyan Eduard,Gevorgyan Gegham,fiurst,Gevorgyan Gegham - Hakobyan Eduard,91,43,48,5,-5,19,19,18,16,19,3,-3,-4,6,3,5,8:11 - 11:8 - 11:7 - 5:11 - 8:11
18767150,2024-05-19 10:15:00,Petrosyan Davit - Soghomonyan Hrayr,3:0,11:4 - 18:16 - 11:2 - 0:0 - 0:0,3,0,Petrosyan Davit,Soghomonyan Hrayr,fiurst,Petrosyan Davit - Soghomonyan Hrayr,62,40,22,-18,18,15,34,13,0,0,-7,-2,-9,0,0,-18,11:4 - 18:16 - 11:2 - 0:0 - 0:0
18767140,2024-05-19 10:00:00,Gevorgyan Hayk - Avakimyan Davit,3:0,8:11 - 5:11 - 9:11 - 0:0 - 0:0,0,3,Gevorgyan Hayk,Avakimyan Davit,fiurst,Avakimyan Davit - Gevorgyan Hayk,55,33,22,-11,11,19,16,20,0,0,-3,-6,-2,0,0,-11,11:8 - 11:5 - 11:9 - 0:0 - 0:0
18751033,2024-05-18 17:45:00,Petrosyan Davit - Gevorgyan Hayk,0:3,11:7 - 11:4 - 11:7 - 0:0 - 0:0,3,0,Petrosyan Davit,Gevorgyan Hayk,fiurst,Gevorgyan Hayk - Petrosyan Davit,51,18,33,15,-15,18,15,18,0,0,4,7,4,0,0,15,7:11 - 4:11 - 7:11 - 0:0 - 0:0
18751018,2024-05-18 17:30:00,Gevorgyan Gegham - Hakobyan Eduard,3:1,11:5 - 11:7 - 9:11 - 11:3 - 0:0,3,1,Gevorgyan Gegham,Hakobyan Eduard,fiurst,Gevorgyan Gegham - Hakobyan Eduard,68,42,26,-16,16,16,18,20,14,0,-6,-4,2,-8,0,-16,11:5 - 11:7 - 9:11 - 11:3 - 0:0
18751009,2024-05-18 17:15:00,Avakimyan Davit - Petrosyan Davit,3:1,11:13 - 11:6 - 11:4 - 11:9 - 0:0,3,1,Avakimyan Davit,Petrosyan Davit,fiurst,Avakimyan Davit - Petrosyan Davit,76,44,32,-12,12,24,17,15,20,0,2,-5,-7,-2,0,-12,11:13 - 11:6 - 11:4 - 11:9 - 0:0
18751005,2024-05-18 17:00:00,Gevorgyan Gegham - Gevorgyan Hayk,1:3,11:5 - 7:11 - 2:11 - 8:11 - 0:0,1,3,Gevorgyan Gegham,Gevorgyan Hayk,fiurst,Gevorgyan Gegham - Gevorgyan Hayk,66,28,38,10,-10,16,18,13,19,0,-6,4,9,3,0,10,11:5 - 7:11 - 2:11 - 8:11 - 0:0
18751004,2024-05-18 16:45:00,Hakobyan Eduard - Avakimyan Davit,0:3,11:7 - 12:10 - 11:6 - 0:0 - 0:0,3,0,Hakobyan Eduard,Avakimyan Davit,fiurst,Avakimyan Davit - Hakobyan Eduard,57,23,34,11,-11,18,22,17,0,0,4,2,5,0,0,11,7:11 - 10:12 - 6:11 - 0:0 - 0:0
18751002,2024-05-18 16:30:00,Petrosyan Davit - Gevorgyan Gegham,0:3,13:11 - 11:9 - 11:9 - 0:0 - 0:0,3,0,Petrosyan Davit,Gevorgyan Gegham,fiurst,Gevorgyan Gegham - Petrosyan Davit,64,29,35,6,-6,24,20,20,0,0,2,2,2,0,0,6,11:13 - 9:11 - 9:11 - 0:0 - 0:0
18751000,2024-05-18 16:15:00,Gevorgyan Hayk - Avakimyan Davit,0:3,12:10 - 11:9 - 11:8 - 0:0 - 0:0,3,0,Gevorgyan Hayk,Avakimyan Davit,fiurst,Avakimyan Davit - Gevorgyan Hayk,61,27,34,7,-7,22,20,19,0,0,2,2,3,0,0,7,10:12 - 9:11 - 8:11 - 0:0 - 0:0
18750997,2024-05-18 16:00:00,Hakobyan Eduard - Petrosyan Davit,0:3,12:14 - 9:11 - 9:11 - 0:0 - 0:0,0,3,Hakobyan Eduard,Petrosyan Davit,fiurst,Hakobyan Eduard - Petrosyan Davit,66,30,36,6,-6,26,20,20,0,0,2,2,2,0,0,6,12:14 - 9:11 - 9:11 - 0:0 - 0:0
18750995,2024-05-18 15:45:00,Avakimyan Davit - Gevorgyan Gegham,3:2,11:4 - 9:11 - 11:8 - 9:11 - 11:7,3,2,Avakimyan Davit,Gevorgyan Gegham,fiurst,Avakimyan Davit - Gevorgyan Gegham,92,51,41,-10,10,15,20,19,20,18,-7,2,-3,2,-4,-10,11:4 - 9:11 - 11:8 - 9:11 - 11:7
18750991,2024-05-18 15:30:00,Gevorgyan Hayk - Hakobyan Eduard,3:1,6:11 - 14:12 - 11:3 - 11:4 - 0:0,3,1,Gevorgyan Hayk,Hakobyan Eduard,fiurst,Gevorgyan Hayk - Hakobyan Eduard,72,42,30,-12,12,17,26,14,15,0,5,-2,-8,-7,0,-12,6:11 - 14:12 - 11:3 - 11:4 - 0:0
18750989,2024-05-18 15:15:00,Diaryan Aleksandr - Nikoghosyan Narek,3:0,11:6 - 11:4 - 11:9 - 0:0 - 0:0,3,0,Diaryan Aleksandr,Nikoghosyan Narek,fiurst,Diaryan Aleksandr - Nikoghosyan Narek,52,33,19,-14,14,17,15,20,0,0,-5,-7,-2,0,0,-14,11:6 - 11:4 - 11:9 - 0:0 - 0:0
18750988,2024-05-18 15:00:00,Asatryan Murad - Nazaryan Mushegh,3:0,11:5 - 12:10 - 11:8 - 0:0 - 0:0,3,0,Asatryan Murad,Nazaryan Mushegh,fiurst,Asatryan Murad - Nazaryan Mushegh,57,34,23,-11,11,16,22,19,0,0,-6,-2,-3,0,0,-11,11:5 - 12:10 - 11:8 - 0:0 - 0:0
18750986,2024-05-18 14:55:00,Papyan Karen - Diaryan Aleksandr,3:1,11:9 - 6:11 - 5:11 - 9:11 - 0:0,1,3,Papyan Karen,Diaryan Aleksandr,fiurst,Diaryan Aleksandr - Papyan Karen,73,42,31,-11,11,20,17,16,20,0,2,-5,-6,-2,0,-11,9:11 - 11:6 - 11:5 - 11:9 - 0:0
18750982,2024-05-18 14:30:00,Nikoghosyan Narek - Asatryan Murad,3:0,6:11 - 3:11 - 9:11 - 0:0 - 0:0,0,3,Nikoghosyan Narek,Asatryan Murad,fiurst,Asatryan Murad - Nikoghosyan Narek,51,33,18,-15,15,17,14,20,0,0,-5,-8,-2,0,0,-15,11:6 - 11:3 - 11:9 - 0:0 - 0:0
18750973,2024-05-18 14:30:00,Papyan Karen - Nazaryan Mushegh,1:3,7:11 - 11:6 - 11:6 - 11:4 - 0:0,3,1,Papyan Karen,Nazaryan Mushegh,fiurst,Nazaryan Mushegh - Papyan Karen,67,27,40,13,-13,18,17,17,15,0,-4,5,5,7,0,13,11:7 - 6:11 - 6:11 - 4:11 - 0:0
18750971,2024-05-18 14:00:00,Diaryan Aleksandr - Asatryan Murad,3:0,6:11 - 1:11 - 6:11 - 0:0 - 0:0,0,3,Diaryan Aleksandr,Asatryan Murad,fiurst,Asatryan Murad - Diaryan Aleksandr,46,33,13,-20,20,17,12,17,0,0,-5,-10,-5,0,0,-20,11:6 - 11:1 - 11:6 - 0:0 - 0:0
18750969,2024-05-18 13:45:00,Nikoghosyan Narek - Papyan Karen,2:3,11:9 - 10:12 - 10:12 - 11:9 - 11:13,2,3,Nikoghosyan Narek,Papyan Karen,fiurst,Nikoghosyan Narek - Papyan Karen,108,53,55,2,-2,20,22,22,20,24,-2,2,2,-2,2,2,11:9 - 10:12 - 10:12 - 11:9 - 11:13
18750967,2024-05-18 13:30:00,Nazaryan Mushegh - Diaryan Aleksandr,3:0,6:11 - 9:11 - 7:11 - 0:0 - 0:0,0,3,Nazaryan Mushegh,Diaryan Aleksandr,fiurst,Diaryan Aleksandr - Nazaryan Mushegh,55,33,22,-11,11,17,20,18,0,0,-5,-2,-4,0,0,-11,11:6 - 11:9 - 11:7 - 0:0 - 0:0
18750966,2024-05-18 13:15:00,Asatryan Murad - Papyan Karen,3:1,8:11 - 11:4 - 11:5 - 12:10 - 0:0,3,1,Asatryan Murad,Papyan Karen,fiurst,Asatryan Murad - Papyan Karen,72,42,30,-12,12,19,15,16,22,0,3,-7,-6,-2,0,-12,8:11 - 11:4 - 11:5 - 12:10 - 0:0
18750965,2024-05-18 13:00:00,Nazaryan Mushegh - Nikoghosyan Narek,0:3,8:11 - 6:11 - 8:11 - 0:0 - 0:0,0,3,Nazaryan Mushegh,Nikoghosyan Narek,fiurst,Nazaryan Mushegh - Nikoghosyan Narek,55,22,33,11,-11,19,17,19,0,0,3,5,3,0,0,11,8:11 - 6:11 - 8:11 - 0:0 - 0:0
18750959,2024-05-18 12:30:00,Diaryan Aleksandr - Papyan Karen,3:2,8:11 - 11:5 - 8:11 - 11:6 - 11:1,3,2,Diaryan Aleksandr,Papyan Karen,fiurst,Diaryan Aleksandr - Papyan Karen,83,49,34,-15,15,19,16,19,17,12,3,-6,3,-5,-10,-15,8:11 - 11:5 - 8:11 - 11:6 - 11:1
18750942,2024-05-18 12:00:00,Nazaryan Mushegh - Asatryan Murad,3:0,7:11 - 8:11 - 5:11 - 0:0 - 0:0,0,3,Nazaryan Mushegh,Asatryan Murad,fiurst,Asatryan Murad - Nazaryan Mushegh,53,33,20,-13,13,18,19,16,0,0,-4,-3,-6,0,0,-13,11:7 - 11:8 - 11:5 - 0:0 - 0:0
18750941,2024-05-18 11:45:00,Nikoghosyan Narek - Diaryan Aleksandr,3:2,9:11 - 13:11 - 11:9 - 7:11 - 6:11,2,3,Nikoghosyan Narek,Diaryan Aleksandr,fiurst,Diaryan Aleksandr - Nikoghosyan Narek,99,53,46,-7,7,20,24,20,18,17,-2,2,2,-4,-5,-7,11:9 - 11:13 - 9:11 - 11:7 - 11:6
18750939,2024-05-18 11:30:00,Nazaryan Mushegh - Papyan Karen,1:3,11:7 - 8:11 - 6:11 - 7:11 - 0:0,1,3,Nazaryan Mushegh,Papyan Karen,fiurst,Nazaryan Mushegh - Papyan Karen,72,32,40,8,-8,18,19,17,18,0,-4,3,5,4,0,8,11:7 - 8:11 - 6:11 - 7:11 - 0:0
18750929,2024-05-18 11:15:00,Asatryan Murad - Nikoghosyan Narek,3:0,11:5 - 11:9 - 11:3 - 0:0 - 0:0,3,0,Asatryan Murad,Nikoghosyan Narek,fiurst,Asatryan Murad - Nikoghosyan Narek,50,33,17,-16,16,16,20,14,0,0,-6,-2,-8,0,0,-16,11:5 - 11:9 - 11:3 - 0:0 - 0:0
18750927,2024-05-18 11:00:00,Diaryan Aleksandr - Nazaryan Mushegh,3:0,11:6 - 11:3 - 12:10 - 0:0 - 0:0,3,0,Diaryan Aleksandr,Nazaryan Mushegh,fiurst,Diaryan Aleksandr - Nazaryan Mushegh,53,34,19,-15,15,17,14,22,0,0,-5,-8,-2,0,0,-15,11:6 - 11:3 - 12:10 - 0:0 - 0:0
18750925,2024-05-18 10:45:00,Papyan Karen - Nikoghosyan Narek,1:3,11:6 - 7:11 - 12:10 - 11:5 - 0:0,3,1,Papyan Karen,Nikoghosyan Narek,fiurst,Nikoghosyan Narek - Papyan Karen,73,32,41,9,-9,17,18,22,16,0,5,-4,2,6,0,9,6:11 - 11:7 - 10:12 - 5:11 - 0:0
18750923,2024-05-18 10:30:00,Asatryan Murad - Diaryan Aleksandr,1:3,5:11 - 9:11 - 11:8 - 5:11 - 0:0,1,3,Asatryan Murad,Diaryan Aleksandr,fiurst,Asatryan Murad - Diaryan Aleksandr,71,30,41,11,-11,16,20,19,16,0,6,2,-3,6,0,11,5:11 - 9:11 - 11:8 - 5:11 - 0:0
18750921,2024-05-18 10:15:00,Nikoghosyan Narek - Nazaryan Mushegh,0:3,11:8 - 11:5 - 11:7 - 0:0 - 0:0,3,0,Nikoghosyan Narek,Nazaryan Mushegh,fiurst,Nazaryan Mushegh - Nikoghosyan Narek,53,20,33,13,-13,19,16,18,0,0,3,6,4,0,0,13,8:11 - 5:11 - 7:11 - 0:0 - 0:0
18750920,2024-05-18 10:00:00,Papyan Karen - Asatryan Murad,3:0,8:11 - 7:11 - 5:11 - 0:0 - 0:0,0,3,Papyan Karen,Asatryan Murad,fiurst,Asatryan Murad - Papyan Karen,53,33,20,-13,13,19,18,16,0,0,-3,-4,-6,0,0,-13,11:8 - 11:7 - 11:5 - 0:0 - 0:0
18729822,2024-05-17 17:30:00,Petrosyan Davit - Avakimyan Davit,2:3,5:11 - 11:9 - 11:6 - 8:11 - 11:9,3,2,Petrosyan Davit,Avakimyan Davit,fiurst,Avakimyan Davit - Petrosyan Davit,92,46,46,0,0,16,20,17,19,20,-6,2,5,-3,2,0,11:5 - 9:11 - 6:11 - 11:8 - 9:11
18729819,2024-05-17 17:15:00,Gevorgyan Hayk - Hakobyan Eduard,3:0,11:3 - 11:8 - 11:3 - 0:0 - 0:0,3,0,Gevorgyan Hayk,Hakobyan Eduard,fiurst,Gevorgyan Hayk - Hakobyan Eduard,47,33,14,-19,19,14,19,14,0,0,-8,-3,-8,0,0,-19,11:3 - 11:8 - 11:3 - 0:0 - 0:0
18729818,2024-05-17 17:00:00,Petrosyan Davit - Soghomonyan Hrayr,0:3,12:14 - 8:11 - 4:11 - 0:0 - 0:0,0,3,Petrosyan Davit,Soghomonyan Hrayr,fiurst,Petrosyan Davit - Soghomonyan Hrayr,60,24,36,12,-12,26,19,15,0,0,2,3,7,0,0,12,12:14 - 8:11 - 4:11 - 0:0 - 0:0
18729815,2024-05-17 16:50:00,Avakimyan Davit - Gevorgyan Hayk,1:3,1:11 - 7:11 - 11:8 - 5:11 - 0:0,1,3,Avakimyan Davit,Gevorgyan Hayk,fiurst,Avakimyan Davit - Gevorgyan Hayk,65,24,41,17,-17,12,18,19,16,0,10,4,-3,6,0,17,1:11 - 7:11 - 11:8 - 5:11 - 0:0
18729806,2024-05-17 16:30:00,Hakobyan Eduard - Petrosyan Davit,0:3,7:11 - 8:11 - 3:11 - 0:0 - 0:0,0,3,Hakobyan Eduard,Petrosyan Davit,fiurst,Hakobyan Eduard - Petrosyan Davit,51,18,33,15,-15,18,19,14,0,0,4,3,8,0,0,15,7:11 - 8:11 - 3:11 - 0:0 - 0:0
18729796,2024-05-17 16:15:00,Soghomonyan Hrayr - Gevorgyan Hayk,3:2,8:11 - 11:9 - 11:9 - 9:11 - 5:11,2,3,Soghomonyan Hrayr,Gevorgyan Hayk,fiurst,Gevorgyan Hayk - Soghomonyan Hrayr,95,51,44,-7,7,19,20,20,20,16,-3,2,2,-2,-6,-7,11:8 - 9:11 - 9:11 - 11:9 - 11:5
18729795,2024-05-17 16:00:00,Avakimyan Davit - Hakobyan Eduard,3:1,11:9 - 10:12 - 11:8 - 11:8 - 0:0,3,1,Avakimyan Davit,Hakobyan Eduard,fiurst,Avakimyan Davit - Hakobyan Eduard,80,43,37,-6,6,20,22,19,19,0,-2,2,-3,-3,0,-6,11:9 - 10:12 - 11:8 - 11:8 - 0:0
18729792,2024-05-17 15:45:00,Gevorgyan Hayk - Petrosyan Davit,3:1,11:9 - 9:11 - 11:1 - 11:4 - 0:0,3,1,Gevorgyan Hayk,Petrosyan Davit,fiurst,Gevorgyan Hayk - Petrosyan Davit,67,42,25,-17,17,20,20,12,15,0,-2,2,-10,-7,0,-17,11:9 - 9:11 - 11:1 - 11:4 - 0:0
18729790,2024-05-17 15:30:00,Soghomonyan Hrayr - Avakimyan Davit,1:3,6:11 - 11:6 - 11:9 - 11:7 - 0:0,3,1,Soghomonyan Hrayr,Avakimyan Davit,fiurst,Avakimyan Davit - Soghomonyan Hrayr,72,33,39,6,-6,17,17,20,18,0,-5,5,2,4,0,6,11:6 - 6:11 - 9:11 - 7:11 - 0:0
18729784,2024-05-17 15:15:00,Nazaryan Mushegh - Papyan Karen,3:0,11:6 - 11:9 - 11:7 - 0:0 - 0:0,3,0,Nazaryan Mushegh,Papyan Karen,fiurst,Nazaryan Mushegh - Papyan Karen,55,33,22,-11,11,17,20,18,0,0,-5,-2,-4,0,0,-11,11:6 - 11:9 - 11:7 - 0:0 - 0:0
18729781,2024-05-17 15:00:00,Diaryan Aleksandr - Nikoghosyan Narek,0:3,9:11 - 9:11 - 9:11 - 0:0 - 0:0,0,3,Diaryan Aleksandr,Nikoghosyan Narek,fiurst,Diaryan Aleksandr - Nikoghosyan Narek,60,27,33,6,-6,20,20,20,0,0,2,2,2,0,0,6,9:11 - 9:11 - 9:11 - 0:0 - 0:0
18729774,2024-05-17 14:45:00,Rafayelyan Edgar - Nazaryan Mushegh,0:3,11:8 - 11:8 - 11:6 - 0:0 - 0:0,3,0,Rafayelyan Edgar,Nazaryan Mushegh,fiurst,Nazaryan Mushegh - Rafayelyan Edgar,55,22,33,11,-11,19,19,17,0,0,3,3,5,0,0,11,8:11 - 8:11 - 6:11 - 0:0 - 0:0
18729767,2024-05-17 14:30:00,Papyan Karen - Diaryan Aleksandr,3:1,11:13 - 9:11 - 11:7 - 8:11 - 0:0,1,3,Papyan Karen,Diaryan Aleksandr,fiurst,Diaryan Aleksandr - Papyan Karen,81,42,39,-3,3,24,20,18,19,0,-2,-2,4,-3,0,-3,13:11 - 11:9 - 7:11 - 11:8 - 0:0
18729765,2024-05-17 14:15:00,Rafayelyan Edgar - Nikoghosyan Narek,2:3,11:6 - 11:6 - 6:11 - 7:11 - 11:5,3,2,Rafayelyan Edgar,Nikoghosyan Narek,fiurst,Nikoghosyan Narek - Rafayelyan Edgar,85,39,46,7,-7,17,17,17,18,16,5,5,-5,-4,6,7,6:11 - 6:11 - 11:6 - 11:7 - 5:11
18729764,2024-05-17 14:05:00,Nazaryan Mushegh - Diaryan Aleksandr,3:0,8:11 - 5:11 - 9:11 - 0:0 - 0:0,0,3,Nazaryan Mushegh,Diaryan Aleksandr,fiurst,Diaryan Aleksandr - Nazaryan Mushegh,55,33,22,-11,11,19,16,20,0,0,-3,-6,-2,0,0,-11,11:8 - 11:5 - 11:9 - 0:0 - 0:0
18729762,2024-05-17 13:50:00,Papyan Karen - Rafayelyan Edgar,0:3,8:11 - 7:11 - 4:11 - 0:0 - 0:0,0,3,Papyan Karen,Rafayelyan Edgar,fiurst,Papyan Karen - Rafayelyan Edgar,52,19,33,14,-14,19,18,15,0,0,3,4,7,0,0,14,8:11 - 7:11 - 4:11 - 0:0 - 0:0
18729758,2024-05-17 13:40:00,Nikoghosyan Narek - Nazaryan Mushegh,3:2,10:12 - 11:5 - 11:3 - 6:11 - 5:11,2,3,Nikoghosyan Narek,Nazaryan Mushegh,fiurst,Nazaryan Mushegh - Nikoghosyan Narek,85,42,43,1,-1,22,16,14,17,16,-2,6,8,-5,-6,1,12:10 - 5:11 - 3:11 - 11:6 - 11:5
18729757,2024-05-17 13:15:00,Diaryan Aleksandr - Rafayelyan Edgar,1:3,7:11 - 11:9 - 6:11 - 10:12 - 0:0,1,3,Diaryan Aleksandr,Rafayelyan Edgar,fiurst,Diaryan Aleksandr - Rafayelyan Edgar,77,34,43,9,-9,18,20,17,22,0,4,-2,5,2,0,9,7:11 - 11:9 - 6:11 - 10:12 - 0:0
18729754,2024-05-17 13:00:00,Nikoghosyan Narek - Papyan Karen,2:3,11:9 - 7:11 - 9:11 - 11:7 - 8:11,2,3,Nikoghosyan Narek,Papyan Karen,fiurst,Nikoghosyan Narek - Papyan Karen,95,46,49,3,-3,20,18,20,18,19,-2,4,2,-4,3,3,11:9 - 7:11 - 9:11 - 11:7 - 8:11
18729751,2024-05-17 12:20:00,Nazaryan Mushegh - Rafayelyan Edgar,1:3,4:11 - 11:8 - 8:11 - 7:11 - 0:0,1,3,Nazaryan Mushegh,Rafayelyan Edgar,fiurst,Nazaryan Mushegh - Rafayelyan Edgar,71,30,41,11,-11,15,19,19,18,0,7,-3,3,4,0,11,4:11 - 11:8 - 8:11 - 7:11 - 0:0
18729740,2024-05-17 12:05:00,Nikoghosyan Narek - Diaryan Aleksandr,1:3,11:8 - 11:5 - 7:11 - 11:6 - 0:0,3,1,Nikoghosyan Narek,Diaryan Aleksandr,fiurst,Diaryan Aleksandr - Nikoghosyan Narek,70,30,40,10,-10,19,16,18,17,0,3,6,-4,5,0,10,8:11 - 5:11 - 11:7 - 6:11 - 0:0
18729738,2024-05-17 11:45:00,Papyan Karen - Nazaryan Mushegh,3:1,12:10 - 11:13 - 9:11 - 7:11 - 0:0,1,3,Papyan Karen,Nazaryan Mushegh,fiurst,Nazaryan Mushegh - Papyan Karen,84,45,39,-6,6,22,24,20,18,0,2,-2,-2,-4,0,-6,10:12 - 13:11 - 11:9 - 11:7 - 0:0
18729736,2024-05-17 11:30:00,Nikoghosyan Narek - Rafayelyan Edgar,1:3,11:8 - 4:11 - 5:11 - 5:11 - 0:0,1,3,Nikoghosyan Narek,Rafayelyan Edgar,fiurst,Nikoghosyan Narek - Rafayelyan Edgar,66,25,41,16,-16,19,15,16,16,0,-3,7,6,6,0,16,11:8 - 4:11 - 5:11 - 5:11 - 0:0
18729733,2024-05-17 11:15:00,Diaryan Aleksandr - Papyan Karen,3:0,11:5 - 11:8 - 11:4 - 0:0 - 0:0,3,0,Diaryan Aleksandr,Papyan Karen,fiurst,Diaryan Aleksandr - Papyan Karen,50,33,17,-16,16,16,19,15,0,0,-6,-3,-7,0,0,-16,11:5 - 11:8 - 11:4 - 0:0 - 0:0
18729732,2024-05-17 11:00:00,Nazaryan Mushegh - Nikoghosyan Narek,0:3,6:11 - 11:13 - 7:11 - 0:0 - 0:0,0,3,Nazaryan Mushegh,Nikoghosyan Narek,fiurst,Nazaryan Mushegh - Nikoghosyan Narek,59,24,35,11,-11,17,24,18,0,0,5,2,4,0,0,11,6:11 - 11:13 - 7:11 - 0:0 - 0:0
18729720,2024-05-17 10:50:00,Rafayelyan Edgar - Papyan Karen,1:3,11:6 - 9:11 - 11:4 - 11:4 - 0:0,3,1,Rafayelyan Edgar,Papyan Karen,fiurst,Papyan Karen - Rafayelyan Edgar,67,25,42,17,-17,17,20,15,15,0,5,-2,7,7,0,17,6:11 - 11:9 - 4:11 - 4:11 - 0:0
18729717,2024-05-17 10:30:00,Diaryan Aleksandr - Nazaryan Mushegh,3:0,11:6 - 11:8 - 11:8 - 0:0 - 0:0,3,0,Diaryan Aleksandr,Nazaryan Mushegh,fiurst,Diaryan Aleksandr - Nazaryan Mushegh,55,33,22,-11,11,17,19,19,0,0,-5,-3,-3,0,0,-11,11:6 - 11:8 - 11:8 - 0:0 - 0:0
18729714,2024-05-17 10:15:00,Papyan Karen - Nikoghosyan Narek,1:3,11:9 - 11:7 - 10:12 - 11:8 - 0:0,3,1,Papyan Karen,Nikoghosyan Narek,fiurst,Nikoghosyan Narek - Papyan Karen,79,36,43,7,-7,20,18,22,19,0,2,4,-2,3,0,7,9:11 - 7:11 - 12:10 - 8:11 - 0:0
18729704,2024-05-17 10:00:00,Rafayelyan Edgar - Diaryan Aleksandr,2:3,3:11 - 10:12 - 11:4 - 11:5 - 11:4,3,2,Rafayelyan Edgar,Diaryan Aleksandr,fiurst,Diaryan Aleksandr - Rafayelyan Edgar,82,36,46,10,-10,14,22,15,16,15,-8,-2,7,6,7,10,11:3 - 12:10 - 4:11 - 5:11 - 4:11
18713077,2024-05-16 17:45:00,Soghomonyan Hrayr - Petrosyan Davit,3:1,11:8 - 8:11 - 3:11 - 4:11 - 0:0,1,3,Soghomonyan Hrayr,Petrosyan Davit,fiurst,Petrosyan Davit - Soghomonyan Hrayr,67,41,26,-15,15,19,19,14,15,0,3,-3,-8,-7,0,-15,8:11 - 11:8 - 11:3 - 11:4 - 0:0
18713076,2024-05-16 17:30:00,Gevorgyan Gegham - Gevorgyan Hayk,2:3,8:11 - 11:9 - 11:13 - 11:9 - 3:11,2,3,Gevorgyan Gegham,Gevorgyan Hayk,fiurst,Gevorgyan Gegham - Gevorgyan Hayk,97,44,53,9,-9,19,20,24,20,14,3,-2,2,-2,8,9,8:11 - 11:9 - 11:13 - 11:9 - 3:11
18713072,2024-05-16 17:15:00,Avakimyan Davit - Soghomonyan Hrayr,3:0,13:11 - 11:7 - 11:9 - 0:0 - 0:0,3,0,Avakimyan Davit,Soghomonyan Hrayr,fiurst,Avakimyan Davit - Soghomonyan Hrayr,62,35,27,-8,8,24,18,20,0,0,-2,-4,-2,0,0,-8,13:11 - 11:7 - 11:9 - 0:0 - 0:0
18713068,2024-05-16 17:00:00,Gevorgyan Gegham - Petrosyan Davit,1:3,11:13 - 11:7 - 4:11 - 6:11 - 0:0,1,3,Gevorgyan Gegham,Petrosyan Davit,fiurst,Gevorgyan Gegham - Petrosyan Davit,74,32,42,10,-10,24,18,15,17,0,2,-4,7,5,0,10,11:13 - 11:7 - 4:11 - 6:11 - 0:0
18713060,2024-05-16 16:45:00,Gevorgyan Hayk - Avakimyan Davit,1:3,5:11 - 11:5 - 11:2 - 11:6 - 0:0,3,1,Gevorgyan Hayk,Avakimyan Davit,fiurst,Avakimyan Davit - Gevorgyan Hayk,62,24,38,14,-14,16,16,13,17,0,-6,6,9,5,0,14,11:5 - 5:11 - 2:11 - 6:11 - 0:0
18713059,2024-05-16 16:30:00,Soghomonyan Hrayr - Gevorgyan Gegham,0:3,11:6 - 12:10 - 12:10 - 0:0 - 0:0,3,0,Soghomonyan Hrayr,Gevorgyan Gegham,fiurst,Gevorgyan Gegham - Soghomonyan Hrayr,61,26,35,9,-9,17,22,22,0,0,5,2,2,0,0,9,6:11 - 10:12 - 10:12 - 0:0 - 0:0
18713047,2024-05-16 16:15:00,Petrosyan Davit - Avakimyan Davit,2:3,3:11 - 11:7 - 4:11 - 11:9 - 11:4,3,2,Petrosyan Davit,Avakimyan Davit,fiurst,Avakimyan Davit - Petrosyan Davit,82,42,40,-2,2,14,18,15,20,15,-8,4,-7,2,7,-2,11:3 - 7:11 - 11:4 - 9:11 - 4:11
18713045,2024-05-16 16:00:00,Gevorgyan Hayk - Soghomonyan Hrayr,0:3,7:11 - 6:11 - 7:11 - 0:0 - 0:0,0,3,Gevorgyan Hayk,Soghomonyan Hrayr,fiurst,Gevorgyan Hayk - Soghomonyan Hrayr,53,20,33,13,-13,18,17,18,0,0,4,5,4,0,0,13,7:11 - 6:11 - 7:11 - 0:0 - 0:0
18713043,2024-05-16 15:45:00,Avakimyan Davit - Gevorgyan Gegham,1:3,8:11 - 11:6 - 8:11 - 7:11 - 0:0,1,3,Avakimyan Davit,Gevorgyan Gegham,fiurst,Avakimyan Davit - Gevorgyan Gegham,73,34,39,5,-5,19,17,19,18,0,3,-5,3,4,0,5,8:11 - 11:6 - 8:11 - 7:11 - 0:0
18713042,2024-05-16 15:30:00,Petrosyan Davit - Gevorgyan Hayk,2:3,11:8 - 11:7 - 12:14 - 8:11 - 11:4,3,2,Petrosyan Davit,Gevorgyan Hayk,fiurst,Gevorgyan Hayk - Petrosyan Davit,97,44,53,9,-9,19,18,26,19,15,3,4,-2,-3,7,9,8:11 - 7:11 - 14:12 - 11:8 - 4:11
18713039,2024-05-16 15:15:00,Diaryan Aleksandr - Asatryan Murad,3:1,13:11 - 9:11 - 9:11 - 6:11 - 0:0,1,3,Diaryan Aleksandr,Asatryan Murad,fiurst,Asatryan Murad - Diaryan Aleksandr,81,44,37,-7,7,24,20,20,17,0,2,-2,-2,-5,0,-7,11:13 - 11:9 - 11:9 - 11:6 - 0:0
18713035,2024-05-16 15:00:00,Papyan Karen - Rafayelyan Edgar,2:3,6:11 - 11:7 - 15:13 - 5:11 - 11:13,2,3,Papyan Karen,Rafayelyan Edgar,fiurst,Papyan Karen - Rafayelyan Edgar,103,48,55,7,-7,17,18,28,16,24,5,-4,-2,6,2,7,6:11 - 11:7 - 15:13 - 5:11 - 11:13
18713030,2024-05-16 14:50:00,Nikoghosyan Narek - Diaryan Aleksandr,3:0,8:11 - 7:11 - 3:11 - 0:0 - 0:0,0,3,Nikoghosyan Narek,Diaryan Aleksandr,fiurst,Diaryan Aleksandr - Nikoghosyan Narek,51,33,18,-15,15,19,18,14,0,0,-3,-4,-8,0,0,-15,11:8 - 11:7 - 11:3 - 0:0 - 0:0
18713028,2024-05-16 14:30:00,Asatryan Murad - Papyan Karen,3:1,10:12 - 12:10 - 11:6 - 11:5 - 0:0,3,1,Asatryan Murad,Papyan Karen,fiurst,Asatryan Murad - Papyan Karen,77,44,33,-11,11,22,22,17,16,0,2,-2,-5,-6,0,-11,10:12 - 12:10 - 11:6 - 11:5 - 0:0
18713026,2024-05-16 14:15:00,Nikoghosyan Narek - Rafayelyan Edgar,2:3,4:11 - 6:11 - 11:6 - 11:5 - 3:11,2,3,Nikoghosyan Narek,Rafayelyan Edgar,fiurst,Nikoghosyan Narek - Rafayelyan Edgar,79,35,44,9,-9,15,17,17,16,14,7,5,-5,-6,8,9,4:11 - 6:11 - 11:6 - 11:5 - 3:11
18708285,2024-05-16 14:00:00,Diaryan Aleksandr - Papyan Karen,3:0,11:3 - 11:4 - 11:6 - 0:0 - 0:0,3,0,Diaryan Aleksandr,Papyan Karen,fiurst,Diaryan Aleksandr - Papyan Karen,46,33,13,-20,20,14,15,17,0,0,-8,-7,-5,0,0,-20,11:3 - 11:4 - 11:6 - 0:0 - 0:0
18708283,2024-05-16 13:45:00,Asatryan Murad - Nikoghosyan Narek,3:0,11:5 - 11:4 - 11:5 - 0:0 - 0:0,3,0,Asatryan Murad,Nikoghosyan Narek,fiurst,Asatryan Murad - Nikoghosyan Narek,47,33,14,-19,19,16,15,16,0,0,-6,-7,-6,0,0,-19,11:5 - 11:4 - 11:5 - 0:0 - 0:0
18708280,2024-05-16 13:35:00,Rafayelyan Edgar - Diaryan Aleksandr,1:3,11:6 - 6:11 - 11:5 - 11:6 - 0:0,3,1,Rafayelyan Edgar,Diaryan Aleksandr,fiurst,Diaryan Aleksandr - Rafayelyan Edgar,67,28,39,11,-11,17,17,16,17,0,5,-5,6,5,0,11,6:11 - 11:6 - 5:11 - 6:11 - 0:0
18708278,2024-05-16 13:15:00,Papyan Karen - Nikoghosyan Narek,1:3,6:11 - 11:9 - 11:7 - 11:7 - 0:0,3,1,Papyan Karen,Nikoghosyan Narek,fiurst,Nikoghosyan Narek - Papyan Karen,73,34,39,5,-5,17,20,18,18,0,-5,2,4,4,0,5,11:6 - 9:11 - 7:11 - 7:11 - 0:0
18708275,2024-05-16 13:00:00,Rafayelyan Edgar - Asatryan Murad,3:2,2:11 - 3:11 - 11:7 - 12:10 - 5:11,2,3,Rafayelyan Edgar,Asatryan Murad,fiurst,Asatryan Murad - Rafayelyan Edgar,83,50,33,-17,17,13,14,18,22,16,-9,-8,4,2,-6,-17,11:2 - 11:3 - 7:11 - 10:12 - 11:5
18708265,2024-05-16 12:20:00,Diaryan Aleksandr - Nikoghosyan Narek,3:1,11:4 - 11:4 - 7:11 - 11:8 - 0:0,3,1,Diaryan Aleksandr,Nikoghosyan Narek,fiurst,Diaryan Aleksandr - Nikoghosyan Narek,67,40,27,-13,13,15,15,18,19,0,-7,-7,4,-3,0,-13,11:4 - 11:4 - 7:11 - 11:8 - 0:0
18708241,2024-05-16 12:00:00,Rafayelyan Edgar - Papyan Karen,1:3,11:8 - 12:14 - 11:3 - 11:8 - 0:0,3,1,Rafayelyan Edgar,Papyan Karen,fiurst,Papyan Karen - Rafayelyan Edgar,78,33,45,12,-12,19,26,14,19,0,3,-2,8,3,0,12,8:11 - 14:12 - 3:11 - 8:11 - 0:0
18708231,2024-05-16 11:45:00,Asatryan Murad - Diaryan Aleksandr,3:2,11:7 - 11:9 - 11:13 - 6:11 - 11:5,3,2,Asatryan Murad,Diaryan Aleksandr,fiurst,Asatryan Murad - Diaryan Aleksandr,95,50,45,-5,5,18,20,24,17,16,-4,-2,2,5,-6,-5,11:7 - 11:9 - 11:13 - 6:11 - 11:5
18708229,2024-05-16 11:30:00,Rafayelyan Edgar - Nikoghosyan Narek,0:3,11:5 - 11:7 - 11:2 - 0:0 - 0:0,3,0,Rafayelyan Edgar,Nikoghosyan Narek,fiurst,Nikoghosyan Narek - Rafayelyan Edgar,47,14,33,19,-19,16,18,13,0,0,6,4,9,0,0,19,5:11 - 7:11 - 2:11 - 0:0 - 0:0
18708228,2024-05-16 11:15:00,Papyan Karen - Asatryan Murad,3:0,5:11 - 7:11 - 4:11 - 0:0 - 0:0,0,3,Papyan Karen,Asatryan Murad,fiurst,Asatryan Murad - Papyan Karen,49,33,16,-17,17,16,18,15,0,0,-6,-4,-7,0,0,-17,11:5 - 11:7 - 11:4 - 0:0 - 0:0
18708224,2024-05-16 11:00:00,Diaryan Aleksandr - Rafayelyan Edgar,0:3,11:13 - 4:11 - 2:11 - 0:0 - 0:0,0,3,Diaryan Aleksandr,Rafayelyan Edgar,fiurst,Diaryan Aleksandr - Rafayelyan Edgar,52,17,35,18,-18,24,15,13,0,0,2,7,9,0,0,18,11:13 - 4:11 - 2:11 - 0:0 - 0:0
18708219,2024-05-16 10:45:00,Nikoghosyan Narek - Asatryan Murad,3:1,11:5 - 3:11 - 4:11 - 7:11 - 0:0,1,3,Nikoghosyan Narek,Asatryan Murad,fiurst,Asatryan Murad - Nikoghosyan Narek,63,38,25,-13,13,16,14,15,18,0,6,-8,-7,-4,0,-13,5:11 - 11:3 - 11:4 - 11:7 - 0:0
18708216,2024-05-16 10:30:00,Papyan Karen - Diaryan Aleksandr,3:2,7:11 - 11:7 - 7:11 - 11:8 - 4:11,2,3,Papyan Karen,Diaryan Aleksandr,fiurst,Diaryan Aleksandr - Papyan Karen,88,48,40,-8,8,18,18,18,19,15,-4,4,-4,3,-7,-8,11:7 - 7:11 - 11:7 - 8:11 - 11:4
18708215,2024-05-16 10:15:00,Asatryan Murad - Rafayelyan Edgar,3:0,11:9 - 11:6 - 11:4 - 0:0 - 0:0,3,0,Asatryan Murad,Rafayelyan Edgar,fiurst,Asatryan Murad - Rafayelyan Edgar,52,33,19,-14,14,20,17,15,0,0,-2,-5,-7,0,0,-14,11:9 - 11:6 - 11:4 - 0:0 - 0:0
18708209,2024-05-16 10:00:00,Nikoghosyan Narek - Papyan Karen,0:3,4:11 - 4:11 - 12:14 - 0:0 - 0:0,0,3,Nikoghosyan Narek,Papyan Karen,fiurst,Nikoghosyan Narek - Papyan Karen,56,20,36,16,-16,15,15,26,0,0,7,7,2,0,0,16,4:11 - 4:11 - 12:14 - 0:0 - 0:0
18687627,2024-05-15 17:45:00,Hakobyan Eduard - Avakimyan Davit,3:2,5:11 - 5:11 - 11:8 - 11:8 - 9:11,2,3,Hakobyan Eduard,Avakimyan Davit,fiurst,Avakimyan Davit - Hakobyan Eduard,90,49,41,-8,8,16,16,19,19,20,-6,-6,3,3,-2,-8,11:5 - 11:5 - 8:11 - 8:11 - 11:9
18687624,2024-05-15 17:30:00,Petrosyan Davit - Gevorgyan Gegham,0:3,11:6 - 11:6 - 11:8 - 0:0 - 0:0,3,0,Petrosyan Davit,Gevorgyan Gegham,fiurst,Gevorgyan Gegham - Petrosyan Davit,53,20,33,13,-13,17,17,19,0,0,5,5,3,0,0,13,6:11 - 6:11 - 8:11 - 0:0 - 0:0
18687623,2024-05-15 17:15:00,Soghomonyan Hrayr - Hakobyan Eduard,1:3,11:7 - 7:11 - 11:4 - 11:6 - 0:0,3,1,Soghomonyan Hrayr,Hakobyan Eduard,fiurst,Hakobyan Eduard - Soghomonyan Hrayr,68,28,40,12,-12,18,18,15,17,0,4,-4,7,5,0,12,7:11 - 11:7 - 4:11 - 6:11 - 0:0
18687622,2024-05-15 17:00:00,Petrosyan Davit - Avakimyan Davit,2:3,8:11 - 6:11 - 11:6 - 11:9 - 11:7,3,2,Petrosyan Davit,Avakimyan Davit,fiurst,Avakimyan Davit - Petrosyan Davit,91,44,47,3,-3,19,17,17,20,18,-3,-5,5,2,4,3,11:8 - 11:6 - 6:11 - 9:11 - 7:11
18687615,2024-05-15 16:45:00,Gevorgyan Gegham - Soghomonyan Hrayr,0:3,7:11 - 7:11 - 6:11 - 0:0 - 0:0,0,3,Gevorgyan Gegham,Soghomonyan Hrayr,fiurst,Gevorgyan Gegham - Soghomonyan Hrayr,53,20,33,13,-13,18,18,17,0,0,4,4,5,0,0,13,7:11 - 7:11 - 6:11 - 0:0 - 0:0
18687606,2024-05-15 16:30:00,Hakobyan Eduard - Petrosyan Davit,1:3,11:8 - 5:11 - 5:11 - 9:11 - 0:0,1,3,Hakobyan Eduard,Petrosyan Davit,fiurst,Hakobyan Eduard - Petrosyan Davit,71,30,41,11,-11,19,16,16,20,0,-3,6,6,2,0,11,11:8 - 5:11 - 5:11 - 9:11 - 0:0
18687602,2024-05-15 16:15:00,Avakimyan Davit - Soghomonyan Hrayr,0:3,6:11 - 7:11 - 10:12 - 0:0 - 0:0,0,3,Avakimyan Davit,Soghomonyan Hrayr,fiurst,Avakimyan Davit - Soghomonyan Hrayr,57,23,34,11,-11,17,18,22,0,0,5,4,2,0,0,11,6:11 - 7:11 - 10:12 - 0:0 - 0:0
18687601,2024-05-15 16:00:00,Gevorgyan Gegham - Hakobyan Eduard,2:3,11:8 - 9:11 - 7:11 - 12:10 - 9:11,2,3,Gevorgyan Gegham,Hakobyan Eduard,fiurst,Gevorgyan Gegham - Hakobyan Eduard,99,48,51,3,-3,19,20,18,22,20,-3,2,4,-2,2,3,11:8 - 9:11 - 7:11 - 12:10 - 9:11
18687597,2024-05-15 15:45:00,Soghomonyan Hrayr - Petrosyan Davit,0:3,11:6 - 11:7 - 11:9 - 0:0 - 0:0,3,0,Soghomonyan Hrayr,Petrosyan Davit,fiurst,Petrosyan Davit - Soghomonyan Hrayr,55,22,33,11,-11,17,18,20,0,0,5,4,2,0,0,11,6:11 - 7:11 - 9:11 - 0:0 - 0:0
18687595,2024-05-15 15:30:00,Avakimyan Davit - Gevorgyan Gegham,0:3,5:11 - 5:11 - 5:11 - 0:0 - 0:0,0,3,Avakimyan Davit,Gevorgyan Gegham,fiurst,Avakimyan Davit - Gevorgyan Gegham,48,15,33,18,-18,16,16,16,0,0,6,6,6,0,0,18,5:11 - 5:11 - 5:11 - 0:0 - 0:0
18687593,2024-05-15 15:15:00,Nikoghosyan Narek - Papyan Karen,0:3,9:11 - 8:11 - 5:11 - 0:0 - 0:0,0,3,Nikoghosyan Narek,Papyan Karen,fiurst,Nikoghosyan Narek - Papyan Karen,55,22,33,11,-11,20,19,16,0,0,2,3,6,0,0,11,9:11 - 8:11 - 5:11 - 0:0 - 0:0
18687591,2024-05-15 15:00:00,Rafayelyan Edgar - Nazaryan Mushegh,0:3,11:5 - 11:4 - 11:5 - 0:0 - 0:0,3,0,Rafayelyan Edgar,Nazaryan Mushegh,fiurst,Nazaryan Mushegh - Rafayelyan Edgar,47,14,33,19,-19,16,15,16,0,0,6,7,6,0,0,19,5:11 - 4:11 - 5:11 - 0:0 - 0:0
18687580,2024-05-15 14:45:00,Asatryan Murad - Nikoghosyan Narek,3:0,11:6 - 11:7 - 11:2 - 0:0 - 0:0,3,0,Asatryan Murad,Nikoghosyan Narek,fiurst,Asatryan Murad - Nikoghosyan Narek,48,33,15,-18,18,17,18,13,0,0,-5,-4,-9,0,0,-18,11:6 - 11:7 - 11:2 - 0:0 - 0:0
18687578,2024-05-15 14:35:00,Papyan Karen - Rafayelyan Edgar,0:3,10:12 - 8:11 - 8:11 - 0:0 - 0:0,0,3,Papyan Karen,Rafayelyan Edgar,fiurst,Papyan Karen - Rafayelyan Edgar,60,26,34,8,-8,22,19,19,0,0,2,3,3,0,0,8,10:12 - 8:11 - 8:11 - 0:0 - 0:0
18687575,2024-05-15 14:15:00,Asatryan Murad - Nazaryan Mushegh,3:0,11:2 - 11:6 - 11:3 - 0:0 - 0:0,3,0,Asatryan Murad,Nazaryan Mushegh,fiurst,Asatryan Murad - Nazaryan Mushegh,44,33,11,-22,22,13,17,14,0,0,-9,-5,-8,0,0,-22,11:2 - 11:6 - 11:3 - 0:0 - 0:0
18687572,2024-05-15 14:00:00,Nikoghosyan Narek - Rafayelyan Edgar,2:3,12:10 - 8:11 - 5:11 - 11:7 - 5:11,2,3,Nikoghosyan Narek,Rafayelyan Edgar,fiurst,Nikoghosyan Narek - Rafayelyan Edgar,91,41,50,9,-9,22,19,16,18,16,-2,3,6,-4,6,9,12:10 - 8:11 - 5:11 - 11:7 - 5:11
18687570,2024-05-15 13:45:00,Papyan Karen - Asatryan Murad,3:0,10:12 - 3:11 - 7:11 - 0:0 - 0:0,0,3,Papyan Karen,Asatryan Murad,fiurst,Asatryan Murad - Papyan Karen,54,34,20,-14,14,22,14,18,0,0,-2,-8,-4,0,0,-14,12:10 - 11:3 - 11:7 - 0:0 - 0:0
18687569,2024-05-15 13:30:00,Nazaryan Mushegh - Nikoghosyan Narek,3:1,11:7 - 9:11 - 11:6 - 11:6 - 0:0,3,1,Nazaryan Mushegh,Nikoghosyan Narek,fiurst,Nazaryan Mushegh - Nikoghosyan Narek,72,42,30,-12,12,18,20,17,17,0,-4,2,-5,-5,0,-12,11:7 - 9:11 - 11:6 - 11:6 - 0:0
18687563,2024-05-15 13:15:00,Rafayelyan Edgar - Asatryan Murad,3:0,3:11 - 7:11 - 12:14 - 0:0 - 0:0,0,3,Rafayelyan Edgar,Asatryan Murad,fiurst,Asatryan Murad - Rafayelyan Edgar,58,36,22,-14,14,14,18,26,0,0,-8,-4,-2,0,0,-14,11:3 - 11:7 - 14:12 - 0:0 - 0:0
18687562,2024-05-15 13:00:00,Nazaryan Mushegh - Papyan Karen,3:0,12:10 - 11:7 - 11:8 - 0:0 - 0:0,3,0,Nazaryan Mushegh,Papyan Karen,fiurst,Nazaryan Mushegh - Papyan Karen,59,34,25,-9,9,22,18,19,0,0,-2,-4,-3,0,0,-9,12:10 - 11:7 - 11:8 - 0:0 - 0:0
18687550,2024-05-15 12:25:00,Nikoghosyan Narek - Asatryan Murad,3:0,5:11 - 4:11 - 3:11 - 0:0 - 0:0,0,3,Nikoghosyan Narek,Asatryan Murad,fiurst,Asatryan Murad - Nikoghosyan Narek,45,33,12,-21,21,16,15,14,0,0,-6,-7,-8,0,0,-21,11:5 - 11:4 - 11:3 - 0:0 - 0:0
18687548,2024-05-15 12:00:00,Nazaryan Mushegh - Rafayelyan Edgar,0:3,6:11 - 7:11 - 5:11 - 0:0 - 0:0,0,3,Nazaryan Mushegh,Rafayelyan Edgar,fiurst,Nazaryan Mushegh - Rafayelyan Edgar,51,18,33,15,-15,17,18,16,0,0,5,4,6,0,0,15,6:11 - 7:11 - 5:11 - 0:0 - 0:0
18687547,2024-05-15 11:45:00,Papyan Karen - Nikoghosyan Narek,3:2,8:11 - 11:8 - 11:9 - 9:11 - 8:11,2,3,Papyan Karen,Nikoghosyan Narek,fiurst,Nikoghosyan Narek - Papyan Karen,97,50,47,-3,3,19,19,20,20,19,-3,3,2,-2,-3,-3,11:8 - 8:11 - 9:11 - 11:9 - 11:8
18687545,2024-05-15 11:30:00,Nazaryan Mushegh - Asatryan Murad,3:0,3:11 - 9:11 - 5:11 - 0:0 - 0:0,0,3,Nazaryan Mushegh,Asatryan Murad,fiurst,Asatryan Murad - Nazaryan Mushegh,50,33,17,-16,16,14,20,16,0,0,-8,-2,-6,0,0,-16,11:3 - 11:9 - 11:5 - 0:0 - 0:0
18687539,2024-05-15 11:15:00,Rafayelyan Edgar - Papyan Karen,1:3,12:10 - 8:11 - 11:5 - 11:4 - 0:0,3,1,Rafayelyan Edgar,Papyan Karen,fiurst,Papyan Karen - Rafayelyan Edgar,72,30,42,12,-12,22,19,16,15,0,2,-3,6,7,0,12,10:12 - 11:8 - 5:11 - 4:11 - 0:0
18687535,2024-05-15 11:00:00,Nikoghosyan Narek - Nazaryan Mushegh,1:3,11:7 - 5:11 - 11:4 - 11:4 - 0:0,3,1,Nikoghosyan Narek,Nazaryan Mushegh,fiurst,Nazaryan Mushegh - Nikoghosyan Narek,64,26,38,12,-12,18,16,15,15,0,4,-6,7,7,0,12,7:11 - 11:5 - 4:11 - 4:11 - 0:0
18687518,2024-05-15 10:45:00,Asatryan Murad - Papyan Karen,3:0,11:6 - 11:6 - 11:4 - 0:0 - 0:0,3,0,Asatryan Murad,Papyan Karen,fiurst,Asatryan Murad - Papyan Karen,49,33,16,-17,17,17,17,15,0,0,-5,-5,-7,0,0,-17,11:6 - 11:6 - 11:4 - 0:0 - 0:0
18687516,2024-05-15 10:35:00,Rafayelyan Edgar - Nikoghosyan Narek,0:3,17:15 - 11:2 - 11:4 - 0:0 - 0:0,3,0,Rafayelyan Edgar,Nikoghosyan Narek,fiurst,Nikoghosyan Narek - Rafayelyan Edgar,60,21,39,18,-18,32,13,15,0,0,2,9,7,0,0,18,15:17 - 2:11 - 4:11 - 0:0 - 0:0
18687513,2024-05-15 10:15:00,Papyan Karen - Nazaryan Mushegh,2:3,5:11 - 11:8 - 5:11 - 11:7 - 11:9,3,2,Papyan Karen,Nazaryan Mushegh,fiurst,Nazaryan Mushegh - Papyan Karen,89,46,43,-3,3,16,19,16,18,20,-6,3,-6,4,2,-3,11:5 - 8:11 - 11:5 - 7:11 - 9:11
18687510,2024-05-15 10:00:00,Asatryan Murad - Rafayelyan Edgar,3:1,12:10 - 13:11 - 8:11 - 11:5 - 0:0,3,1,Asatryan Murad,Rafayelyan Edgar,fiurst,Asatryan Murad - Rafayelyan Edgar,81,44,37,-7,7,22,24,19,16,0,-2,-2,3,-6,0,-7,12:10 - 13:11 - 8:11 - 11:5 - 0:0
18664014,2024-05-14 17:45:00,Hakobyan Eduard - Gevorgyan Gegham,0:3,11:7 - 11:9 - 12:10 - 0:0 - 0:0,3,0,Hakobyan Eduard,Gevorgyan Gegham,fiurst,Gevorgyan Gegham - Hakobyan Eduard,60,26,34,8,-8,18,20,22,0,0,4,2,2,0,0,8,7:11 - 9:11 - 10:12 - 0:0 - 0:0
18664011,2024-05-14 17:40:00,Gevorgyan Hayk - Soghomonyan Hrayr,3:0,11:7 - 11:9 - 11:2 - 0:0 - 0:0,3,0,Gevorgyan Hayk,Soghomonyan Hrayr,fiurst,Gevorgyan Hayk - Soghomonyan Hrayr,51,33,18,-15,15,18,20,13,0,0,-4,-2,-9,0,0,-15,11:7 - 11:9 - 11:2 - 0:0 - 0:0
18663976,2024-05-14 17:00:00,Gevorgyan Hayk - Gevorgyan Gegham,3:1,11:9 - 7:11 - 6:11 - 6:11 - 0:0,1,3,Gevorgyan Hayk,Gevorgyan Gegham,fiurst,Gevorgyan Gegham - Gevorgyan Hayk,72,42,30,-12,12,20,18,17,17,0,2,-4,-5,-5,0,-12,9:11 - 11:7 - 11:6 - 11:6 - 0:0
18663958,2024-05-14 16:45:00,Soghomonyan Hrayr - Petrosyan Davit,0:0,0:0 - 0:0 - 0:0 - 0:0 - 0:0,0,0,Soghomonyan Hrayr,Petrosyan Davit,fiurst,Petrosyan Davit - Soghomonyan Hrayr,0,0,0,0,0,0,0,0,0,0,0,0,0,0,0,0,0:0 - 0:0 - 0:0 - 0:0 - 0:0
18663954,2024-05-14 16:30:00,Hakobyan Eduard - Gevorgyan Hayk,3:1,11:9 - 10:12 - 8:11 - 5:11 - 0:0,1,3,Hakobyan Eduard,Gevorgyan Hayk,fiurst,Gevorgyan Hayk - Hakobyan Eduard,77,43,34,-9,9,20,22,19,16,0,2,-2,-3,-6,0,-9,9:11 - 12:10 - 11:8 - 11:5 - 0:0
18663951,2024-05-14 16:15:00,Gevorgyan Gegham - Petrosyan Davit,3:1,11:5 - 11:7 - 9:11 - 11:5 - 0:0,3,1,Gevorgyan Gegham,Petrosyan Davit,fiurst,Gevorgyan Gegham - Petrosyan Davit,70,42,28,-14,14,16,18,20,16,0,-6,-4,2,-6,0,-14,11:5 - 11:7 - 9:11 - 11:5 - 0:0
18663939,2024-05-14 16:00:00,Soghomonyan Hrayr - Hakobyan Eduard,1:3,8:11 - 11:5 - 11:3 - 11:4 - 0:0,3,1,Soghomonyan Hrayr,Hakobyan Eduard,fiurst,Hakobyan Eduard - Soghomonyan Hrayr,64,23,41,18,-18,19,16,14,15,0,-3,6,8,7,0,18,11:8 - 5:11 - 3:11 - 4:11 - 0:0
18663937,2024-05-14 15:45:00,Petrosyan Davit - Gevorgyan Hayk,3:0,2:11 - 4:11 - 7:11 - 0:0 - 0:0,0,3,Petrosyan Davit,Gevorgyan Hayk,fiurst,Gevorgyan Hayk - Petrosyan Davit,46,33,13,-20,20,13,15,18,0,0,-9,-7,-4,0,0,-20,11:2 - 11:4 - 11:7 - 0:0 - 0:0
18663885,2024-05-14 15:30:00,Gevorgyan Gegham - Soghomonyan Hrayr,1:3,6:11 - 11:6 - 4:11 - 5:11 - 0:0,1,3,Gevorgyan Gegham,Soghomonyan Hrayr,fiurst,Gevorgyan Gegham - Soghomonyan Hrayr,65,26,39,13,-13,17,17,15,16,0,5,-5,7,6,0,13,6:11 - 11:6 - 4:11 - 5:11 - 0:0
18663882,2024-05-14 15:15:00,Nazaryan Mushegh - Rafayelyan Edgar,0:3,6:11 - 7:11 - 7:11 - 0:0 - 0:0,0,3,Nazaryan Mushegh,Rafayelyan Edgar,fiurst,Nazaryan Mushegh - Rafayelyan Edgar,53,20,33,13,-13,17,18,18,0,0,5,4,4,0,0,13,6:11 - 7:11 - 7:11 - 0:0 - 0:0
18663881,2024-05-14 15:00:00,Nikoghosyan Narek - Asatryan Murad,3:0,5:11 - 5:11 - 4:11 - 0:0 - 0:0,0,3,Nikoghosyan Narek,Asatryan Murad,fiurst,Asatryan Murad - Nikoghosyan Narek,47,33,14,-19,19,16,16,15,0,0,-6,-6,-7,0,0,-19,11:5 - 11:5 - 11:4 - 0:0 - 0:0
18663870,2024-05-14 14:50:00,Diaryan Aleksandr - Nazaryan Mushegh,3:0,11:4 - 11:5 - 11:5 - 0:0 - 0:0,3,0,Diaryan Aleksandr,Nazaryan Mushegh,fiurst,Diaryan Aleksandr - Nazaryan Mushegh,47,33,14,-19,19,15,16,16,0,0,-7,-6,-6,0,0,-19,11:4 - 11:5 - 11:5 - 0:0 - 0:0
18663869,2024-05-14 14:30:00,Rafayelyan Edgar - Nikoghosyan Narek,1:3,11:5 - 6:11 - 11:9 - 11:8 - 0:0,3,1,Rafayelyan Edgar,Nikoghosyan Narek,fiurst,Nikoghosyan Narek - Rafayelyan Edgar,72,33,39,6,-6,16,17,20,19,0,6,-5,2,3,0,6,5:11 - 11:6 - 9:11 - 8:11 - 0:0
18663866,2024-05-14 14:15:00,Diaryan Aleksandr - Asatryan Murad,3:1,8:11 - 11:7 - 7:11 - 11:13 - 0:0,1,3,Diaryan Aleksandr,Asatryan Murad,fiurst,Asatryan Murad - Diaryan Aleksandr,79,42,37,-5,5,19,18,18,24,0,-3,4,-4,-2,0,-5,11:8 - 7:11 - 11:7 - 13:11 - 0:0
18663863,2024-05-14 14:00:00,Nazaryan Mushegh - Nikoghosyan Narek,3:0,11:4 - 11:9 - 11:6 - 0:0 - 0:0,3,0,Nazaryan Mushegh,Nikoghosyan Narek,fiurst,Nazaryan Mushegh - Nikoghosyan Narek,52,33,19,-14,14,15,20,17,0,0,-7,-2,-5,0,0,-14,11:4 - 11:9 - 11:6 - 0:0 - 0:0
18663859,2024-05-14 13:45:00,Rafayelyan Edgar - Diaryan Aleksandr,2:3,11:8 - 7:11 - 11:4 - 10:12 - 11:9,3,2,Rafayelyan Edgar,Diaryan Aleksandr,fiurst,Diaryan Aleksandr - Rafayelyan Edgar,94,44,50,6,-6,19,18,15,22,20,3,-4,7,-2,2,6,8:11 - 11:7 - 4:11 - 12:10 - 9:11
18663858,2024-05-14 13:30:00,Asatryan Murad - Nazaryan Mushegh,3:0,11:4 - 11:4 - 11:6 - 0:0 - 0:0,3,0,Asatryan Murad,Nazaryan Mushegh,fiurst,Asatryan Murad - Nazaryan Mushegh,47,33,14,-19,19,15,15,17,0,0,-7,-7,-5,0,0,-19,11:4 - 11:4 - 11:6 - 0:0 - 0:0
18663857,2024-05-14 13:15:00,Nikoghosyan Narek - Diaryan Aleksandr,3:0,9:11 - 3:11 - 7:11 - 0:0 - 0:0,0,3,Nikoghosyan Narek,Diaryan Aleksandr,fiurst,Diaryan Aleksandr - Nikoghosyan Narek,52,33,19,-14,14,20,14,18,0,0,-2,-8,-4,0,0,-14,11:9 - 11:3 - 11:7 - 0:0 - 0:0
18663856,2024-05-14 13:00:00,Asatryan Murad - Rafayelyan Edgar,3:1,11:4 - 8:11 - 11:9 - 11:7 - 0:0,3,1,Asatryan Murad,Rafayelyan Edgar,fiurst,Asatryan Murad - Rafayelyan Edgar,72,41,31,-10,10,15,19,20,18,0,-7,3,-2,-4,0,-10,11:4 - 8:11 - 11:9 - 11:7 - 0:0
18663845,2024-05-14 12:15:00,Nazaryan Mushegh - Diaryan Aleksandr,3:1,11:9 - 3:11 - 4:11 - 8:11 - 0:0,1,3,Nazaryan Mushegh,Diaryan Aleksandr,fiurst,Diaryan Aleksandr - Nazaryan Mushegh,68,42,26,-16,16,20,14,15,19,0,2,-8,-7,-3,0,-16,9:11 - 11:3 - 11:4 - 11:8 - 0:0
18663844,2024-05-14 12:10:00,Asatryan Murad - Nikoghosyan Narek,3:0,11:5 - 11:7 - 11:4 - 0:0 - 0:0,3,0,Asatryan Murad,Nikoghosyan Narek,fiurst,Asatryan Murad - Nikoghosyan Narek,49,33,16,-17,17,16,18,15,0,0,-6,-4,-7,0,0,-17,11:5 - 11:7 - 11:4 - 0:0 - 0:0
18663842,2024-05-14 11:45:00,Rafayelyan Edgar - Nazaryan Mushegh,2:3,6:11 - 11:4 - 9:11 - 11:9 - 11:7,3,2,Rafayelyan Edgar,Nazaryan Mushegh,fiurst,Nazaryan Mushegh - Rafayelyan Edgar,90,42,48,6,-6,17,15,20,20,18,-5,7,-2,2,4,6,11:6 - 4:11 - 11:9 - 9:11 - 7:11
18663838,2024-05-14 11:30:00,Asatryan Murad - Diaryan Aleksandr,3:1,9:11 - 11:8 - 12:10 - 11:9 - 0:0,3,1,Asatryan Murad,Diaryan Aleksandr,fiurst,Asatryan Murad - Diaryan Aleksandr,81,43,38,-5,5,20,19,22,20,0,2,-3,-2,-2,0,-5,9:11 - 11:8 - 12:10 - 11:9 - 0:0
18663837,2024-05-14 11:20:00,Nikoghosyan Narek - Rafayelyan Edgar,0:3,5:11 - 5:11 - 4:11 - 0:0 - 0:0,0,3,Nikoghosyan Narek,Rafayelyan Edgar,fiurst,Nikoghosyan Narek - Rafayelyan Edgar,47,14,33,19,-19,16,16,15,0,0,6,6,7,0,0,19,5:11 - 5:11 - 4:11 - 0:0 - 0:0
18663833,2024-05-14 11:10:00,Nazaryan Mushegh - Asatryan Murad,3:2,11:9 - 3:11 - 11:9 - 6:11 - 7:11,2,3,Nazaryan Mushegh,Asatryan Murad,fiurst,Asatryan Murad - Nazaryan Mushegh,89,51,38,-13,13,20,14,20,17,18,2,-8,2,-5,-4,-13,9:11 - 11:3 - 9:11 - 11:6 - 11:7
18663822,2024-05-14 10:45:00,Diaryan Aleksandr - Rafayelyan Edgar,3:0,12:10 - 14:12 - 14:12 - 0:0 - 0:0,3,0,Diaryan Aleksandr,Rafayelyan Edgar,fiurst,Diaryan Aleksandr - Rafayelyan Edgar,74,40,34,-6,6,22,26,26,0,0,-2,-2,-2,0,0,-6,12:10 - 14:12 - 14:12 - 0:0 - 0:0
18663821,2024-05-14 10:35:00,Nikoghosyan Narek - Nazaryan Mushegh,2:3,11:9 - 7:11 - 11:6 - 3:11 - 13:11,3,2,Nikoghosyan Narek,Nazaryan Mushegh,fiurst,Nazaryan Mushegh - Nikoghosyan Narek,93,48,45,-3,3,20,18,17,14,24,2,-4,5,-8,2,-3,9:11 - 11:7 - 6:11 - 11:3 - 11:13
18663820,2024-05-14 10:15:00,Rafayelyan Edgar - Asatryan Murad,3:1,5:11 - 11:9 - 5:11 - 5:11 - 0:0,1,3,Rafayelyan Edgar,Asatryan Murad,fiurst,Asatryan Murad - Rafayelyan Edgar,68,42,26,-16,16,16,20,16,16,0,-6,2,-6,-6,0,-16,11:5 - 9:11 - 11:5 - 11:5 - 0:0
18663817,2024-05-14 10:00:00,Diaryan Aleksandr - Nikoghosyan Narek,3:1,11:4 - 11:7 - 15:17 - 11:9 - 0:0,3,1,Diaryan Aleksandr,Nikoghosyan Narek,fiurst,Diaryan Aleksandr - Nikoghosyan Narek,85,48,37,-11,11,15,18,32,20,0,-7,-4,2,-2,0,-11,11:4 - 11:7 - 15:17 - 11:9 - 0:0
18649864,2024-05-13 17:45:00,Hakobyan Eduard - Soghomonyan Hrayr,3:1,11:9 - 11:5 - 6:11 - 11:8 - 0:0,3,1,Hakobyan Eduard,Soghomonyan Hrayr,fiurst,Hakobyan Eduard - Soghomonyan Hrayr,72,39,33,-6,6,20,16,17,19,0,-2,-6,5,-3,0,-6,11:9 - 11:5 - 6:11 - 11:8 - 0:0
18649862,2024-05-13 17:30:00,Gevorgyan Hayk - Avakimyan Davit,3:0,3:11 - 6:11 - 6:11 - 0:0 - 0:0,0,3,Gevorgyan Hayk,Avakimyan Davit,fiurst,Avakimyan Davit - Gevorgyan Hayk,48,33,15,-18,18,14,17,17,0,0,-8,-5,-5,0,0,-18,11:3 - 11:6 - 11:6 - 0:0 - 0:0
18649861,2024-05-13 17:20:00,Gevorgyan Gegham - Hakobyan Eduard,3:1,12:10 - 11:9 - 6:11 - 11:7 - 0:0,3,1,Gevorgyan Gegham,Hakobyan Eduard,fiurst,Gevorgyan Gegham - Hakobyan Eduard,77,40,37,-3,3,22,20,17,18,0,-2,-2,5,-4,0,-3,12:10 - 11:9 - 6:11 - 11:7 - 0:0
18649836,2024-05-13 17:00:00,Gevorgyan Hayk - Soghomonyan Hrayr,1:3,6:11 - 11:5 - 3:11 - 5:11 - 0:0,1,3,Gevorgyan Hayk,Soghomonyan Hrayr,fiurst,Gevorgyan Hayk - Soghomonyan Hrayr,63,25,38,13,-13,17,16,14,16,0,5,-6,8,6,0,13,6:11 - 11:5 - 3:11 - 5:11 - 0:0
18649829,2024-05-13 16:50:00,Avakimyan Davit - Gevorgyan Gegham,3:2,11:13 - 11:6 - 9:11 - 11:5 - 12:10,3,2,Avakimyan Davit,Gevorgyan Gegham,fiurst,Avakimyan Davit - Gevorgyan Gegham,99,54,45,-9,9,24,17,20,16,22,2,-5,2,-6,-2,-9,11:13 - 11:6 - 9:11 - 11:5 - 12:10
18649828,2024-05-13 16:30:00,Hakobyan Eduard - Gevorgyan Hayk,0:3,11:9 - 11:6 - 11:5 - 0:0 - 0:0,3,0,Hakobyan Eduard,Gevorgyan Hayk,fiurst,Gevorgyan Hayk - Hakobyan Eduard,53,20,33,13,-13,20,17,16,0,0,2,5,6,0,0,13,9:11 - 6:11 - 5:11 - 0:0 - 0:0
18649826,2024-05-13 16:15:00,Soghomonyan Hrayr - Gevorgyan Gegham,3:2,5:11 - 6:11 - 11:6 - 11:6 - 6:11,2,3,Soghomonyan Hrayr,Gevorgyan Gegham,fiurst,Gevorgyan Gegham - Soghomonyan Hrayr,84,45,39,-6,6,16,17,17,17,17,-6,-5,5,5,-5,-6,11:5 - 11:6 - 6:11 - 6:11 - 11:6
18649822,2024-05-13 16:00:00,Avakimyan Davit - Hakobyan Eduard,1:3,8:11 - 5:11 - 14:12 - 14:16 - 0:0,1,3,Avakimyan Davit,Hakobyan Eduard,fiurst,Avakimyan Davit - Hakobyan Eduard,91,41,50,9,-9,19,16,26,30,0,3,6,-2,2,0,9,8:11 - 5:11 - 14:12 - 14:16 - 0:0
18649817,2024-05-13 15:45:00,Gevorgyan Gegham - Gevorgyan Hayk,0:3,4:11 - 6:11 - 8:11 - 0:0 - 0:0,0,3,Gevorgyan Gegham,Gevorgyan Hayk,fiurst,Gevorgyan Gegham - Gevorgyan Hayk,51,18,33,15,-15,15,17,19,0,0,7,5,3,0,0,15,4:11 - 6:11 - 8:11 - 0:0 - 0:0
18649813,2024-05-13 15:40:00,Soghomonyan Hrayr - Avakimyan Davit,1:3,11:4 - 9:11 - 11:3 - 11:7 - 0:0,3,1,Soghomonyan Hrayr,Avakimyan Davit,fiurst,Avakimyan Davit - Soghomonyan Hrayr,67,25,42,17,-17,15,20,14,18,0,7,-2,8,4,0,17,4:11 - 11:9 - 3:11 - 7:11 - 0:0
18649808,2024-05-13 15:15:00,Asatryan Murad - Papyan Karen,3:2,11:9 - 10:12 - 11:8 - 8:11 - 11:4,3,2,Asatryan Murad,Papyan Karen,fiurst,Asatryan Murad - Papyan Karen,95,51,44,-7,7,20,22,19,19,15,-2,2,-3,3,-7,-7,11:9 - 10:12 - 11:8 - 8:11 - 11:4
18649806,2024-05-13 15:00:00,Diaryan Aleksandr - Rafayelyan Edgar,2:3,11:9 - 11:9 - 4:11 - 3:11 - 9:11,2,3,Diaryan Aleksandr,Rafayelyan Edgar,fiurst,Diaryan Aleksandr - Rafayelyan Edgar,89,38,51,13,-13,20,20,15,14,20,-2,-2,7,8,2,13,11:9 - 11:9 - 4:11 - 3:11 - 9:11
18649805,2024-05-13 14:45:00,Nazaryan Mushegh - Asatryan Murad,3:1,8:11 - 12:10 - 8:11 - 6:11 - 0:0,1,3,Nazaryan Mushegh,Asatryan Murad,fiurst,Asatryan Murad - Nazaryan Mushegh,77,43,34,-9,9,19,22,19,17,0,-3,2,-3,-5,0,-9,11:8 - 10:12 - 11:8 - 11:6 - 0:0
18649801,2024-05-13 14:30:00,Papyan Karen - Diaryan Aleksandr,3:0,7:11 - 5:11 - 8:11 - 0:0 - 0:0,0,3,Papyan Karen,Diaryan Aleksandr,fiurst,Diaryan Aleksandr - Papyan Karen,53,33,20,-13,13,18,16,19,0,0,-4,-6,-3,0,0,-13,11:7 - 11:5 - 11:8 - 0:0 - 0:0
18649781,2024-05-13 14:20:00,Nazaryan Mushegh - Rafayelyan Edgar,0:3,5:11 - 6:11 - 7:11 - 0:0 - 0:0,0,3,Nazaryan Mushegh,Rafayelyan Edgar,fiurst,Nazaryan Mushegh - Rafayelyan Edgar,51,18,33,15,-15,16,17,18,0,0,6,5,4,0,0,15,5:11 - 6:11 - 7:11 - 0:0 - 0:0
18649778,2024-05-13 14:00:00,Asatryan Murad - Diaryan Aleksandr,3:0,17:15 - 11:7 - 11:3 - 0:0 - 0:0,3,0,Asatryan Murad,Diaryan Aleksandr,fiurst,Asatryan Murad - Diaryan Aleksandr,64,39,25,-14,14,32,18,14,0,0,-2,-4,-8,0,0,-14,17:15 - 11:7 - 11:3 - 0:0 - 0:0
18649757,2024-05-13 13:55:00,Papyan Karen - Nazaryan Mushegh,0:3,11:7 - 11:8 - 15:13 - 0:0 - 0:0,3,0,Papyan Karen,Nazaryan Mushegh,fiurst,Nazaryan Mushegh - Papyan Karen,65,28,37,9,-9,18,19,28,0,0,4,3,2,0,0,9,7:11 - 8:11 - 13:15 - 0:0 - 0:0
18649756,2024-05-13 13:30:00,Rafayelyan Edgar - Asatryan Murad,3:0,3:11 - 5:11 - 6:11 - 0:0 - 0:0,0,3,Rafayelyan Edgar,Asatryan Murad,fiurst,Asatryan Murad - Rafayelyan Edgar,47,33,14,-19,19,14,16,17,0,0,-8,-6,-5,0,0,-19,11:3 - 11:5 - 11:6 - 0:0 - 0:0
18649753,2024-05-13 13:15:00,Diaryan Aleksandr - Nazaryan Mushegh,3:2,11:13 - 11:4 - 11:8 - 10:12 - 11:2,3,2,Diaryan Aleksandr,Nazaryan Mushegh,fiurst,Diaryan Aleksandr - Nazaryan Mushegh,93,54,39,-15,15,24,15,19,22,13,2,-7,-3,2,-9,-15,11:13 - 11:4 - 11:8 - 10:12 - 11:2
18649749,2024-05-13 13:00:00,Rafayelyan Edgar - Papyan Karen,0:3,11:7 - 11:9 - 14:12 - 0:0 - 0:0,3,0,Rafayelyan Edgar,Papyan Karen,fiurst,Papyan Karen - Rafayelyan Edgar,64,28,36,8,-8,18,20,26,0,0,4,2,2,0,0,8,7:11 - 9:11 - 12:14 - 0:0 - 0:0
18649745,2024-05-13 12:20:00,Asatryan Murad - Nazaryan Mushegh,3:0,12:10 - 11:3 - 11:6 - 0:0 - 0:0,3,0,Asatryan Murad,Nazaryan Mushegh,fiurst,Asatryan Murad - Nazaryan Mushegh,53,34,19,-15,15,22,14,17,0,0,-2,-8,-5,0,0,-15,12:10 - 11:3 - 11:6 - 0:0 - 0:0
18649744,2024-05-13 12:00:00,Rafayelyan Edgar - Diaryan Aleksandr,3:0,7:11 - 8:11 - 4:11 - 0:0 - 0:0,0,3,Rafayelyan Edgar,Diaryan Aleksandr,fiurst,Diaryan Aleksandr - Rafayelyan Edgar,52,33,19,-14,14,18,19,15,0,0,-4,-3,-7,0,0,-14,11:7 - 11:8 - 11:4 - 0:0 - 0:0
18649741,2024-05-13 11:45:00,Papyan Karen - Asatryan Murad,2:3,11:9 - 11:8 - 8:11 - 4:11 - 11:9,3,2,Papyan Karen,Asatryan Murad,fiurst,Asatryan Murad - Papyan Karen,93,48,45,-3,3,20,19,19,15,20,2,3,-3,-7,2,-3,9:11 - 8:11 - 11:8 - 11:4 - 9:11
18649740,2024-05-13 11:30:00,Rafayelyan Edgar - Nazaryan Mushegh,0:3,11:7 - 11:6 - 11:6 - 0:0 - 0:0,3,0,Rafayelyan Edgar,Nazaryan Mushegh,fiurst,Nazaryan Mushegh - Rafayelyan Edgar,52,19,33,14,-14,18,17,17,0,0,4,5,5,0,0,14,7:11 - 6:11 - 6:11 - 0:0 - 0:0
18649736,2024-05-13 11:20:00,Diaryan Aleksandr - Papyan Karen,3:2,7:11 - 11:7 - 9:11 - 11:9 - 11:3,3,2,Diaryan Aleksandr,Papyan Karen,fiurst,Diaryan Aleksandr - Papyan Karen,90,49,41,-8,8,18,18,20,20,14,4,-4,2,-2,-8,-8,7:11 - 11:7 - 9:11 - 11:9 - 11:3
18649734,2024-05-13 11:00:00,Asatryan Murad - Rafayelyan Edgar,3:1,11:9 - 11:2 - 10:12 - 12:10 - 0:0,3,1,Asatryan Murad,Rafayelyan Edgar,fiurst,Asatryan Murad - Rafayelyan Edgar,77,44,33,-11,11,20,13,22,22,0,-2,-9,2,-2,0,-11,11:9 - 11:2 - 10:12 - 12:10 - 0:0
18649729,2024-05-13 10:45:00,Nazaryan Mushegh - Papyan Karen,2:3,5:11 - 12:10 - 11:8 - 8:11 - 10:12,2,3,Nazaryan Mushegh,Papyan Karen,fiurst,Nazaryan Mushegh - Papyan Karen,98,46,52,6,-6,16,22,19,19,22,6,-2,-3,3,2,6,5:11 - 12:10 - 11:8 - 8:11 - 10:12
18649724,2024-05-13 10:30:00,Diaryan Aleksandr - Asatryan Murad,3:2,11:4 - 11:6 - 8:11 - 8:11 - 8:11,2,3,Diaryan Aleksandr,Asatryan Murad,fiurst,Asatryan Murad - Diaryan Aleksandr,89,43,46,3,-3,15,17,19,19,19,7,5,-3,-3,-3,3,4:11 - 6:11 - 11:8 - 11:8 - 11:8
18649718,2024-05-13 10:15:00,Papyan Karen - Rafayelyan Edgar,1:3,6:11 - 5:11 - 11:9 - 8:11 - 0:0,1,3,Papyan Karen,Rafayelyan Edgar,fiurst,Papyan Karen - Rafayelyan Edgar,72,30,42,12,-12,17,16,20,19,0,5,6,-2,3,0,12,6:11 - 5:11 - 11:9 - 8:11 - 0:0
18649710,2024-05-13 10:00:00,Nazaryan Mushegh - Diaryan Aleksandr,3:0,5:11 - 6:11 - 3:11 - 0:0 - 0:0,0,3,Nazaryan Mushegh,Diaryan Aleksandr,fiurst,Diaryan Aleksandr - Nazaryan Mushegh,47,33,14,-19,19,16,17,14,0,0,-6,-5,-8,0,0,-19,11:5 - 11:6 - 11:3 - 0:0 - 0:0
18630100,2024-05-12 17:45:00,Hakobyan Eduard - Gevorgyan Hayk,3:0,9:11 - 11:13 - 7:11 - 0:0 - 0:0,0,3,Hakobyan Eduard,Gevorgyan Hayk,fiurst,Gevorgyan Hayk - Hakobyan Eduard,62,35,27,-8,8,20,24,18,0,0,-2,-2,-4,0,0,-8,11:9 - 13:11 - 11:7 - 0:0 - 0:0
18630091,2024-05-12 17:30:00,Petrosyan Davit - Gevorgyan Gegham,0:3,11:9 - 11:9 - 11:8 - 0:0 - 0:0,3,0,Petrosyan Davit,Gevorgyan Gegham,fiurst,Gevorgyan Gegham - Petrosyan Davit,59,26,33,7,-7,20,20,19,0,0,2,2,3,0,0,7,9:11 - 9:11 - 8:11 - 0:0 - 0:0
18630090,2024-05-12 17:15:00,Avakimyan Davit - Hakobyan Eduard,3:2,3:11 - 16:14 - 12:10 - 9:11 - 11:9,3,2,Avakimyan Davit,Hakobyan Eduard,fiurst,Avakimyan Davit - Hakobyan Eduard,106,51,55,4,-4,14,30,22,20,20,8,-2,-2,2,-2,4,3:11 - 16:14 - 12:10 - 9:11 - 11:9
18630088,2024-05-12 17:00:00,Petrosyan Davit - Gevorgyan Hayk,3:1,8:11 - 9:11 - 11:7 - 4:11 - 0:0,1,3,Petrosyan Davit,Gevorgyan Hayk,fiurst,Gevorgyan Hayk - Petrosyan Davit,72,40,32,-8,8,19,20,18,15,0,-3,-2,4,-7,0,-8,11:8 - 11:9 - 7:11 - 11:4 - 0:0
18630078,2024-05-12 16:45:00,Gevorgyan Gegham - Avakimyan Davit,3:2,11:5 - 13:11 - 9:11 - 9:11 - 10:12,2,3,Gevorgyan Gegham,Avakimyan Davit,fiurst,Avakimyan Davit - Gevorgyan Gegham,102,50,52,2,-2,16,24,20,20,22,6,2,-2,-2,-2,2,5:11 - 11:13 - 11:9 - 11:9 - 12:10
18630076,2024-05-12 16:30:00,Hakobyan Eduard - Petrosyan Davit,0:3,9:11 - 5:11 - 4:11 - 0:0 - 0:0,0,3,Hakobyan Eduard,Petrosyan Davit,fiurst,Hakobyan Eduard - Petrosyan Davit,51,18,33,15,-15,20,16,15,0,0,2,6,7,0,0,15,9:11 - 5:11 - 4:11 - 0:0 - 0:0
18630070,2024-05-12 16:15:00,Gevorgyan Hayk - Avakimyan Davit,3:2,10:12 - 12:10 - 11:8 - 5:11 - 7:11,2,3,Gevorgyan Hayk,Avakimyan Davit,fiurst,Avakimyan Davit - Gevorgyan Hayk,97,52,45,-7,7,22,22,19,16,18,-2,2,3,-6,-4,-7,12:10 - 10:12 - 8:11 - 11:5 - 11:7
18630053,2024-05-12 16:00:00,Gevorgyan Gegham - Hakobyan Eduard,3:2,11:5 - 3:11 - 11:8 - 6:11 - 11:5,3,2,Gevorgyan Gegham,Hakobyan Eduard,fiurst,Gevorgyan Gegham - Hakobyan Eduard,82,42,40,-2,2,16,14,19,17,16,-6,8,-3,5,-6,-2,11:5 - 3:11 - 11:8 - 6:11 - 11:5
18630051,2024-05-12 15:45:00,Avakimyan Davit - Petrosyan Davit,0:3,9:11 - 8:11 - 6:11 - 0:0 - 0:0,0,3,Avakimyan Davit,Petrosyan Davit,fiurst,Avakimyan Davit - Petrosyan Davit,56,23,33,10,-10,20,19,17,0,0,2,3,5,0,0,10,9:11 - 8:11 - 6:11 - 0:0 - 0:0
18630050,2024-05-12 15:30:00,Gevorgyan Hayk - Gevorgyan Gegham,0:3,11:8 - 12:10 - 11:3 - 0:0 - 0:0,3,0,Gevorgyan Hayk,Gevorgyan Gegham,fiurst,Gevorgyan Gegham - Gevorgyan Hayk,55,21,34,13,-13,19,22,14,0,0,3,2,8,0,0,13,8:11 - 10:12 - 3:11 - 0:0 - 0:0
18630048,2024-05-12 15:15:00,Nazaryan Mushegh - Diaryan Aleksandr,3:1,10:12 - 11:9 - 11:13 - 5:11 - 0:0,1,3,Nazaryan Mushegh,Diaryan Aleksandr,fiurst,Diaryan Aleksandr - Nazaryan Mushegh,82,45,37,-8,8,22,20,24,16,0,-2,2,-2,-6,0,-8,12:10 - 9:11 - 13:11 - 11:5 - 0:0
18630043,2024-05-12 15:00:00,Papyan Karen - Hovhannesyan Rafik,3:2,11:8 - 9:11 - 11:2 - 7:11 - 9:11,2,3,Papyan Karen,Hovhannesyan Rafik,fiurst,Hovhannesyan Rafik - Papyan Karen,90,43,47,4,-4,19,20,13,18,20,3,-2,9,-4,-2,4,8:11 - 11:9 - 2:11 - 11:7 - 11:9
18630042,2024-05-12 14:45:00,Rafayelyan Edgar - Nazaryan Mushegh,1:3,4:11 - 11:6 - 11:4 - 11:8 - 0:0,3,1,Rafayelyan Edgar,Nazaryan Mushegh,fiurst,Nazaryan Mushegh - Rafayelyan Edgar,66,29,37,8,-8,15,17,15,19,0,-7,5,7,3,0,8,11:4 - 6:11 - 4:11 - 8:11 - 0:0
18630039,2024-05-12 14:35:00,Diaryan Aleksandr - Papyan Karen,3:1,11:6 - 8:11 - 14:12 - 11:8 - 0:0,3,1,Diaryan Aleksandr,Papyan Karen,fiurst,Diaryan Aleksandr - Papyan Karen,81,44,37,-7,7,17,19,26,19,0,-5,3,-2,-3,0,-7,11:6 - 8:11 - 14:12 - 11:8 - 0:0
18630038,2024-05-12 14:15:00,Rafayelyan Edgar - Hovhannesyan Rafik,0:3,11:4 - 11:8 - 11:8 - 0:0 - 0:0,3,0,Rafayelyan Edgar,Hovhannesyan Rafik,fiurst,Hovhannesyan Rafik - Rafayelyan Edgar,53,20,33,13,-13,15,19,19,0,0,7,3,3,0,0,13,4:11 - 8:11 - 8:11 - 0:0 - 0:0
18630025,2024-05-12 14:05:00,Nazaryan Mushegh - Papyan Karen,3:1,11:3 - 11:8 - 10:12 - 14:12 - 0:0,3,1,Nazaryan Mushegh,Papyan Karen,fiurst,Nazaryan Mushegh - Papyan Karen,81,46,35,-11,11,14,19,22,26,0,-8,-3,2,-2,0,-11,11:3 - 11:8 - 10:12 - 14:12 - 0:0
18630023,2024-05-12 13:45:00,Diaryan Aleksandr - Rafayelyan Edgar,1:3,11:9 - 2:11 - 4:11 - 10:12 - 0:0,1,3,Diaryan Aleksandr,Rafayelyan Edgar,fiurst,Diaryan Aleksandr - Rafayelyan Edgar,70,27,43,16,-16,20,13,15,22,0,-2,9,7,2,0,16,11:9 - 2:11 - 4:11 - 10:12 - 0:0
18629460,2024-05-12 13:35:00,Hovhannesyan Rafik - Nazaryan Mushegh,3:1,12:10 - 11:7 - 5:11 - 11:6 - 0:0,3,1,Hovhannesyan Rafik,Nazaryan Mushegh,fiurst,Hovhannesyan Rafik - Nazaryan Mushegh,73,39,34,-5,5,22,18,16,17,0,-2,-4,6,-5,0,-5,12:10 - 11:7 - 5:11 - 11:6 - 0:0
18629456,2024-05-12 13:15:00,Papyan Karen - Rafayelyan Edgar,0:3,3:11 - 6:11 - 9:11 - 0:0 - 0:0,0,3,Papyan Karen,Rafayelyan Edgar,fiurst,Papyan Karen - Rafayelyan Edgar,51,18,33,15,-15,14,17,20,0,0,8,5,2,0,0,15,3:11 - 6:11 - 9:11 - 0:0 - 0:0
18629454,2024-05-12 13:00:00,Hovhannesyan Rafik - Diaryan Aleksandr,3:2,11:7 - 12:10 - 3:11 - 4:11 - 6:11,2,3,Hovhannesyan Rafik,Diaryan Aleksandr,fiurst,Diaryan Aleksandr - Hovhannesyan Rafik,86,50,36,-14,14,18,22,14,15,17,4,2,-8,-7,-5,-14,7:11 - 10:12 - 11:3 - 11:4 - 11:6
18629439,2024-05-12 12:15:00,Nazaryan Mushegh - Rafayelyan Edgar,1:3,5:11 - 4:11 - 11:8 - 6:11 - 0:0,1,3,Nazaryan Mushegh,Rafayelyan Edgar,fiurst,Nazaryan Mushegh - Rafayelyan Edgar,67,26,41,15,-15,16,15,19,17,0,6,7,-3,5,0,15,5:11 - 4:11 - 11:8 - 6:11 - 0:0
18629437,2024-05-12 12:00:00,Hovhannesyan Rafik - Papyan Karen,3:2,11:6 - 12:14 - 11:8 - 8:11 - 12:10,3,2,Hovhannesyan Rafik,Papyan Karen,fiurst,Hovhannesyan Rafik - Papyan Karen,103,54,49,-5,5,17,26,19,19,22,-5,2,-3,3,-2,-5,11:6 - 12:14 - 11:8 - 8:11 - 12:10
18629435,2024-05-12 11:45:00,Diaryan Aleksandr - Nazaryan Mushegh,3:0,11:6 - 11:6 - 11:6 - 0:0 - 0:0,3,0,Diaryan Aleksandr,Nazaryan Mushegh,fiurst,Diaryan Aleksandr - Nazaryan Mushegh,51,33,18,-15,15,17,17,17,0,0,-5,-5,-5,0,0,-15,11:6 - 11:6 - 11:6 - 0:0 - 0:0
18629432,2024-05-12 11:30:00,Hovhannesyan Rafik - Rafayelyan Edgar,0:3,4:11 - 8:11 - 9:11 - 0:0 - 0:0,0,3,Hovhannesyan Rafik,Rafayelyan Edgar,fiurst,Hovhannesyan Rafik - Rafayelyan Edgar,54,21,33,12,-12,15,19,20,0,0,7,3,2,0,0,12,4:11 - 8:11 - 9:11 - 0:0 - 0:0
18629430,2024-05-12 11:15:00,Papyan Karen - Diaryan Aleksandr,3:2,11:9 - 9:11 - 5:11 - 11:3 - 5:11,2,3,Papyan Karen,Diaryan Aleksandr,fiurst,Diaryan Aleksandr - Papyan Karen,86,45,41,-4,4,20,20,16,14,16,2,-2,-6,8,-6,-4,9:11 - 11:9 - 11:5 - 3:11 - 11:5
18629424,2024-05-12 11:00:00,Nazaryan Mushegh - Hovhannesyan Rafik,0:3,11:8 - 11:7 - 11:8 - 0:0 - 0:0,3,0,Nazaryan Mushegh,Hovhannesyan Rafik,fiurst,Hovhannesyan Rafik - Nazaryan Mushegh,56,23,33,10,-10,19,18,19,0,0,3,4,3,0,0,10,8:11 - 7:11 - 8:11 - 0:0 - 0:0
18629410,2024-05-12 10:45:00,Rafayelyan Edgar - Diaryan Aleksandr,3:1,6:11 - 11:8 - 9:11 - 2:11 - 0:0,1,3,Rafayelyan Edgar,Diaryan Aleksandr,fiurst,Diaryan Aleksandr - Rafayelyan Edgar,69,41,28,-13,13,17,19,20,13,0,-5,3,-2,-9,0,-13,11:6 - 8:11 - 11:9 - 11:2 - 0:0
18629405,2024-05-12 10:30:00,Papyan Karen - Nazaryan Mushegh,0:3,12:10 - 11:7 - 11:8 - 0:0 - 0:0,3,0,Papyan Karen,Nazaryan Mushegh,fiurst,Nazaryan Mushegh - Papyan Karen,59,25,34,9,-9,22,18,19,0,0,2,4,3,0,0,9,10:12 - 7:11 - 8:11 - 0:0 - 0:0
18629400,2024-05-12 10:15:00,Diaryan Aleksandr - Hovhannesyan Rafik,3:0,11:2 - 11:7 - 11:7 - 0:0 - 0:0,3,0,Diaryan Aleksandr,Hovhannesyan Rafik,fiurst,Diaryan Aleksandr - Hovhannesyan Rafik,49,33,16,-17,17,13,18,18,0,0,-9,-4,-4,0,0,-17,11:2 - 11:7 - 11:7 - 0:0 - 0:0
18629398,2024-05-12 10:00:00,Rafayelyan Edgar - Papyan Karen,0:3,11:3 - 11:9 - 11:5 - 0:0 - 0:0,3,0,Rafayelyan Edgar,Papyan Karen,fiurst,Papyan Karen - Rafayelyan Edgar,50,17,33,16,-16,14,20,16,0,0,8,2,6,0,0,16,3:11 - 9:11 - 5:11 - 0:0 - 0:0
18610996,2024-05-11 17:45:00,Hakobyan Eduard - Avakimyan Davit,3:2,11:6 - 10:12 - 11:9 - 7:11 - 6:11,2,3,Hakobyan Eduard,Avakimyan Davit,fiurst,Avakimyan Davit - Hakobyan Eduard,94,49,45,-4,4,17,22,20,18,17,5,-2,2,-4,-5,-4,6:11 - 12:10 - 9:11 - 11:7 - 11:6
18610995,2024-05-11 17:40:00,Petrosyan Davit - Gevorgyan Hayk,1:3,11:4 - 9:11 - 11:5 - 11:8 - 0:0,3,1,Petrosyan Davit,Gevorgyan Hayk,fiurst,Gevorgyan Hayk - Petrosyan Davit,70,28,42,14,-14,15,20,16,19,0,7,-2,6,3,0,14,4:11 - 11:9 - 5:11 - 8:11 - 0:0
18610982,2024-05-11 17:15:00,Soghomonyan Hrayr - Hakobyan Eduard,0:3,11:6 - 11:3 - 11:6 - 0:0 - 0:0,3,0,Soghomonyan Hrayr,Hakobyan Eduard,fiurst,Hakobyan Eduard - Soghomonyan Hrayr,48,15,33,18,-18,17,14,17,0,0,5,8,5,0,0,18,6:11 - 3:11 - 6:11 - 0:0 - 0:0
18610980,2024-05-11 17:05:00,Petrosyan Davit - Avakimyan Davit,3:1,6:11 - 11:13 - 11:9 - 3:11 - 0:0,1,3,Petrosyan Davit,Avakimyan Davit,fiurst,Avakimyan Davit - Petrosyan Davit,75,44,31,-13,13,17,24,20,14,0,-5,-2,2,-8,0,-13,11:6 - 13:11 - 9:11 - 11:3 - 0:0
18610976,2024-05-11 16:50:00,Gevorgyan Hayk - Soghomonyan Hrayr,3:2,7:11 - 10:12 - 11:7 - 11:7 - 11:4,3,2,Gevorgyan Hayk,Soghomonyan Hrayr,fiurst,Gevorgyan Hayk - Soghomonyan Hrayr,91,50,41,-9,9,18,22,18,18,15,4,2,-4,-4,-7,-9,7:11 - 10:12 - 11:7 - 11:7 - 11:4
18610974,2024-05-11 16:35:00,Hakobyan Eduard - Petrosyan Davit,1:3,2:11 - 9:11 - 11:8 - 7:11 - 0:0,1,3,Hakobyan Eduard,Petrosyan Davit,fiurst,Hakobyan Eduard - Petrosyan Davit,70,29,41,12,-12,13,20,19,18,0,9,2,-3,4,0,12,2:11 - 9:11 - 11:8 - 7:11 - 0:0
18610951,2024-05-11 16:30:00,Avakimyan Davit - Soghomonyan Hrayr,0:3,6:11 - 8:11 - 9:11 - 0:0 - 0:0,0,3,Avakimyan Davit,Soghomonyan Hrayr,fiurst,Avakimyan Davit - Soghomonyan Hrayr,56,23,33,10,-10,17,19,20,0,0,5,3,2,0,0,10,6:11 - 8:11 - 9:11 - 0:0 - 0:0
18610950,2024-05-11 16:00:00,Gevorgyan Hayk - Hakobyan Eduard,3:2,11:8 - 8:11 - 11:8 - 8:11 - 11:9,3,2,Gevorgyan Hayk,Hakobyan Eduard,fiurst,Gevorgyan Hayk - Hakobyan Eduard,96,49,47,-2,2,19,19,19,19,20,-3,3,-3,3,-2,-2,11:8 - 8:11 - 11:8 - 8:11 - 11:9
18610948,2024-05-11 15:45:00,Soghomonyan Hrayr - Petrosyan Davit,3:2,11:8 - 7:11 - 13:11 - 10:12 - 7:11,2,3,Soghomonyan Hrayr,Petrosyan Davit,fiurst,Petrosyan Davit - Soghomonyan Hrayr,101,53,48,-5,5,19,18,24,22,18,3,-4,2,-2,-4,-5,8:11 - 11:7 - 11:13 - 12:10 - 11:7
18610939,2024-05-11 15:30:00,Avakimyan Davit - Gevorgyan Hayk,3:0,11:8 - 11:8 - 12:10 - 0:0 - 0:0,3,0,Avakimyan Davit,Gevorgyan Hayk,fiurst,Avakimyan Davit - Gevorgyan Hayk,60,34,26,-8,8,19,19,22,0,0,-3,-3,-2,0,0,-8,11:8 - 11:8 - 12:10 - 0:0 - 0:0
18610557,2024-05-11 15:15:00,Papyan Karen - Nazaryan Mushegh,1:3,8:11 - 12:10 - 14:12 - 11:5 - 0:0,3,1,Papyan Karen,Nazaryan Mushegh,fiurst,Nazaryan Mushegh - Papyan Karen,83,38,45,7,-7,19,22,26,16,0,-3,2,2,6,0,7,11:8 - 10:12 - 12:14 - 5:11 - 0:0
18610548,2024-05-11 15:00:00,Rafayelyan Edgar - Asatryan Murad,2:3,7:11 - 11:6 - 11:7 - 9:11 - 11:6,3,2,Rafayelyan Edgar,Asatryan Murad,fiurst,Asatryan Murad - Rafayelyan Edgar,90,41,49,8,-8,18,17,18,20,17,-4,5,4,-2,5,8,11:7 - 6:11 - 7:11 - 11:9 - 6:11
18610543,2024-05-11 14:50:00,Hovhannesyan Rafik - Papyan Karen,2:3,11:9 - 7:11 - 11:7 - 13:15 - 7:11,2,3,Hovhannesyan Rafik,Papyan Karen,fiurst,Hovhannesyan Rafik - Papyan Karen,102,49,53,4,-4,20,18,18,28,18,-2,4,-4,2,4,4,11:9 - 7:11 - 11:7 - 13:15 - 7:11
18610541,2024-05-11 14:30:00,Nazaryan Mushegh - Rafayelyan Edgar,0:3,7:11 - 6:11 - 5:11 - 0:0 - 0:0,0,3,Nazaryan Mushegh,Rafayelyan Edgar,fiurst,Nazaryan Mushegh - Rafayelyan Edgar,51,18,33,15,-15,18,17,16,0,0,4,5,6,0,0,15,7:11 - 6:11 - 5:11 - 0:0 - 0:0
18610540,2024-05-11 14:15:00,Hovhannesyan Rafik - Asatryan Murad,3:0,2:11 - 2:11 - 10:12 - 0:0 - 0:0,0,3,Hovhannesyan Rafik,Asatryan Murad,fiurst,Asatryan Murad - Hovhannesyan Rafik,48,34,14,-20,20,13,13,22,0,0,-9,-9,-2,0,0,-20,11:2 - 11:2 - 12:10 - 0:0 - 0:0
18610535,2024-05-11 14:00:00,Papyan Karen - Rafayelyan Edgar,3:0,11:9 - 11:5 - 11:9 - 0:0 - 0:0,3,0,Papyan Karen,Rafayelyan Edgar,fiurst,Papyan Karen - Rafayelyan Edgar,56,33,23,-10,10,20,16,20,0,0,-2,-6,-2,0,0,-10,11:9 - 11:5 - 11:9 - 0:0 - 0:0
18610533,2024-05-11 13:45:00,Nazaryan Mushegh - Hovhannesyan Rafik,0:3,11:4 - 11:7 - 11:5 - 0:0 - 0:0,3,0,Nazaryan Mushegh,Hovhannesyan Rafik,fiurst,Hovhannesyan Rafik - Nazaryan Mushegh,49,16,33,17,-17,15,18,16,0,0,7,4,6,0,0,17,4:11 - 7:11 - 5:11 - 0:0 - 0:0
18610528,2024-05-11 13:30:00,Asatryan Murad - Papyan Karen,1:3,8:11 - 11:9 - 7:11 - 7:11 - 0:0,1,3,Asatryan Murad,Papyan Karen,fiurst,Asatryan Murad - Papyan Karen,75,33,42,9,-9,19,20,18,18,0,3,-2,4,4,0,9,8:11 - 11:9 - 7:11 - 7:11 - 0:0
18610527,2024-05-11 13:15:00,Rafayelyan Edgar - Hovhannesyan Rafik,0:3,12:10 - 11:3 - 11:7 - 0:0 - 0:0,3,0,Rafayelyan Edgar,Hovhannesyan Rafik,fiurst,Hovhannesyan Rafik - Rafayelyan Edgar,54,20,34,14,-14,22,14,18,0,0,2,8,4,0,0,14,10:12 - 3:11 - 7:11 - 0:0 - 0:0
18610515,2024-05-11 13:00:00,Asatryan Murad - Nazaryan Mushegh,1:3,9:11 - 8:11 - 11:9 - 10:12 - 0:0,1,3,Asatryan Murad,Nazaryan Mushegh,fiurst,Asatryan Murad - Nazaryan Mushegh,81,38,43,5,-5,20,19,20,22,0,2,3,-2,2,0,5,9:11 - 8:11 - 11:9 - 10:12 - 0:0
18610512,2024-05-11 12:15:00,Papyan Karen - Hovhannesyan Rafik,0:3,11:9 - 11:7 - 11:9 - 0:0 - 0:0,3,0,Papyan Karen,Hovhannesyan Rafik,fiurst,Hovhannesyan Rafik - Papyan Karen,58,25,33,8,-8,20,18,20,0,0,2,4,2,0,0,8,9:11 - 7:11 - 9:11 - 0:0 - 0:0
18610510,2024-05-11 12:00:00,Asatryan Murad - Rafayelyan Edgar,0:3,11:13 - 9:11 - 9:11 - 0:0 - 0:0,0,3,Asatryan Murad,Rafayelyan Edgar,fiurst,Asatryan Murad - Rafayelyan Edgar,64,29,35,6,-6,24,20,20,0,0,2,2,2,0,0,6,11:13 - 9:11 - 9:11 - 0:0 - 0:0
18610479,2024-05-11 11:45:00,Nazaryan Mushegh - Papyan Karen,0:3,6:11 - 11:13 - 10:12 - 0:0 - 0:0,0,3,Nazaryan Mushegh,Papyan Karen,fiurst,Nazaryan Mushegh - Papyan Karen,63,27,36,9,-9,17,24,22,0,0,5,2,2,0,0,9,6:11 - 11:13 - 10:12 - 0:0 - 0:0
18610474,2024-05-11 11:30:00,Asatryan Murad - Hovhannesyan Rafik,3:1,11:9 - 11:6 - 7:11 - 11:4 - 0:0,3,1,Asatryan Murad,Hovhannesyan Rafik,fiurst,Asatryan Murad - Hovhannesyan Rafik,70,40,30,-10,10,20,17,18,15,0,-2,-5,4,-7,0,-10,11:9 - 11:6 - 7:11 - 11:4 - 0:0
18610472,2024-05-11 11:15:00,Rafayelyan Edgar - Nazaryan Mushegh,1:3,11:8 - 9:11 - 11:7 - 11:5 - 0:0,3,1,Rafayelyan Edgar,Nazaryan Mushegh,fiurst,Nazaryan Mushegh - Rafayelyan Edgar,73,31,42,11,-11,19,20,18,16,0,3,-2,4,6,0,11,8:11 - 11:9 - 7:11 - 5:11 - 0:0
18610469,2024-05-11 11:00:00,Papyan Karen - Asatryan Murad,3:2,11:9 - 6:11 - 10:12 - 11:8 - 8:11,2,3,Papyan Karen,Asatryan Murad,fiurst,Asatryan Murad - Papyan Karen,97,51,46,-5,5,20,17,22,19,19,2,-5,-2,3,-3,-5,9:11 - 11:6 - 12:10 - 8:11 - 11:8
18610467,2024-05-11 10:45:00,Hovhannesyan Rafik - Nazaryan Mushegh,3:0,11:6 - 11:9 - 11:8 - 0:0 - 0:0,3,0,Hovhannesyan Rafik,Nazaryan Mushegh,fiurst,Hovhannesyan Rafik - Nazaryan Mushegh,56,33,23,-10,10,17,20,19,0,0,-5,-2,-3,0,0,-10,11:6 - 11:9 - 11:8 - 0:0 - 0:0
18610466,2024-05-11 10:30:00,Rafayelyan Edgar - Papyan Karen,0:3,11:8 - 11:2 - 11:7 - 0:0 - 0:0,3,0,Rafayelyan Edgar,Papyan Karen,fiurst,Papyan Karen - Rafayelyan Edgar,50,17,33,16,-16,19,13,18,0,0,3,9,4,0,0,16,8:11 - 2:11 - 7:11 - 0:0 - 0:0
18610457,2024-05-11 10:15:00,Nazaryan Mushegh - Asatryan Murad,3:1,12:10 - 7:11 - 8:11 - 5:11 - 0:0,1,3,Nazaryan Mushegh,Asatryan Murad,fiurst,Asatryan Murad - Nazaryan Mushegh,75,43,32,-11,11,22,18,19,16,0,2,-4,-3,-6,0,-11,10:12 - 11:7 - 11:8 - 11:5 - 0:0
18610456,2024-05-11 10:00:00,Hovhannesyan Rafik - Rafayelyan Edgar,1:3,9:11 - 11:4 - 4:11 - 2:11 - 0:0,1,3,Hovhannesyan Rafik,Rafayelyan Edgar,fiurst,Hovhannesyan Rafik - Rafayelyan Edgar,63,26,37,11,-11,20,15,15,13,0,2,-7,7,9,0,11,9:11 - 11:4 - 4:11 - 2:11 - 0:0
18587650,2024-05-10 17:45:00,Hakobyan Eduard - Petrosyan Davit,1:3,10:12 - 2:11 - 11:9 - 8:11 - 0:0,1,3,Hakobyan Eduard,Petrosyan Davit,fiurst,Hakobyan Eduard - Petrosyan Davit,74,31,43,12,-12,22,13,20,19,0,2,9,-2,3,0,12,10:12 - 2:11 - 11:9 - 8:11 - 0:0
18587646,2024-05-10 17:30:00,Avakimyan Davit - Soghomonyan Hrayr,2:3,7:11 - 12:10 - 11:3 - 11:13 - 5:11,2,3,Avakimyan Davit,Soghomonyan Hrayr,fiurst,Avakimyan Davit - Soghomonyan Hrayr,94,46,48,2,-2,18,22,14,24,16,4,-2,-8,2,6,2,7:11 - 12:10 - 11:3 - 11:13 - 5:11
18587644,2024-05-10 17:15:00,Gevorgyan Gegham - Hakobyan Eduard,2:3,11:5 - 11:6 - 5:11 - 9:11 - 7:11,2,3,Gevorgyan Gegham,Hakobyan Eduard,fiurst,Gevorgyan Gegham - Hakobyan Eduard,87,43,44,1,-1,16,17,16,20,18,-6,-5,6,2,4,1,11:5 - 11:6 - 5:11 - 9:11 - 7:11
18587643,2024-05-10 17:00:00,Avakimyan Davit - Petrosyan Davit,3:0,11:2 - 11:5 - 11:1 - 0:0 - 0:0,3,0,Avakimyan Davit,Petrosyan Davit,fiurst,Avakimyan Davit - Petrosyan Davit,41,33,8,-25,25,13,16,12,0,0,-9,-6,-10,0,0,-25,11:2 - 11:5 - 11:1 - 0:0 - 0:0
18587634,2024-05-10 16:45:00,Soghomonyan Hrayr - Gevorgyan Gegham,0:3,11:9 - 11:8 - 11:6 - 0:0 - 0:0,3,0,Soghomonyan Hrayr,Gevorgyan Gegham,fiurst,Gevorgyan Gegham - Soghomonyan Hrayr,56,23,33,10,-10,20,19,17,0,0,2,3,5,0,0,10,9:11 - 8:11 - 6:11 - 0:0 - 0:0
18587632,2024-05-10 16:30:00,Hakobyan Eduard - Avakimyan Davit,2:3,11:5 - 9:11 - 13:11 - 15:17 - 11:8,3,2,Hakobyan Eduard,Avakimyan Davit,fiurst,Avakimyan Davit - Hakobyan Eduard,111,52,59,7,-7,16,20,24,32,19,6,-2,2,-2,3,7,5:11 - 11:9 - 11:13 - 17:15 - 8:11
18587620,2024-05-10 16:15:00,Petrosyan Davit - Gevorgyan Gegham,1:3,8:11 - 11:4 - 11:9 - 11:7 - 0:0,3,1,Petrosyan Davit,Gevorgyan Gegham,fiurst,Gevorgyan Gegham - Petrosyan Davit,72,31,41,10,-10,19,15,20,18,0,-3,7,2,4,0,10,11:8 - 4:11 - 9:11 - 7:11 - 0:0
18587605,2024-05-10 16:05:00,Soghomonyan Hrayr - Hakobyan Eduard,1:3,9:11 - 11:8 - 11:6 - 11:7 - 0:0,3,1,Soghomonyan Hrayr,Hakobyan Eduard,fiurst,Hakobyan Eduard - Soghomonyan Hrayr,74,32,42,10,-10,20,19,17,18,0,-2,3,5,4,0,10,11:9 - 8:11 - 6:11 - 7:11 - 0:0
18587594,2024-05-10 15:45:00,Gevorgyan Gegham - Avakimyan Davit,3:1,11:8 - 7:11 - 2:11 - 10:12 - 0:0,1,3,Gevorgyan Gegham,Avakimyan Davit,fiurst,Avakimyan Davit - Gevorgyan Gegham,72,42,30,-12,12,19,18,13,22,0,3,-4,-9,-2,0,-12,8:11 - 11:7 - 11:2 - 12:10 - 0:0
18587590,2024-05-10 15:30:00,Petrosyan Davit - Soghomonyan Hrayr,3:2,6:11 - 11:6 - 9:11 - 12:10 - 11:7,3,2,Petrosyan Davit,Soghomonyan Hrayr,fiurst,Petrosyan Davit - Soghomonyan Hrayr,94,49,45,-4,4,17,17,20,22,18,5,-5,2,-2,-4,-4,6:11 - 11:6 - 9:11 - 12:10 - 11:7
18587586,2024-05-10 15:15:00,Diaryan Aleksandr - Hovhannesyan Rafik,3:0,11:3 - 11:3 - 11:9 - 0:0 - 0:0,3,0,Diaryan Aleksandr,Hovhannesyan Rafik,fiurst,Diaryan Aleksandr - Hovhannesyan Rafik,48,33,15,-18,18,14,14,20,0,0,-8,-8,-2,0,0,-18,11:3 - 11:3 - 11:9 - 0:0 - 0:0
18587577,2024-05-10 15:10:00,Asatryan Murad - Rafayelyan Edgar,3:0,11:6 - 14:12 - 11:6 - 0:0 - 0:0,3,0,Asatryan Murad,Rafayelyan Edgar,fiurst,Asatryan Murad - Rafayelyan Edgar,60,36,24,-12,12,17,26,17,0,0,-5,-2,-5,0,0,-12,11:6 - 14:12 - 11:6 - 0:0 - 0:0
18587566,2024-05-10 14:50:00,Papyan Karen - Diaryan Aleksandr,1:3,5:11 - 11:9 - 11:8 - 11:8 - 0:0,3,1,Papyan Karen,Diaryan Aleksandr,fiurst,Diaryan Aleksandr - Papyan Karen,74,36,38,2,-2,16,20,19,19,0,-6,2,3,3,0,2,11:5 - 9:11 - 8:11 - 8:11 - 0:0
18587565,2024-05-10 14:40:00,Hovhannesyan Rafik - Asatryan Murad,3:1,11:9 - 9:11 - 5:11 - 6:11 - 0:0,1,3,Hovhannesyan Rafik,Asatryan Murad,fiurst,Asatryan Murad - Hovhannesyan Rafik,73,42,31,-11,11,20,20,16,17,0,2,-2,-6,-5,0,-11,9:11 - 11:9 - 11:5 - 11:6 - 0:0
18587564,2024-05-10 14:20:00,Papyan Karen - Rafayelyan Edgar,2:3,11:9 - 5:11 - 9:11 - 11:9 - 5:11,2,3,Papyan Karen,Rafayelyan Edgar,fiurst,Papyan Karen - Rafayelyan Edgar,92,41,51,10,-10,20,16,20,20,16,-2,6,2,-2,6,10,11:9 - 5:11 - 9:11 - 11:9 - 5:11
18587561,2024-05-10 14:00:00,Diaryan Aleksandr - Asatryan Murad,3:0,9:11 - 12:14 - 9:11 - 0:0 - 0:0,0,3,Diaryan Aleksandr,Asatryan Murad,fiurst,Asatryan Murad - Diaryan Aleksandr,66,36,30,-6,6,20,26,20,0,0,-2,-2,-2,0,0,-6,11:9 - 14:12 - 11:9 - 0:0 - 0:0
18587559,2024-05-10 13:50:00,Hovhannesyan Rafik - Papyan Karen,1:3,11:7 - 9:11 - 9:11 - 11:13 - 0:0,1,3,Hovhannesyan Rafik,Papyan Karen,fiurst,Hovhannesyan Rafik - Papyan Karen,82,40,42,2,-2,18,20,20,24,0,-4,2,2,2,0,2,11:7 - 9:11 - 9:11 - 11:13 - 0:0
18587546,2024-05-10 13:30:00,Rafayelyan Edgar - Diaryan Aleksandr,2:3,7:11 - 11:9 - 13:11 - 8:11 - 11:6,3,2,Rafayelyan Edgar,Diaryan Aleksandr,fiurst,Diaryan Aleksandr - Rafayelyan Edgar,98,48,50,2,-2,18,20,24,19,17,-4,2,2,-3,5,2,11:7 - 9:11 - 11:13 - 11:8 - 6:11
18587542,2024-05-10 13:15:00,Asatryan Murad - Papyan Karen,3:0,11:6 - 11:9 - 11:5 - 0:0 - 0:0,3,0,Asatryan Murad,Papyan Karen,fiurst,Asatryan Murad - Papyan Karen,53,33,20,-13,13,17,20,16,0,0,-5,-2,-6,0,0,-13,11:6 - 11:9 - 11:5 - 0:0 - 0:0
18587540,2024-05-10 13:00:00,Rafayelyan Edgar - Hovhannesyan Rafik,0:3,11:4 - 11:9 - 11:8 - 0:0 - 0:0,3,0,Rafayelyan Edgar,Hovhannesyan Rafik,fiurst,Hovhannesyan Rafik - Rafayelyan Edgar,54,21,33,12,-12,15,20,19,0,0,7,2,3,0,0,12,4:11 - 9:11 - 8:11 - 0:0 - 0:0
18587538,2024-05-10 12:15:00,Diaryan Aleksandr - Papyan Karen,1:3,9:11 - 7:11 - 11:8 - 7:11 - 0:0,1,3,Diaryan Aleksandr,Papyan Karen,fiurst,Diaryan Aleksandr - Papyan Karen,75,34,41,7,-7,20,18,19,18,0,2,4,-3,4,0,7,9:11 - 7:11 - 11:8 - 7:11 - 0:0
18587534,2024-05-10 12:00:00,Rafayelyan Edgar - Asatryan Murad,1:3,11:2 - 11:7 - 6:11 - 11:5 - 0:0,3,1,Rafayelyan Edgar,Asatryan Murad,fiurst,Asatryan Murad - Rafayelyan Edgar,64,25,39,14,-14,13,18,17,16,0,9,4,-5,6,0,14,2:11 - 7:11 - 11:6 - 5:11 - 0:0
18587531,2024-05-10 11:55:00,Hovhannesyan Rafik - Diaryan Aleksandr,3:0,6:11 - 5:11 - 3:11 - 0:0 - 0:0,0,3,Hovhannesyan Rafik,Diaryan Aleksandr,fiurst,Diaryan Aleksandr - Hovhannesyan Rafik,47,33,14,-19,19,17,16,14,0,0,-5,-6,-8,0,0,-19,11:6 - 11:5 - 11:3 - 0:0 - 0:0
18587529,2024-05-10 11:30:00,Rafayelyan Edgar - Papyan Karen,0:3,11:7 - 11:8 - 11:7 - 0:0 - 0:0,3,0,Rafayelyan Edgar,Papyan Karen,fiurst,Papyan Karen - Rafayelyan Edgar,55,22,33,11,-11,18,19,18,0,0,4,3,4,0,0,11,7:11 - 8:11 - 7:11 - 0:0 - 0:0
18587505,2024-05-10 11:15:00,Asatryan Murad - Hovhannesyan Rafik,3:1,8:11 - 11:8 - 11:6 - 11:8 - 0:0,3,1,Asatryan Murad,Hovhannesyan Rafik,fiurst,Asatryan Murad - Hovhannesyan Rafik,74,41,33,-8,8,19,19,17,19,0,3,-3,-5,-3,0,-8,8:11 - 11:8 - 11:6 - 11:8 - 0:0
18587465,2024-05-10 11:00:00,Diaryan Aleksandr - Rafayelyan Edgar,3:0,11:6 - 13:11 - 11:7 - 0:0 - 0:0,3,0,Diaryan Aleksandr,Rafayelyan Edgar,fiurst,Diaryan Aleksandr - Rafayelyan Edgar,59,35,24,-11,11,17,24,18,0,0,-5,-2,-4,0,0,-11,11:6 - 13:11 - 11:7 - 0:0 - 0:0
18587440,2024-05-10 10:45:00,Papyan Karen - Hovhannesyan Rafik,3:0,8:11 - 8:11 - 9:11 - 0:0 - 0:0,0,3,Papyan Karen,Hovhannesyan Rafik,fiurst,Hovhannesyan Rafik - Papyan Karen,58,33,25,-8,8,19,19,20,0,0,-3,-3,-2,0,0,-8,11:8 - 11:8 - 11:9 - 0:0 - 0:0
18587436,2024-05-10 10:35:00,Asatryan Murad - Diaryan Aleksandr,3:1,6:11 - 13:11 - 11:8 - 11:6 - 0:0,3,1,Asatryan Murad,Diaryan Aleksandr,fiurst,Asatryan Murad - Diaryan Aleksandr,77,41,36,-5,5,17,24,19,17,0,5,-2,-3,-5,0,-5,6:11 - 13:11 - 11:8 - 11:6 - 0:0
18587432,2024-05-10 10:15:00,Hovhannesyan Rafik - Rafayelyan Edgar,1:3,14:12 - 8:11 - 8:11 - 5:11 - 0:0,1,3,Hovhannesyan Rafik,Rafayelyan Edgar,fiurst,Hovhannesyan Rafik - Rafayelyan Edgar,80,35,45,10,-10,26,19,19,16,0,-2,3,3,6,0,10,14:12 - 8:11 - 8:11 - 5:11 - 0:0
18587421,2024-05-10 10:00:00,Papyan Karen - Asatryan Murad,3:2,11:9 - 11:6 - 10:12 - 3:11 - 9:11,2,3,Papyan Karen,Asatryan Murad,fiurst,Asatryan Murad - Papyan Karen,93,49,44,-5,5,20,17,22,14,20,2,5,-2,-8,-2,-5,9:11 - 6:11 - 12:10 - 11:3 - 11:9
18571559,2024-05-09 17:50:00,Gevorgyan Hayk - Gevorgyan Gegham,0:3,11:6 - 11:6 - 11:5 - 0:0 - 0:0,3,0,Gevorgyan Hayk,Gevorgyan Gegham,fiurst,Gevorgyan Gegham - Gevorgyan Hayk,50,17,33,16,-16,17,17,16,0,0,5,5,6,0,0,16,6:11 - 6:11 - 5:11 - 0:0 - 0:0
18571558,2024-05-09 17:30:00,Soghomonyan Hrayr - Petrosyan Davit,3:1,11:13 - 11:7 - 5:11 - 10:12 - 0:0,1,3,Soghomonyan Hrayr,Petrosyan Davit,fiurst,Petrosyan Davit - Soghomonyan Hrayr,80,43,37,-6,6,24,18,16,22,0,-2,4,-6,-2,0,-6,13:11 - 7:11 - 11:5 - 12:10 - 0:0
18571556,2024-05-09 17:15:00,Avakimyan Davit - Gevorgyan Hayk,2:3,9:11 - 12:10 - 6:11 - 11:3 - 13:15,2,3,Avakimyan Davit,Gevorgyan Hayk,fiurst,Avakimyan Davit - Gevorgyan Hayk,101,51,50,-1,1,20,22,17,14,28,2,-2,5,-8,2,-1,9:11 - 12:10 - 6:11 - 11:3 - 13:15
18571554,2024-05-09 17:00:00,Soghomonyan Hrayr - Gevorgyan Gegham,0:3,11:8 - 11:8 - 11:5 - 0:0 - 0:0,3,0,Soghomonyan Hrayr,Gevorgyan Gegham,fiurst,Gevorgyan Gegham - Soghomonyan Hrayr,54,21,33,12,-12,19,19,16,0,0,3,3,6,0,0,12,8:11 - 8:11 - 5:11 - 0:0 - 0:0
18571550,2024-05-09 16:45:00,Petrosyan Davit - Avakimyan Davit,3:1,11:5 - 8:11 - 7:11 - 5:11 - 0:0,1,3,Petrosyan Davit,Avakimyan Davit,fiurst,Avakimyan Davit - Petrosyan Davit,69,38,31,-7,7,16,19,18,16,0,6,-3,-4,-6,0,-7,5:11 - 11:8 - 11:7 - 11:5 - 0:0
18571548,2024-05-09 16:30:00,Gevorgyan Hayk - Soghomonyan Hrayr,3:2,11:4 - 10:12 - 11:6 - 9:11 - 14:12,3,2,Gevorgyan Hayk,Soghomonyan Hrayr,fiurst,Gevorgyan Hayk - Soghomonyan Hrayr,100,55,45,-10,10,15,22,17,20,26,-7,2,-5,2,-2,-10,11:4 - 10:12 - 11:6 - 9:11 - 14:12
18571546,2024-05-09 16:15:00,Gevorgyan Gegham - Avakimyan Davit,3:0,5:11 - 5:11 - 8:11 - 0:0 - 0:0,0,3,Gevorgyan Gegham,Avakimyan Davit,fiurst,Avakimyan Davit - Gevorgyan Gegham,51,33,18,-15,15,16,16,19,0,0,-6,-6,-3,0,0,-15,11:5 - 11:5 - 11:8 - 0:0 - 0:0
18571545,2024-05-09 16:00:00,Petrosyan Davit - Gevorgyan Hayk,0:3,11:8 - 11:8 - 11:6 - 0:0 - 0:0,3,0,Petrosyan Davit,Gevorgyan Hayk,fiurst,Gevorgyan Hayk - Petrosyan Davit,55,22,33,11,-11,19,19,17,0,0,3,3,5,0,0,11,8:11 - 8:11 - 6:11 - 0:0 - 0:0
18571528,2024-05-09 15:45:00,Avakimyan Davit - Soghomonyan Hrayr,2:3,7:11 - 11:6 - 8:11 - 11:9 - 4:11,2,3,Avakimyan Davit,Soghomonyan Hrayr,fiurst,Avakimyan Davit - Soghomonyan Hrayr,89,41,48,7,-7,18,17,19,20,15,4,-5,3,-2,7,7,7:11 - 11:6 - 8:11 - 11:9 - 4:11
18571526,2024-05-09 15:30:00,Gevorgyan Gegham - Petrosyan Davit,0:3,7:11 - 8:11 - 5:11 - 0:0 - 0:0,0,3,Gevorgyan Gegham,Petrosyan Davit,fiurst,Gevorgyan Gegham - Petrosyan Davit,53,20,33,13,-13,18,19,16,0,0,4,3,6,0,0,13,7:11 - 8:11 - 5:11 - 0:0 - 0:0
18571515,2024-05-09 15:15:00,Papyan Karen - Rafayelyan Edgar,2:3,4:11 - 11:9 - 5:11 - 16:14 - 7:11,2,3,Papyan Karen,Rafayelyan Edgar,fiurst,Papyan Karen - Rafayelyan Edgar,99,43,56,13,-13,15,20,16,30,18,7,-2,6,-2,4,13,4:11 - 11:9 - 5:11 - 16:14 - 7:11
18571513,2024-05-09 15:00:00,Nazaryan Mushegh - Asatryan Murad,3:1,9:11 - 11:8 - 8:11 - 5:11 - 0:0,1,3,Nazaryan Mushegh,Asatryan Murad,fiurst,Asatryan Murad - Nazaryan Mushegh,74,41,33,-8,8,20,19,19,16,0,-2,3,-3,-6,0,-8,11:9 - 8:11 - 11:8 - 11:5 - 0:0
18571510,2024-05-09 14:50:00,Diaryan Aleksandr - Papyan Karen,3:0,11:6 - 11:4 - 11:4 - 0:0 - 0:0,3,0,Diaryan Aleksandr,Papyan Karen,fiurst,Diaryan Aleksandr - Papyan Karen,47,33,14,-19,19,17,15,15,0,0,-5,-7,-7,0,0,-19,11:6 - 11:4 - 11:4 - 0:0 - 0:0
18571508,2024-05-09 14:30:00,Rafayelyan Edgar - Nazaryan Mushegh,0:3,11:5 - 12:10 - 11:8 - 0:0 - 0:0,3,0,Rafayelyan Edgar,Nazaryan Mushegh,fiurst,Nazaryan Mushegh - Rafayelyan Edgar,57,23,34,11,-11,16,22,19,0,0,6,2,3,0,0,11,5:11 - 10:12 - 8:11 - 0:0 - 0:0
18571501,2024-05-09 14:20:00,Diaryan Aleksandr - Asatryan Murad,3:0,8:11 - 5:11 - 5:11 - 0:0 - 0:0,0,3,Diaryan Aleksandr,Asatryan Murad,fiurst,Asatryan Murad - Diaryan Aleksandr,51,33,18,-15,15,19,16,16,0,0,-3,-6,-6,0,0,-15,11:8 - 11:5 - 11:5 - 0:0 - 0:0
18571500,2024-05-09 14:00:00,Papyan Karen - Nazaryan Mushegh,1:3,12:10 - 9:11 - 11:5 - 11:4 - 0:0,3,1,Papyan Karen,Nazaryan Mushegh,fiurst,Nazaryan Mushegh - Papyan Karen,73,30,43,13,-13,22,20,16,15,0,2,-2,6,7,0,13,10:12 - 11:9 - 5:11 - 4:11 - 0:0
18571496,2024-05-09 13:45:00,Rafayelyan Edgar - Diaryan Aleksandr,3:0,9:11 - 6:11 - 1:11 - 0:0 - 0:0,0,3,Rafayelyan Edgar,Diaryan Aleksandr,fiurst,Diaryan Aleksandr - Rafayelyan Edgar,49,33,16,-17,17,20,17,12,0,0,-2,-5,-10,0,0,-17,11:9 - 11:6 - 11:1 - 0:0 - 0:0
18571483,2024-05-09 13:30:00,Asatryan Murad - Papyan Karen,3:1,11:4 - 11:8 - 9:11 - 14:12 - 0:0,3,1,Asatryan Murad,Papyan Karen,fiurst,Asatryan Murad - Papyan Karen,80,45,35,-10,10,15,19,20,26,0,-7,-3,2,-2,0,-10,11:4 - 11:8 - 9:11 - 14:12 - 0:0
18571482,2024-05-09 13:15:00,Nazaryan Mushegh - Diaryan Aleksandr,3:0,5:11 - 6:11 - 5:11 - 0:0 - 0:0,0,3,Nazaryan Mushegh,Diaryan Aleksandr,fiurst,Diaryan Aleksandr - Nazaryan Mushegh,49,33,16,-17,17,16,17,16,0,0,-6,-5,-6,0,0,-17,11:5 - 11:6 - 11:5 - 0:0 - 0:0
18571481,2024-05-09 13:00:00,Asatryan Murad - Rafayelyan Edgar,1:3,5:11 - 11:4 - 10:12 - 13:15 - 0:0,1,3,Asatryan Murad,Rafayelyan Edgar,fiurst,Asatryan Murad - Rafayelyan Edgar,81,39,42,3,-3,16,15,22,28,0,6,-7,2,2,0,3,5:11 - 11:4 - 10:12 - 13:15 - 0:0
18571477,2024-05-09 12:25:00,Papyan Karen - Diaryan Aleksandr,3:1,7:11 - 11:7 - 2:11 - 3:11 - 0:0,1,3,Papyan Karen,Diaryan Aleksandr,fiurst,Diaryan Aleksandr - Papyan Karen,63,40,23,-17,17,18,18,13,14,0,-4,4,-9,-8,0,-17,11:7 - 7:11 - 11:2 - 11:3 - 0:0
18571474,2024-05-09 12:10:00,Asatryan Murad - Nazaryan Mushegh,3:0,11:1 - 11:9 - 11:3 - 0:0 - 0:0,3,0,Asatryan Murad,Nazaryan Mushegh,fiurst,Asatryan Murad - Nazaryan Mushegh,46,33,13,-20,20,12,20,14,0,0,-10,-2,-8,0,0,-20,11:1 - 11:9 - 11:3 - 0:0 - 0:0
18571461,2024-05-09 11:50:00,Asatryan Murad - Diaryan Aleksandr,3:1,12:10 - 11:4 - 7:11 - 11:7 - 0:0,3,1,Asatryan Murad,Diaryan Aleksandr,fiurst,Asatryan Murad - Diaryan Aleksandr,73,41,32,-9,9,22,15,18,18,0,-2,-7,4,-4,0,-9,12:10 - 11:4 - 7:11 - 11:7 - 0:0
18571462,2024-05-09 11:50:00,Rafayelyan Edgar - Papyan Karen,3:2,11:13 - 11:5 - 11:9 - 6:11 - 8:11,2,3,Rafayelyan Edgar,Papyan Karen,fiurst,Papyan Karen - Rafayelyan Edgar,96,49,47,-2,2,24,16,20,17,19,-2,6,2,-5,-3,-2,13:11 - 5:11 - 9:11 - 11:6 - 11:8
18571460,2024-05-09 11:20:00,Nazaryan Mushegh - Rafayelyan Edgar,0:3,8:11 - 3:11 - 6:11 - 0:0 - 0:0,0,3,Nazaryan Mushegh,Rafayelyan Edgar,fiurst,Nazaryan Mushegh - Rafayelyan Edgar,50,17,33,16,-16,19,14,17,0,0,3,8,5,0,0,16,8:11 - 3:11 - 6:11 - 0:0 - 0:0
18571456,2024-05-09 11:15:00,Papyan Karen - Asatryan Murad,3:2,11:6 - 11:5 - 9:11 - 12:14 - 2:11,2,3,Papyan Karen,Asatryan Murad,fiurst,Asatryan Murad - Papyan Karen,92,47,45,-2,2,17,16,20,26,13,5,6,-2,-2,-9,-2,6:11 - 5:11 - 11:9 - 14:12 - 11:2
18571446,2024-05-09 10:55:00,Diaryan Aleksandr - Rafayelyan Edgar,3:1,11:7 - 11:7 - 9:11 - 11:6 - 0:0,3,1,Diaryan Aleksandr,Rafayelyan Edgar,fiurst,Diaryan Aleksandr - Rafayelyan Edgar,73,42,31,-11,11,18,18,20,17,0,-4,-4,2,-5,0,-11,11:7 - 11:7 - 9:11 - 11:6 - 0:0
18571442,2024-05-09 10:40:00,Nazaryan Mushegh - Papyan Karen,2:3,7:11 - 11:6 - 11:8 - 11:13 - 8:11,2,3,Nazaryan Mushegh,Papyan Karen,fiurst,Nazaryan Mushegh - Papyan Karen,97,48,49,1,-1,18,17,19,24,19,4,-5,-3,2,3,1,7:11 - 11:6 - 11:8 - 11:13 - 8:11
18571441,2024-05-09 10:15:00,Rafayelyan Edgar - Asatryan Murad,2:3,9:11 - 11:8 - 7:11 - 11:6 - 11:6,3,2,Rafayelyan Edgar,Asatryan Murad,fiurst,Asatryan Murad - Rafayelyan Edgar,91,42,49,7,-7,20,19,18,17,17,-2,3,-4,5,5,7,11:9 - 8:11 - 11:7 - 6:11 - 6:11
18571440,2024-05-09 10:00:00,Diaryan Aleksandr - Nazaryan Mushegh,2:3,8:11 - 11:3 - 7:11 - 11:9 - 11:13,2,3,Diaryan Aleksandr,Nazaryan Mushegh,fiurst,Diaryan Aleksandr - Nazaryan Mushegh,95,48,47,-1,1,19,14,18,20,24,3,-8,4,-2,2,-1,8:11 - 11:3 - 7:11 - 11:9 - 11:13
18552442,2024-05-08 17:45:00,Petrosyan Davit - Soghomonyan Hrayr,2:3,13:15 - 5:11 - 11:8 - 11:6 - 5:11,2,3,Petrosyan Davit,Soghomonyan Hrayr,fiurst,Petrosyan Davit - Soghomonyan Hrayr,96,45,51,6,-6,28,16,19,17,16,2,6,-3,-5,6,6,13:15 - 5:11 - 11:8 - 11:6 - 5:11
18552440,2024-05-08 17:30:00,Gevorgyan Gegham - Gevorgyan Hayk,3:2,9:11 - 11:7 - 11:7 - 14:16 - 11:7,3,2,Gevorgyan Gegham,Gevorgyan Hayk,fiurst,Gevorgyan Gegham - Gevorgyan Hayk,104,56,48,-8,8,20,18,18,30,18,2,-4,-4,2,-4,-8,9:11 - 11:7 - 11:7 - 14:16 - 11:7
18552437,2024-05-08 17:15:00,Hakobyan Eduard - Petrosyan Davit,0:3,4:11 - 8:11 - 9:11 - 0:0 - 0:0,0,3,Hakobyan Eduard,Petrosyan Davit,fiurst,Hakobyan Eduard - Petrosyan Davit,54,21,33,12,-12,15,19,20,0,0,7,3,2,0,0,12,4:11 - 8:11 - 9:11 - 0:0 - 0:0
18552436,2024-05-08 17:10:00,Gevorgyan Gegham - Soghomonyan Hrayr,1:3,11:9 - 8:11 - 9:11 - 7:11 - 0:0,1,3,Gevorgyan Gegham,Soghomonyan Hrayr,fiurst,Gevorgyan Gegham - Soghomonyan Hrayr,77,35,42,7,-7,20,19,20,18,0,-2,3,2,4,0,7,11:9 - 8:11 - 9:11 - 7:11 - 0:0
18552435,2024-05-08 16:45:00,Gevorgyan Hayk - Hakobyan Eduard,3:0,11:5 - 11:6 - 11:9 - 0:0 - 0:0,3,0,Gevorgyan Hayk,Hakobyan Eduard,fiurst,Gevorgyan Hayk - Hakobyan Eduard,53,33,20,-13,13,16,17,20,0,0,-6,-5,-2,0,0,-13,11:5 - 11:6 - 11:9 - 0:0 - 0:0
18552424,2024-05-08 16:30:00,Petrosyan Davit - Gevorgyan Gegham,2:3,11:13 - 11:3 - 6:11 - 11:5 - 11:7,3,2,Petrosyan Davit,Gevorgyan Gegham,fiurst,Gevorgyan Gegham - Petrosyan Davit,89,39,50,11,-11,24,14,17,16,18,-2,8,-5,6,4,11,13:11 - 3:11 - 11:6 - 5:11 - 7:11
18552421,2024-05-08 16:15:00,Soghomonyan Hrayr - Hakobyan Eduard,0:3,11:7 - 11:6 - 11:9 - 0:0 - 0:0,3,0,Soghomonyan Hrayr,Hakobyan Eduard,fiurst,Hakobyan Eduard - Soghomonyan Hrayr,55,22,33,11,-11,18,17,20,0,0,4,5,2,0,0,11,7:11 - 6:11 - 9:11 - 0:0 - 0:0
18552419,2024-05-08 16:00:00,Gevorgyan Hayk - Petrosyan Davit,3:2,5:11 - 11:7 - 11:4 - 11:13 - 11:8,3,2,Gevorgyan Hayk,Petrosyan Davit,fiurst,Gevorgyan Hayk - Petrosyan Davit,92,49,43,-6,6,16,18,15,24,19,6,-4,-7,2,-3,-6,5:11 - 11:7 - 11:4 - 11:13 - 11:8
18552285,2024-05-08 15:45:00,Hakobyan Eduard - Gevorgyan Gegham,1:3,10:12 - 11:7 - 11:9 - 11:5 - 0:0,3,1,Hakobyan Eduard,Gevorgyan Gegham,fiurst,Gevorgyan Gegham - Hakobyan Eduard,76,33,43,10,-10,22,18,20,16,0,-2,4,2,6,0,10,12:10 - 7:11 - 9:11 - 5:11 - 0:0
18552284,2024-05-08 15:30:00,Soghomonyan Hrayr - Gevorgyan Hayk,1:3,11:3 - 11:2 - 6:11 - 11:7 - 0:0,3,1,Soghomonyan Hrayr,Gevorgyan Hayk,fiurst,Gevorgyan Hayk - Soghomonyan Hrayr,62,23,39,16,-16,14,13,17,18,0,8,9,-5,4,0,16,3:11 - 2:11 - 11:6 - 7:11 - 0:0
18552283,2024-05-08 15:15:00,Asatryan Murad - Hovhannesyan Rafik,3:0,11:9 - 12:10 - 11:5 - 0:0 - 0:0,3,0,Asatryan Murad,Hovhannesyan Rafik,fiurst,Asatryan Murad - Hovhannesyan Rafik,58,34,24,-10,10,20,22,16,0,0,-2,-2,-6,0,0,-10,11:9 - 12:10 - 11:5 - 0:0 - 0:0
18552273,2024-05-08 15:00:00,Diaryan Aleksandr - Rafayelyan Edgar,3:2,11:13 - 11:7 - 11:5 - 7:11 - 11:9,3,2,Diaryan Aleksandr,Rafayelyan Edgar,fiurst,Diaryan Aleksandr - Rafayelyan Edgar,96,51,45,-6,6,24,18,16,18,20,2,-4,-6,4,-2,-6,11:13 - 11:7 - 11:5 - 7:11 - 11:9
18552265,2024-05-08 14:45:00,Nazaryan Mushegh - Asatryan Murad,3:0,8:11 - 8:11 - 7:11 - 0:0 - 0:0,0,3,Nazaryan Mushegh,Asatryan Murad,fiurst,Asatryan Murad - Nazaryan Mushegh,56,33,23,-10,10,19,19,18,0,0,-3,-3,-4,0,0,-10,11:8 - 11:8 - 11:7 - 0:0 - 0:0
18552264,2024-05-08 14:30:00,Hovhannesyan Rafik - Diaryan Aleksandr,3:1,12:10 - 1:11 - 6:11 - 4:11 - 0:0,1,3,Hovhannesyan Rafik,Diaryan Aleksandr,fiurst,Diaryan Aleksandr - Hovhannesyan Rafik,66,43,23,-20,20,22,12,17,15,0,2,-10,-5,-7,0,-20,10:12 - 11:1 - 11:6 - 11:4 - 0:0
18552260,2024-05-08 14:20:00,Nazaryan Mushegh - Rafayelyan Edgar,3:0,11:9 - 11:5 - 12:10 - 0:0 - 0:0,3,0,Nazaryan Mushegh,Rafayelyan Edgar,fiurst,Nazaryan Mushegh - Rafayelyan Edgar,58,34,24,-10,10,20,16,22,0,0,-2,-6,-2,0,0,-10,11:9 - 11:5 - 12:10 - 0:0 - 0:0
18552258,2024-05-08 14:00:00,Asatryan Murad - Diaryan Aleksandr,3:0,11:5 - 11:7 - 11:4 - 0:0 - 0:0,3,0,Asatryan Murad,Diaryan Aleksandr,fiurst,Asatryan Murad - Diaryan Aleksandr,49,33,16,-17,17,16,18,15,0,0,-6,-4,-7,0,0,-17,11:5 - 11:7 - 11:4 - 0:0 - 0:0
18552251,2024-05-08 13:45:00,Hovhannesyan Rafik - Nazaryan Mushegh,2:3,11:13 - 11:7 - 5:11 - 11:8 - 9:11,2,3,Hovhannesyan Rafik,Nazaryan Mushegh,fiurst,Hovhannesyan Rafik - Nazaryan Mushegh,97,47,50,3,-3,24,18,16,19,20,2,-4,6,-3,2,3,11:13 - 11:7 - 5:11 - 11:8 - 9:11
18552250,2024-05-08 13:30:00,Rafayelyan Edgar - Asatryan Murad,3:1,9:11 - 11:8 - 9:11 - 8:11 - 0:0,1,3,Rafayelyan Edgar,Asatryan Murad,fiurst,Asatryan Murad - Rafayelyan Edgar,78,41,37,-4,4,20,19,20,19,0,-2,3,-2,-3,0,-4,11:9 - 8:11 - 11:9 - 11:8 - 0:0
18552243,2024-05-08 13:15:00,Diaryan Aleksandr - Nazaryan Mushegh,3:0,11:4 - 11:9 - 11:7 - 0:0 - 0:0,3,0,Diaryan Aleksandr,Nazaryan Mushegh,fiurst,Diaryan Aleksandr - Nazaryan Mushegh,53,33,20,-13,13,15,20,18,0,0,-7,-2,-4,0,0,-13,11:4 - 11:9 - 11:7 - 0:0 - 0:0
18552235,2024-05-08 13:00:00,Rafayelyan Edgar - Hovhannesyan Rafik,0:3,11:5 - 11:6 - 11:8 - 0:0 - 0:0,3,0,Rafayelyan Edgar,Hovhannesyan Rafik,fiurst,Hovhannesyan Rafik - Rafayelyan Edgar,52,19,33,14,-14,16,17,19,0,0,6,5,3,0,0,14,5:11 - 6:11 - 8:11 - 0:0 - 0:0
18552233,2024-05-08 12:20:00,Asatryan Murad - Nazaryan Mushegh,3:0,11:3 - 11:8 - 11:6 - 0:0 - 0:0,3,0,Asatryan Murad,Nazaryan Mushegh,fiurst,Asatryan Murad - Nazaryan Mushegh,50,33,17,-16,16,14,19,17,0,0,-8,-3,-5,0,0,-16,11:3 - 11:8 - 11:6 - 0:0 - 0:0
18552231,2024-05-08 12:00:00,Rafayelyan Edgar - Diaryan Aleksandr,3:0,9:11 - 9:11 - 6:11 - 0:0 - 0:0,0,3,Rafayelyan Edgar,Diaryan Aleksandr,fiurst,Diaryan Aleksandr - Rafayelyan Edgar,57,33,24,-9,9,20,20,17,0,0,-2,-2,-5,0,0,-9,11:9 - 11:9 - 11:6 - 0:0 - 0:0
18552230,2024-05-08 11:50:00,Hovhannesyan Rafik - Asatryan Murad,3:1,2:11 - 9:11 - 11:3 - 1:11 - 0:0,1,3,Hovhannesyan Rafik,Asatryan Murad,fiurst,Asatryan Murad - Hovhannesyan Rafik,59,36,23,-13,13,13,20,14,12,0,-9,-2,8,-10,0,-13,11:2 - 11:9 - 3:11 - 11:1 - 0:0
18552225,2024-05-08 11:35:00,Rafayelyan Edgar - Nazaryan Mushegh,0:3,11:9 - 12:10 - 11:4 - 0:0 - 0:0,3,0,Rafayelyan Edgar,Nazaryan Mushegh,fiurst,Nazaryan Mushegh - Rafayelyan Edgar,57,23,34,11,-11,20,22,15,0,0,2,2,7,0,0,11,9:11 - 10:12 - 4:11 - 0:0 - 0:0
18552224,2024-05-08 11:15:00,Diaryan Aleksandr - Hovhannesyan Rafik,1:3,10:12 - 9:11 - 11:3 - 7:11 - 0:0,1,3,Diaryan Aleksandr,Hovhannesyan Rafik,fiurst,Diaryan Aleksandr - Hovhannesyan Rafik,74,37,37,0,0,22,20,14,18,0,2,2,-8,4,0,0,10:12 - 9:11 - 11:3 - 7:11 - 0:0
18552222,2024-05-08 11:00:00,Asatryan Murad - Rafayelyan Edgar,3:0,11:7 - 11:6 - 11:9 - 0:0 - 0:0,3,0,Asatryan Murad,Rafayelyan Edgar,fiurst,Asatryan Murad - Rafayelyan Edgar,55,33,22,-11,11,18,17,20,0,0,-4,-5,-2,0,0,-11,11:7 - 11:6 - 11:9 - 0:0 - 0:0
18552219,2024-05-08 10:45:00,Nazaryan Mushegh - Hovhannesyan Rafik,0:3,11:7 - 11:5 - 11:6 - 0:0 - 0:0,3,0,Nazaryan Mushegh,Hovhannesyan Rafik,fiurst,Hovhannesyan Rafik - Nazaryan Mushegh,51,18,33,15,-15,18,16,17,0,0,4,6,5,0,0,15,7:11 - 5:11 - 6:11 - 0:0 - 0:0
18552217,2024-05-08 10:30:00,Diaryan Aleksandr - Asatryan Murad,3:0,10:12 - 8:11 - 8:11 - 0:0 - 0:0,0,3,Diaryan Aleksandr,Asatryan Murad,fiurst,Asatryan Murad - Diaryan Aleksandr,60,34,26,-8,8,22,19,19,0,0,-2,-3,-3,0,0,-8,12:10 - 11:8 - 11:8 - 0:0 - 0:0
18552216,2024-05-08 10:15:00,Hovhannesyan Rafik - Rafayelyan Edgar,0:3,4:11 - 5:11 - 8:11 - 0:0 - 0:0,0,3,Hovhannesyan Rafik,Rafayelyan Edgar,fiurst,Hovhannesyan Rafik - Rafayelyan Edgar,50,17,33,16,-16,15,16,19,0,0,7,6,3,0,0,16,4:11 - 5:11 - 8:11 - 0:0 - 0:0
18552205,2024-05-08 10:00:00,Nazaryan Mushegh - Diaryan Aleksandr,3:1,6:11 - 11:9 - 5:11 - 3:11 - 0:0,1,3,Nazaryan Mushegh,Diaryan Aleksandr,fiurst,Diaryan Aleksandr - Nazaryan Mushegh,67,42,25,-17,17,17,20,16,14,0,-5,2,-6,-8,0,-17,11:6 - 9:11 - 11:5 - 11:3 - 0:0
18530163,2024-05-07 17:55:00,Gevorgyan Gegham - Avakimyan Davit,1:3,9:11 - 11:8 - 11:4 - 12:10 - 0:0,3,1,Gevorgyan Gegham,Avakimyan Davit,fiurst,Avakimyan Davit - Gevorgyan Gegham,76,33,43,10,-10,20,19,15,22,0,-2,3,7,2,0,10,11:9 - 8:11 - 4:11 - 10:12 - 0:0
18530162,2024-05-07 17:30:00,Gevorgyan Hayk - Soghomonyan Hrayr,0:3,4:11 - 10:12 - 6:11 - 0:0 - 0:0,0,3,Gevorgyan Hayk,Soghomonyan Hrayr,fiurst,Gevorgyan Hayk - Soghomonyan Hrayr,54,20,34,14,-14,15,22,17,0,0,7,2,5,0,0,14,4:11 - 10:12 - 6:11 - 0:0 - 0:0
18530159,2024-05-07 17:15:00,Hakobyan Eduard - Gevorgyan Gegham,1:3,11:7 - 30:28 - 5:11 - 11:7 - 0:0,3,1,Hakobyan Eduard,Gevorgyan Gegham,fiurst,Gevorgyan Gegham - Hakobyan Eduard,110,53,57,4,-4,18,58,16,18,0,4,2,-6,4,0,4,7:11 - 28:30 - 11:5 - 7:11 - 0:0
18530158,2024-05-07 17:05:00,Gevorgyan Hayk - Avakimyan Davit,1:3,11:6 - 11:8 - 7:11 - 11:9 - 0:0,3,1,Gevorgyan Hayk,Avakimyan Davit,fiurst,Avakimyan Davit - Gevorgyan Hayk,74,34,40,6,-6,17,19,18,20,0,5,3,-4,2,0,6,6:11 - 8:11 - 11:7 - 9:11 - 0:0
18530156,2024-05-07 16:45:00,Soghomonyan Hrayr - Hakobyan Eduard,0:3,11:8 - 11:5 - 11:9 - 0:0 - 0:0,3,0,Soghomonyan Hrayr,Hakobyan Eduard,fiurst,Hakobyan Eduard - Soghomonyan Hrayr,55,22,33,11,-11,19,16,20,0,0,3,6,2,0,0,11,8:11 - 5:11 - 9:11 - 0:0 - 0:0
18530154,2024-05-07 16:30:00,Gevorgyan Gegham - Gevorgyan Hayk,2:3,11:9 - 7:11 - 11:9 - 8:11 - 7:11,2,3,Gevorgyan Gegham,Gevorgyan Hayk,fiurst,Gevorgyan Gegham - Gevorgyan Hayk,95,44,51,7,-7,20,18,20,19,18,-2,4,-2,3,4,7,11:9 - 7:11 - 11:9 - 8:11 - 7:11
18530152,2024-05-07 16:15:00,Avakimyan Davit - Hakobyan Eduard,2:3,2:11 - 11:6 - 11:9 - 6:11 - 4:11,2,3,Avakimyan Davit,Hakobyan Eduard,fiurst,Avakimyan Davit - Hakobyan Eduard,82,34,48,14,-14,13,17,20,17,15,9,-5,-2,5,7,14,2:11 - 11:6 - 11:9 - 6:11 - 4:11
18530150,2024-05-07 16:00:00,Soghomonyan Hrayr - Gevorgyan Gegham,1:3,11:5 - 14:16 - 11:5 - 11:7 - 0:0,3,1,Soghomonyan Hrayr,Gevorgyan Gegham,fiurst,Gevorgyan Gegham - Soghomonyan Hrayr,80,33,47,14,-14,16,30,16,18,0,6,-2,6,4,0,14,5:11 - 16:14 - 5:11 - 7:11 - 0:0
18530149,2024-05-07 15:45:00,Hakobyan Eduard - Gevorgyan Hayk,3:1,7:11 - 3:11 - 11:4 - 6:11 - 0:0,1,3,Hakobyan Eduard,Gevorgyan Hayk,fiurst,Gevorgyan Hayk - Hakobyan Eduard,64,37,27,-10,10,18,14,15,17,0,-4,-8,7,-5,0,-10,11:7 - 11:3 - 4:11 - 11:6 - 0:0
18530144,2024-05-07 15:30:00,Avakimyan Davit - Soghomonyan Hrayr,0:3,9:11 - 12:14 - 5:11 - 0:0 - 0:0,0,3,Avakimyan Davit,Soghomonyan Hrayr,fiurst,Avakimyan Davit - Soghomonyan Hrayr,62,26,36,10,-10,20,26,16,0,0,2,2,6,0,0,10,9:11 - 12:14 - 5:11 - 0:0 - 0:0
18530137,2024-05-07 15:15:00,Papyan Karen - Diaryan Aleksandr,3:0,8:11 - 4:11 - 9:11 - 0:0 - 0:0,0,3,Papyan Karen,Diaryan Aleksandr,fiurst,Diaryan Aleksandr - Papyan Karen,54,33,21,-12,12,19,15,20,0,0,-3,-7,-2,0,0,-12,11:8 - 11:4 - 11:9 - 0:0 - 0:0
18530133,2024-05-07 15:00:00,Nazaryan Mushegh - Hovhannesyan Rafik,3:0,2:11 - 7:11 - 8:11 - 0:0 - 0:0,0,3,Nazaryan Mushegh,Hovhannesyan Rafik,fiurst,Hovhannesyan Rafik - Nazaryan Mushegh,50,33,17,-16,16,13,18,19,0,0,-9,-4,-3,0,0,-16,11:2 - 11:7 - 11:8 - 0:0 - 0:0
18530131,2024-05-07 14:55:00,Asatryan Murad - Papyan Karen,3:0,11:5 - 11:4 - 11:5 - 0:0 - 0:0,3,0,Asatryan Murad,Papyan Karen,fiurst,Asatryan Murad - Papyan Karen,47,33,14,-19,19,16,15,16,0,0,-6,-7,-6,0,0,-19,11:5 - 11:4 - 11:5 - 0:0 - 0:0
18530130,2024-05-07 14:30:00,Diaryan Aleksandr - Nazaryan Mushegh,3:0,11:7 - 11:4 - 11:4 - 0:0 - 0:0,3,0,Diaryan Aleksandr,Nazaryan Mushegh,fiurst,Diaryan Aleksandr - Nazaryan Mushegh,48,33,15,-18,18,18,15,15,0,0,-4,-7,-7,0,0,-18,11:7 - 11:4 - 11:4 - 0:0 - 0:0
18530128,2024-05-07 14:20:00,Asatryan Murad - Hovhannesyan Rafik,3:2,9:11 - 15:13 - 5:11 - 11:5 - 11:1,3,2,Asatryan Murad,Hovhannesyan Rafik,fiurst,Asatryan Murad - Hovhannesyan Rafik,92,51,41,-10,10,20,28,16,16,12,2,-2,6,-6,-10,-10,9:11 - 15:13 - 5:11 - 11:5 - 11:1
18530123,2024-05-07 14:00:00,Papyan Karen - Nazaryan Mushegh,1:3,8:11 - 11:4 - 11:4 - 11:6 - 0:0,3,1,Papyan Karen,Nazaryan Mushegh,fiurst,Nazaryan Mushegh - Papyan Karen,66,25,41,16,-16,19,15,15,17,0,-3,7,7,5,0,16,11:8 - 4:11 - 4:11 - 6:11 - 0:0
18530122,2024-05-07 13:45:00,Diaryan Aleksandr - Asatryan Murad,3:2,11:6 - 4:11 - 15:13 - 8:11 - 7:11,2,3,Diaryan Aleksandr,Asatryan Murad,fiurst,Asatryan Murad - Diaryan Aleksandr,97,52,45,-7,7,17,15,28,19,18,5,-7,2,-3,-4,-7,6:11 - 11:4 - 13:15 - 11:8 - 11:7
18530120,2024-05-07 13:30:00,Hovhannesyan Rafik - Papyan Karen,0:3,5:11 - 7:11 - 5:11 - 0:0 - 0:0,0,3,Hovhannesyan Rafik,Papyan Karen,fiurst,Hovhannesyan Rafik - Papyan Karen,50,17,33,16,-16,16,18,16,0,0,6,4,6,0,0,16,5:11 - 7:11 - 5:11 - 0:0 - 0:0
18530109,2024-05-07 13:15:00,Nazaryan Mushegh - Asatryan Murad,3:0,2:11 - 6:11 - 7:11 - 0:0 - 0:0,0,3,Nazaryan Mushegh,Asatryan Murad,fiurst,Asatryan Murad - Nazaryan Mushegh,48,33,15,-18,18,13,17,18,0,0,-9,-5,-4,0,0,-18,11:2 - 11:6 - 11:7 - 0:0 - 0:0
18530108,2024-05-07 13:00:00,Hovhannesyan Rafik - Diaryan Aleksandr,3:0,10:12 - 2:11 - 6:11 - 0:0 - 0:0,0,3,Hovhannesyan Rafik,Diaryan Aleksandr,fiurst,Diaryan Aleksandr - Hovhannesyan Rafik,52,34,18,-16,16,22,13,17,0,0,-2,-9,-5,0,0,-16,12:10 - 11:2 - 11:6 - 0:0 - 0:0
18530105,2024-05-07 12:20:00,Papyan Karen - Asatryan Murad,3:2,11:5 - 12:10 - 4:11 - 7:11 - 6:11,2,3,Papyan Karen,Asatryan Murad,fiurst,Asatryan Murad - Papyan Karen,88,48,40,-8,8,16,22,15,18,17,6,2,-7,-4,-5,-8,5:11 - 10:12 - 11:4 - 11:7 - 11:6
18530102,2024-05-07 12:10:00,Hovhannesyan Rafik - Nazaryan Mushegh,3:0,11:5 - 11:9 - 11:8 - 0:0 - 0:0,3,0,Hovhannesyan Rafik,Nazaryan Mushegh,fiurst,Hovhannesyan Rafik - Nazaryan Mushegh,55,33,22,-11,11,16,20,19,0,0,-6,-2,-3,0,0,-11,11:5 - 11:9 - 11:8 - 0:0 - 0:0
18514646,2024-05-07 11:50:00,Diaryan Aleksandr - Papyan Karen,3:0,11:7 - 11:8 - 11:8 - 0:0 - 0:0,3,0,Diaryan Aleksandr,Papyan Karen,fiurst,Diaryan Aleksandr - Papyan Karen,56,33,23,-10,10,18,19,19,0,0,-4,-3,-3,0,0,-10,11:7 - 11:8 - 11:8 - 0:0 - 0:0
18514644,2024-05-07 11:35:00,Hovhannesyan Rafik - Asatryan Murad,3:1,12:14 - 11:7 - 11:13 - 11:13 - 0:0,1,3,Hovhannesyan Rafik,Asatryan Murad,fiurst,Asatryan Murad - Hovhannesyan Rafik,92,47,45,-2,2,26,18,24,24,0,-2,4,-2,-2,0,-2,14:12 - 7:11 - 13:11 - 13:11 - 0:0
18514638,2024-05-07 11:20:00,Nazaryan Mushegh - Diaryan Aleksandr,3:1,3:11 - 11:9 - 2:11 - 3:11 - 0:0,1,3,Nazaryan Mushegh,Diaryan Aleksandr,fiurst,Diaryan Aleksandr - Nazaryan Mushegh,61,42,19,-23,23,14,20,13,14,0,-8,2,-9,-8,0,-23,11:3 - 9:11 - 11:2 - 11:3 - 0:0
18514624,2024-05-07 11:00:00,Papyan Karen - Hovhannesyan Rafik,1:3,11:2 - 15:17 - 11:4 - 11:9 - 0:0,3,1,Papyan Karen,Hovhannesyan Rafik,fiurst,Hovhannesyan Rafik - Papyan Karen,80,32,48,16,-16,13,32,15,20,0,9,-2,7,2,0,16,2:11 - 17:15 - 4:11 - 9:11 - 0:0
18514618,2024-05-07 10:45:00,Asatryan Murad - Diaryan Aleksandr,1:3,6:11 - 11:6 - 10:12 - 6:11 - 0:0,1,3,Asatryan Murad,Diaryan Aleksandr,fiurst,Asatryan Murad - Diaryan Aleksandr,73,33,40,7,-7,17,17,22,17,0,5,-5,2,5,0,7,6:11 - 11:6 - 10:12 - 6:11 - 0:0
18514611,2024-05-07 10:30:00,Nazaryan Mushegh - Papyan Karen,0:3,12:14 - 11:13 - 6:11 - 0:0 - 0:0,0,3,Nazaryan Mushegh,Papyan Karen,fiurst,Nazaryan Mushegh - Papyan Karen,67,29,38,9,-9,26,24,17,0,0,2,2,5,0,0,9,12:14 - 11:13 - 6:11 - 0:0 - 0:0
18514587,2024-05-07 10:15:00,Diaryan Aleksandr - Hovhannesyan Rafik,3:0,11:6 - 11:3 - 11:3 - 0:0 - 0:0,3,0,Diaryan Aleksandr,Hovhannesyan Rafik,fiurst,Diaryan Aleksandr - Hovhannesyan Rafik,45,33,12,-21,21,17,14,14,0,0,-5,-8,-8,0,0,-21,11:6 - 11:3 - 11:3 - 0:0 - 0:0
18514579,2024-05-07 10:10:00,Asatryan Murad - Nazaryan Mushegh,3:0,11:7 - 11:9 - 11:5 - 0:0 - 0:0,3,0,Asatryan Murad,Nazaryan Mushegh,fiurst,Asatryan Murad - Nazaryan Mushegh,54,33,21,-12,12,18,20,16,0,0,-4,-2,-6,0,0,-12,11:7 - 11:9 - 11:5 - 0:0 - 0:0
18514689,2024-05-06 17:45:00,Hakobyan Eduard - Gevorgyan Hayk,1:3,6:11 - 11:8 - 12:10 - 11:7 - 0:0,3,1,Hakobyan Eduard,Gevorgyan Hayk,fiurst,Gevorgyan Hayk - Hakobyan Eduard,76,36,40,4,-4,17,19,22,18,0,-5,3,2,4,0,4,11:6 - 8:11 - 10:12 - 7:11 - 0:0
18514688,2024-05-06 17:30:00,Avakimyan Davit - Gevorgyan Gegham,3:1,11:6 - 3:11 - 13:11 - 11:5 - 0:0,3,1,Avakimyan Davit,Gevorgyan Gegham,fiurst,Avakimyan Davit - Gevorgyan Gegham,71,38,33,-5,5,17,14,24,16,0,-5,8,-2,-6,0,-5,11:6 - 3:11 - 13:11 - 11:5 - 0:0
18514685,2024-05-06 17:15:00,Petrosyan Davit - Hakobyan Eduard,3:1,9:11 - 7:11 - 11:5 - 6:11 - 0:0,1,3,Petrosyan Davit,Hakobyan Eduard,fiurst,Hakobyan Eduard - Petrosyan Davit,71,38,33,-5,5,20,18,16,17,0,-2,-4,6,-5,0,-5,11:9 - 11:7 - 5:11 - 11:6 - 0:0
18514675,2024-05-06 17:00:00,Avakimyan Davit - Gevorgyan Hayk,2:3,14:12 - 7:11 - 6:11 - 12:10 - 5:11,2,3,Avakimyan Davit,Gevorgyan Hayk,fiurst,Avakimyan Davit - Gevorgyan Hayk,99,44,55,11,-11,26,18,17,22,16,-2,4,5,-2,6,11,14:12 - 7:11 - 6:11 - 12:10 - 5:11
18514674,2024-05-06 16:45:00,Gevorgyan Gegham - Petrosyan Davit,0:3,8:11 - 5:11 - 9:11 - 0:0 - 0:0,0,3,Gevorgyan Gegham,Petrosyan Davit,fiurst,Gevorgyan Gegham - Petrosyan Davit,55,22,33,11,-11,19,16,20,0,0,3,6,2,0,0,11,8:11 - 5:11 - 9:11 - 0:0 - 0:0
18514671,2024-05-06 16:30:00,Hakobyan Eduard - Avakimyan Davit,2:3,5:11 - 11:9 - 11:8 - 11:13 - 11:6,3,2,Hakobyan Eduard,Avakimyan Davit,fiurst,Avakimyan Davit - Hakobyan Eduard,96,47,49,2,-2,16,20,19,24,17,-6,2,3,-2,5,2,11:5 - 9:11 - 8:11 - 13:11 - 6:11
18514669,2024-05-06 16:15:00,Gevorgyan Hayk - Petrosyan Davit,0:3,6:11 - 8:11 - 15:17 - 0:0 - 0:0,0,3,Gevorgyan Hayk,Petrosyan Davit,fiurst,Gevorgyan Hayk - Petrosyan Davit,68,29,39,10,-10,17,19,32,0,0,5,3,2,0,0,10,6:11 - 8:11 - 15:17 - 0:0 - 0:0
18514664,2024-05-06 16:00:00,Gevorgyan Gegham - Hakobyan Eduard,2:3,11:9 - 8:11 - 11:2 - 9:11 - 10:12,2,3,Gevorgyan Gegham,Hakobyan Eduard,fiurst,Gevorgyan Gegham - Hakobyan Eduard,94,49,45,-4,4,20,19,13,20,22,-2,3,-9,2,2,-4,11:9 - 8:11 - 11:2 - 9:11 - 10:12
18514662,2024-05-06 15:45:00,Petrosyan Davit - Avakimyan Davit,3:2,8:11 - 9:11 - 11:7 - 11:6 - 9:11,2,3,Petrosyan Davit,Avakimyan Davit,fiurst,Avakimyan Davit - Petrosyan Davit,94,46,48,2,-2,19,20,18,17,20,-3,-2,4,5,-2,2,11:8 - 11:9 - 7:11 - 6:11 - 11:9
18514657,2024-05-06 15:30:00,Gevorgyan Hayk - Gevorgyan Gegham,0:3,11:7 - 11:2 - 11:9 - 0:0 - 0:0,3,0,Gevorgyan Hayk,Gevorgyan Gegham,fiurst,Gevorgyan Gegham - Gevorgyan Hayk,51,18,33,15,-15,18,13,20,0,0,4,9,2,0,0,15,7:11 - 2:11 - 9:11 - 0:0 - 0:0
18514647,2024-05-06 15:15:00,Nazaryan Mushegh - Rafayelyan Edgar,0:3,6:11 - 8:11 - 8:11 - 0:0 - 0:0,0,3,Nazaryan Mushegh,Rafayelyan Edgar,fiurst,Nazaryan Mushegh - Rafayelyan Edgar,55,22,33,11,-11,17,19,19,0,0,5,3,3,0,0,11,6:11 - 8:11 - 8:11 - 0:0 - 0:0
18514645,2024-05-06 14:45:00,Diaryan Aleksandr - Nazaryan Mushegh,3:1,8:11 - 15:13 - 11:7 - 11:4 - 0:0,3,1,Diaryan Aleksandr,Nazaryan Mushegh,fiurst,Diaryan Aleksandr - Nazaryan Mushegh,80,45,35,-10,10,19,28,18,15,0,3,-2,-4,-7,0,-10,8:11 - 15:13 - 11:7 - 11:4 - 0:0
18514642,2024-05-06 14:15:00,Diaryan Aleksandr - Asatryan Murad,3:0,8:11 - 7:11 - 7:11 - 0:0 - 0:0,0,3,Diaryan Aleksandr,Asatryan Murad,fiurst,Asatryan Murad - Diaryan Aleksandr,55,33,22,-11,11,19,18,18,0,0,-3,-4,-4,0,0,-11,11:8 - 11:7 - 11:7 - 0:0 - 0:0
18514637,2024-05-06 13:45:00,Rafayelyan Edgar - Diaryan Aleksandr,0:3,11:8 - 12:10 - 11:5 - 0:0 - 0:0,3,0,Rafayelyan Edgar,Diaryan Aleksandr,fiurst,Diaryan Aleksandr - Rafayelyan Edgar,57,23,34,11,-11,19,22,16,0,0,3,2,6,0,0,11,8:11 - 10:12 - 5:11 - 0:0 - 0:0
18514636,2024-05-06 13:30:00,Asatryan Murad - Nazaryan Mushegh,3:0,11:5 - 11:3 - 11:8 - 0:0 - 0:0,3,0,Asatryan Murad,Nazaryan Mushegh,fiurst,Asatryan Murad - Nazaryan Mushegh,49,33,16,-17,17,16,14,19,0,0,-6,-8,-3,0,0,-17,11:5 - 11:3 - 11:8 - 0:0 - 0:0
18514623,2024-05-06 13:00:00,Asatryan Murad - Rafayelyan Edgar,1:3,15:13 - 7:11 - 9:11 - 10:12 - 0:0,1,3,Asatryan Murad,Rafayelyan Edgar,fiurst,Asatryan Murad - Rafayelyan Edgar,88,41,47,6,-6,28,18,20,22,0,-2,4,2,2,0,6,15:13 - 7:11 - 9:11 - 10:12 - 0:0
18514619,2024-05-06 12:15:00,Nazaryan Mushegh - Diaryan Aleksandr,3:0,7:11 - 7:11 - 8:11 - 0:0 - 0:0,0,3,Nazaryan Mushegh,Diaryan Aleksandr,fiurst,Diaryan Aleksandr - Nazaryan Mushegh,55,33,22,-11,11,18,18,19,0,0,-4,-4,-3,0,0,-11,11:7 - 11:7 - 11:8 - 0:0 - 0:0
18514613,2024-05-06 11:45:00,Rafayelyan Edgar - Nazaryan Mushegh,0:3,11:8 - 11:5 - 11:7 - 0:0 - 0:0,3,0,Rafayelyan Edgar,Nazaryan Mushegh,fiurst,Nazaryan Mushegh - Rafayelyan Edgar,53,20,33,13,-13,19,16,18,0,0,3,6,4,0,0,13,8:11 - 5:11 - 7:11 - 0:0 - 0:0
18514612,2024-05-06 11:30:00,Asatryan Murad - Diaryan Aleksandr,3:1,11:7 - 3:11 - 11:8 - 11:5 - 0:0,3,1,Asatryan Murad,Diaryan Aleksandr,fiurst,Asatryan Murad - Diaryan Aleksandr,67,36,31,-5,5,18,14,19,16,0,-4,8,-3,-6,0,-5,11:7 - 3:11 - 11:8 - 11:5 - 0:0
18514602,2024-05-06 11:00:00,Nazaryan Mushegh - Asatryan Murad,3:0,5:11 - 5:11 - 8:11 - 0:0 - 0:0,0,3,Nazaryan Mushegh,Asatryan Murad,fiurst,Asatryan Murad - Nazaryan Mushegh,51,33,18,-15,15,16,16,19,0,0,-6,-6,-3,0,0,-15,11:5 - 11:5 - 11:8 - 0:0 - 0:0
18514597,2024-05-06 10:45:00,Diaryan Aleksandr - Rafayelyan Edgar,2:3,11:3 - 11:13 - 10:12 - 11:6 - 8:11,2,3,Diaryan Aleksandr,Rafayelyan Edgar,fiurst,Diaryan Aleksandr - Rafayelyan Edgar,96,51,45,-6,6,14,24,22,17,19,-8,2,2,-5,3,-6,11:3 - 11:13 - 10:12 - 11:6 - 8:11
18514585,2024-05-06 10:15:00,Rafayelyan Edgar - Asatryan Murad,3:1,7:11 - 12:10 - 11:13 - 4:11 - 0:0,1,3,Rafayelyan Edgar,Asatryan Murad,fiurst,Asatryan Murad - Rafayelyan Edgar,79,45,34,-11,11,18,22,24,15,0,-4,2,-2,-7,0,-11,11:7 - 10:12 - 13:11 - 11:4 - 0:0
18492797,2024-05-05 17:45:00,Darbinyan Armen - Petrosyan Karen,3:1,12:10 - 8:11 - 11:6 - 11:5 - 0:0,3,1,Darbinyan Armen,Petrosyan Karen,fiurst,Darbinyan Armen - Petrosyan Karen,74,42,32,-10,10,22,19,17,16,0,-2,3,-5,-6,0,-10,12:10 - 8:11 - 11:6 - 11:5 - 0:0
18492792,2024-05-05 17:30:00,Babakhanyan Artak - Sahakyan Arman,1:3,11:4 - 9:11 - 8:11 - 3:11 - 0:0,1,3,Babakhanyan Artak,Sahakyan Arman,fiurst,Babakhanyan Artak - Sahakyan Arman,68,31,37,6,-6,15,20,19,14,0,-7,2,3,8,0,6,11:4 - 9:11 - 8:11 - 3:11 - 0:0
18492773,2024-05-05 17:15:00,Miroyan Hakob - Darbinyan Armen,1:3,8:11 - 12:10 - 11:9 - 11:8 - 0:0,3,1,Miroyan Hakob,Darbinyan Armen,fiurst,Darbinyan Armen - Miroyan Hakob,80,38,42,4,-4,19,22,20,19,0,-3,2,2,3,0,4,11:8 - 10:12 - 9:11 - 8:11 - 0:0
18492766,2024-05-05 17:00:00,Babakhanyan Artak - Petrosyan Karen,3:1,11:8 - 9:11 - 11:6 - 11:8 - 0:0,3,1,Babakhanyan Artak,Petrosyan Karen,fiurst,Babakhanyan Artak - Petrosyan Karen,75,42,33,-9,9,19,20,17,19,0,-3,2,-5,-3,0,-9,11:8 - 9:11 - 11:6 - 11:8 - 0:0
18492760,2024-05-05 16:45:00,Sahakyan Arman - Miroyan Hakob,3:0,5:11 - 7:11 - 3:11 - 0:0 - 0:0,0,3,Sahakyan Arman,Miroyan Hakob,fiurst,Miroyan Hakob - Sahakyan Arman,48,33,15,-18,18,16,18,14,0,0,-6,-4,-8,0,0,-18,11:5 - 11:7 - 11:3 - 0:0 - 0:0
18492754,2024-05-05 16:30:00,Darbinyan Armen - Babakhanyan Artak,3:1,10:12 - 11:9 - 7:11 - 9:11 - 0:0,1,3,Darbinyan Armen,Babakhanyan Artak,fiurst,Babakhanyan Artak - Darbinyan Armen,80,43,37,-6,6,22,20,18,20,0,-2,2,-4,-2,0,-6,12:10 - 9:11 - 11:7 - 11:9 - 0:0
18492752,2024-05-05 16:15:00,Petrosyan Karen - Miroyan Hakob,3:1,6:11 - 16:14 - 9:11 - 7:11 - 0:0,1,3,Petrosyan Karen,Miroyan Hakob,fiurst,Miroyan Hakob - Petrosyan Karen,85,47,38,-9,9,17,30,20,18,0,-5,2,-2,-4,0,-9,11:6 - 14:16 - 11:9 - 11:7 - 0:0
18492738,2024-05-05 16:00:00,Sahakyan Arman - Darbinyan Armen,3:2,11:4 - 6:11 - 9:11 - 11:6 - 9:11,2,3,Sahakyan Arman,Darbinyan Armen,fiurst,Darbinyan Armen - Sahakyan Arman,89,43,46,3,-3,15,17,20,17,20,7,-5,-2,5,-2,3,4:11 - 11:6 - 11:9 - 6:11 - 11:9
18492736,2024-05-05 15:45:00,Miroyan Hakob - Babakhanyan Artak,3:1,6:11 - 14:12 - 7:11 - 8:11 - 0:0,1,3,Miroyan Hakob,Babakhanyan Artak,fiurst,Babakhanyan Artak - Miroyan Hakob,80,45,35,-10,10,17,26,18,19,0,-5,2,-4,-3,0,-10,11:6 - 12:14 - 11:7 - 11:8 - 0:0
18492722,2024-05-05 15:30:00,Petrosyan Karen - Sahakyan Arman,0:3,8:11 - 2:11 - 5:11 - 0:0 - 0:0,0,3,Petrosyan Karen,Sahakyan Arman,fiurst,Petrosyan Karen - Sahakyan Arman,48,15,33,18,-18,19,13,16,0,0,3,9,6,0,0,18,8:11 - 2:11 - 5:11 - 0:0 - 0:0
18491366,2024-05-05 15:05:00,Rafayelyan Edgar - Asatryan Murad,3:0,4:11 - 4:11 - 7:11 - 0:0 - 0:0,0,3,Rafayelyan Edgar,Asatryan Murad,fiurst,Asatryan Murad - Rafayelyan Edgar,48,33,15,-18,18,15,15,18,0,0,-7,-7,-4,0,0,-18,11:4 - 11:4 - 11:7 - 0:0 - 0:0
18491360,2024-05-05 15:00:00,Diaryan Aleksandr - Papyan Karen,3:0,11:5 - 13:11 - 11:8 - 0:0 - 0:0,3,0,Diaryan Aleksandr,Papyan Karen,fiurst,Diaryan Aleksandr - Papyan Karen,59,35,24,-11,11,16,24,19,0,0,-6,-2,-3,0,0,-11,11:5 - 13:11 - 11:8 - 0:0 - 0:0
18491354,2024-05-05 14:30:00,Asatryan Murad - Diaryan Aleksandr,3:0,11:9 - 11:5 - 11:8 - 0:0 - 0:0,3,0,Asatryan Murad,Diaryan Aleksandr,fiurst,Asatryan Murad - Diaryan Aleksandr,55,33,22,-11,11,20,16,19,0,0,-2,-6,-3,0,0,-11,11:9 - 11:5 - 11:8 - 0:0 - 0:0
18491350,2024-05-05 14:00:00,Rafayelyan Edgar - Diaryan Aleksandr,3:2,11:6 - 11:9 - 9:11 - 8:11 - 10:12,2,3,Rafayelyan Edgar,Diaryan Aleksandr,fiurst,Diaryan Aleksandr - Rafayelyan Edgar,98,49,49,0,0,17,20,20,19,22,5,2,-2,-3,-2,0,6:11 - 9:11 - 11:9 - 11:8 - 12:10
18491348,2024-05-05 13:45:00,Asatryan Murad - Nazaryan Mushegh,3:0,11:6 - 11:8 - 11:4 - 0:0 - 0:0,3,0,Asatryan Murad,Nazaryan Mushegh,fiurst,Asatryan Murad - Nazaryan Mushegh,51,33,18,-15,15,17,19,15,0,0,-5,-3,-7,0,0,-15,11:6 - 11:8 - 11:4 - 0:0 - 0:0
18491341,2024-05-05 13:30:00,Papyan Karen - Rafayelyan Edgar,1:3,5:11 - 13:15 - 11:8 - 6:11 - 0:0,1,3,Papyan Karen,Rafayelyan Edgar,fiurst,Papyan Karen - Rafayelyan Edgar,80,35,45,10,-10,16,28,19,17,0,6,2,-3,5,0,10,5:11 - 13:15 - 11:8 - 6:11 - 0:0
18491340,2024-05-05 13:15:00,Diaryan Aleksandr - Nazaryan Mushegh,3:0,11:5 - 11:8 - 11:4 - 0:0 - 0:0,3,0,Diaryan Aleksandr,Nazaryan Mushegh,fiurst,Diaryan Aleksandr - Nazaryan Mushegh,50,33,17,-16,16,16,19,15,0,0,-6,-3,-7,0,0,-16,11:5 - 11:8 - 11:4 - 0:0 - 0:0
18491329,2024-05-05 13:00:00,Papyan Karen - Asatryan Murad,3:1,5:11 - 6:11 - 13:11 - 7:11 - 0:0,1,3,Papyan Karen,Asatryan Murad,fiurst,Asatryan Murad - Papyan Karen,75,44,31,-13,13,16,17,24,18,0,-6,-5,2,-4,0,-13,11:5 - 11:6 - 11:13 - 11:7 - 0:0
18491327,2024-05-05 12:15:00,Rafayelyan Edgar - Nazaryan Mushegh,0:3,12:10 - 11:6 - 11:9 - 0:0 - 0:0,3,0,Rafayelyan Edgar,Nazaryan Mushegh,fiurst,Nazaryan Mushegh - Rafayelyan Edgar,59,25,34,9,-9,22,17,20,0,0,2,5,2,0,0,9,10:12 - 6:11 - 9:11 - 0:0 - 0:0
18491324,2024-05-05 12:00:00,Papyan Karen - Diaryan Aleksandr,2:3,10:12 - 6:11 - 11:5 - 11:9 - 11:5,3,2,Papyan Karen,Diaryan Aleksandr,fiurst,Diaryan Aleksandr - Papyan Karen,91,42,49,7,-7,22,17,16,20,16,-2,-5,6,2,6,7,12:10 - 11:6 - 5:11 - 9:11 - 5:11
18491321,2024-05-05 11:45:00,Asatryan Murad - Rafayelyan Edgar,1:3,8:11 - 7:11 - 11:6 - 9:11 - 0:0,1,3,Asatryan Murad,Rafayelyan Edgar,fiurst,Asatryan Murad - Rafayelyan Edgar,74,35,39,4,-4,19,18,17,20,0,3,4,-5,2,0,4,8:11 - 7:11 - 11:6 - 9:11 - 0:0
18491320,2024-05-05 11:30:00,Papyan Karen - Nazaryan Mushegh,3:1,7:11 - 11:13 - 11:8 - 8:11 - 0:0,1,3,Papyan Karen,Nazaryan Mushegh,fiurst,Nazaryan Mushegh - Papyan Karen,80,43,37,-6,6,18,24,19,19,0,-4,-2,3,-3,0,-6,11:7 - 13:11 - 8:11 - 11:8 - 0:0
18491319,2024-05-05 11:15:00,Diaryan Aleksandr - Asatryan Murad,0:3,11:8 - 11:2 - 11:6 - 0:0 - 0:0,3,0,Diaryan Aleksandr,Asatryan Murad,fiurst,Asatryan Murad - Diaryan Aleksandr,49,16,33,17,-17,19,13,17,0,0,3,9,5,0,0,17,8:11 - 2:11 - 6:11 - 0:0 - 0:0
18491307,2024-05-05 11:05:00,Rafayelyan Edgar - Papyan Karen,1:3,8:11 - 11:5 - 11:3 - 11:2 - 0:0,3,1,Rafayelyan Edgar,Papyan Karen,fiurst,Papyan Karen - Rafayelyan Edgar,62,21,41,20,-20,19,16,14,13,0,-3,6,8,9,0,20,11:8 - 5:11 - 3:11 - 2:11 - 0:0
18491305,2024-05-05 10:45:00,Nazaryan Mushegh - Asatryan Murad,3:0,5:11 - 8:11 - 3:11 - 0:0 - 0:0,0,3,Nazaryan Mushegh,Asatryan Murad,fiurst,Asatryan Murad - Nazaryan Mushegh,49,33,16,-17,17,16,19,14,0,0,-6,-3,-8,0,0,-17,11:5 - 11:8 - 11:3 - 0:0 - 0:0
18452382,2024-05-05 10:30:00,Diaryan Aleksandr - Rafayelyan Edgar,2:3,11:4 - 11:4 - 9:11 - 7:11 - 3:11,2,3,Diaryan Aleksandr,Rafayelyan Edgar,fiurst,Diaryan Aleksandr - Rafayelyan Edgar,82,41,41,0,0,15,15,20,18,14,-7,-7,2,4,8,0,11:4 - 11:4 - 9:11 - 7:11 - 3:11
18452381,2024-05-05 10:15:00,Asatryan Murad - Papyan Karen,1:3,11:6 - 5:11 - 8:11 - 10:12 - 0:0,1,3,Asatryan Murad,Papyan Karen,fiurst,Asatryan Murad - Papyan Karen,74,34,40,6,-6,17,16,19,22,0,-5,6,3,2,0,6,11:6 - 5:11 - 8:11 - 10:12 - 0:0
18476127,2024-05-05 10:00:00,Nazaryan Mushegh - Diaryan Aleksandr,3:0,6:11 - 4:11 - 10:12 - 0:0 - 0:0,0,3,Nazaryan Mushegh,Diaryan Aleksandr,fiurst,Diaryan Aleksandr - Nazaryan Mushegh,54,34,20,-14,14,17,15,22,0,0,-5,-7,-2,0,0,-14,11:6 - 11:4 - 12:10 - 0:0 - 0:0
18476200,2024-05-04 17:45:00,Hakobyan Eduard - Soghomonyan Hrayr,0:3,9:11 - 9:11 - 11:13 - 0:0 - 0:0,0,3,Hakobyan Eduard,Soghomonyan Hrayr,fiurst,Hakobyan Eduard - Soghomonyan Hrayr,64,29,35,6,-6,20,20,24,0,0,2,2,2,0,0,6,9:11 - 9:11 - 11:13 - 0:0 - 0:0
18476198,2024-05-04 17:30:00,Gevorgyan Gegham - Gevorgyan Hayk,2:3,12:10 - 3:11 - 11:8 - 6:11 - 4:11,2,3,Gevorgyan Gegham,Gevorgyan Hayk,fiurst,Gevorgyan Gegham - Gevorgyan Hayk,87,36,51,15,-15,22,14,19,17,15,-2,8,-3,5,7,15,12:10 - 3:11 - 11:8 - 6:11 - 4:11
18476197,2024-05-04 17:15:00,Avakimyan Davit - Hakobyan Eduard,2:3,11:8 - 8:11 - 11:8 - 3:11 - 4:11,2,3,Avakimyan Davit,Hakobyan Eduard,fiurst,Avakimyan Davit - Hakobyan Eduard,86,37,49,12,-12,19,19,19,14,15,-3,3,-3,8,7,12,11:8 - 8:11 - 11:8 - 3:11 - 4:11
18476185,2024-05-04 17:00:00,Gevorgyan Gegham - Soghomonyan Hrayr,1:3,6:11 - 11:9 - 9:11 - 5:11 - 0:0,1,3,Gevorgyan Gegham,Soghomonyan Hrayr,fiurst,Gevorgyan Gegham - Soghomonyan Hrayr,73,31,42,11,-11,17,20,20,16,0,5,-2,2,6,0,11,6:11 - 11:9 - 9:11 - 5:11 - 0:0
18476184,2024-05-04 16:45:00,Gevorgyan Hayk - Avakimyan Davit,2:3,21:23 - 11:9 - 9:11 - 11:9 - 12:10,3,2,Gevorgyan Hayk,Avakimyan Davit,fiurst,Avakimyan Davit - Gevorgyan Hayk,126,62,64,2,-2,44,20,20,20,22,-2,2,-2,2,2,2,23:21 - 9:11 - 11:9 - 9:11 - 10:12
18476181,2024-05-04 16:30:00,Hakobyan Eduard - Gevorgyan Gegham,2:3,11:8 - 6:11 - 8:11 - 11:6 - 11:7,3,2,Hakobyan Eduard,Gevorgyan Gegham,fiurst,Gevorgyan Gegham - Hakobyan Eduard,90,43,47,4,-4,19,17,19,17,18,3,-5,-3,5,4,4,8:11 - 11:6 - 11:8 - 6:11 - 7:11
18476169,2024-05-04 16:15:00,Soghomonyan Hrayr - Avakimyan Davit,3:2,6:11 - 11:5 - 11:8 - 10:12 - 9:11,2,3,Soghomonyan Hrayr,Avakimyan Davit,fiurst,Avakimyan Davit - Soghomonyan Hrayr,94,47,47,0,0,17,16,19,22,20,-5,6,3,-2,-2,0,11:6 - 5:11 - 8:11 - 12:10 - 11:9
18476168,2024-05-04 16:00:00,Gevorgyan Hayk - Hakobyan Eduard,2:3,12:10 - 11:5 - 9:11 - 9:11 - 9:11,2,3,Gevorgyan Hayk,Hakobyan Eduard,fiurst,Gevorgyan Hayk - Hakobyan Eduard,98,50,48,-2,2,22,16,20,20,20,-2,-6,2,2,2,-2,12:10 - 11:5 - 9:11 - 9:11 - 9:11
18476167,2024-05-04 15:45:00,Avakimyan Davit - Gevorgyan Gegham,3:0,11:5 - 14:12 - 11:7 - 0:0 - 0:0,3,0,Avakimyan Davit,Gevorgyan Gegham,fiurst,Avakimyan Davit - Gevorgyan Gegham,60,36,24,-12,12,16,26,18,0,0,-6,-2,-4,0,0,-12,11:5 - 14:12 - 11:7 - 0:0 - 0:0
18476165,2024-05-04 15:30:00,Soghomonyan Hrayr - Gevorgyan Hayk,3:0,6:11 - 5:11 - 2:11 - 0:0 - 0:0,0,3,Soghomonyan Hrayr,Gevorgyan Hayk,fiurst,Gevorgyan Hayk - Soghomonyan Hrayr,46,33,13,-20,20,17,16,13,0,0,-5,-6,-9,0,0,-20,11:6 - 11:5 - 11:2 - 0:0 - 0:0
18476159,2024-05-04 15:20:00,Diaryan Aleksandr - Arutyunov Ruben,1:3,11:3 - 11:8 - 17:19 - 11:8 - 0:0,3,1,Diaryan Aleksandr,Arutyunov Ruben,fiurst,Arutyunov Ruben - Diaryan Aleksandr,88,38,50,12,-12,14,19,36,19,0,8,3,-2,3,0,12,3:11 - 8:11 - 19:17 - 8:11 - 0:0
18476152,2024-05-04 15:00:00,Rafayelyan Edgar - Hovhannesyan Rafik,0:3,11:4 - 11:5 - 11:7 - 0:0 - 0:0,3,0,Rafayelyan Edgar,Hovhannesyan Rafik,fiurst,Hovhannesyan Rafik - Rafayelyan Edgar,49,16,33,17,-17,15,16,18,0,0,7,6,4,0,0,17,4:11 - 5:11 - 7:11 - 0:0 - 0:0
18476149,2024-05-04 14:50:00,Papyan Karen - Diaryan Aleksandr,2:3,12:10 - 8:11 - 13:15 - 11:8 - 11:8,3,2,Papyan Karen,Diaryan Aleksandr,fiurst,Diaryan Aleksandr - Papyan Karen,107,52,55,3,-3,22,19,28,19,19,2,-3,-2,3,3,3,10:12 - 11:8 - 15:13 - 8:11 - 8:11
18476139,2024-05-04 14:30:00,Arutyunov Ruben - Rafayelyan Edgar,0:3,2:11 - 9:11 - 8:11 - 0:0 - 0:0,0,3,Arutyunov Ruben,Rafayelyan Edgar,fiurst,Arutyunov Ruben - Rafayelyan Edgar,52,19,33,14,-14,13,20,19,0,0,9,2,3,0,0,14,2:11 - 9:11 - 8:11 - 0:0 - 0:0
18476135,2024-05-04 14:20:00,Papyan Karen - Hovhannesyan Rafik,2:3,11:2 - 10:12 - 7:11 - 11:6 - 11:8,3,2,Papyan Karen,Hovhannesyan Rafik,fiurst,Hovhannesyan Rafik - Papyan Karen,89,39,50,11,-11,13,22,18,17,19,9,-2,-4,5,3,11,2:11 - 12:10 - 11:7 - 6:11 - 8:11
18476132,2024-05-04 14:00:00,Diaryan Aleksandr - Rafayelyan Edgar,2:3,11:9 - 8:11 - 11:5 - 6:11 - 6:11,2,3,Diaryan Aleksandr,Rafayelyan Edgar,fiurst,Diaryan Aleksandr - Rafayelyan Edgar,89,42,47,5,-5,20,19,16,17,17,-2,3,-6,5,5,5,11:9 - 8:11 - 11:5 - 6:11 - 6:11
18476130,2024-05-04 13:45:00,Arutyunov Ruben - Papyan Karen,3:2,11:3 - 8:11 - 11:5 - 8:11 - 11:6,3,2,Arutyunov Ruben,Papyan Karen,fiurst,Arutyunov Ruben - Papyan Karen,85,49,36,-13,13,14,19,16,19,17,-8,3,-6,3,-5,-13,11:3 - 8:11 - 11:5 - 8:11 - 11:6
18476115,2024-05-04 13:30:00,Hovhannesyan Rafik - Diaryan Aleksandr,0:3,11:9 - 11:7 - 12:10 - 0:0 - 0:0,3,0,Hovhannesyan Rafik,Diaryan Aleksandr,fiurst,Diaryan Aleksandr - Hovhannesyan Rafik,60,26,34,8,-8,20,18,22,0,0,2,4,2,0,0,8,9:11 - 7:11 - 10:12 - 0:0 - 0:0
18476114,2024-05-04 13:15:00,Rafayelyan Edgar - Papyan Karen,0:3,11:8 - 11:3 - 11:2 - 0:0 - 0:0,3,0,Rafayelyan Edgar,Papyan Karen,fiurst,Papyan Karen - Rafayelyan Edgar,46,13,33,20,-20,19,14,13,0,0,3,8,9,0,0,20,8:11 - 3:11 - 2:11 - 0:0 - 0:0
18476113,2024-05-04 13:00:00,Hovhannesyan Rafik - Arutyunov Ruben,0:3,11:4 - 11:5 - 11:5 - 0:0 - 0:0,3,0,Hovhannesyan Rafik,Arutyunov Ruben,fiurst,Arutyunov Ruben - Hovhannesyan Rafik,47,14,33,19,-19,15,16,16,0,0,7,6,6,0,0,19,4:11 - 5:11 - 5:11 - 0:0 - 0:0
18476112,2024-05-04 12:20:00,Diaryan Aleksandr - Papyan Karen,3:0,11:5 - 11:4 - 11:6 - 0:0 - 0:0,3,0,Diaryan Aleksandr,Papyan Karen,fiurst,Diaryan Aleksandr - Papyan Karen,48,33,15,-18,18,16,15,17,0,0,-6,-7,-5,0,0,-18,11:5 - 11:4 - 11:6 - 0:0 - 0:0
18476108,2024-05-04 12:00:00,Hovhannesyan Rafik - Rafayelyan Edgar,0:3,4:11 - 8:11 - 6:11 - 0:0 - 0:0,0,3,Hovhannesyan Rafik,Rafayelyan Edgar,fiurst,Hovhannesyan Rafik - Rafayelyan Edgar,51,18,33,15,-15,15,19,17,0,0,7,3,5,0,0,15,4:11 - 8:11 - 6:11 - 0:0 - 0:0
18476105,2024-05-04 11:55:00,Arutyunov Ruben - Diaryan Aleksandr,0:3,6:11 - 19:21 - 7:11 - 0:0 - 0:0,0,3,Arutyunov Ruben,Diaryan Aleksandr,fiurst,Arutyunov Ruben - Diaryan Aleksandr,75,32,43,11,-11,17,40,18,0,0,5,2,4,0,0,11,6:11 - 19:21 - 7:11 - 0:0 - 0:0
18476099,2024-05-04 11:30:00,Hovhannesyan Rafik - Papyan Karen,3:1,11:6 - 11:3 - 5:11 - 11:6 - 0:0,3,1,Hovhannesyan Rafik,Papyan Karen,fiurst,Hovhannesyan Rafik - Papyan Karen,64,38,26,-12,12,17,14,16,17,0,-5,-8,6,-5,0,-12,11:6 - 11:3 - 5:11 - 11:6 - 0:0
18476088,2024-05-04 11:25:00,Rafayelyan Edgar - Arutyunov Ruben,0:3,11:7 - 11:6 - 11:6 - 0:0 - 0:0,3,0,Rafayelyan Edgar,Arutyunov Ruben,fiurst,Arutyunov Ruben - Rafayelyan Edgar,52,19,33,14,-14,18,17,17,0,0,4,5,5,0,0,14,7:11 - 6:11 - 6:11 - 0:0 - 0:0
18476082,2024-05-04 11:00:00,Diaryan Aleksandr - Hovhannesyan Rafik,3:0,11:7 - 11:2 - 11:8 - 0:0 - 0:0,3,0,Diaryan Aleksandr,Hovhannesyan Rafik,fiurst,Diaryan Aleksandr - Hovhannesyan Rafik,50,33,17,-16,16,18,13,19,0,0,-4,-9,-3,0,0,-16,11:7 - 11:2 - 11:8 - 0:0 - 0:0
18476081,2024-05-04 10:45:00,Papyan Karen - Arutyunov Ruben,3:2,11:8 - 11:8 - 5:11 - 7:11 - 11:13,2,3,Papyan Karen,Arutyunov Ruben,fiurst,Arutyunov Ruben - Papyan Karen,96,51,45,-6,6,19,19,16,18,24,3,3,-6,-4,-2,-6,8:11 - 8:11 - 11:5 - 11:7 - 13:11
18476079,2024-05-04 10:30:00,Rafayelyan Edgar - Diaryan Aleksandr,1:3,11:5 - 11:9 - 5:11 - 11:4 - 0:0,3,1,Rafayelyan Edgar,Diaryan Aleksandr,fiurst,Diaryan Aleksandr - Rafayelyan Edgar,67,29,38,9,-9,16,20,16,15,0,6,2,-6,7,0,9,5:11 - 9:11 - 11:5 - 4:11 - 0:0
18476024,2024-05-04 10:15:00,Arutyunov Ruben - Hovhannesyan Rafik,2:1,6:11 - 11:7 - 11:2 - 8:3 - 0:0,2,1,Arutyunov Ruben,Hovhannesyan Rafik,fiurst,Arutyunov Ruben - Hovhannesyan Rafik,59,36,23,-13,13,17,18,13,11,0,5,-4,-9,-5,0,-13,6:11 - 11:7 - 11:2 - 8:3 - 0:0
18476022,2024-05-04 10:00:00,Papyan Karen - Rafayelyan Edgar,1:3,11:6 - 9:11 - 11:13 - 5:11 - 0:0,1,3,Papyan Karen,Rafayelyan Edgar,fiurst,Papyan Karen - Rafayelyan Edgar,77,36,41,5,-5,17,20,24,16,0,-5,2,2,6,0,5,11:6 - 9:11 - 11:13 - 5:11 - 0:0
18452384,2024-05-03 17:45:00,Hakobyan Eduard - Gevorgyan Gegham,1:3,12:10 - 4:11 - 18:16 - 11:9 - 0:0,3,1,Hakobyan Eduard,Gevorgyan Gegham,fiurst,Gevorgyan Gegham - Hakobyan Eduard,91,46,45,-1,1,22,15,34,20,0,2,-7,2,2,0,-1,10:12 - 11:4 - 16:18 - 9:11 - 0:0
18452368,2024-05-03 16:40:00,Avakimyan Davit - Petrosyan Davit,3:1,11:8 - 13:11 - 9:11 - 11:9 - 0:0,3,1,Avakimyan Davit,Petrosyan Davit,fiurst,Avakimyan Davit - Petrosyan Davit,83,44,39,-5,5,19,24,20,20,0,-3,-2,2,-2,0,-5,11:8 - 13:11 - 9:11 - 11:9 - 0:0
18452367,2024-05-03 16:30:00,Hakobyan Eduard - Soghomonyan Hrayr,0:3,9:11 - 5:11 - 6:11 - 0:0 - 0:0,0,3,Hakobyan Eduard,Soghomonyan Hrayr,fiurst,Hakobyan Eduard - Soghomonyan Hrayr,53,20,33,13,-13,20,16,17,0,0,2,6,5,0,0,13,9:11 - 5:11 - 6:11 - 0:0 - 0:0
18452366,2024-05-03 16:15:00,Gevorgyan Gegham - Petrosyan Davit,0:3,7:11 - 7:11 - 7:11 - 0:0 - 0:0,0,3,Gevorgyan Gegham,Petrosyan Davit,fiurst,Gevorgyan Gegham - Petrosyan Davit,54,21,33,12,-12,18,18,18,0,0,4,4,4,0,0,12,7:11 - 7:11 - 7:11 - 0:0 - 0:0
18452363,2024-05-03 16:00:00,Avakimyan Davit - Hakobyan Eduard,0:3,8:11 - 6:11 - 3:11 - 0:0 - 0:0,0,3,Avakimyan Davit,Hakobyan Eduard,fiurst,Avakimyan Davit - Hakobyan Eduard,50,17,33,16,-16,19,17,14,0,0,3,5,8,0,0,16,8:11 - 6:11 - 3:11 - 0:0 - 0:0
18452361,2024-05-03 15:45:00,Petrosyan Davit - Soghomonyan Hrayr,1:3,11:6 - 4:11 - 4:11 - 2:11 - 0:0,1,3,Petrosyan Davit,Soghomonyan Hrayr,fiurst,Petrosyan Davit - Soghomonyan Hrayr,60,21,39,18,-18,17,15,15,13,0,-5,7,7,9,0,18,11:6 - 4:11 - 4:11 - 2:11 - 0:0
18452360,2024-05-03 15:30:00,Gevorgyan Gegham - Avakimyan Davit,3:1,9:11 - 12:10 - 10:12 - 7:11 - 0:0,1,3,Gevorgyan Gegham,Avakimyan Davit,fiurst,Avakimyan Davit - Gevorgyan Gegham,82,44,38,-6,6,20,22,22,18,0,-2,2,-2,-4,0,-6,11:9 - 10:12 - 12:10 - 11:7 - 0:0
18452356,2024-05-03 15:20:00,Nazaryan Mushegh - Papyan Karen,0:3,8:11 - 6:11 - 7:11 - 0:0 - 0:0,0,3,Nazaryan Mushegh,Papyan Karen,fiurst,Nazaryan Mushegh - Papyan Karen,54,21,33,12,-12,19,17,18,0,0,3,5,4,0,0,12,8:11 - 6:11 - 7:11 - 0:0 - 0:0
18452348,2024-05-03 15:05:00,Arutyunov Ruben - Asatryan Murad,1:3,11:5 - 9:11 - 9:11 - 9:11 - 0:0,1,3,Arutyunov Ruben,Asatryan Murad,fiurst,Arutyunov Ruben - Asatryan Murad,76,38,38,0,0,16,20,20,20,0,-6,2,2,2,0,0,11:5 - 9:11 - 9:11 - 9:11 - 0:0
18452346,2024-05-03 14:50:00,Hovhannesyan Rafik - Nazaryan Mushegh,3:2,9:11 - 6:11 - 11:9 - 11:5 - 11:4,3,2,Hovhannesyan Rafik,Nazaryan Mushegh,fiurst,Hovhannesyan Rafik - Nazaryan Mushegh,88,48,40,-8,8,20,17,20,16,15,2,5,-2,-6,-7,-8,9:11 - 6:11 - 11:9 - 11:5 - 11:4
18452344,2024-05-03 14:30:00,Papyan Karen - Arutyunov Ruben,3:2,11:9 - 8:11 - 6:11 - 11:9 - 8:11,2,3,Papyan Karen,Arutyunov Ruben,fiurst,Arutyunov Ruben - Papyan Karen,95,51,44,-7,7,20,19,17,20,19,2,-3,-5,2,-3,-7,9:11 - 11:8 - 11:6 - 9:11 - 11:8
18452342,2024-05-03 14:20:00,Hovhannesyan Rafik - Asatryan Murad,3:1,11:6 - 10:12 - 7:11 - 8:11 - 0:0,1,3,Hovhannesyan Rafik,Asatryan Murad,fiurst,Asatryan Murad - Hovhannesyan Rafik,76,40,36,-4,4,17,22,18,19,0,5,-2,-4,-3,0,-4,6:11 - 12:10 - 11:7 - 11:8 - 0:0
18452337,2024-05-03 14:00:00,Nazaryan Mushegh - Arutyunov Ruben,0:3,11:2 - 11:3 - 11:5 - 0:0 - 0:0,3,0,Nazaryan Mushegh,Arutyunov Ruben,fiurst,Arutyunov Ruben - Nazaryan Mushegh,43,10,33,23,-23,13,14,16,0,0,9,8,6,0,0,23,2:11 - 3:11 - 5:11 - 0:0 - 0:0
18452325,2024-05-03 13:50:00,Papyan Karen - Hovhannesyan Rafik,3:2,4:11 - 11:7 - 11:13 - 11:8 - 9:11,2,3,Papyan Karen,Hovhannesyan Rafik,fiurst,Hovhannesyan Rafik - Papyan Karen,96,50,46,-4,4,15,18,24,19,20,-7,4,-2,3,-2,-4,11:4 - 7:11 - 13:11 - 8:11 - 11:9
18452316,2024-05-03 13:30:00,Asatryan Murad - Nazaryan Mushegh,3:0,11:4 - 11:3 - 11:6 - 0:0 - 0:0,3,0,Asatryan Murad,Nazaryan Mushegh,fiurst,Asatryan Murad - Nazaryan Mushegh,46,33,13,-20,20,15,14,17,0,0,-7,-8,-5,0,0,-20,11:4 - 11:3 - 11:6 - 0:0 - 0:0
18452315,2024-05-03 13:15:00,Arutyunov Ruben - Hovhannesyan Rafik,3:1,5:11 - 11:4 - 11:3 - 11:9 - 0:0,3,1,Arutyunov Ruben,Hovhannesyan Rafik,fiurst,Arutyunov Ruben - Hovhannesyan Rafik,65,38,27,-11,11,16,15,14,20,0,6,-7,-8,-2,0,-11,5:11 - 11:4 - 11:3 - 11:9 - 0:0
18452290,2024-05-03 13:00:00,Asatryan Murad - Papyan Karen,3:1,11:6 - 8:11 - 11:3 - 11:5 - 0:0,3,1,Asatryan Murad,Papyan Karen,fiurst,Asatryan Murad - Papyan Karen,66,41,25,-16,16,17,19,14,16,0,-5,3,-8,-6,0,-16,11:6 - 8:11 - 11:3 - 11:5 - 0:0
18452286,2024-05-03 12:15:00,Nazaryan Mushegh - Hovhannesyan Rafik,3:0,6:11 - 7:11 - 7:11 - 0:0 - 0:0,0,3,Nazaryan Mushegh,Hovhannesyan Rafik,fiurst,Hovhannesyan Rafik - Nazaryan Mushegh,53,33,20,-13,13,17,18,18,0,0,-5,-4,-4,0,0,-13,11:6 - 11:7 - 11:7 - 0:0 - 0:0
18452285,2024-05-03 12:00:00,Asatryan Murad - Arutyunov Ruben,1:3,12:10 - 9:11 - 11:9 - 11:1 - 0:0,3,1,Asatryan Murad,Arutyunov Ruben,fiurst,Arutyunov Ruben - Asatryan Murad,74,31,43,12,-12,22,20,20,12,0,2,-2,2,10,0,12,10:12 - 11:9 - 9:11 - 1:11 - 0:0
18452282,2024-05-03 11:45:00,Papyan Karen - Nazaryan Mushegh,1:3,11:5 - 8:11 - 11:6 - 11:9 - 0:0,3,1,Papyan Karen,Nazaryan Mushegh,fiurst,Nazaryan Mushegh - Papyan Karen,72,31,41,10,-10,16,19,17,20,0,6,-3,5,2,0,10,5:11 - 11:8 - 6:11 - 9:11 - 0:0
18452278,2024-05-03 11:30:00,Asatryan Murad - Hovhannesyan Rafik,2:3,11:8 - 10:12 - 8:11 - 11:6 - 9:11,2,3,Asatryan Murad,Hovhannesyan Rafik,fiurst,Asatryan Murad - Hovhannesyan Rafik,97,49,48,-1,1,19,22,19,17,20,-3,2,3,-5,2,-1,11:8 - 10:12 - 8:11 - 11:6 - 9:11
18452276,2024-05-03 11:15:00,Arutyunov Ruben - Papyan Karen,2:3,5:11 - 4:11 - 13:11 - 11:7 - 12:14,2,3,Arutyunov Ruben,Papyan Karen,fiurst,Arutyunov Ruben - Papyan Karen,99,45,54,9,-9,16,15,24,18,26,6,7,-2,-4,2,9,5:11 - 4:11 - 13:11 - 11:7 - 12:14
18452265,2024-05-03 11:00:00,Nazaryan Mushegh - Asatryan Murad,3:0,5:11 - 7:11 - 8:11 - 0:0 - 0:0,0,3,Nazaryan Mushegh,Asatryan Murad,fiurst,Asatryan Murad - Nazaryan Mushegh,53,33,20,-13,13,16,18,19,0,0,-6,-4,-3,0,0,-13,11:5 - 11:7 - 11:8 - 0:0 - 0:0
18452263,2024-05-03 10:45:00,Hovhannesyan Rafik - Papyan Karen,0:3,9:11 - 8:11 - 8:11 - 0:0 - 0:0,0,3,Hovhannesyan Rafik,Papyan Karen,fiurst,Hovhannesyan Rafik - Papyan Karen,58,25,33,8,-8,20,19,19,0,0,2,3,3,0,0,8,9:11 - 8:11 - 8:11 - 0:0 - 0:0
18452259,2024-05-03 10:30:00,Arutyunov Ruben - Nazaryan Mushegh,3:1,13:11 - 4:11 - 11:5 - 11:8 - 0:0,3,1,Arutyunov Ruben,Nazaryan Mushegh,fiurst,Arutyunov Ruben - Nazaryan Mushegh,74,39,35,-4,4,24,15,16,19,0,-2,7,-6,-3,0,-4,13:11 - 4:11 - 11:5 - 11:8 - 0:0
18452257,2024-05-03 10:15:00,Papyan Karen - Asatryan Murad,3:0,11:13 - 1:11 - 2:11 - 0:0 - 0:0,0,3,Papyan Karen,Asatryan Murad,fiurst,Asatryan Murad - Papyan Karen,49,35,14,-21,21,24,12,13,0,0,-2,-10,-9,0,0,-21,13:11 - 11:1 - 11:2 - 0:0 - 0:0
18452256,2024-05-03 10:00:00,Hovhannesyan Rafik - Arutyunov Ruben,1:3,11:6 - 4:11 - 11:8 - 13:11 - 0:0,3,1,Hovhannesyan Rafik,Arutyunov Ruben,fiurst,Arutyunov Ruben - Hovhannesyan Rafik,75,36,39,3,-3,17,15,19,24,0,5,-7,3,2,0,3,6:11 - 11:4 - 8:11 - 11:13 - 0:0
18438110,2024-05-02 17:50:00,Gevorgyan Gegham - Soghomonyan Hrayr,0:3,5:11 - 6:11 - 5:11 - 0:0 - 0:0,0,3,Gevorgyan Gegham,Soghomonyan Hrayr,fiurst,Gevorgyan Gegham - Soghomonyan Hrayr,49,16,33,17,-17,16,17,16,0,0,6,5,6,0,0,17,5:11 - 6:11 - 5:11 - 0:0 - 0:0
18438108,2024-05-02 17:20:00,Petrosyan Davit - Soghomonyan Hrayr,3:2,11:8 - 11:5 - 10:12 - 8:11 - 11:5,3,2,Petrosyan Davit,Soghomonyan Hrayr,fiurst,Petrosyan Davit - Soghomonyan Hrayr,92,51,41,-10,10,19,16,22,19,16,-3,-6,2,3,-6,-10,11:8 - 11:5 - 10:12 - 8:11 - 11:5
18438106,2024-05-02 17:00:00,Avakimyan Davit - Gevorgyan Gegham,1:3,7:11 - 15:13 - 8:11 - 8:11 - 0:0,1,3,Avakimyan Davit,Gevorgyan Gegham,fiurst,Avakimyan Davit - Gevorgyan Gegham,84,38,46,8,-8,18,28,19,19,0,4,-2,3,3,0,8,7:11 - 15:13 - 8:11 - 8:11 - 0:0
18438095,2024-05-02 16:30:00,Avakimyan Davit - Soghomonyan Hrayr,0:3,10:12 - 7:11 - 3:11 - 0:0 - 0:0,0,3,Avakimyan Davit,Soghomonyan Hrayr,fiurst,Avakimyan Davit - Soghomonyan Hrayr,54,20,34,14,-14,22,18,14,0,0,2,4,8,0,0,14,10:12 - 7:11 - 3:11 - 0:0 - 0:0
18438092,2024-05-02 16:15:00,Gevorgyan Gegham - Petrosyan Davit,0:3,7:11 - 8:11 - 8:11 - 0:0 - 0:0,0,3,Gevorgyan Gegham,Petrosyan Davit,fiurst,Gevorgyan Gegham - Petrosyan Davit,56,23,33,10,-10,18,19,19,0,0,4,3,3,0,0,10,7:11 - 8:11 - 8:11 - 0:0 - 0:0
18438085,2024-05-02 15:45:00,Petrosyan Davit - Avakimyan Davit,2:3,10:12 - 11:6 - 5:11 - 11:8 - 11:7,3,2,Petrosyan Davit,Avakimyan Davit,fiurst,Avakimyan Davit - Petrosyan Davit,92,44,48,4,-4,22,17,16,19,18,-2,5,-6,3,4,4,12:10 - 6:11 - 11:5 - 8:11 - 7:11
18438084,2024-05-02 15:30:00,Soghomonyan Hrayr - Gevorgyan Gegham,1:3,11:6 - 11:9 - 8:11 - 11:7 - 0:0,3,1,Soghomonyan Hrayr,Gevorgyan Gegham,fiurst,Gevorgyan Gegham - Soghomonyan Hrayr,74,33,41,8,-8,17,20,19,18,0,5,2,-3,4,0,8,6:11 - 9:11 - 11:8 - 7:11 - 0:0
18438067,2024-05-02 15:15:00,Diaryan Aleksandr - Arutyunov Ruben,0:3,11:9 - 11:8 - 11:5 - 0:0 - 0:0,3,0,Diaryan Aleksandr,Arutyunov Ruben,fiurst,Arutyunov Ruben - Diaryan Aleksandr,55,22,33,11,-11,20,19,16,0,0,2,3,6,0,0,11,9:11 - 8:11 - 5:11 - 0:0 - 0:0
18438065,2024-05-02 15:00:00,Gevorgyan Gegham - Avakimyan Davit,3:0,7:11 - 9:11 - 8:11 - 0:0 - 0:0,0,3,Gevorgyan Gegham,Avakimyan Davit,fiurst,Avakimyan Davit - Gevorgyan Gegham,57,33,24,-9,9,18,20,19,0,0,-4,-2,-3,0,0,-9,11:7 - 11:9 - 11:8 - 0:0 - 0:0
18438060,2024-05-02 14:45:00,Asatryan Murad - Diaryan Aleksandr,3:1,11:4 - 13:11 - 5:11 - 11:7 - 0:0,3,1,Asatryan Murad,Diaryan Aleksandr,fiurst,Asatryan Murad - Diaryan Aleksandr,73,40,33,-7,7,15,24,16,18,0,-7,-2,6,-4,0,-7,11:4 - 13:11 - 5:11 - 11:7 - 0:0
18438058,2024-05-02 14:30:00,Arutyunov Ruben - Papyan Karen,3:1,12:14 - 11:9 - 11:4 - 11:4 - 0:0,3,1,Arutyunov Ruben,Papyan Karen,fiurst,Arutyunov Ruben - Papyan Karen,76,45,31,-14,14,26,20,15,15,0,2,-2,-7,-7,0,-14,12:14 - 11:9 - 11:4 - 11:4 - 0:0
18438055,2024-05-02 14:15:00,Asatryan Murad - Rafayelyan Edgar,3:0,11:4 - 11:5 - 11:4 - 0:0 - 0:0,3,0,Asatryan Murad,Rafayelyan Edgar,fiurst,Asatryan Murad - Rafayelyan Edgar,46,33,13,-20,20,15,16,15,0,0,-7,-6,-7,0,0,-20,11:4 - 11:5 - 11:4 - 0:0 - 0:0
18438048,2024-05-02 14:00:00,Diaryan Aleksandr - Papyan Karen,3:0,11:5 - 11:5 - 11:4 - 0:0 - 0:0,3,0,Diaryan Aleksandr,Papyan Karen,fiurst,Diaryan Aleksandr - Papyan Karen,47,33,14,-19,19,16,16,15,0,0,-6,-6,-7,0,0,-19,11:5 - 11:5 - 11:4 - 0:0 - 0:0
18438043,2024-05-02 13:45:00,Arutyunov Ruben - Asatryan Murad,0:3,5:11 - 7:11 - 7:11 - 0:0 - 0:0,0,3,Arutyunov Ruben,Asatryan Murad,fiurst,Arutyunov Ruben - Asatryan Murad,52,19,33,14,-14,16,18,18,0,0,6,4,4,0,0,14,5:11 - 7:11 - 7:11 - 0:0 - 0:0
18438040,2024-05-02 13:30:00,Rafayelyan Edgar - Diaryan Aleksandr,1:3,11:6 - 9:11 - 11:7 - 11:9 - 0:0,3,1,Rafayelyan Edgar,Diaryan Aleksandr,fiurst,Diaryan Aleksandr - Rafayelyan Edgar,75,33,42,9,-9,17,20,18,20,0,5,-2,4,2,0,9,6:11 - 11:9 - 7:11 - 9:11 - 0:0
18438036,2024-05-02 13:15:00,Papyan Karen - Asatryan Murad,3:1,8:11 - 11:13 - 12:10 - 6:11 - 0:0,1,3,Papyan Karen,Asatryan Murad,fiurst,Asatryan Murad - Papyan Karen,82,45,37,-8,8,19,24,22,17,0,-3,-2,2,-5,0,-8,11:8 - 13:11 - 10:12 - 11:6 - 0:0
18438035,2024-05-02 13:00:00,Rafayelyan Edgar - Arutyunov Ruben,0:3,11:9 - 11:9 - 11:8 - 0:0 - 0:0,3,0,Rafayelyan Edgar,Arutyunov Ruben,fiurst,Arutyunov Ruben - Rafayelyan Edgar,59,26,33,7,-7,20,20,19,0,0,2,2,3,0,0,7,9:11 - 9:11 - 8:11 - 0:0 - 0:0
18438022,2024-05-02 12:25:00,Diaryan Aleksandr - Asatryan Murad,3:1,5:11 - 12:10 - 11:13 - 8:11 - 0:0,1,3,Diaryan Aleksandr,Asatryan Murad,fiurst,Asatryan Murad - Diaryan Aleksandr,81,45,36,-9,9,16,22,24,19,0,-6,2,-2,-3,0,-9,11:5 - 10:12 - 13:11 - 11:8 - 0:0
18438015,2024-05-02 12:00:00,Arutyunov Ruben - Diaryan Aleksandr,1:3,10:12 - 12:10 - 3:11 - 3:11 - 0:0,1,3,Arutyunov Ruben,Diaryan Aleksandr,fiurst,Arutyunov Ruben - Diaryan Aleksandr,72,28,44,16,-16,22,22,14,14,0,2,-2,8,8,0,16,10:12 - 12:10 - 3:11 - 3:11 - 0:0
18438017,2024-05-02 12:00:00,Rafayelyan Edgar - Papyan Karen,1:3,11:9 - 11:7 - 9:11 - 11:4 - 0:0,3,1,Rafayelyan Edgar,Papyan Karen,fiurst,Papyan Karen - Rafayelyan Edgar,73,31,42,11,-11,20,18,20,15,0,2,4,-2,7,0,11,9:11 - 7:11 - 11:9 - 4:11 - 0:0
18438011,2024-05-02 11:30:00,Rafayelyan Edgar - Asatryan Murad,3:2,8:11 - 11:9 - 4:11 - 14:12 - 5:11,2,3,Rafayelyan Edgar,Asatryan Murad,fiurst,Asatryan Murad - Rafayelyan Edgar,96,54,42,-12,12,19,20,15,26,16,-3,2,-7,2,-6,-12,11:8 - 9:11 - 11:4 - 12:14 - 11:5
18438008,2024-05-02 11:20:00,Papyan Karen - Arutyunov Ruben,2:3,14:12 - 6:11 - 4:11 - 11:2 - 11:7,3,2,Papyan Karen,Arutyunov Ruben,fiurst,Arutyunov Ruben - Papyan Karen,89,43,46,3,-3,26,17,15,13,18,2,-5,-7,9,4,3,12:14 - 11:6 - 11:4 - 2:11 - 7:11
18438005,2024-05-02 11:00:00,Diaryan Aleksandr - Rafayelyan Edgar,2:3,9:11 - 5:11 - 11:9 - 11:8 - 5:11,2,3,Diaryan Aleksandr,Rafayelyan Edgar,fiurst,Diaryan Aleksandr - Rafayelyan Edgar,91,41,50,9,-9,20,16,20,19,16,2,6,-2,-3,6,9,9:11 - 5:11 - 11:9 - 11:8 - 5:11
18438003,2024-05-02 10:50:00,Asatryan Murad - Arutyunov Ruben,0:3,11:7 - 12:10 - 11:3 - 0:0 - 0:0,3,0,Asatryan Murad,Arutyunov Ruben,fiurst,Arutyunov Ruben - Asatryan Murad,54,20,34,14,-14,18,22,14,0,0,4,2,8,0,0,14,7:11 - 10:12 - 3:11 - 0:0 - 0:0
18437991,2024-05-02 10:30:00,Papyan Karen - Diaryan Aleksandr,3:1,11:5 - 2:11 - 3:11 - 3:11 - 0:0,1,3,Papyan Karen,Diaryan Aleksandr,fiurst,Diaryan Aleksandr - Papyan Karen,57,38,19,-19,19,16,13,14,14,0,6,-9,-8,-8,0,-19,5:11 - 11:2 - 11:3 - 11:3 - 0:0
18437986,2024-05-02 10:15:00,Arutyunov Ruben - Rafayelyan Edgar,0:3,8:11 - 12:14 - 22:24 - 0:0 - 0:0,0,3,Arutyunov Ruben,Rafayelyan Edgar,fiurst,Arutyunov Ruben - Rafayelyan Edgar,91,42,49,7,-7,19,26,46,0,0,3,2,2,0,0,7,8:11 - 12:14 - 22:24 - 0:0 - 0:0
18437981,2024-05-02 10:00:00,Asatryan Murad - Papyan Karen,3:0,13:11 - 11:7 - 11:6 - 0:0 - 0:0,3,0,Asatryan Murad,Papyan Karen,fiurst,Asatryan Murad - Papyan Karen,59,35,24,-11,11,24,18,17,0,0,-2,-4,-5,0,0,-11,13:11 - 11:7 - 11:6 - 0:0 - 0:0
18421237,2024-05-01 17:45:00,Hakobyan Eduard - Soghomonyan Hrayr,0:3,8:11 - 7:11 - 5:11 - 0:0 - 0:0,0,3,Hakobyan Eduard,Soghomonyan Hrayr,fiurst,Hakobyan Eduard - Soghomonyan Hrayr,53,20,33,13,-13,19,18,16,0,0,3,4,6,0,0,13,8:11 - 7:11 - 5:11 - 0:0 - 0:0
18421232,2024-05-01 17:30:00,Petrosyan Davit - Gevorgyan Hayk,1:3,11:8 - 11:4 - 6:11 - 11:6 - 0:0,3,1,Petrosyan Davit,Gevorgyan Hayk,fiurst,Gevorgyan Hayk - Petrosyan Davit,68,29,39,10,-10,19,15,17,17,0,3,7,-5,5,0,10,8:11 - 4:11 - 11:6 - 6:11 - 0:0
18421231,2024-05-01 17:15:00,Gevorgyan Gegham - Hakobyan Eduard,1:3,11:9 - 11:13 - 9:11 - 11:13 - 0:0,1,3,Gevorgyan Gegham,Hakobyan Eduard,fiurst,Gevorgyan Gegham - Hakobyan Eduard,88,42,46,4,-4,20,24,20,24,0,-2,2,2,2,0,4,11:9 - 11:13 - 9:11 - 11:13 - 0:0
18421220,2024-05-01 17:00:00,Petrosyan Davit - Soghomonyan Hrayr,0:3,3:11 - 6:11 - 9:11 - 0:0 - 0:0,0,3,Petrosyan Davit,Soghomonyan Hrayr,fiurst,Petrosyan Davit - Soghomonyan Hrayr,51,18,33,15,-15,14,17,20,0,0,8,5,2,0,0,15,3:11 - 6:11 - 9:11 - 0:0 - 0:0
18421217,2024-05-01 16:45:00,Gevorgyan Hayk - Gevorgyan Gegham,1:3,11:7 - 11:1 - 7:11 - 11:8 - 0:0,3,1,Gevorgyan Hayk,Gevorgyan Gegham,fiurst,Gevorgyan Gegham - Gevorgyan Hayk,67,27,40,13,-13,18,12,18,19,0,4,10,-4,3,0,13,7:11 - 1:11 - 11:7 - 8:11 - 0:0
18421213,2024-05-01 16:30:00,Hakobyan Eduard - Petrosyan Davit,3:1,11:9 - 9:11 - 11:3 - 11:6 - 0:0,3,1,Hakobyan Eduard,Petrosyan Davit,fiurst,Hakobyan Eduard - Petrosyan Davit,71,42,29,-13,13,20,20,14,17,0,-2,2,-8,-5,0,-13,11:9 - 9:11 - 11:3 - 11:6 - 0:0
18421201,2024-05-01 16:15:00,Soghomonyan Hrayr - Gevorgyan Gegham,0:3,11:4 - 11:6 - 11:4 - 0:0 - 0:0,3,0,Soghomonyan Hrayr,Gevorgyan Gegham,fiurst,Gevorgyan Gegham - Soghomonyan Hrayr,47,14,33,19,-19,15,17,15,0,0,7,5,7,0,0,19,4:11 - 6:11 - 4:11 - 0:0 - 0:0
18421191,2024-05-01 16:00:00,Gevorgyan Hayk - Hakobyan Eduard,3:0,11:4 - 11:7 - 12:10 - 0:0 - 0:0,3,0,Gevorgyan Hayk,Hakobyan Eduard,fiurst,Gevorgyan Hayk - Hakobyan Eduard,55,34,21,-13,13,15,18,22,0,0,-7,-4,-2,0,0,-13,11:4 - 11:7 - 12:10 - 0:0 - 0:0
18421185,2024-05-01 15:45:00,Gevorgyan Gegham - Petrosyan Davit,1:3,5:11 - 8:11 - 11:9 - 5:11 - 0:0,1,3,Gevorgyan Gegham,Petrosyan Davit,fiurst,Gevorgyan Gegham - Petrosyan Davit,71,29,42,13,-13,16,19,20,16,0,6,3,-2,6,0,13,5:11 - 8:11 - 11:9 - 5:11 - 0:0
18421180,2024-05-01 15:30:00,Soghomonyan Hrayr - Gevorgyan Hayk,3:2,11:8 - 11:5 - 9:11 - 4:11 - 7:11,2,3,Soghomonyan Hrayr,Gevorgyan Hayk,fiurst,Gevorgyan Hayk - Soghomonyan Hrayr,88,46,42,-4,4,19,16,20,15,18,3,6,-2,-7,-4,-4,8:11 - 5:11 - 11:9 - 11:4 - 11:7
18421174,2024-05-01 15:15:00,Papyan Karen - Rafayelyan Edgar,0:3,4:11 - 10:12 - 7:11 - 0:0 - 0:0,0,3,Papyan Karen,Rafayelyan Edgar,fiurst,Papyan Karen - Rafayelyan Edgar,55,21,34,13,-13,15,22,18,0,0,7,2,4,0,0,13,4:11 - 10:12 - 7:11 - 0:0 - 0:0
18421172,2024-05-01 15:00:00,Asatryan Murad - Hovhannesyan Rafik,3:0,11:7 - 13:11 - 11:8 - 0:0 - 0:0,3,0,Asatryan Murad,Hovhannesyan Rafik,fiurst,Asatryan Murad - Hovhannesyan Rafik,61,35,26,-9,9,18,24,19,0,0,-4,-2,-3,0,0,-9,11:7 - 13:11 - 11:8 - 0:0 - 0:0
18421168,2024-05-01 14:45:00,Diaryan Aleksandr - Papyan Karen,3:0,11:7 - 11:4 - 11:9 - 0:0 - 0:0,3,0,Diaryan Aleksandr,Papyan Karen,fiurst,Diaryan Aleksandr - Papyan Karen,53,33,20,-13,13,18,15,20,0,0,-4,-7,-2,0,0,-13,11:7 - 11:4 - 11:9 - 0:0 - 0:0
18420280,2024-05-01 14:30:00,Rafayelyan Edgar - Asatryan Murad,3:2,4:11 - 8:11 - 11:6 - 11:7 - 7:11,2,3,Rafayelyan Edgar,Asatryan Murad,fiurst,Asatryan Murad - Rafayelyan Edgar,87,46,41,-5,5,15,19,17,18,18,-7,-3,5,4,-4,-5,11:4 - 11:8 - 6:11 - 7:11 - 11:7
18420252,2024-05-01 14:15:00,Diaryan Aleksandr - Hovhannesyan Rafik,3:0,11:5 - 11:6 - 11:3 - 0:0 - 0:0,3,0,Diaryan Aleksandr,Hovhannesyan Rafik,fiurst,Diaryan Aleksandr - Hovhannesyan Rafik,47,33,14,-19,19,16,17,14,0,0,-6,-5,-8,0,0,-19,11:5 - 11:6 - 11:3 - 0:0 - 0:0
18420251,2024-05-01 14:00:00,Papyan Karen - Asatryan Murad,3:0,5:11 - 8:11 - 4:11 - 0:0 - 0:0,0,3,Papyan Karen,Asatryan Murad,fiurst,Asatryan Murad - Papyan Karen,50,33,17,-16,16,16,19,15,0,0,-6,-3,-7,0,0,-16,11:5 - 11:8 - 11:4 - 0:0 - 0:0
18420247,2024-05-01 13:45:00,Hovhannesyan Rafik - Papyan Karen,3:0,11:7 - 12:10 - 11:9 - 0:0 - 0:0,3,0,Hovhannesyan Rafik,Papyan Karen,fiurst,Hovhannesyan Rafik - Papyan Karen,60,34,26,-8,8,18,22,20,0,0,-4,-2,-2,0,0,-8,11:7 - 12:10 - 11:9 - 0:0 - 0:0
18420249,2024-05-01 13:45:00,Rafayelyan Edgar - Diaryan Aleksandr,1:3,11:6 - 7:11 - 11:6 - 11:8 - 0:0,3,1,Rafayelyan Edgar,Diaryan Aleksandr,fiurst,Diaryan Aleksandr - Rafayelyan Edgar,71,31,40,9,-9,17,18,17,19,0,5,-4,5,3,0,9,6:11 - 11:7 - 6:11 - 8:11 - 0:0
18420215,2024-05-01 13:15:00,Asatryan Murad - Diaryan Aleksandr,3:0,11:4 - 11:5 - 11:7 - 0:0 - 0:0,3,0,Asatryan Murad,Diaryan Aleksandr,fiurst,Asatryan Murad - Diaryan Aleksandr,49,33,16,-17,17,15,16,18,0,0,-7,-6,-4,0,0,-17,11:4 - 11:5 - 11:7 - 0:0 - 0:0
18420186,2024-05-01 13:00:00,Hovhannesyan Rafik - Rafayelyan Edgar,2:3,5:11 - 11:9 - 9:11 - 13:11 - 0:11,2,3,Hovhannesyan Rafik,Rafayelyan Edgar,fiurst,Hovhannesyan Rafik - Rafayelyan Edgar,91,38,53,15,-15,16,20,20,24,11,6,-2,2,-2,11,15,5:11 - 11:9 - 9:11 - 13:11 - 0:11
18420184,2024-05-01 12:15:00,Papyan Karen - Diaryan Aleksandr,3:1,10:12 - 5:11 - 11:9 - 2:11 - 0:0,1,3,Papyan Karen,Diaryan Aleksandr,fiurst,Diaryan Aleksandr - Papyan Karen,71,43,28,-15,15,22,16,20,13,0,-2,-6,2,-9,0,-15,12:10 - 11:5 - 9:11 - 11:2 - 0:0
18420182,2024-05-01 11:55:00,Hovhannesyan Rafik - Asatryan Murad,3:0,9:11 - 9:11 - 5:11 - 0:0 - 0:0,0,3,Hovhannesyan Rafik,Asatryan Murad,fiurst,Asatryan Murad - Hovhannesyan Rafik,56,33,23,-10,10,20,20,16,0,0,-2,-2,-6,0,0,-10,11:9 - 11:9 - 11:5 - 0:0 - 0:0
18420169,2024-05-01 11:45:00,Rafayelyan Edgar - Papyan Karen,0:3,11:7 - 11:6 - 11:4 - 0:0 - 0:0,3,0,Rafayelyan Edgar,Papyan Karen,fiurst,Papyan Karen - Rafayelyan Edgar,50,17,33,16,-16,18,17,15,0,0,4,5,7,0,0,16,7:11 - 6:11 - 4:11 - 0:0 - 0:0
18420117,2024-05-01 11:30:00,Hovhannesyan Rafik - Diaryan Aleksandr,1:3,12:10 - 10:12 - 11:9 - 11:7 - 0:0,3,1,Hovhannesyan Rafik,Diaryan Aleksandr,fiurst,Diaryan Aleksandr - Hovhannesyan Rafik,82,38,44,6,-6,22,22,20,18,0,2,-2,2,4,0,6,10:12 - 12:10 - 9:11 - 7:11 - 0:0
18420091,2024-05-01 11:15:00,Asatryan Murad - Rafayelyan Edgar,1:3,11:5 - 12:14 - 6:11 - 5:11 - 0:0,1,3,Asatryan Murad,Rafayelyan Edgar,fiurst,Asatryan Murad - Rafayelyan Edgar,75,34,41,7,-7,16,26,17,16,0,-6,2,5,6,0,7,11:5 - 12:14 - 6:11 - 5:11 - 0:0
18420024,2024-05-01 11:00:00,Papyan Karen - Hovhannesyan Rafik,0:3,11:8 - 11:7 - 11:8 - 0:0 - 0:0,3,0,Papyan Karen,Hovhannesyan Rafik,fiurst,Hovhannesyan Rafik - Papyan Karen,56,23,33,10,-10,19,18,19,0,0,3,4,3,0,0,10,8:11 - 7:11 - 8:11 - 0:0 - 0:0
18420023,2024-05-01 10:45:00,Diaryan Aleksandr - Rafayelyan Edgar,1:3,13:11 - 7:11 - 4:11 - 4:11 - 0:0,1,3,Diaryan Aleksandr,Rafayelyan Edgar,fiurst,Diaryan Aleksandr - Rafayelyan Edgar,72,28,44,16,-16,24,18,15,15,0,-2,4,7,7,0,16,13:11 - 7:11 - 4:11 - 4:11 - 0:0
18401579,2024-05-01 10:30:00,Asatryan Murad - Papyan Karen,3:0,11:5 - 11:3 - 11:4 - 0:0 - 0:0,3,0,Asatryan Murad,Papyan Karen,fiurst,Asatryan Murad - Papyan Karen,45,33,12,-21,21,16,14,15,0,0,-6,-8,-7,0,0,-21,11:5 - 11:3 - 11:4 - 0:0 - 0:0
18401570,2024-05-01 10:15:00,Rafayelyan Edgar - Hovhannesyan Rafik,0:3,11:8 - 13:11 - 11:5 - 0:0 - 0:0,3,0,Rafayelyan Edgar,Hovhannesyan Rafik,fiurst,Hovhannesyan Rafik - Rafayelyan Edgar,59,24,35,11,-11,19,24,16,0,0,3,2,6,0,0,11,8:11 - 11:13 - 5:11 - 0:0 - 0:0
18401565,2024-05-01 10:00:00,Diaryan Aleksandr - Asatryan Murad,3:0,8:11 - 10:12 - 4:11 - 0:0 - 0:0,0,3,Diaryan Aleksandr,Asatryan Murad,fiurst,Asatryan Murad - Diaryan Aleksandr,56,34,22,-12,12,19,22,15,0,0,-3,-2,-7,0,0,-12,11:8 - 12:10 - 11:4 - 0:0 - 0:0
18401562,2024-04-30 17:45:00,Hakobyan Eduard - Petrosyan Davit,3:2,11:4 - 12:14 - 6:11 - 11:8 - 11:3,3,2,Hakobyan Eduard,Petrosyan Davit,fiurst,Hakobyan Eduard - Petrosyan Davit,91,51,40,-11,11,15,26,17,19,14,-7,2,5,-3,-8,-11,11:4 - 12:14 - 6:11 - 11:8 - 11:3
18401558,2024-04-30 17:30:00,Soghomonyan Hrayr - Avakimyan Davit,2:3,12:14 - 11:7 - 11:13 - 11:1 - 11:6,3,2,Soghomonyan Hrayr,Avakimyan Davit,fiurst,Avakimyan Davit - Soghomonyan Hrayr,97,41,56,15,-15,26,18,24,12,17,-2,4,-2,10,5,15,14:12 - 7:11 - 13:11 - 1:11 - 6:11
18401556,2024-04-30 17:15:00,Gevorgyan Hayk - Hakobyan Eduard,2:3,11:6 - 11:4 - 8:11 - 7:11 - 7:11,2,3,Gevorgyan Hayk,Hakobyan Eduard,fiurst,Gevorgyan Hayk - Hakobyan Eduard,87,44,43,-1,1,17,15,19,18,18,-5,-7,3,4,4,-1,11:6 - 11:4 - 8:11 - 7:11 - 7:11
18401553,2024-04-30 17:00:00,Soghomonyan Hrayr - Petrosyan Davit,1:3,11:13 - 11:5 - 11:4 - 11:8 - 0:0,3,1,Soghomonyan Hrayr,Petrosyan Davit,fiurst,Petrosyan Davit - Soghomonyan Hrayr,74,30,44,14,-14,24,16,15,19,0,-2,6,7,3,0,14,13:11 - 5:11 - 4:11 - 8:11 - 0:0
18401551,2024-04-30 16:45:00,Avakimyan Davit - Gevorgyan Hayk,2:3,11:9 - 7:11 - 11:7 - 8:11 - 7:11,2,3,Avakimyan Davit,Gevorgyan Hayk,fiurst,Avakimyan Davit - Gevorgyan Hayk,93,44,49,5,-5,20,18,18,19,18,-2,4,-4,3,4,5,11:9 - 7:11 - 11:7 - 8:11 - 7:11
18401526,2024-04-30 16:25:00,Hakobyan Eduard - Soghomonyan Hrayr,0:3,5:11 - 6:11 - 7:11 - 0:0 - 0:0,0,3,Hakobyan Eduard,Soghomonyan Hrayr,fiurst,Hakobyan Eduard - Soghomonyan Hrayr,51,18,33,15,-15,16,17,18,0,0,6,5,4,0,0,15,5:11 - 6:11 - 7:11 - 0:0 - 0:0
18401522,2024-04-30 16:20:00,Petrosyan Davit - Gevorgyan Hayk,2:3,12:14 - 7:11 - 11:3 - 11:4 - 12:10,3,2,Petrosyan Davit,Gevorgyan Hayk,fiurst,Gevorgyan Hayk - Petrosyan Davit,95,42,53,11,-11,26,18,14,15,22,-2,-4,8,7,2,11,14:12 - 11:7 - 3:11 - 4:11 - 10:12
18401516,2024-04-30 16:00:00,Avakimyan Davit - Hakobyan Eduard,1:3,8:11 - 13:11 - 8:11 - 10:12 - 0:0,1,3,Avakimyan Davit,Hakobyan Eduard,fiurst,Avakimyan Davit - Hakobyan Eduard,84,39,45,6,-6,19,24,19,22,0,3,-2,3,2,0,6,8:11 - 13:11 - 8:11 - 10:12 - 0:0
18401512,2024-04-30 15:45:00,Gevorgyan Hayk - Soghomonyan Hrayr,3:2,11:9 - 11:4 - 7:11 - 6:11 - 11:2,3,2,Gevorgyan Hayk,Soghomonyan Hrayr,fiurst,Gevorgyan Hayk - Soghomonyan Hrayr,83,46,37,-9,9,20,15,18,17,13,-2,-7,4,5,-9,-9,11:9 - 11:4 - 7:11 - 6:11 - 11:2
18401509,2024-04-30 15:30:00,Petrosyan Davit - Avakimyan Davit,2:3,11:13 - 4:11 - 11:7 - 11:5 - 11:8,3,2,Petrosyan Davit,Avakimyan Davit,fiurst,Avakimyan Davit - Petrosyan Davit,92,44,48,4,-4,24,15,18,16,19,-2,-7,4,6,3,4,13:11 - 11:4 - 7:11 - 5:11 - 8:11
18401505,2024-04-30 15:20:00,Asatryan Murad - Hovhannesyan Rafik,3:0,11:5 - 11:7 - 11:2 - 0:0 - 0:0,3,0,Asatryan Murad,Hovhannesyan Rafik,fiurst,Asatryan Murad - Hovhannesyan Rafik,47,33,14,-19,19,16,18,13,0,0,-6,-4,-9,0,0,-19,11:5 - 11:7 - 11:2 - 0:0 - 0:0
18401499,2024-04-30 15:00:00,Arutyunov Ruben - Asatryan Murad,1:3,9:11 - 11:5 - 8:11 - 7:11 - 0:0,1,3,Arutyunov Ruben,Asatryan Murad,fiurst,Arutyunov Ruben - Asatryan Murad,73,35,38,3,-3,20,16,19,18,0,2,-6,3,4,0,3,9:11 - 11:5 - 8:11 - 7:11 - 0:0
18401504,2024-04-30 15:00:00,Rafayelyan Edgar - Diaryan Aleksandr,0:3,11:6 - 11:7 - 11:7 - 0:0 - 0:0,3,0,Rafayelyan Edgar,Diaryan Aleksandr,fiurst,Diaryan Aleksandr - Rafayelyan Edgar,53,20,33,13,-13,17,18,18,0,0,5,4,4,0,0,13,6:11 - 7:11 - 7:11 - 0:0 - 0:0
18401483,2024-04-30 14:40:00,Hovhannesyan Rafik - Rafayelyan Edgar,1:3,9:11 - 8:11 - 11:9 - 12:14 - 0:0,1,3,Hovhannesyan Rafik,Rafayelyan Edgar,fiurst,Hovhannesyan Rafik - Rafayelyan Edgar,85,40,45,5,-5,20,19,20,26,0,2,3,-2,2,0,5,9:11 - 8:11 - 11:9 - 12:14 - 0:0
18401465,2024-04-30 14:30:00,Arutyunov Ruben - Diaryan Aleksandr,1:3,6:11 - 11:6 - 7:11 - 6:11 - 0:0,1,3,Arutyunov Ruben,Diaryan Aleksandr,fiurst,Arutyunov Ruben - Diaryan Aleksandr,69,30,39,9,-9,17,17,18,17,0,5,-5,4,5,0,9,6:11 - 11:6 - 7:11 - 6:11 - 0:0
18401459,2024-04-30 14:00:00,Asatryan Murad - Rafayelyan Edgar,0:3,6:11 - 8:11 - 4:11 - 0:0 - 0:0,0,3,Asatryan Murad,Rafayelyan Edgar,fiurst,Asatryan Murad - Rafayelyan Edgar,51,18,33,15,-15,17,19,15,0,0,5,3,7,0,0,15,6:11 - 8:11 - 4:11 - 0:0 - 0:0
18401457,2024-04-30 13:55:00,Hovhannesyan Rafik - Arutyunov Ruben,3:2,3:11 - 11:9 - 4:11 - 11:7 - 5:11,2,3,Hovhannesyan Rafik,Arutyunov Ruben,fiurst,Arutyunov Ruben - Hovhannesyan Rafik,83,49,34,-15,15,14,20,15,18,16,-8,2,-7,4,-6,-15,11:3 - 9:11 - 11:4 - 7:11 - 11:5
18401438,2024-04-30 13:30:00,Diaryan Aleksandr - Asatryan Murad,2:3,11:8 - 11:7 - 8:11 - 11:13 - 11:6,3,2,Diaryan Aleksandr,Asatryan Murad,fiurst,Asatryan Murad - Diaryan Aleksandr,97,45,52,7,-7,19,18,19,24,17,3,4,-3,-2,5,7,8:11 - 7:11 - 11:8 - 13:11 - 6:11
18401435,2024-04-30 13:15:00,Rafayelyan Edgar - Arutyunov Ruben,1:3,12:14 - 11:9 - 11:2 - 11:8 - 0:0,3,1,Rafayelyan Edgar,Arutyunov Ruben,fiurst,Arutyunov Ruben - Rafayelyan Edgar,78,33,45,12,-12,26,20,13,19,0,-2,2,9,3,0,12,14:12 - 9:11 - 2:11 - 8:11 - 0:0
18401432,2024-04-30 13:00:00,Diaryan Aleksandr - Hovhannesyan Rafik,3:1,10:12 - 11:7 - 11:5 - 12:10 - 0:0,3,1,Diaryan Aleksandr,Hovhannesyan Rafik,fiurst,Diaryan Aleksandr - Hovhannesyan Rafik,78,44,34,-10,10,22,18,16,22,0,2,-4,-6,-2,0,-10,10:12 - 11:7 - 11:5 - 12:10 - 0:0
18401415,2024-04-30 12:15:00,Asatryan Murad - Arutyunov Ruben,0:3,11:2 - 11:3 - 12:10 - 0:0 - 0:0,3,0,Asatryan Murad,Arutyunov Ruben,fiurst,Arutyunov Ruben - Asatryan Murad,49,15,34,19,-19,13,14,22,0,0,9,8,2,0,0,19,2:11 - 3:11 - 10:12 - 0:0 - 0:0
18401408,2024-04-30 12:05:00,Hovhannesyan Rafik - Asatryan Murad,3:0,6:11 - 8:11 - 4:11 - 0:0 - 0:0,0,3,Hovhannesyan Rafik,Asatryan Murad,fiurst,Asatryan Murad - Hovhannesyan Rafik,51,33,18,-15,15,17,19,15,0,0,-5,-3,-7,0,0,-15,11:6 - 11:8 - 11:4 - 0:0 - 0:0
18401413,2024-04-30 12:00:00,Diaryan Aleksandr - Rafayelyan Edgar,3:1,9:11 - 11:6 - 11:2 - 11:9 - 0:0,3,1,Diaryan Aleksandr,Rafayelyan Edgar,fiurst,Diaryan Aleksandr - Rafayelyan Edgar,70,42,28,-14,14,20,17,13,20,0,2,-5,-9,-2,0,-14,9:11 - 11:6 - 11:2 - 11:9 - 0:0
18401407,2024-04-30 11:30:00,Diaryan Aleksandr - Arutyunov Ruben,0:3,11:6 - 11:5 - 12:10 - 0:0 - 0:0,3,0,Diaryan Aleksandr,Arutyunov Ruben,fiurst,Arutyunov Ruben - Diaryan Aleksandr,55,21,34,13,-13,17,16,22,0,0,5,6,2,0,0,13,6:11 - 5:11 - 10:12 - 0:0 - 0:0
18401405,2024-04-30 11:25:00,Rafayelyan Edgar - Hovhannesyan Rafik,2:3,6:11 - 11:7 - 11:9 - 8:11 - 11:7,3,2,Rafayelyan Edgar,Hovhannesyan Rafik,fiurst,Hovhannesyan Rafik - Rafayelyan Edgar,92,45,47,2,-2,17,18,20,19,18,-5,4,2,-3,4,2,11:6 - 7:11 - 9:11 - 11:8 - 7:11
18401366,2024-04-30 11:00:00,Asatryan Murad - Diaryan Aleksandr,3:0,11:9 - 12:10 - 11:8 - 0:0 - 0:0,3,0,Asatryan Murad,Diaryan Aleksandr,fiurst,Asatryan Murad - Diaryan Aleksandr,61,34,27,-7,7,20,22,19,0,0,-2,-2,-3,0,0,-7,11:9 - 12:10 - 11:8 - 0:0 - 0:0
18401361,2024-04-30 10:55:00,Arutyunov Ruben - Hovhannesyan Rafik,3:1,12:10 - 11:1 - 7:11 - 11:6 - 0:0,3,1,Arutyunov Ruben,Hovhannesyan Rafik,fiurst,Arutyunov Ruben - Hovhannesyan Rafik,69,41,28,-13,13,22,12,18,17,0,-2,-10,4,-5,0,-13,12:10 - 11:1 - 7:11 - 11:6 - 0:0
18401358,2024-04-30 10:30:00,Rafayelyan Edgar - Asatryan Murad,3:0,6:11 - 8:11 - 4:11 - 0:0 - 0:0,0,3,Rafayelyan Edgar,Asatryan Murad,fiurst,Asatryan Murad - Rafayelyan Edgar,51,33,18,-15,15,17,19,15,0,0,-5,-3,-7,0,0,-15,11:6 - 11:8 - 11:4 - 0:0 - 0:0
18401332,2024-04-30 10:15:00,Hovhannesyan Rafik - Diaryan Aleksandr,3:1,5:11 - 16:14 - 4:11 - 7:11 - 0:0,1,3,Hovhannesyan Rafik,Diaryan Aleksandr,fiurst,Diaryan Aleksandr - Hovhannesyan Rafik,79,47,32,-15,15,16,30,15,18,0,-6,2,-7,-4,0,-15,11:5 - 14:16 - 11:4 - 11:7 - 0:0
18401283,2024-04-30 10:00:00,Arutyunov Ruben - Rafayelyan Edgar,0:3,6:11 - 6:11 - 12:14 - 0:0 - 0:0,0,3,Arutyunov Ruben,Rafayelyan Edgar,fiurst,Arutyunov Ruben - Rafayelyan Edgar,60,24,36,12,-12,17,17,26,0,0,5,5,2,0,0,12,6:11 - 6:11 - 12:14 - 0:0 - 0:0
18383027,2024-04-29 17:45:00,Hakobyan Eduard - Avakimyan Davit,1:3,13:11 - 8:11 - 11:8 - 14:12 - 0:0,3,1,Hakobyan Eduard,Avakimyan Davit,fiurst,Avakimyan Davit - Hakobyan Eduard,88,42,46,4,-4,24,19,19,26,0,2,-3,3,2,0,4,11:13 - 11:8 - 8:11 - 12:14 - 0:0
18383018,2024-04-29 17:30:00,Soghomonyan Hrayr - Petrosyan Davit,0:3,11:7 - 11:3 - 11:6 - 0:0 - 0:0,3,0,Soghomonyan Hrayr,Petrosyan Davit,fiurst,Petrosyan Davit - Soghomonyan Hrayr,49,16,33,17,-17,18,14,17,0,0,4,8,5,0,0,17,7:11 - 3:11 - 6:11 - 0:0 - 0:0
18382995,2024-04-29 17:15:00,Mkrtchyan Andranik - Hakobyan Eduard,3:0,9:11 - 6:11 - 6:11 - 0:0 - 0:0,0,3,Mkrtchyan Andranik,Hakobyan Eduard,fiurst,Hakobyan Eduard - Mkrtchyan Andranik,54,33,21,-12,12,20,17,17,0,0,-2,-5,-5,0,0,-12,11:9 - 11:6 - 11:6 - 0:0 - 0:0
18382963,2024-04-29 17:00:00,Soghomonyan Hrayr - Avakimyan Davit,0:3,11:9 - 11:6 - 11:9 - 0:0 - 0:0,3,0,Soghomonyan Hrayr,Avakimyan Davit,fiurst,Avakimyan Davit - Soghomonyan Hrayr,57,24,33,9,-9,20,17,20,0,0,2,5,2,0,0,9,9:11 - 6:11 - 9:11 - 0:0 - 0:0
18382960,2024-04-29 16:55:00,Petrosyan Davit - Mkrtchyan Andranik,0:3,11:5 - 11:9 - 11:9 - 0:0 - 0:0,3,0,Petrosyan Davit,Mkrtchyan Andranik,fiurst,Mkrtchyan Andranik - Petrosyan Davit,56,23,33,10,-10,16,20,20,0,0,6,2,2,0,0,10,5:11 - 9:11 - 9:11 - 0:0 - 0:0
18382956,2024-04-29 16:30:00,Hakobyan Eduard - Soghomonyan Hrayr,0:3,7:11 - 11:13 - 11:13 - 0:0 - 0:0,0,3,Hakobyan Eduard,Soghomonyan Hrayr,fiurst,Hakobyan Eduard - Soghomonyan Hrayr,66,29,37,8,-8,18,24,24,0,0,4,2,2,0,0,8,7:11 - 11:13 - 11:13 - 0:0 - 0:0
18382941,2024-04-29 16:15:00,Avakimyan Davit - Mkrtchyan Andranik,2:3,5:11 - 11:8 - 15:17 - 11:9 - 9:11,2,3,Avakimyan Davit,Mkrtchyan Andranik,fiurst,Avakimyan Davit - Mkrtchyan Andranik,107,51,56,5,-5,16,19,32,20,20,6,-3,2,-2,2,5,5:11 - 11:8 - 15:17 - 11:9 - 9:11
18382918,2024-04-29 16:05:00,Petrosyan Davit - Hakobyan Eduard,2:3,9:11 - 14:16 - 11:3 - 11:5 - 11:7,3,2,Petrosyan Davit,Hakobyan Eduard,fiurst,Hakobyan Eduard - Petrosyan Davit,98,42,56,14,-14,20,30,14,16,18,-2,-2,8,6,4,14,11:9 - 16:14 - 3:11 - 5:11 - 7:11
18382914,2024-04-29 15:45:00,Mkrtchyan Andranik - Soghomonyan Hrayr,1:3,11:6 - 6:11 - 6:11 - 2:11 - 0:0,1,3,Mkrtchyan Andranik,Soghomonyan Hrayr,fiurst,Mkrtchyan Andranik - Soghomonyan Hrayr,64,25,39,14,-14,17,17,17,13,0,-5,5,5,9,0,14,11:6 - 6:11 - 6:11 - 2:11 - 0:0
18382907,2024-04-29 15:30:00,Avakimyan Davit - Petrosyan Davit,2:3,13:11 - 12:10 - 6:11 - 5:11 - 10:12,2,3,Avakimyan Davit,Petrosyan Davit,fiurst,Avakimyan Davit - Petrosyan Davit,101,46,55,9,-9,24,22,17,16,22,-2,-2,5,6,2,9,13:11 - 12:10 - 6:11 - 5:11 - 10:12
18397914,2024-04-29 15:15:00,Rafayelyan Edgar - Asatryan Murad,3:0,6:11 - 8:11 - 12:14 - 0:0 - 0:0,0,3,Rafayelyan Edgar,Asatryan Murad,fiurst,Asatryan Murad - Rafayelyan Edgar,62,36,26,-10,10,17,19,26,0,0,-5,-3,-2,0,0,-10,11:6 - 11:8 - 14:12 - 0:0 - 0:0
18382858,2024-04-29 15:00:00,Diaryan Aleksandr - Arutyunov Ruben,1:3,11:9 - 9:11 - 11:6 - 11:6 - 0:0,3,1,Diaryan Aleksandr,Arutyunov Ruben,fiurst,Arutyunov Ruben - Diaryan Aleksandr,74,32,42,10,-10,20,20,17,17,0,2,-2,5,5,0,10,9:11 - 11:9 - 6:11 - 6:11 - 0:0
18382849,2024-04-29 14:55:00,Hovhannesyan Rafik - Rafayelyan Edgar,0:3,6:11 - 14:16 - 8:11 - 0:0 - 0:0,0,3,Hovhannesyan Rafik,Rafayelyan Edgar,fiurst,Hovhannesyan Rafik - Rafayelyan Edgar,66,28,38,10,-10,17,30,19,0,0,5,2,3,0,0,10,6:11 - 14:16 - 8:11 - 0:0 - 0:0
18397902,2024-04-29 14:30:00,Asatryan Murad - Diaryan Aleksandr,3:0,12:10 - 11:5 - 11:5 - 0:0 - 0:0,3,0,Asatryan Murad,Diaryan Aleksandr,fiurst,Asatryan Murad - Diaryan Aleksandr,54,34,20,-14,14,22,16,16,0,0,-2,-6,-6,0,0,-14,12:10 - 11:5 - 11:5 - 0:0 - 0:0
18382826,2024-04-29 14:20:00,Hovhannesyan Rafik - Arutyunov Ruben,3:1,7:11 - 11:9 - 4:11 - 4:11 - 0:0,1,3,Hovhannesyan Rafik,Arutyunov Ruben,fiurst,Arutyunov Ruben - Hovhannesyan Rafik,68,42,26,-16,16,18,20,15,15,0,-4,2,-7,-7,0,-16,11:7 - 9:11 - 11:4 - 11:4 - 0:0
18382825,2024-04-29 14:00:00,Rafayelyan Edgar - Diaryan Aleksandr,1:3,10:12 - 11:3 - 11:3 - 11:9 - 0:0,3,1,Rafayelyan Edgar,Diaryan Aleksandr,fiurst,Diaryan Aleksandr - Rafayelyan Edgar,70,27,43,16,-16,22,14,14,20,0,-2,8,8,2,0,16,12:10 - 3:11 - 3:11 - 9:11 - 0:0
18397900,2024-04-29 13:50:00,Asatryan Murad - Hovhannesyan Rafik,3:0,11:7 - 11:7 - 11:6 - 0:0 - 0:0,3,0,Asatryan Murad,Hovhannesyan Rafik,fiurst,Asatryan Murad - Hovhannesyan Rafik,53,33,20,-13,13,18,18,17,0,0,-4,-4,-5,0,0,-13,11:7 - 11:7 - 11:6 - 0:0 - 0:0
18382819,2024-04-29 13:30:00,Arutyunov Ruben - Rafayelyan Edgar,1:3,11:9 - 4:11 - 2:11 - 4:11 - 0:0,1,3,Arutyunov Ruben,Rafayelyan Edgar,fiurst,Arutyunov Ruben - Rafayelyan Edgar,63,21,42,21,-21,20,15,13,15,0,-2,7,9,7,0,21,11:9 - 4:11 - 2:11 - 4:11 - 0:0
18382815,2024-04-29 13:15:00,Diaryan Aleksandr - Hovhannesyan Rafik,3:1,2:11 - 11:9 - 11:4 - 11:8 - 0:0,3,1,Diaryan Aleksandr,Hovhannesyan Rafik,fiurst,Diaryan Aleksandr - Hovhannesyan Rafik,67,35,32,-3,3,13,20,15,19,0,9,-2,-7,-3,0,-3,2:11 - 11:9 - 11:4 - 11:8 - 0:0
18397896,2024-04-29 13:00:00,Arutyunov Ruben - Asatryan Murad,0:3,8:11 - 5:11 - 8:11 - 0:0 - 0:0,0,3,Arutyunov Ruben,Asatryan Murad,fiurst,Arutyunov Ruben - Asatryan Murad,54,21,33,12,-12,19,16,19,0,0,3,6,3,0,0,12,8:11 - 5:11 - 8:11 - 0:0 - 0:0
18382807,2024-04-29 12:15:00,Rafayelyan Edgar - Hovhannesyan Rafik,2:3,9:11 - 8:11 - 11:8 - 11:4 - 11:4,3,2,Rafayelyan Edgar,Hovhannesyan Rafik,fiurst,Hovhannesyan Rafik - Rafayelyan Edgar,88,38,50,12,-12,20,19,19,15,15,-2,-3,3,7,7,12,11:9 - 11:8 - 8:11 - 4:11 - 4:11
18382799,2024-04-29 12:10:00,Arutyunov Ruben - Diaryan Aleksandr,1:3,5:11 - 4:11 - 11:7 - 4:11 - 0:0,1,3,Arutyunov Ruben,Diaryan Aleksandr,fiurst,Arutyunov Ruben - Diaryan Aleksandr,64,24,40,16,-16,16,15,18,15,0,6,7,-4,7,0,16,5:11 - 4:11 - 11:7 - 4:11 - 0:0
18341998,2024-04-29 11:40:00,Arutyunov Ruben - Hovhannesyan Rafik,0:3,7:11 - 9:11 - 7:11 - 0:0 - 0:0,0,3,Arutyunov Ruben,Hovhannesyan Rafik,fiurst,Arutyunov Ruben - Hovhannesyan Rafik,56,23,33,10,-10,18,20,18,0,0,4,2,4,0,0,10,7:11 - 9:11 - 7:11 - 0:0 - 0:0
18341949,2024-04-29 11:10:00,Rafayelyan Edgar - Arutyunov Ruben,0:3,11:8 - 11:6 - 11:5 - 0:0 - 0:0,3,0,Rafayelyan Edgar,Arutyunov Ruben,fiurst,Arutyunov Ruben - Rafayelyan Edgar,52,19,33,14,-14,19,17,16,0,0,3,5,6,0,0,14,8:11 - 6:11 - 5:11 - 0:0 - 0:0
18341916,2024-04-29 10:45:00,Diaryan Aleksandr - Rafayelyan Edgar,1:3,11:9 - 6:11 - 5:11 - 9:11 - 0:0,1,3,Diaryan Aleksandr,Rafayelyan Edgar,fiurst,Diaryan Aleksandr - Rafayelyan Edgar,73,31,42,11,-11,20,17,16,20,0,-2,5,6,2,0,11,11:9 - 6:11 - 5:11 - 9:11 - 0:0
18341902,2024-04-29 10:30:00,Hovhannesyan Rafik - Diaryan Aleksandr,3:0,4:11 - 7:11 - 7:11 - 0:0 - 0:0,0,3,Hovhannesyan Rafik,Diaryan Aleksandr,fiurst,Diaryan Aleksandr - Hovhannesyan Rafik,51,33,18,-15,15,15,18,18,0,0,-7,-4,-4,0,0,-15,11:4 - 11:7 - 11:7 - 0:0 - 0:0
18358102,2024-04-28 17:45:00,Mkrtchyan Andranik - Soghomonyan Hrayr,2:3,11:8 - 9:11 - 11:9 - 7:11 - 6:11,2,3,Mkrtchyan Andranik,Soghomonyan Hrayr,fiurst,Mkrtchyan Andranik - Soghomonyan Hrayr,94,44,50,6,-6,19,20,20,18,17,-3,2,-2,4,5,6,11:8 - 9:11 - 11:9 - 7:11 - 6:11
18358098,2024-04-28 17:15:00,Petrosyan Davit - Soghomonyan Hrayr,1:3,8:11 - 8:11 - 12:10 - 9:11 - 0:0,1,3,Petrosyan Davit,Soghomonyan Hrayr,fiurst,Petrosyan Davit - Soghomonyan Hrayr,80,37,43,6,-6,19,19,22,20,0,3,3,-2,2,0,6,8:11 - 8:11 - 12:10 - 9:11 - 0:0
18358094,2024-04-28 17:00:00,Avakimyan Davit - Mkrtchyan Andranik,3:2,11:9 - 11:13 - 16:14 - 10:12 - 14:12,3,2,Avakimyan Davit,Mkrtchyan Andranik,fiurst,Avakimyan Davit - Mkrtchyan Andranik,122,62,60,-2,2,20,24,30,22,26,-2,2,-2,2,-2,-2,11:9 - 11:13 - 16:14 - 10:12 - 14:12
18358080,2024-04-28 16:30:00,Avakimyan Davit - Soghomonyan Hrayr,0:3,7:11 - 7:11 - 11:13 - 0:0 - 0:0,0,3,Avakimyan Davit,Soghomonyan Hrayr,fiurst,Avakimyan Davit - Soghomonyan Hrayr,60,25,35,10,-10,18,18,24,0,0,4,4,2,0,0,10,7:11 - 7:11 - 11:13 - 0:0 - 0:0
18358079,2024-04-28 16:15:00,Mkrtchyan Andranik - Petrosyan Davit,2:3,13:15 - 11:4 - 9:11 - 14:12 - 8:11,2,3,Mkrtchyan Andranik,Petrosyan Davit,fiurst,Mkrtchyan Andranik - Petrosyan Davit,108,55,53,-2,2,28,15,20,26,19,2,-7,2,-2,3,-2,13:15 - 11:4 - 9:11 - 14:12 - 8:11
18358075,2024-04-28 15:45:00,Petrosyan Davit - Avakimyan Davit,1:3,15:17 - 11:9 - 11:1 - 17:15 - 0:0,3,1,Petrosyan Davit,Avakimyan Davit,fiurst,Avakimyan Davit - Petrosyan Davit,96,42,54,12,-12,32,20,12,32,0,-2,2,10,2,0,12,17:15 - 9:11 - 1:11 - 15:17 - 0:0
18358074,2024-04-28 15:30:00,Soghomonyan Hrayr - Mkrtchyan Andranik,1:3,11:9 - 11:8 - 9:11 - 11:8 - 0:0,3,1,Soghomonyan Hrayr,Mkrtchyan Andranik,fiurst,Mkrtchyan Andranik - Soghomonyan Hrayr,78,36,42,6,-6,20,19,20,19,0,2,3,-2,3,0,6,9:11 - 8:11 - 11:9 - 8:11 - 0:0
18358058,2024-04-28 15:15:00,Diaryan Aleksandr - Hovhannesyan Rafik,3:1,5:11 - 11:2 - 11:6 - 11:3 - 0:0,3,1,Diaryan Aleksandr,Hovhannesyan Rafik,fiurst,Diaryan Aleksandr - Hovhannesyan Rafik,60,38,22,-16,16,16,13,17,14,0,6,-9,-5,-8,0,-16,5:11 - 11:2 - 11:6 - 11:3 - 0:0
18358057,2024-04-28 15:00:00,Asatryan Murad - Arutyunov Ruben,1:3,11:9 - 10:12 - 11:6 - 11:4 - 0:0,3,1,Asatryan Murad,Arutyunov Ruben,fiurst,Arutyunov Ruben - Asatryan Murad,74,31,43,12,-12,20,22,17,15,0,2,-2,5,7,0,12,9:11 - 12:10 - 6:11 - 4:11 - 0:0
18358056,2024-04-28 14:45:00,Nazaryan Mushegh - Diaryan Aleksandr,3:0,6:11 - 8:11 - 7:11 - 0:0 - 0:0,0,3,Nazaryan Mushegh,Diaryan Aleksandr,fiurst,Diaryan Aleksandr - Nazaryan Mushegh,54,33,21,-12,12,17,19,18,0,0,-5,-3,-4,0,0,-12,11:6 - 11:8 - 11:7 - 0:0 - 0:0
18358053,2024-04-28 14:30:00,Hovhannesyan Rafik - Asatryan Murad,3:0,9:11 - 10:12 - 9:11 - 0:0 - 0:0,0,3,Hovhannesyan Rafik,Asatryan Murad,fiurst,Asatryan Murad - Hovhannesyan Rafik,62,34,28,-6,6,20,22,20,0,0,-2,-2,-2,0,0,-6,11:9 - 12:10 - 11:9 - 0:0 - 0:0
18358051,2024-04-28 14:20:00,Nazaryan Mushegh - Arutyunov Ruben,0:3,11:8 - 11:6 - 11:4 - 0:0 - 0:0,3,0,Nazaryan Mushegh,Arutyunov Ruben,fiurst,Arutyunov Ruben - Nazaryan Mushegh,51,18,33,15,-15,19,17,15,0,0,3,5,7,0,0,15,8:11 - 6:11 - 4:11 - 0:0 - 0:0
18358048,2024-04-28 14:00:00,Diaryan Aleksandr - Asatryan Murad,3:1,11:9 - 7:11 - 7:11 - 6:11 - 0:0,1,3,Diaryan Aleksandr,Asatryan Murad,fiurst,Asatryan Murad - Diaryan Aleksandr,73,42,31,-11,11,20,18,18,17,0,2,-4,-4,-5,0,-11,9:11 - 11:7 - 11:7 - 11:6 - 0:0
18358047,2024-04-28 13:45:00,Hovhannesyan Rafik - Nazaryan Mushegh,1:3,9:11 - 11:5 - 3:11 - 8:11 - 0:0,1,3,Hovhannesyan Rafik,Nazaryan Mushegh,fiurst,Hovhannesyan Rafik - Nazaryan Mushegh,69,31,38,7,-7,20,16,14,19,0,2,-6,8,3,0,7,9:11 - 11:5 - 3:11 - 8:11 - 0:0
18358042,2024-04-28 13:40:00,Arutyunov Ruben - Diaryan Aleksandr,0:3,2:11 - 4:11 - 7:11 - 0:0 - 0:0,0,3,Arutyunov Ruben,Diaryan Aleksandr,fiurst,Arutyunov Ruben - Diaryan Aleksandr,46,13,33,20,-20,13,15,18,0,0,9,7,4,0,0,20,2:11 - 4:11 - 7:11 - 0:0 - 0:0
18358033,2024-04-28 13:15:00,Asatryan Murad - Nazaryan Mushegh,3:0,11:8 - 11:2 - 11:2 - 0:0 - 0:0,3,0,Asatryan Murad,Nazaryan Mushegh,fiurst,Asatryan Murad - Nazaryan Mushegh,45,33,12,-21,21,19,13,13,0,0,-3,-9,-9,0,0,-21,11:8 - 11:2 - 11:2 - 0:0 - 0:0
18358029,2024-04-28 13:00:00,Arutyunov Ruben - Hovhannesyan Rafik,3:2,11:13 - 12:10 - 11:3 - 8:11 - 11:6,3,2,Arutyunov Ruben,Hovhannesyan Rafik,fiurst,Arutyunov Ruben - Hovhannesyan Rafik,96,53,43,-10,10,24,22,14,19,17,2,-2,-8,3,-5,-10,11:13 - 12:10 - 11:3 - 8:11 - 11:6
18358024,2024-04-28 12:15:00,Diaryan Aleksandr - Nazaryan Mushegh,3:0,11:8 - 11:5 - 11:8 - 0:0 - 0:0,3,0,Diaryan Aleksandr,Nazaryan Mushegh,fiurst,Diaryan Aleksandr - Nazaryan Mushegh,54,33,21,-12,12,19,16,19,0,0,-3,-6,-3,0,0,-12,11:8 - 11:5 - 11:8 - 0:0 - 0:0
18358023,2024-04-28 12:10:00,Arutyunov Ruben - Asatryan Murad,0:3,7:11 - 7:11 - 14:16 - 0:0 - 0:0,0,3,Arutyunov Ruben,Asatryan Murad,fiurst,Arutyunov Ruben - Asatryan Murad,66,28,38,10,-10,18,18,30,0,0,4,4,2,0,0,10,7:11 - 7:11 - 14:16 - 0:0 - 0:0
18358021,2024-04-28 11:45:00,Hovhannesyan Rafik - Diaryan Aleksandr,3:0,8:11 - 5:11 - 7:11 - 0:0 - 0:0,0,3,Hovhannesyan Rafik,Diaryan Aleksandr,fiurst,Diaryan Aleksandr - Hovhannesyan Rafik,53,33,20,-13,13,19,16,18,0,0,-3,-6,-4,0,0,-13,11:8 - 11:5 - 11:7 - 0:0 - 0:0
18358010,2024-04-28 11:30:00,Arutyunov Ruben - Nazaryan Mushegh,2:3,2:11 - 11:7 - 6:11 - 11:8 - 4:11,2,3,Arutyunov Ruben,Nazaryan Mushegh,fiurst,Arutyunov Ruben - Nazaryan Mushegh,82,34,48,14,-14,13,18,17,19,15,9,-4,5,-3,7,14,2:11 - 11:7 - 6:11 - 11:8 - 4:11
18358008,2024-04-28 11:15:00,Asatryan Murad - Hovhannesyan Rafik,3:0,11:8 - 11:6 - 11:3 - 0:0 - 0:0,3,0,Asatryan Murad,Hovhannesyan Rafik,fiurst,Asatryan Murad - Hovhannesyan Rafik,50,33,17,-16,16,19,17,14,0,0,-3,-5,-8,0,0,-16,11:8 - 11:6 - 11:3 - 0:0 - 0:0
18358007,2024-04-28 11:00:00,Diaryan Aleksandr - Arutyunov Ruben,0:3,11:8 - 11:5 - 11:7 - 0:0 - 0:0,3,0,Diaryan Aleksandr,Arutyunov Ruben,fiurst,Arutyunov Ruben - Diaryan Aleksandr,53,20,33,13,-13,19,16,18,0,0,3,6,4,0,0,13,8:11 - 5:11 - 7:11 - 0:0 - 0:0
18358005,2024-04-28 10:50:00,Nazaryan Mushegh - Hovhannesyan Rafik,0:3,11:5 - 15:13 - 11:4 - 0:0 - 0:0,3,0,Nazaryan Mushegh,Hovhannesyan Rafik,fiurst,Hovhannesyan Rafik - Nazaryan Mushegh,59,22,37,15,-15,16,28,15,0,0,6,2,7,0,0,15,5:11 - 13:15 - 4:11 - 0:0 - 0:0
18357999,2024-04-28 10:30:00,Asatryan Murad - Diaryan Aleksandr,3:0,11:6 - 11:9 - 11:6 - 0:0 - 0:0,3,0,Asatryan Murad,Diaryan Aleksandr,fiurst,Asatryan Murad - Diaryan Aleksandr,54,33,21,-12,12,17,20,17,0,0,-5,-2,-5,0,0,-12,11:6 - 11:9 - 11:6 - 0:0 - 0:0
18357997,2024-04-28 10:15:00,Hovhannesyan Rafik - Arutyunov Ruben,3:0,1:11 - 3:11 - 3:11 - 0:0 - 0:0,0,3,Hovhannesyan Rafik,Arutyunov Ruben,fiurst,Arutyunov Ruben - Hovhannesyan Rafik,40,33,7,-26,26,12,14,14,0,0,-10,-8,-8,0,0,-26,11:1 - 11:3 - 11:3 - 0:0 - 0:0
18357995,2024-04-28 10:00:00,Nazaryan Mushegh - Asatryan Murad,3:0,8:11 - 3:11 - 3:11 - 0:0 - 0:0,0,3,Nazaryan Mushegh,Asatryan Murad,fiurst,Asatryan Murad - Nazaryan Mushegh,47,33,14,-19,19,19,14,14,0,0,-3,-8,-8,0,0,-19,11:8 - 11:3 - 11:3 - 0:0 - 0:0
18341975,2024-04-27 17:30:00,Avakimyan Davit - Mkrtchyan Andranik,3:0,11:7 - 11:6 - 11:8 - 0:0 - 0:0,3,0,Avakimyan Davit,Mkrtchyan Andranik,fiurst,Avakimyan Davit - Mkrtchyan Andranik,54,33,21,-12,12,18,17,19,0,0,-4,-5,-3,0,0,-12,11:7 - 11:6 - 11:8 - 0:0 - 0:0
18341928,2024-04-27 17:00:00,Avakimyan Davit - Soghomonyan Hrayr,2:3,8:11 - 11:8 - 3:11 - 11:7 - 4:11,2,3,Avakimyan Davit,Soghomonyan Hrayr,fiurst,Avakimyan Davit - Soghomonyan Hrayr,85,37,48,11,-11,19,19,14,18,15,3,-3,8,-4,7,11,8:11 - 11:8 - 3:11 - 11:7 - 4:11
18341926,2024-04-27 16:45:00,Mkrtchyan Andranik - Petrosyan Davit,3:1,11:8 - 8:11 - 11:8 - 11:9 - 0:0,3,1,Mkrtchyan Andranik,Petrosyan Davit,fiurst,Mkrtchyan Andranik - Petrosyan Davit,77,41,36,-5,5,19,19,19,20,0,-3,3,-3,-2,0,-5,11:8 - 8:11 - 11:8 - 11:9 - 0:0
18341906,2024-04-27 16:15:00,Soghomonyan Hrayr - Petrosyan Davit,0:3,12:10 - 11:3 - 11:5 - 0:0 - 0:0,3,0,Soghomonyan Hrayr,Petrosyan Davit,fiurst,Petrosyan Davit - Soghomonyan Hrayr,52,18,34,16,-16,22,14,16,0,0,2,8,6,0,0,16,10:12 - 3:11 - 5:11 - 0:0 - 0:0
18341900,2024-04-27 15:45:00,Petrosyan Davit - Avakimyan Davit,0:3,11:6 - 11:9 - 11:3 - 0:0 - 0:0,3,0,Petrosyan Davit,Avakimyan Davit,fiurst,Avakimyan Davit - Petrosyan Davit,51,18,33,15,-15,17,20,14,0,0,5,2,8,0,0,15,6:11 - 9:11 - 3:11 - 0:0 - 0:0
18341889,2024-04-27 15:30:00,Soghomonyan Hrayr - Mkrtchyan Andranik,1:3,11:9 - 11:8 - 6:11 - 11:2 - 0:0,3,1,Soghomonyan Hrayr,Mkrtchyan Andranik,fiurst,Mkrtchyan Andranik - Soghomonyan Hrayr,69,30,39,9,-9,20,19,17,13,0,2,3,-5,9,0,9,9:11 - 8:11 - 11:6 - 2:11 - 0:0
18341882,2024-04-27 15:30:00,Rafayelyan Edgar - Arutyunov Ruben,0:3,11:4 - 11:8 - 13:11 - 0:0 - 0:0,3,0,Rafayelyan Edgar,Arutyunov Ruben,fiurst,Arutyunov Ruben - Rafayelyan Edgar,58,23,35,12,-12,15,19,24,0,0,7,3,2,0,0,12,4:11 - 8:11 - 11:13 - 0:0 - 0:0
18341870,2024-04-27 15:10:00,Nazaryan Mushegh - Hovhannesyan Rafik,1:3,11:8 - 11:9 - 11:13 - 11:6 - 0:0,3,1,Nazaryan Mushegh,Hovhannesyan Rafik,fiurst,Hovhannesyan Rafik - Nazaryan Mushegh,80,36,44,8,-8,19,20,24,17,0,3,2,-2,5,0,8,8:11 - 9:11 - 13:11 - 6:11 - 0:0
18341868,2024-04-27 14:45:00,Asatryan Murad - Rafayelyan Edgar,3:2,11:6 - 13:11 - 8:11 - 11:13 - 11:6,3,2,Asatryan Murad,Rafayelyan Edgar,fiurst,Asatryan Murad - Rafayelyan Edgar,101,54,47,-7,7,17,24,19,24,17,-5,-2,3,2,-5,-7,11:6 - 13:11 - 8:11 - 11:13 - 11:6
18341867,2024-04-27 14:40:00,Arutyunov Ruben - Nazaryan Mushegh,2:3,11:9 - 8:11 - 6:11 - 11:6 - 12:14,2,3,Arutyunov Ruben,Nazaryan Mushegh,fiurst,Arutyunov Ruben - Nazaryan Mushegh,99,48,51,3,-3,20,19,17,17,26,-2,3,5,-5,2,3,11:9 - 8:11 - 6:11 - 11:6 - 12:14
18341864,2024-04-27 14:15:00,Asatryan Murad - Hovhannesyan Rafik,3:1,11:8 - 5:11 - 11:9 - 11:4 - 0:0,3,1,Asatryan Murad,Hovhannesyan Rafik,fiurst,Asatryan Murad - Hovhannesyan Rafik,70,38,32,-6,6,19,16,20,15,0,-3,6,-2,-7,0,-6,11:8 - 5:11 - 11:9 - 11:4 - 0:0
18341863,2024-04-27 14:00:00,Rafayelyan Edgar - Nazaryan Mushegh,1:3,11:9 - 4:11 - 11:5 - 11:4 - 0:0,3,1,Rafayelyan Edgar,Nazaryan Mushegh,fiurst,Nazaryan Mushegh - Rafayelyan Edgar,66,29,37,8,-8,20,15,16,15,0,2,-7,6,7,0,8,9:11 - 11:4 - 5:11 - 4:11 - 0:0
18341842,2024-04-27 13:45:00,Hovhannesyan Rafik - Rafayelyan Edgar,0:3,5:11 - 9:11 - 6:11 - 0:0 - 0:0,0,3,Hovhannesyan Rafik,Rafayelyan Edgar,fiurst,Hovhannesyan Rafik - Rafayelyan Edgar,53,20,33,13,-13,16,20,17,0,0,6,2,5,0,0,13,5:11 - 9:11 - 6:11 - 0:0 - 0:0
18341858,2024-04-27 13:45:00,Arutyunov Ruben - Asatryan Murad,0:3,9:11 - 8:11 - 4:11 - 0:0 - 0:0,0,3,Arutyunov Ruben,Asatryan Murad,fiurst,Arutyunov Ruben - Asatryan Murad,54,21,33,12,-12,20,19,15,0,0,2,3,7,0,0,12,9:11 - 8:11 - 4:11 - 0:0 - 0:0
18341840,2024-04-27 13:15:00,Nazaryan Mushegh - Asatryan Murad,3:0,4:11 - 5:11 - 6:11 - 0:0 - 0:0,0,3,Nazaryan Mushegh,Asatryan Murad,fiurst,Asatryan Murad - Nazaryan Mushegh,48,33,15,-18,18,15,16,17,0,0,-7,-6,-5,0,0,-18,11:4 - 11:5 - 11:6 - 0:0 - 0:0
18341828,2024-04-27 13:00:00,Hovhannesyan Rafik - Arutyunov Ruben,3:1,8:11 - 9:11 - 11:9 - 4:11 - 0:0,1,3,Hovhannesyan Rafik,Arutyunov Ruben,fiurst,Arutyunov Ruben - Hovhannesyan Rafik,74,42,32,-10,10,19,20,20,15,0,-3,-2,2,-7,0,-10,11:8 - 11:9 - 9:11 - 11:4 - 0:0
18341823,2024-04-27 12:20:00,Rafayelyan Edgar - Asatryan Murad,2:3,7:11 - 6:11 - 11:3 - 12:10 - 11:7,3,2,Rafayelyan Edgar,Asatryan Murad,fiurst,Asatryan Murad - Rafayelyan Edgar,89,42,47,5,-5,18,17,14,22,18,-4,-5,8,2,4,5,11:7 - 11:6 - 3:11 - 10:12 - 7:11
18341818,2024-04-27 12:10:00,Arutyunov Ruben - Rafayelyan Edgar,0:3,6:11 - 6:11 - 9:11 - 0:0 - 0:0,0,3,Arutyunov Ruben,Rafayelyan Edgar,fiurst,Arutyunov Ruben - Rafayelyan Edgar,54,21,33,12,-12,17,17,20,0,0,5,5,2,0,0,12,6:11 - 6:11 - 9:11 - 0:0 - 0:0
18341821,2024-04-27 12:05:00,Hovhannesyan Rafik - Nazaryan Mushegh,1:3,11:3 - 10:12 - 10:12 - 9:11 - 0:0,1,3,Hovhannesyan Rafik,Nazaryan Mushegh,fiurst,Hovhannesyan Rafik - Nazaryan Mushegh,78,40,38,-2,2,14,22,22,20,0,-8,2,2,2,0,-2,11:3 - 10:12 - 10:12 - 9:11 - 0:0
18341808,2024-04-27 11:30:00,Nazaryan Mushegh - Arutyunov Ruben,1:3,8:11 - 11:8 - 14:12 - 11:6 - 0:0,3,1,Nazaryan Mushegh,Arutyunov Ruben,fiurst,Arutyunov Ruben - Nazaryan Mushegh,81,37,44,7,-7,19,19,26,17,0,-3,3,2,5,0,7,11:8 - 8:11 - 12:14 - 6:11 - 0:0
18341809,2024-04-27 11:30:00,Hovhannesyan Rafik - Asatryan Murad,3:0,8:11 - 6:11 - 1:11 - 0:0 - 0:0,0,3,Hovhannesyan Rafik,Asatryan Murad,fiurst,Asatryan Murad - Hovhannesyan Rafik,48,33,15,-18,18,19,17,12,0,0,-3,-5,-10,0,0,-18,11:8 - 11:6 - 11:1 - 0:0 - 0:0
18341804,2024-04-27 11:00:00,Rafayelyan Edgar - Hovhannesyan Rafik,0:3,11:4 - 11:7 - 11:8 - 0:0 - 0:0,3,0,Rafayelyan Edgar,Hovhannesyan Rafik,fiurst,Hovhannesyan Rafik - Rafayelyan Edgar,52,19,33,14,-14,15,18,19,0,0,7,4,3,0,0,14,4:11 - 7:11 - 8:11 - 0:0 - 0:0
18341791,2024-04-27 10:45:00,Asatryan Murad - Arutyunov Ruben,2:3,11:6 - 11:8 - 7:11 - 9:11 - 14:12,3,2,Asatryan Murad,Arutyunov Ruben,fiurst,Arutyunov Ruben - Asatryan Murad,100,48,52,4,-4,17,19,18,20,26,5,3,-4,-2,2,4,6:11 - 8:11 - 11:7 - 11:9 - 12:14
18341780,2024-04-27 10:30:00,Nazaryan Mushegh - Rafayelyan Edgar,2:3,11:9 - 11:4 - 9:11 - 6:11 - 3:11,2,3,Nazaryan Mushegh,Rafayelyan Edgar,fiurst,Nazaryan Mushegh - Rafayelyan Edgar,86,40,46,6,-6,20,15,20,17,14,-2,-7,2,5,8,6,11:9 - 11:4 - 9:11 - 6:11 - 3:11
18341778,2024-04-27 10:15:00,Arutyunov Ruben - Hovhannesyan Rafik,3:0,11:8 - 11:7 - 11:5 - 0:0 - 0:0,3,0,Arutyunov Ruben,Hovhannesyan Rafik,fiurst,Arutyunov Ruben - Hovhannesyan Rafik,53,33,20,-13,13,19,18,16,0,0,-3,-4,-6,0,0,-13,11:8 - 11:7 - 11:5 - 0:0 - 0:0
18341777,2024-04-27 10:00:00,Asatryan Murad - Nazaryan Mushegh,3:0,15:13 - 11:7 - 11:9 - 0:0 - 0:0,3,0,Asatryan Murad,Nazaryan Mushegh,fiurst,Asatryan Murad - Nazaryan Mushegh,66,37,29,-8,8,28,18,20,0,0,-2,-4,-2,0,0,-8,15:13 - 11:7 - 11:9 - 0:0 - 0:0
18317793,2024-04-26 17:45:00,Mkrtchyan Andranik - Petrosyan Davit,3:1,10:12 - 11:8 - 11:8 - 12:10 - 0:0,3,1,Mkrtchyan Andranik,Petrosyan Davit,fiurst,Mkrtchyan Andranik - Petrosyan Davit,82,44,38,-6,6,22,19,19,22,0,2,-3,-3,-2,0,-6,10:12 - 11:8 - 11:8 - 12:10 - 0:0
18317790,2024-04-26 17:30:00,Soghomonyan Hrayr - Gevorgyan Hayk,3:1,10:12 - 11:9 - 7:11 - 3:11 - 0:0,1,3,Soghomonyan Hrayr,Gevorgyan Hayk,fiurst,Gevorgyan Hayk - Soghomonyan Hrayr,74,43,31,-12,12,22,20,18,14,0,-2,2,-4,-8,0,-12,12:10 - 9:11 - 11:7 - 11:3 - 0:0
18317789,2024-04-26 17:15:00,Hakobyan Eduard - Mkrtchyan Andranik,1:3,11:13 - 4:11 - 11:8 - 7:11 - 0:0,1,3,Hakobyan Eduard,Mkrtchyan Andranik,fiurst,Hakobyan Eduard - Mkrtchyan Andranik,76,33,43,10,-10,24,15,19,18,0,2,7,-3,4,0,10,11:13 - 4:11 - 11:8 - 7:11 - 0:0
18317787,2024-04-26 17:00:00,Soghomonyan Hrayr - Petrosyan Davit,0:3,11:9 - 13:11 - 11:8 - 0:0 - 0:0,3,0,Soghomonyan Hrayr,Petrosyan Davit,fiurst,Petrosyan Davit - Soghomonyan Hrayr,63,28,35,7,-7,20,24,19,0,0,2,2,3,0,0,7,9:11 - 11:13 - 8:11 - 0:0 - 0:0
18317776,2024-04-26 16:45:00,Gevorgyan Hayk - Hakobyan Eduard,3:1,11:7 - 11:6 - 13:15 - 11:5 - 0:0,3,1,Gevorgyan Hayk,Hakobyan Eduard,fiurst,Gevorgyan Hayk - Hakobyan Eduard,79,46,33,-13,13,18,17,28,16,0,-4,-5,2,-6,0,-13,11:7 - 11:6 - 13:15 - 11:5 - 0:0
18317774,2024-04-26 16:30:00,Mkrtchyan Andranik - Soghomonyan Hrayr,1:3,8:11 - 11:7 - 5:11 - 8:11 - 0:0,1,3,Mkrtchyan Andranik,Soghomonyan Hrayr,fiurst,Mkrtchyan Andranik - Soghomonyan Hrayr,72,32,40,8,-8,19,18,16,19,0,3,-4,6,3,0,8,8:11 - 11:7 - 5:11 - 8:11 - 0:0
18317771,2024-04-26 16:15:00,Petrosyan Davit - Hakobyan Eduard,0:3,11:9 - 11:9 - 12:10 - 0:0 - 0:0,3,0,Petrosyan Davit,Hakobyan Eduard,fiurst,Hakobyan Eduard - Petrosyan Davit,62,28,34,6,-6,20,20,22,0,0,2,2,2,0,0,6,9:11 - 9:11 - 10:12 - 0:0 - 0:0
18317764,2024-04-26 16:10:00,Gevorgyan Hayk - Mkrtchyan Andranik,3:0,11:4 - 11:8 - 11:5 - 0:0 - 0:0,3,0,Gevorgyan Hayk,Mkrtchyan Andranik,fiurst,Gevorgyan Hayk - Mkrtchyan Andranik,50,33,17,-16,16,15,19,16,0,0,-7,-3,-6,0,0,-16,11:4 - 11:8 - 11:5 - 0:0 - 0:0
18317761,2024-04-26 15:45:00,Hakobyan Eduard - Soghomonyan Hrayr,0:3,5:11 - 6:11 - 5:11 - 0:0 - 0:0,0,3,Hakobyan Eduard,Soghomonyan Hrayr,fiurst,Hakobyan Eduard - Soghomonyan Hrayr,49,16,33,17,-17,16,17,16,0,0,6,5,6,0,0,17,5:11 - 6:11 - 5:11 - 0:0 - 0:0
18317756,2024-04-26 15:35:00,Petrosyan Davit - Gevorgyan Hayk,0:2,12:10 - 11:7 - 0:0 - 0:0 - 0:0,2,0,Petrosyan Davit,Gevorgyan Hayk,fiurst,Gevorgyan Hayk - Petrosyan Davit,40,17,23,6,-6,22,18,0,0,0,2,4,0,0,0,6,10:12 - 7:11 - 0:0 - 0:0 - 0:0
18317744,2024-04-26 15:20:00,Nazaryan Mushegh - Asatryan Murad,3:0,5:11 - 4:11 - 2:11 - 0:0 - 0:0,0,3,Nazaryan Mushegh,Asatryan Murad,fiurst,Asatryan Murad - Nazaryan Mushegh,44,33,11,-22,22,16,15,13,0,0,-6,-7,-9,0,0,-22,11:5 - 11:4 - 11:2 - 0:0 - 0:0
18317741,2024-04-26 15:15:00,Hovhannesyan Rafik - Diaryan Aleksandr,3:1,11:7 - 5:11 - 7:11 - 5:11 - 0:0,1,3,Hovhannesyan Rafik,Diaryan Aleksandr,fiurst,Diaryan Aleksandr - Hovhannesyan Rafik,68,40,28,-12,12,18,16,18,16,0,4,-6,-4,-6,0,-12,7:11 - 11:5 - 11:7 - 11:5 - 0:0
18317740,2024-04-26 15:00:00,Arutyunov Ruben - Nazaryan Mushegh,1:3,3:11 - 11:7 - 5:11 - 8:11 - 0:0,1,3,Arutyunov Ruben,Nazaryan Mushegh,fiurst,Arutyunov Ruben - Nazaryan Mushegh,67,27,40,13,-13,14,18,16,19,0,8,-4,6,3,0,13,3:11 - 11:7 - 5:11 - 8:11 - 0:0
18317736,2024-04-26 14:40:00,Asatryan Murad - Hovhannesyan Rafik,3:1,11:6 - 10:12 - 11:3 - 11:5 - 0:0,3,1,Asatryan Murad,Hovhannesyan Rafik,fiurst,Asatryan Murad - Hovhannesyan Rafik,69,43,26,-17,17,17,22,14,16,0,-5,2,-8,-6,0,-17,11:6 - 10:12 - 11:3 - 11:5 - 0:0
18317735,2024-04-26 14:20:00,Arutyunov Ruben - Diaryan Aleksandr,3:2,4:11 - 11:6 - 11:8 - 3:11 - 11:8,3,2,Arutyunov Ruben,Diaryan Aleksandr,fiurst,Arutyunov Ruben - Diaryan Aleksandr,84,40,44,4,-4,15,17,19,14,19,7,-5,-3,8,-3,4,4:11 - 11:6 - 11:8 - 3:11 - 11:8
18317734,2024-04-26 14:10:00,Nazaryan Mushegh - Hovhannesyan Rafik,0:3,11:7 - 12:10 - 11:5 - 0:0 - 0:0,3,0,Nazaryan Mushegh,Hovhannesyan Rafik,fiurst,Hovhannesyan Rafik - Nazaryan Mushegh,56,22,34,12,-12,18,22,16,0,0,4,2,6,0,0,12,7:11 - 10:12 - 5:11 - 0:0 - 0:0
18317732,2024-04-26 13:45:00,Asatryan Murad - Arutyunov Ruben,1:3,12:10 - 8:11 - 12:10 - 11:1 - 0:0,3,1,Asatryan Murad,Arutyunov Ruben,fiurst,Arutyunov Ruben - Asatryan Murad,75,32,43,11,-11,22,19,22,12,0,2,-3,2,10,0,11,10:12 - 11:8 - 10:12 - 1:11 - 0:0
18317720,2024-04-26 13:30:00,Diaryan Aleksandr - Nazaryan Mushegh,3:1,11:8 - 9:11 - 11:5 - 14:12 - 0:0,3,1,Diaryan Aleksandr,Nazaryan Mushegh,fiurst,Diaryan Aleksandr - Nazaryan Mushegh,81,45,36,-9,9,19,20,16,26,0,-3,2,-6,-2,0,-9,11:8 - 9:11 - 11:5 - 14:12 - 0:0
18317719,2024-04-26 13:15:00,Hovhannesyan Rafik - Arutyunov Ruben,3:0,11:13 - 10:12 - 5:11 - 0:0 - 0:0,0,3,Hovhannesyan Rafik,Arutyunov Ruben,fiurst,Arutyunov Ruben - Hovhannesyan Rafik,62,36,26,-10,10,24,22,16,0,0,-2,-2,-6,0,0,-10,13:11 - 12:10 - 11:5 - 0:0 - 0:0
18317718,2024-04-26 13:00:00,Diaryan Aleksandr - Asatryan Murad,0:3,11:7 - 11:6 - 11:3 - 0:0 - 0:0,3,0,Diaryan Aleksandr,Asatryan Murad,fiurst,Asatryan Murad - Diaryan Aleksandr,49,16,33,17,-17,18,17,14,0,0,4,5,8,0,0,17,7:11 - 6:11 - 3:11 - 0:0 - 0:0
18317712,2024-04-26 12:15:00,Nazaryan Mushegh - Arutyunov Ruben,3:2,13:11 - 4:11 - 11:9 - 7:11 - 9:11,2,3,Nazaryan Mushegh,Arutyunov Ruben,fiurst,Arutyunov Ruben - Nazaryan Mushegh,97,53,44,-9,9,24,15,20,18,20,2,-7,2,-4,-2,-9,11:13 - 11:4 - 9:11 - 11:7 - 11:9
18317708,2024-04-26 12:10:00,Diaryan Aleksandr - Hovhannesyan Rafik,3:0,12:10 - 11:4 - 11:6 - 0:0 - 0:0,3,0,Diaryan Aleksandr,Hovhannesyan Rafik,fiurst,Diaryan Aleksandr - Hovhannesyan Rafik,54,34,20,-14,14,22,15,17,0,0,-2,-7,-5,0,0,-14,12:10 - 11:4 - 11:6 - 0:0 - 0:0
18317705,2024-04-26 11:45:00,Asatryan Murad - Nazaryan Mushegh,3:0,11:5 - 11:7 - 11:7 - 0:0 - 0:0,3,0,Asatryan Murad,Nazaryan Mushegh,fiurst,Asatryan Murad - Nazaryan Mushegh,52,33,19,-14,14,16,18,18,0,0,-6,-4,-4,0,0,-14,11:5 - 11:7 - 11:7 - 0:0 - 0:0
18317691,2024-04-26 11:30:00,Diaryan Aleksandr - Arutyunov Ruben,1:3,11:6 - 11:8 - 10:12 - 11:9 - 0:0,3,1,Diaryan Aleksandr,Arutyunov Ruben,fiurst,Arutyunov Ruben - Diaryan Aleksandr,78,35,43,8,-8,17,19,22,20,0,5,3,-2,2,0,8,6:11 - 8:11 - 12:10 - 9:11 - 0:0
18317690,2024-04-26 11:15:00,Hovhannesyan Rafik - Asatryan Murad,3:1,9:11 - 11:8 - 1:11 - 8:11 - 0:0,1,3,Hovhannesyan Rafik,Asatryan Murad,fiurst,Asatryan Murad - Hovhannesyan Rafik,70,41,29,-12,12,20,19,12,19,0,-2,3,-10,-3,0,-12,11:9 - 8:11 - 11:1 - 11:8 - 0:0
18317688,2024-04-26 11:05:00,Nazaryan Mushegh - Diaryan Aleksandr,3:1,11:7 - 5:11 - 6:11 - 8:11 - 0:0,1,3,Nazaryan Mushegh,Diaryan Aleksandr,fiurst,Diaryan Aleksandr - Nazaryan Mushegh,70,40,30,-10,10,18,16,17,19,0,4,-6,-5,-3,0,-10,7:11 - 11:5 - 11:6 - 11:8 - 0:0
18317680,2024-04-26 10:45:00,Hovhannesyan Rafik - Nazaryan Mushegh,3:1,15:13 - 11:5 - 5:11 - 11:2 - 0:0,3,1,Hovhannesyan Rafik,Nazaryan Mushegh,fiurst,Hovhannesyan Rafik - Nazaryan Mushegh,73,42,31,-11,11,28,16,16,13,0,-2,-6,6,-9,0,-11,15:13 - 11:5 - 5:11 - 11:2 - 0:0
18317686,2024-04-26 10:45:00,Arutyunov Ruben - Asatryan Murad,1:3,11:5 - 9:11 - 7:11 - 2:11 - 0:0,1,3,Arutyunov Ruben,Asatryan Murad,fiurst,Arutyunov Ruben - Asatryan Murad,67,29,38,9,-9,16,20,18,13,0,-6,2,4,9,0,9,11:5 - 9:11 - 7:11 - 2:11 - 0:0
18317678,2024-04-26 10:15:00,Arutyunov Ruben - Hovhannesyan Rafik,3:1,11:2 - 3:11 - 11:9 - 11:6 - 0:0,3,1,Arutyunov Ruben,Hovhannesyan Rafik,fiurst,Arutyunov Ruben - Hovhannesyan Rafik,64,36,28,-8,8,13,14,20,17,0,-9,8,-2,-5,0,-8,11:2 - 3:11 - 11:9 - 11:6 - 0:0
18317679,2024-04-26 10:15:00,Asatryan Murad - Diaryan Aleksandr,3:0,14:12 - 11:8 - 11:9 - 0:0 - 0:0,3,0,Asatryan Murad,Diaryan Aleksandr,fiurst,Asatryan Murad - Diaryan Aleksandr,65,36,29,-7,7,26,19,20,0,0,-2,-3,-2,0,0,-7,14:12 - 11:8 - 11:9 - 0:0 - 0:0
18303278,2024-04-25 17:40:00,Soghomonyan Hrayr - Hakobyan Eduard,1:3,6:11 - 11:7 - 11:9 - 11:4 - 0:0,3,1,Soghomonyan Hrayr,Hakobyan Eduard,fiurst,Hakobyan Eduard - Soghomonyan Hrayr,70,31,39,8,-8,17,18,20,15,0,-5,4,2,7,0,8,11:6 - 7:11 - 9:11 - 4:11 - 0:0
18303272,2024-04-25 17:30:00,Avakimyan Davit - Gevorgyan Gegham,0:3,8:11 - 8:11 - 6:11 - 0:0 - 0:0,0,3,Avakimyan Davit,Gevorgyan Gegham,fiurst,Avakimyan Davit - Gevorgyan Gegham,55,22,33,11,-11,19,19,17,0,0,3,3,5,0,0,11,8:11 - 8:11 - 6:11 - 0:0 - 0:0
18303260,2024-04-25 17:20:00,Petrosyan Davit - Soghomonyan Hrayr,3:1,11:9 - 6:11 - 11:1 - 13:11 - 0:0,3,1,Petrosyan Davit,Soghomonyan Hrayr,fiurst,Petrosyan Davit - Soghomonyan Hrayr,73,41,32,-9,9,20,17,12,24,0,-2,5,-10,-2,0,-9,11:9 - 6:11 - 11:1 - 13:11 - 0:0
18303259,2024-04-25 17:00:00,Avakimyan Davit - Hakobyan Eduard,1:3,8:11 - 8:11 - 11:9 - 9:11 - 0:0,1,3,Avakimyan Davit,Hakobyan Eduard,fiurst,Avakimyan Davit - Hakobyan Eduard,78,36,42,6,-6,19,19,20,20,0,3,3,-2,2,0,6,8:11 - 8:11 - 11:9 - 9:11 - 0:0
18303254,2024-04-25 16:50:00,Gevorgyan Gegham - Petrosyan Davit,0:3,9:11 - 4:11 - 10:12 - 0:0 - 0:0,0,3,Gevorgyan Gegham,Petrosyan Davit,fiurst,Gevorgyan Gegham - Petrosyan Davit,57,23,34,11,-11,20,15,22,0,0,2,7,2,0,0,11,9:11 - 4:11 - 10:12 - 0:0 - 0:0
18303252,2024-04-25 16:30:00,Soghomonyan Hrayr - Avakimyan Davit,0:3,11:6 - 11:3 - 11:5 - 0:0 - 0:0,3,0,Soghomonyan Hrayr,Avakimyan Davit,fiurst,Avakimyan Davit - Soghomonyan Hrayr,47,14,33,19,-19,17,14,16,0,0,5,8,6,0,0,19,6:11 - 3:11 - 5:11 - 0:0 - 0:0
18303250,2024-04-25 16:15:00,Hakobyan Eduard - Petrosyan Davit,3:2,11:9 - 7:11 - 11:8 - 10:12 - 14:12,3,2,Hakobyan Eduard,Petrosyan Davit,fiurst,Hakobyan Eduard - Petrosyan Davit,105,53,52,-1,1,20,18,19,22,26,-2,4,-3,2,-2,-1,11:9 - 7:11 - 11:8 - 10:12 - 14:12
18303248,2024-04-25 16:10:00,Gevorgyan Gegham - Soghomonyan Hrayr,0:3,3:11 - 6:11 - 9:11 - 0:0 - 0:0,0,3,Gevorgyan Gegham,Soghomonyan Hrayr,fiurst,Gevorgyan Gegham - Soghomonyan Hrayr,51,18,33,15,-15,14,17,20,0,0,8,5,2,0,0,15,3:11 - 6:11 - 9:11 - 0:0 - 0:0
18303235,2024-04-25 15:45:00,Hakobyan Eduard - Gevorgyan Gegham,2:3,11:8 - 3:11 - 11:9 - 5:11 - 11:7,3,2,Hakobyan Eduard,Gevorgyan Gegham,fiurst,Gevorgyan Gegham - Hakobyan Eduard,87,46,41,-5,5,19,14,20,16,18,3,-8,2,-6,4,-5,8:11 - 11:3 - 9:11 - 11:5 - 7:11
18303246,2024-04-25 15:45:00,Petrosyan Davit - Avakimyan Davit,1:3,9:11 - 11:7 - 11:9 - 11:9 - 0:0,3,1,Petrosyan Davit,Avakimyan Davit,fiurst,Avakimyan Davit - Petrosyan Davit,78,36,42,6,-6,20,18,20,20,0,-2,4,2,2,0,6,11:9 - 7:11 - 9:11 - 9:11 - 0:0
18303233,2024-04-25 15:15:00,Asatryan Murad - Diaryan Aleksandr,3:0,11:8 - 11:7 - 11:7 - 0:0 - 0:0,3,0,Asatryan Murad,Diaryan Aleksandr,fiurst,Asatryan Murad - Diaryan Aleksandr,55,33,22,-11,11,19,18,18,0,0,-3,-4,-4,0,0,-11,11:8 - 11:7 - 11:7 - 0:0 - 0:0
18303229,2024-04-25 15:15:00,Rafayelyan Edgar - Nazaryan Mushegh,1:3,11:4 - 5:11 - 11:6 - 11:7 - 0:0,3,1,Rafayelyan Edgar,Nazaryan Mushegh,fiurst,Nazaryan Mushegh - Rafayelyan Edgar,66,28,38,10,-10,15,16,17,18,0,7,-6,5,4,0,10,4:11 - 11:5 - 6:11 - 7:11 - 0:0
18303227,2024-04-25 14:50:00,Nikoghosyan Narek - Asatryan Murad,3:0,5:11 - 2:11 - 6:11 - 0:0 - 0:0,0,3,Nikoghosyan Narek,Asatryan Murad,fiurst,Asatryan Murad - Nikoghosyan Narek,46,33,13,-20,20,16,13,17,0,0,-6,-9,-5,0,0,-20,11:5 - 11:2 - 11:6 - 0:0 - 0:0
18303221,2024-04-25 14:45:00,Diaryan Aleksandr - Rafayelyan Edgar,2:3,5:11 - 10:12 - 11:8 - 11:7 - 5:11,2,3,Diaryan Aleksandr,Rafayelyan Edgar,fiurst,Diaryan Aleksandr - Rafayelyan Edgar,91,42,49,7,-7,16,22,19,18,16,6,2,-3,-4,6,7,5:11 - 10:12 - 11:8 - 11:7 - 5:11
18303208,2024-04-25 14:30:00,Nikoghosyan Narek - Nazaryan Mushegh,0:3,11:6 - 11:9 - 11:2 - 0:0 - 0:0,3,0,Nikoghosyan Narek,Nazaryan Mushegh,fiurst,Nazaryan Mushegh - Nikoghosyan Narek,50,17,33,16,-16,17,20,13,0,0,5,2,9,0,0,16,6:11 - 9:11 - 2:11 - 0:0 - 0:0
18303206,2024-04-25 14:00:00,Asatryan Murad - Rafayelyan Edgar,2:3,11:6 - 11:6 - 10:12 - 11:13 - 8:11,2,3,Asatryan Murad,Rafayelyan Edgar,fiurst,Asatryan Murad - Rafayelyan Edgar,99,51,48,-3,3,17,17,22,24,19,-5,-5,2,2,3,-3,11:6 - 11:6 - 10:12 - 11:13 - 8:11
18303203,2024-04-25 13:55:00,Diaryan Aleksandr - Nikoghosyan Narek,1:3,7:11 - 8:11 - 12:10 - 10:12 - 0:0,1,3,Diaryan Aleksandr,Nikoghosyan Narek,fiurst,Diaryan Aleksandr - Nikoghosyan Narek,81,37,44,7,-7,18,19,22,22,0,4,3,-2,2,0,7,7:11 - 8:11 - 12:10 - 10:12 - 0:0
18303201,2024-04-25 13:30:00,Nazaryan Mushegh - Asatryan Murad,3:0,6:11 - 6:11 - 4:11 - 0:0 - 0:0,0,3,Nazaryan Mushegh,Asatryan Murad,fiurst,Asatryan Murad - Nazaryan Mushegh,49,33,16,-17,17,17,17,15,0,0,-5,-5,-7,0,0,-17,11:6 - 11:6 - 11:4 - 0:0 - 0:0
18303171,2024-04-25 13:15:00,Rafayelyan Edgar - Nikoghosyan Narek,3:2,11:4 - 9:11 - 8:11 - 11:6 - 8:11,2,3,Rafayelyan Edgar,Nikoghosyan Narek,fiurst,Nikoghosyan Narek - Rafayelyan Edgar,90,43,47,4,-4,15,20,19,17,19,7,-2,-3,5,-3,4,4:11 - 11:9 - 11:8 - 6:11 - 11:8
18303132,2024-04-25 13:00:00,Nazaryan Mushegh - Diaryan Aleksandr,3:0,4:11 - 5:11 - 6:11 - 0:0 - 0:0,0,3,Nazaryan Mushegh,Diaryan Aleksandr,fiurst,Diaryan Aleksandr - Nazaryan Mushegh,48,33,15,-18,18,15,16,17,0,0,-7,-6,-5,0,0,-18,11:4 - 11:5 - 11:6 - 0:0 - 0:0
18303112,2024-04-25 12:15:00,Asatryan Murad - Nikoghosyan Narek,0:3,9:11 - 9:11 - 12:14 - 0:0 - 0:0,0,3,Asatryan Murad,Nikoghosyan Narek,fiurst,Asatryan Murad - Nikoghosyan Narek,66,30,36,6,-6,20,20,26,0,0,2,2,2,0,0,6,9:11 - 9:11 - 12:14 - 0:0 - 0:0
18303109,2024-04-25 12:05:00,Nazaryan Mushegh - Rafayelyan Edgar,0:3,6:11 - 10:12 - 7:11 - 0:0 - 0:0,0,3,Nazaryan Mushegh,Rafayelyan Edgar,fiurst,Nazaryan Mushegh - Rafayelyan Edgar,57,23,34,11,-11,17,22,18,0,0,5,2,4,0,0,11,6:11 - 10:12 - 7:11 - 0:0 - 0:0
18303106,2024-04-25 11:45:00,Diaryan Aleksandr - Asatryan Murad,3:2,11:8 - 9:11 - 9:11 - 13:11 - 3:11,2,3,Diaryan Aleksandr,Asatryan Murad,fiurst,Asatryan Murad - Diaryan Aleksandr,97,52,45,-7,7,19,20,20,24,14,3,-2,-2,2,-8,-7,8:11 - 11:9 - 11:9 - 11:13 - 11:3
18303104,2024-04-25 11:30:00,Nazaryan Mushegh - Nikoghosyan Narek,1:3,6:11 - 9:11 - 11:7 - 4:11 - 0:0,1,3,Nazaryan Mushegh,Nikoghosyan Narek,fiurst,Nazaryan Mushegh - Nikoghosyan Narek,70,30,40,10,-10,17,20,18,15,0,5,2,-4,7,0,10,6:11 - 9:11 - 11:7 - 4:11 - 0:0
18303094,2024-04-25 11:15:00,Rafayelyan Edgar - Diaryan Aleksandr,0:3,14:12 - 11:7 - 11:3 - 0:0 - 0:0,3,0,Rafayelyan Edgar,Diaryan Aleksandr,fiurst,Diaryan Aleksandr - Rafayelyan Edgar,58,22,36,14,-14,26,18,14,0,0,2,4,8,0,0,14,12:14 - 7:11 - 3:11 - 0:0 - 0:0
18303084,2024-04-25 11:00:00,Asatryan Murad - Nazaryan Mushegh,3:0,11:3 - 11:7 - 11:6 - 0:0 - 0:0,3,0,Asatryan Murad,Nazaryan Mushegh,fiurst,Asatryan Murad - Nazaryan Mushegh,49,33,16,-17,17,14,18,17,0,0,-8,-4,-5,0,0,-17,11:3 - 11:7 - 11:6 - 0:0 - 0:0
18303082,2024-04-25 10:45:00,Nikoghosyan Narek - Diaryan Aleksandr,3:0,1:11 - 9:11 - 7:11 - 0:0 - 0:0,0,3,Nikoghosyan Narek,Diaryan Aleksandr,fiurst,Diaryan Aleksandr - Nikoghosyan Narek,50,33,17,-16,16,12,20,18,0,0,-10,-2,-4,0,0,-16,11:1 - 11:9 - 11:7 - 0:0 - 0:0
18303080,2024-04-25 10:30:00,Rafayelyan Edgar - Asatryan Murad,3:1,6:11 - 13:11 - 10:12 - 9:11 - 0:0,1,3,Rafayelyan Edgar,Asatryan Murad,fiurst,Asatryan Murad - Rafayelyan Edgar,83,45,38,-7,7,17,24,22,20,0,-5,2,-2,-2,0,-7,11:6 - 11:13 - 12:10 - 11:9 - 0:0
18303077,2024-04-25 10:15:00,Diaryan Aleksandr - Nazaryan Mushegh,3:2,11:3 - 7:11 - 5:11 - 11:3 - 11:8,3,2,Diaryan Aleksandr,Nazaryan Mushegh,fiurst,Diaryan Aleksandr - Nazaryan Mushegh,81,45,36,-9,9,14,18,16,14,19,-8,4,6,-8,-3,-9,11:3 - 7:11 - 5:11 - 11:3 - 11:8
18303075,2024-04-25 10:00:00,Nikoghosyan Narek - Rafayelyan Edgar,1:3,11:4 - 4:11 - 6:11 - 6:11 - 0:0,1,3,Nikoghosyan Narek,Rafayelyan Edgar,fiurst,Nikoghosyan Narek - Rafayelyan Edgar,64,27,37,10,-10,15,15,17,17,0,-7,7,5,5,0,10,11:4 - 4:11 - 6:11 - 6:11 - 0:0
18282814,2024-04-24 17:45:00,Hakobyan Eduard - Gevorgyan Hayk,3:2,10:12 - 8:11 - 11:4 - 11:4 - 5:11,2,3,Hakobyan Eduard,Gevorgyan Hayk,fiurst,Gevorgyan Hayk - Hakobyan Eduard,87,42,45,3,-3,22,19,15,15,16,-2,-3,7,7,-6,3,12:10 - 11:8 - 4:11 - 4:11 - 11:5
18282813,2024-04-24 17:30:00,Soghomonyan Hrayr - Petrosyan Davit,0:3,11:7 - 11:5 - 11:6 - 0:0 - 0:0,3,0,Soghomonyan Hrayr,Petrosyan Davit,fiurst,Petrosyan Davit - Soghomonyan Hrayr,51,18,33,15,-15,18,16,17,0,0,4,6,5,0,0,15,7:11 - 5:11 - 6:11 - 0:0 - 0:0
18282799,2024-04-24 17:15:00,Gevorgyan Gegham - Hakobyan Eduard,1:3,7:11 - 9:11 - 14:12 - 8:11 - 0:0,1,3,Gevorgyan Gegham,Hakobyan Eduard,fiurst,Gevorgyan Gegham - Hakobyan Eduard,83,38,45,7,-7,18,20,26,19,0,4,2,-2,3,0,7,7:11 - 9:11 - 14:12 - 8:11 - 0:0
18282797,2024-04-24 17:00:00,Soghomonyan Hrayr - Gevorgyan Hayk,1:3,11:5 - 7:11 - 11:6 - 11:5 - 0:0,3,1,Soghomonyan Hrayr,Gevorgyan Hayk,fiurst,Gevorgyan Hayk - Soghomonyan Hrayr,67,27,40,13,-13,16,18,17,16,0,6,-4,5,6,0,13,5:11 - 11:7 - 6:11 - 5:11 - 0:0
18282794,2024-04-24 16:45:00,Petrosyan Davit - Gevorgyan Gegham,0:3,11:7 - 11:6 - 11:3 - 0:0 - 0:0,3,0,Petrosyan Davit,Gevorgyan Gegham,fiurst,Gevorgyan Gegham - Petrosyan Davit,49,16,33,17,-17,18,17,14,0,0,4,5,8,0,0,17,7:11 - 6:11 - 3:11 - 0:0 - 0:0
18282784,2024-04-24 16:30:00,Hakobyan Eduard - Soghomonyan Hrayr,1:3,8:11 - 7:11 - 11:8 - 4:11 - 0:0,1,3,Hakobyan Eduard,Soghomonyan Hrayr,fiurst,Hakobyan Eduard - Soghomonyan Hrayr,71,30,41,11,-11,19,18,19,15,0,3,4,-3,7,0,11,8:11 - 7:11 - 11:8 - 4:11 - 0:0
18282783,2024-04-24 16:15:00,Gevorgyan Hayk - Gevorgyan Gegham,0:3,11:5 - 15:13 - 11:7 - 0:0 - 0:0,3,0,Gevorgyan Hayk,Gevorgyan Gegham,fiurst,Gevorgyan Gegham - Gevorgyan Hayk,62,25,37,12,-12,16,28,18,0,0,6,2,4,0,0,12,5:11 - 13:15 - 7:11 - 0:0 - 0:0
18282782,2024-04-24 16:00:00,Petrosyan Davit - Hakobyan Eduard,3:1,1:11 - 11:7 - 10:12 - 10:12 - 0:0,1,3,Petrosyan Davit,Hakobyan Eduard,fiurst,Hakobyan Eduard - Petrosyan Davit,74,42,32,-10,10,12,18,22,22,0,-10,4,-2,-2,0,-10,11:1 - 7:11 - 12:10 - 12:10 - 0:0
18282768,2024-04-24 15:45:00,Gevorgyan Gegham - Soghomonyan Hrayr,1:3,8:11 - 11:6 - 4:11 - 13:15 - 0:0,1,3,Gevorgyan Gegham,Soghomonyan Hrayr,fiurst,Gevorgyan Gegham - Soghomonyan Hrayr,79,36,43,7,-7,19,17,15,28,0,3,-5,7,2,0,7,8:11 - 11:6 - 4:11 - 13:15 - 0:0
18282766,2024-04-24 15:30:00,Gevorgyan Hayk - Petrosyan Davit,3:0,11:7 - 11:6 - 11:4 - 0:0 - 0:0,3,0,Gevorgyan Hayk,Petrosyan Davit,fiurst,Gevorgyan Hayk - Petrosyan Davit,50,33,17,-16,16,18,17,15,0,0,-4,-5,-7,0,0,-16,11:7 - 11:6 - 11:4 - 0:0 - 0:0
18282754,2024-04-24 15:15:00,Rafayelyan Edgar - Hovhannesyan Rafik,3:2,11:4 - 11:9 - 8:11 - 10:12 - 7:11,2,3,Rafayelyan Edgar,Hovhannesyan Rafik,fiurst,Hovhannesyan Rafik - Rafayelyan Edgar,94,47,47,0,0,15,20,19,22,18,7,2,-3,-2,-4,0,4:11 - 9:11 - 11:8 - 12:10 - 11:7
18282752,2024-04-24 15:10:00,Arutyunov Ruben - Nikoghosyan Narek,1:3,9:11 - 11:9 - 8:11 - 8:11 - 0:0,1,3,Arutyunov Ruben,Nikoghosyan Narek,fiurst,Arutyunov Ruben - Nikoghosyan Narek,78,36,42,6,-6,20,20,19,19,0,2,-2,3,3,0,6,9:11 - 11:9 - 8:11 - 8:11 - 0:0
18282751,2024-04-24 15:00:00,Diaryan Aleksandr - Rafayelyan Edgar,3:0,11:2 - 11:6 - 11:8 - 0:0 - 0:0,3,0,Diaryan Aleksandr,Rafayelyan Edgar,fiurst,Diaryan Aleksandr - Rafayelyan Edgar,49,33,16,-17,17,13,17,19,0,0,-9,-5,-3,0,0,-17,11:2 - 11:6 - 11:8 - 0:0 - 0:0
18282750,2024-04-24 14:40:00,Hovhannesyan Rafik - Arutyunov Ruben,3:1,4:11 - 7:11 - 11:8 - 7:11 - 0:0,1,3,Hovhannesyan Rafik,Arutyunov Ruben,fiurst,Arutyunov Ruben - Hovhannesyan Rafik,70,41,29,-12,12,15,18,19,18,0,-7,-4,3,-4,0,-12,11:4 - 11:7 - 8:11 - 11:7 - 0:0
18282747,2024-04-24 14:25:00,Diaryan Aleksandr - Nikoghosyan Narek,3:1,7:11 - 11:2 - 11:6 - 12:10 - 0:0,3,1,Diaryan Aleksandr,Nikoghosyan Narek,fiurst,Diaryan Aleksandr - Nikoghosyan Narek,70,41,29,-12,12,18,13,17,22,0,4,-9,-5,-2,0,-12,7:11 - 11:2 - 11:6 - 12:10 - 0:0
18282745,2024-04-24 14:10:00,Rafayelyan Edgar - Arutyunov Ruben,0:3,11:4 - 11:5 - 11:4 - 0:0 - 0:0,3,0,Rafayelyan Edgar,Arutyunov Ruben,fiurst,Arutyunov Ruben - Rafayelyan Edgar,46,13,33,20,-20,15,16,15,0,0,7,6,7,0,0,20,4:11 - 5:11 - 4:11 - 0:0 - 0:0
18282743,2024-04-24 13:55:00,Hovhannesyan Rafik - Diaryan Aleksandr,3:0,4:11 - 5:11 - 5:11 - 0:0 - 0:0,0,3,Hovhannesyan Rafik,Diaryan Aleksandr,fiurst,Diaryan Aleksandr - Hovhannesyan Rafik,47,33,14,-19,19,15,16,16,0,0,-7,-6,-6,0,0,-19,11:4 - 11:5 - 11:5 - 0:0 - 0:0
18282742,2024-04-24 13:45:00,Nikoghosyan Narek - Rafayelyan Edgar,3:1,13:11 - 9:11 - 11:8 - 11:7 - 0:0,3,1,Nikoghosyan Narek,Rafayelyan Edgar,fiurst,Nikoghosyan Narek - Rafayelyan Edgar,81,44,37,-7,7,24,20,19,18,0,-2,2,-3,-4,0,-7,13:11 - 9:11 - 11:8 - 11:7 - 0:0
18282740,2024-04-24 13:15:00,Arutyunov Ruben - Diaryan Aleksandr,0:3,6:11 - 8:11 - 3:11 - 0:0 - 0:0,0,3,Arutyunov Ruben,Diaryan Aleksandr,fiurst,Arutyunov Ruben - Diaryan Aleksandr,50,17,33,16,-16,17,19,14,0,0,5,3,8,0,0,16,6:11 - 8:11 - 3:11 - 0:0 - 0:0
18282697,2024-04-24 13:10:00,Nikoghosyan Narek - Hovhannesyan Rafik,2:3,11:7 - 11:9 - 11:13 - 5:11 - 12:10,3,2,Nikoghosyan Narek,Hovhannesyan Rafik,fiurst,Hovhannesyan Rafik - Nikoghosyan Narek,100,50,50,0,0,18,20,24,16,22,4,2,-2,-6,2,0,7:11 - 9:11 - 13:11 - 11:5 - 10:12
18282690,2024-04-24 12:25:00,Nikoghosyan Narek - Arutyunov Ruben,0:3,11:6 - 11:8 - 13:11 - 0:0 - 0:0,3,0,Nikoghosyan Narek,Arutyunov Ruben,fiurst,Arutyunov Ruben - Nikoghosyan Narek,60,25,35,10,-10,17,19,24,0,0,5,3,2,0,0,10,6:11 - 8:11 - 11:13 - 0:0 - 0:0
18282694,2024-04-24 12:25:00,Rafayelyan Edgar - Diaryan Aleksandr,0:3,11:7 - 11:9 - 11:4 - 0:0 - 0:0,3,0,Rafayelyan Edgar,Diaryan Aleksandr,fiurst,Diaryan Aleksandr - Rafayelyan Edgar,53,20,33,13,-13,18,20,15,0,0,4,2,7,0,0,13,7:11 - 9:11 - 4:11 - 0:0 - 0:0
18282688,2024-04-24 12:00:00,Hovhannesyan Rafik - Rafayelyan Edgar,1:3,11:9 - 6:11 - 3:11 - 1:11 - 0:0,1,3,Hovhannesyan Rafik,Rafayelyan Edgar,fiurst,Hovhannesyan Rafik - Rafayelyan Edgar,63,21,42,21,-21,20,17,14,12,0,-2,5,8,10,0,21,11:9 - 6:11 - 3:11 - 1:11 - 0:0
18282686,2024-04-24 11:35:00,Nikoghosyan Narek - Diaryan Aleksandr,3:2,14:16 - 11:13 - 11:5 - 11:8 - 4:11,2,3,Nikoghosyan Narek,Diaryan Aleksandr,fiurst,Diaryan Aleksandr - Nikoghosyan Narek,104,53,51,-2,2,30,24,16,19,15,-2,-2,6,3,-7,-2,16:14 - 13:11 - 5:11 - 8:11 - 11:4
18282684,2024-04-24 11:30:00,Arutyunov Ruben - Hovhannesyan Rafik,1:3,11:13 - 12:10 - 9:11 - 5:11 - 0:0,1,3,Arutyunov Ruben,Hovhannesyan Rafik,fiurst,Arutyunov Ruben - Hovhannesyan Rafik,82,37,45,8,-8,24,22,20,16,0,2,-2,2,6,0,8,11:13 - 12:10 - 9:11 - 5:11 - 0:0
18282683,2024-04-24 11:00:00,Rafayelyan Edgar - Nikoghosyan Narek,2:3,10:12 - 10:12 - 11:9 - 11:7 - 11:5,3,2,Rafayelyan Edgar,Nikoghosyan Narek,fiurst,Nikoghosyan Narek - Rafayelyan Edgar,98,45,53,8,-8,22,22,20,18,16,-2,-2,2,4,6,8,12:10 - 12:10 - 9:11 - 7:11 - 5:11
18282670,2024-04-24 10:55:00,Diaryan Aleksandr - Hovhannesyan Rafik,3:2,11:5 - 11:1 - 8:11 - 7:11 - 11:7,3,2,Diaryan Aleksandr,Hovhannesyan Rafik,fiurst,Diaryan Aleksandr - Hovhannesyan Rafik,83,48,35,-13,13,16,12,19,18,18,-6,-10,3,4,-4,-13,11:5 - 11:1 - 8:11 - 7:11 - 11:7
18282665,2024-04-24 10:30:00,Arutyunov Ruben - Rafayelyan Edgar,1:3,12:10 - 3:11 - 4:11 - 6:11 - 0:0,1,3,Arutyunov Ruben,Rafayelyan Edgar,fiurst,Arutyunov Ruben - Rafayelyan Edgar,68,25,43,18,-18,22,14,15,17,0,-2,8,7,5,0,18,12:10 - 3:11 - 4:11 - 6:11 - 0:0
18282662,2024-04-24 10:15:00,Hovhannesyan Rafik - Nikoghosyan Narek,2:3,5:11 - 2:11 - 11:9 - 11:7 - 8:11,2,3,Hovhannesyan Rafik,Nikoghosyan Narek,fiurst,Hovhannesyan Rafik - Nikoghosyan Narek,86,37,49,12,-12,16,13,20,18,19,6,9,-2,-4,3,12,5:11 - 2:11 - 11:9 - 11:7 - 8:11
18282660,2024-04-24 10:00:00,Diaryan Aleksandr - Arutyunov Ruben,0:3,11:7 - 11:4 - 11:9 - 0:0 - 0:0,3,0,Diaryan Aleksandr,Arutyunov Ruben,fiurst,Arutyunov Ruben - Diaryan Aleksandr,53,20,33,13,-13,18,15,20,0,0,4,7,2,0,0,13,7:11 - 4:11 - 9:11 - 0:0 - 0:0
18264232,2024-04-23 17:45:00,Avakimyan Davit - Mkrtchyan Andranik,3:1,5:11 - 11:9 - 14:12 - 11:6 - 0:0,3,1,Avakimyan Davit,Mkrtchyan Andranik,fiurst,Avakimyan Davit - Mkrtchyan Andranik,79,41,38,-3,3,16,20,26,17,0,6,-2,-2,-5,0,-3,5:11 - 11:9 - 14:12 - 11:6 - 0:0
18264230,2024-04-23 17:40:00,Gevorgyan Gegham - Soghomonyan Hrayr,0:3,9:11 - 3:11 - 7:11 - 0:0 - 0:0,0,3,Gevorgyan Gegham,Soghomonyan Hrayr,fiurst,Gevorgyan Gegham - Soghomonyan Hrayr,52,19,33,14,-14,20,14,18,0,0,2,8,4,0,0,14,9:11 - 3:11 - 7:11 - 0:0 - 0:0
18264222,2024-04-23 17:15:00,Gevorgyan Hayk - Avakimyan Davit,1:3,11:5 - 11:6 - 5:11 - 11:8 - 0:0,3,1,Gevorgyan Hayk,Avakimyan Davit,fiurst,Avakimyan Davit - Gevorgyan Hayk,68,30,38,8,-8,16,17,16,19,0,6,5,-6,3,0,8,5:11 - 6:11 - 11:5 - 8:11 - 0:0
18264217,2024-04-23 17:00:00,Gevorgyan Gegham - Mkrtchyan Andranik,1:3,9:11 - 13:15 - 12:10 - 6:11 - 0:0,1,3,Gevorgyan Gegham,Mkrtchyan Andranik,fiurst,Gevorgyan Gegham - Mkrtchyan Andranik,87,40,47,7,-7,20,28,22,17,0,2,2,-2,5,0,7,9:11 - 13:15 - 12:10 - 6:11 - 0:0
18264214,2024-04-23 16:50:00,Soghomonyan Hrayr - Gevorgyan Hayk,0:3,11:3 - 11:9 - 11:5 - 0:0 - 0:0,3,0,Soghomonyan Hrayr,Gevorgyan Hayk,fiurst,Gevorgyan Hayk - Soghomonyan Hrayr,50,17,33,16,-16,14,20,16,0,0,8,2,6,0,0,16,3:11 - 9:11 - 5:11 - 0:0 - 0:0
18264213,2024-04-23 16:30:00,Avakimyan Davit - Gevorgyan Gegham,3:1,9:11 - 16:14 - 11:5 - 13:11 - 0:0,3,1,Avakimyan Davit,Gevorgyan Gegham,fiurst,Avakimyan Davit - Gevorgyan Gegham,90,49,41,-8,8,20,30,16,24,0,2,-2,-6,-2,0,-8,9:11 - 16:14 - 11:5 - 13:11 - 0:0
18264212,2024-04-23 16:25:00,Mkrtchyan Andranik - Gevorgyan Hayk,3:0,4:11 - 9:11 - 10:12 - 0:0 - 0:0,0,3,Mkrtchyan Andranik,Gevorgyan Hayk,fiurst,Gevorgyan Hayk - Mkrtchyan Andranik,57,34,23,-11,11,15,20,22,0,0,-7,-2,-2,0,0,-11,11:4 - 11:9 - 12:10 - 0:0 - 0:0
18264201,2024-04-23 16:00:00,Soghomonyan Hrayr - Avakimyan Davit,0:3,11:4 - 11:7 - 11:3 - 0:0 - 0:0,3,0,Soghomonyan Hrayr,Avakimyan Davit,fiurst,Avakimyan Davit - Soghomonyan Hrayr,47,14,33,19,-19,15,18,14,0,0,7,4,8,0,0,19,4:11 - 7:11 - 3:11 - 0:0 - 0:0
18264199,2024-04-23 15:45:00,Gevorgyan Hayk - Gevorgyan Gegham,2:3,13:11 - 11:13 - 11:8 - 13:15 - 11:5,3,2,Gevorgyan Hayk,Gevorgyan Gegham,fiurst,Gevorgyan Gegham - Gevorgyan Hayk,111,52,59,7,-7,24,24,19,28,16,2,-2,3,-2,6,7,11:13 - 13:11 - 8:11 - 15:13 - 5:11
18264196,2024-04-23 15:30:00,Mkrtchyan Andranik - Soghomonyan Hrayr,0:3,7:11 - 7:11 - 7:11 - 0:0 - 0:0,0,3,Mkrtchyan Andranik,Soghomonyan Hrayr,fiurst,Mkrtchyan Andranik - Soghomonyan Hrayr,54,21,33,12,-12,18,18,18,0,0,4,4,4,0,0,12,7:11 - 7:11 - 7:11 - 0:0 - 0:0
18264192,2024-04-23 15:15:00,Diaryan Aleksandr - Nazaryan Mushegh,3:0,11:6 - 11:2 - 11:9 - 0:0 - 0:0,3,0,Diaryan Aleksandr,Nazaryan Mushegh,fiurst,Diaryan Aleksandr - Nazaryan Mushegh,50,33,17,-16,16,17,13,20,0,0,-5,-9,-2,0,0,-16,11:6 - 11:2 - 11:9 - 0:0 - 0:0
18264190,2024-04-23 15:00:00,Arutyunov Ruben - Nikoghosyan Narek,1:3,19:21 - 11:8 - 4:11 - 6:11 - 0:0,1,3,Arutyunov Ruben,Nikoghosyan Narek,fiurst,Arutyunov Ruben - Nikoghosyan Narek,91,40,51,11,-11,40,19,15,17,0,2,-3,7,5,0,11,19:21 - 11:8 - 4:11 - 6:11 - 0:0
18264189,2024-04-23 14:50:00,Asatryan Murad - Diaryan Aleksandr,3:0,11:9 - 11:7 - 11:5 - 0:0 - 0:0,3,0,Asatryan Murad,Diaryan Aleksandr,fiurst,Asatryan Murad - Diaryan Aleksandr,54,33,21,-12,12,20,18,16,0,0,-2,-4,-6,0,0,-12,11:9 - 11:7 - 11:5 - 0:0 - 0:0
18264188,2024-04-23 14:30:00,Nazaryan Mushegh - Arutyunov Ruben,0:3,11:3 - 11:6 - 11:6 - 0:0 - 0:0,3,0,Nazaryan Mushegh,Arutyunov Ruben,fiurst,Arutyunov Ruben - Nazaryan Mushegh,48,15,33,18,-18,14,17,17,0,0,8,5,5,0,0,18,3:11 - 6:11 - 6:11 - 0:0 - 0:0
18264167,2024-04-23 14:15:00,Asatryan Murad - Nikoghosyan Narek,3:1,11:9 - 8:11 - 11:3 - 11:5 - 0:0,3,1,Asatryan Murad,Nikoghosyan Narek,fiurst,Asatryan Murad - Nikoghosyan Narek,69,41,28,-13,13,20,19,14,16,0,-2,3,-8,-6,0,-13,11:9 - 8:11 - 11:3 - 11:5 - 0:0
18264165,2024-04-23 14:05:00,Diaryan Aleksandr - Arutyunov Ruben,0:3,11:9 - 11:3 - 11:3 - 0:0 - 0:0,3,0,Diaryan Aleksandr,Arutyunov Ruben,fiurst,Arutyunov Ruben - Diaryan Aleksandr,48,15,33,18,-18,20,14,14,0,0,2,8,8,0,0,18,9:11 - 3:11 - 3:11 - 0:0 - 0:0
18264163,2024-04-23 13:45:00,Nazaryan Mushegh - Asatryan Murad,3:0,2:11 - 6:11 - 6:11 - 0:0 - 0:0,0,3,Nazaryan Mushegh,Asatryan Murad,fiurst,Asatryan Murad - Nazaryan Mushegh,47,33,14,-19,19,13,17,17,0,0,-9,-5,-5,0,0,-19,11:2 - 11:6 - 11:6 - 0:0 - 0:0
18264161,2024-04-23 13:30:00,Nikoghosyan Narek - Diaryan Aleksandr,3:1,9:11 - 4:11 - 11:9 - 8:11 - 0:0,1,3,Nikoghosyan Narek,Diaryan Aleksandr,fiurst,Diaryan Aleksandr - Nikoghosyan Narek,74,42,32,-10,10,20,15,20,19,0,-2,-7,2,-3,0,-10,11:9 - 11:4 - 9:11 - 11:8 - 0:0
18264156,2024-04-23 13:25:00,Arutyunov Ruben - Asatryan Murad,0:3,5:11 - 3:11 - 5:11 - 0:0 - 0:0,0,3,Arutyunov Ruben,Asatryan Murad,fiurst,Arutyunov Ruben - Asatryan Murad,46,13,33,20,-20,16,14,16,0,0,6,8,6,0,0,20,5:11 - 3:11 - 5:11 - 0:0 - 0:0
18264155,2024-04-23 13:00:00,Nikoghosyan Narek - Nazaryan Mushegh,1:3,11:4 - 14:16 - 11:4 - 12:10 - 0:0,3,1,Nikoghosyan Narek,Nazaryan Mushegh,fiurst,Nazaryan Mushegh - Nikoghosyan Narek,82,34,48,14,-14,15,30,15,22,0,7,-2,7,2,0,14,4:11 - 16:14 - 4:11 - 10:12 - 0:0
18264154,2024-04-23 12:25:00,Diaryan Aleksandr - Asatryan Murad,0:3,11:9 - 11:4 - 12:10 - 0:0 - 0:0,3,0,Diaryan Aleksandr,Asatryan Murad,fiurst,Asatryan Murad - Diaryan Aleksandr,57,23,34,11,-11,20,15,22,0,0,2,7,2,0,0,11,9:11 - 4:11 - 10:12 - 0:0 - 0:0
18264142,2024-04-23 12:00:00,Nikoghosyan Narek - Arutyunov Ruben,0:3,11:8 - 11:8 - 11:2 - 0:0 - 0:0,3,0,Nikoghosyan Narek,Arutyunov Ruben,fiurst,Arutyunov Ruben - Nikoghosyan Narek,51,18,33,15,-15,19,19,13,0,0,3,3,9,0,0,15,8:11 - 8:11 - 2:11 - 0:0 - 0:0
18264140,2024-04-23 11:45:00,Nazaryan Mushegh - Diaryan Aleksandr,3:0,7:11 - 8:11 - 8:11 - 0:0 - 0:0,0,3,Nazaryan Mushegh,Diaryan Aleksandr,fiurst,Diaryan Aleksandr - Nazaryan Mushegh,56,33,23,-10,10,18,19,19,0,0,-4,-3,-3,0,0,-10,11:7 - 11:8 - 11:8 - 0:0 - 0:0
18264137,2024-04-23 11:30:00,Nikoghosyan Narek - Asatryan Murad,3:2,6:11 - 11:8 - 5:11 - 11:9 - 7:11,2,3,Nikoghosyan Narek,Asatryan Murad,fiurst,Asatryan Murad - Nikoghosyan Narek,90,50,40,-10,10,17,19,16,20,18,-5,3,-6,2,-4,-10,11:6 - 8:11 - 11:5 - 9:11 - 11:7
18264135,2024-04-23 11:15:00,Arutyunov Ruben - Nazaryan Mushegh,0:3,7:11 - 6:11 - 5:11 - 0:0 - 0:0,0,3,Arutyunov Ruben,Nazaryan Mushegh,fiurst,Arutyunov Ruben - Nazaryan Mushegh,51,18,33,15,-15,18,17,16,0,0,4,5,6,0,0,15,7:11 - 6:11 - 5:11 - 0:0 - 0:0
18264133,2024-04-23 11:00:00,Diaryan Aleksandr - Nikoghosyan Narek,1:3,11:5 - 6:11 - 8:11 - 6:11 - 0:0,1,3,Diaryan Aleksandr,Nikoghosyan Narek,fiurst,Diaryan Aleksandr - Nikoghosyan Narek,69,31,38,7,-7,16,17,19,17,0,-6,5,3,5,0,7,11:5 - 6:11 - 8:11 - 6:11 - 0:0
18264132,2024-04-23 10:50:00,Asatryan Murad - Nazaryan Mushegh,3:1,11:7 - 11:3 - 4:11 - 11:8 - 0:0,3,1,Asatryan Murad,Nazaryan Mushegh,fiurst,Asatryan Murad - Nazaryan Mushegh,66,37,29,-8,8,18,14,15,19,0,-4,-8,7,-3,0,-8,11:7 - 11:3 - 4:11 - 11:8 - 0:0
18264127,2024-04-23 10:30:00,Arutyunov Ruben - Diaryan Aleksandr,0:3,5:11 - 12:14 - 2:11 - 0:0 - 0:0,0,3,Arutyunov Ruben,Diaryan Aleksandr,fiurst,Arutyunov Ruben - Diaryan Aleksandr,55,19,36,17,-17,16,26,13,0,0,6,2,9,0,0,17,5:11 - 12:14 - 2:11 - 0:0 - 0:0
18264120,2024-04-23 10:15:00,Nazaryan Mushegh - Nikoghosyan Narek,3:2,3:11 - 12:10 - 7:11 - 11:8 - 11:8,3,2,Nazaryan Mushegh,Nikoghosyan Narek,fiurst,Nazaryan Mushegh - Nikoghosyan Narek,92,44,48,4,-4,14,22,18,19,19,8,-2,4,-3,-3,4,3:11 - 12:10 - 7:11 - 11:8 - 11:8
18264118,2024-04-23 10:00:00,Asatryan Murad - Arutyunov Ruben,1:3,8:11 - 11:8 - 11:7 - 11:6 - 0:0,3,1,Asatryan Murad,Arutyunov Ruben,fiurst,Arutyunov Ruben - Asatryan Murad,73,32,41,9,-9,19,19,18,17,0,-3,3,4,5,0,9,11:8 - 8:11 - 7:11 - 6:11 - 0:0
18239466,2024-04-22 17:45:00,Mkrtchyan Andranik - Avakimyan Davit,0:3,11:1 - 13:11 - 11:7 - 0:0 - 0:0,3,0,Mkrtchyan Andranik,Avakimyan Davit,fiurst,Avakimyan Davit - Mkrtchyan Andranik,54,19,35,16,-16,12,24,18,0,0,10,2,4,0,0,16,1:11 - 11:13 - 7:11 - 0:0 - 0:0
18239461,2024-04-22 17:30:00,Petrosyan Davit - Hakobyan Eduard,3:2,15:13 - 5:11 - 11:8 - 4:11 - 7:11,2,3,Petrosyan Davit,Hakobyan Eduard,fiurst,Hakobyan Eduard - Petrosyan Davit,96,54,42,-12,12,28,16,19,15,18,2,-6,3,-7,-4,-12,13:15 - 11:5 - 8:11 - 11:4 - 11:7
18239447,2024-04-22 17:15:00,Soghomonyan Hrayr - Mkrtchyan Andranik,3:0,5:11 - 5:11 - 5:11 - 0:0 - 0:0,0,3,Soghomonyan Hrayr,Mkrtchyan Andranik,fiurst,Mkrtchyan Andranik - Soghomonyan Hrayr,48,33,15,-18,18,16,16,16,0,0,-6,-6,-6,0,0,-18,11:5 - 11:5 - 11:5 - 0:0 - 0:0
18239442,2024-04-22 17:10:00,Petrosyan Davit - Avakimyan Davit,1:3,11:4 - 7:11 - 11:8 - 11:8 - 0:0,3,1,Petrosyan Davit,Avakimyan Davit,fiurst,Avakimyan Davit - Petrosyan Davit,71,31,40,9,-9,15,18,19,19,0,7,-4,3,3,0,9,4:11 - 11:7 - 8:11 - 8:11 - 0:0
18239437,2024-04-22 16:45:00,Hakobyan Eduard - Soghomonyan Hrayr,1:3,5:11 - 3:11 - 11:9 - 8:11 - 0:0,1,3,Hakobyan Eduard,Soghomonyan Hrayr,fiurst,Hakobyan Eduard - Soghomonyan Hrayr,69,27,42,15,-15,16,14,20,19,0,6,8,-2,3,0,15,5:11 - 3:11 - 11:9 - 8:11 - 0:0
18239430,2024-04-22 16:35:00,Mkrtchyan Andranik - Petrosyan Davit,2:3,13:11 - 11:8 - 7:11 - 7:11 - 3:11,2,3,Mkrtchyan Andranik,Petrosyan Davit,fiurst,Mkrtchyan Andranik - Petrosyan Davit,93,41,52,11,-11,24,19,18,18,14,-2,-3,4,4,8,11,13:11 - 11:8 - 7:11 - 7:11 - 3:11
18239424,2024-04-22 16:15:00,Avakimyan Davit - Soghomonyan Hrayr,0:3,6:11 - 4:11 - 8:11 - 0:0 - 0:0,0,3,Avakimyan Davit,Soghomonyan Hrayr,fiurst,Avakimyan Davit - Soghomonyan Hrayr,51,18,33,15,-15,17,15,19,0,0,5,7,3,0,0,15,6:11 - 4:11 - 8:11 - 0:0 - 0:0
18239416,2024-04-22 16:00:00,Hakobyan Eduard - Mkrtchyan Andranik,2:3,10:12 - 11:9 - 4:11 - 11:7 - 9:11,2,3,Hakobyan Eduard,Mkrtchyan Andranik,fiurst,Hakobyan Eduard - Mkrtchyan Andranik,95,45,50,5,-5,22,20,15,18,20,2,-2,7,-4,2,5,10:12 - 11:9 - 4:11 - 11:7 - 9:11
18239413,2024-04-22 15:45:00,Soghomonyan Hrayr - Petrosyan Davit,3:1,10:12 - 10:12 - 11:8 - 7:11 - 0:0,1,3,Soghomonyan Hrayr,Petrosyan Davit,fiurst,Petrosyan Davit - Soghomonyan Hrayr,81,43,38,-5,5,22,22,19,18,0,-2,-2,3,-4,0,-5,12:10 - 12:10 - 8:11 - 11:7 - 0:0
18239403,2024-04-22 15:40:00,Avakimyan Davit - Hakobyan Eduard,0:3,11:13 - 1:11 - 4:11 - 0:0 - 0:0,0,3,Avakimyan Davit,Hakobyan Eduard,fiurst,Avakimyan Davit - Hakobyan Eduard,51,16,35,19,-19,24,12,15,0,0,2,10,7,0,0,19,11:13 - 1:11 - 4:11 - 0:0 - 0:0
18239393,2024-04-22 15:20:00,Asatryan Murad - Arutyunov Ruben,0:3,12:10 - 11:4 - 11:2 - 0:0 - 0:0,3,0,Asatryan Murad,Arutyunov Ruben,fiurst,Arutyunov Ruben - Asatryan Murad,50,16,34,18,-18,22,15,13,0,0,2,7,9,0,0,18,10:12 - 4:11 - 2:11 - 0:0 - 0:0
18239380,2024-04-22 15:10:00,Diaryan Aleksandr - Nikoghosyan Narek,3:2,8:11 - 11:6 - 7:11 - 11:9 - 13:11,3,2,Diaryan Aleksandr,Nikoghosyan Narek,fiurst,Diaryan Aleksandr - Nikoghosyan Narek,98,50,48,-2,2,19,17,18,20,24,3,-5,4,-2,-2,-2,8:11 - 11:6 - 7:11 - 11:9 - 13:11
18239378,2024-04-22 14:45:00,Nazaryan Mushegh - Asatryan Murad,3:0,7:11 - 8:11 - 6:11 - 0:0 - 0:0,0,3,Nazaryan Mushegh,Asatryan Murad,fiurst,Asatryan Murad - Nazaryan Mushegh,54,33,21,-12,12,18,19,17,0,0,-4,-3,-5,0,0,-12,11:7 - 11:8 - 11:6 - 0:0 - 0:0
18239372,2024-04-22 14:40:00,Arutyunov Ruben - Diaryan Aleksandr,2:3,3:11 - 9:11 - 11:6 - 11:7 - 7:11,2,3,Arutyunov Ruben,Diaryan Aleksandr,fiurst,Arutyunov Ruben - Diaryan Aleksandr,87,41,46,5,-5,14,20,17,18,18,8,2,-5,-4,4,5,3:11 - 9:11 - 11:6 - 11:7 - 7:11
18239368,2024-04-22 14:25:00,Nazaryan Mushegh - Nikoghosyan Narek,2:3,11:7 - 6:11 - 11:9 - 9:11 - 8:11,2,3,Nazaryan Mushegh,Nikoghosyan Narek,fiurst,Nazaryan Mushegh - Nikoghosyan Narek,94,45,49,4,-4,18,17,20,20,19,-4,5,-2,2,3,4,11:7 - 6:11 - 11:9 - 9:11 - 8:11
18239365,2024-04-22 14:00:00,Asatryan Murad - Diaryan Aleksandr,1:3,11:6 - 9:11 - 10:12 - 9:11 - 0:0,1,3,Asatryan Murad,Diaryan Aleksandr,fiurst,Asatryan Murad - Diaryan Aleksandr,79,39,40,1,-1,17,20,22,20,0,-5,2,2,2,0,1,11:6 - 9:11 - 10:12 - 9:11 - 0:0
18239360,2024-04-22 13:45:00,Arutyunov Ruben - Nazaryan Mushegh,0:3,7:11 - 13:15 - 9:11 - 0:0 - 0:0,0,3,Arutyunov Ruben,Nazaryan Mushegh,fiurst,Arutyunov Ruben - Nazaryan Mushegh,66,29,37,8,-8,18,28,20,0,0,4,2,2,0,0,8,7:11 - 13:15 - 9:11 - 0:0 - 0:0
18239357,2024-04-22 13:30:00,Nikoghosyan Narek - Asatryan Murad,3:0,10:12 - 10:12 - 2:11 - 0:0 - 0:0,0,3,Nikoghosyan Narek,Asatryan Murad,fiurst,Asatryan Murad - Nikoghosyan Narek,57,35,22,-13,13,22,22,13,0,0,-2,-2,-9,0,0,-13,12:10 - 12:10 - 11:2 - 0:0 - 0:0
18239343,2024-04-22 13:15:00,Diaryan Aleksandr - Nazaryan Mushegh,3:0,11:5 - 11:4 - 11:6 - 0:0 - 0:0,3,0,Diaryan Aleksandr,Nazaryan Mushegh,fiurst,Diaryan Aleksandr - Nazaryan Mushegh,48,33,15,-18,18,16,15,17,0,0,-6,-7,-5,0,0,-18,11:5 - 11:4 - 11:6 - 0:0 - 0:0
18239340,2024-04-22 13:00:00,Nikoghosyan Narek - Arutyunov Ruben,1:3,7:11 - 11:8 - 11:5 - 11:6 - 0:0,3,1,Nikoghosyan Narek,Arutyunov Ruben,fiurst,Arutyunov Ruben - Nikoghosyan Narek,70,30,40,10,-10,18,19,16,17,0,-4,3,6,5,0,10,11:7 - 8:11 - 5:11 - 6:11 - 0:0
18239337,2024-04-22 12:15:00,Asatryan Murad - Nazaryan Mushegh,3:0,11:2 - 11:7 - 12:10 - 0:0 - 0:0,3,0,Asatryan Murad,Nazaryan Mushegh,fiurst,Asatryan Murad - Nazaryan Mushegh,53,34,19,-15,15,13,18,22,0,0,-9,-4,-2,0,0,-15,11:2 - 11:7 - 12:10 - 0:0 - 0:0
18239336,2024-04-22 12:05:00,Nikoghosyan Narek - Diaryan Aleksandr,3:0,9:11 - 7:11 - 15:17 - 0:0 - 0:0,0,3,Nikoghosyan Narek,Diaryan Aleksandr,fiurst,Diaryan Aleksandr - Nikoghosyan Narek,70,39,31,-8,8,20,18,32,0,0,-2,-4,-2,0,0,-8,11:9 - 11:7 - 17:15 - 0:0 - 0:0
18239335,2024-04-22 11:50:00,Arutyunov Ruben - Asatryan Murad,1:3,7:11 - 11:3 - 8:11 - 5:11 - 0:0,1,3,Arutyunov Ruben,Asatryan Murad,fiurst,Arutyunov Ruben - Asatryan Murad,67,31,36,5,-5,18,14,19,16,0,4,-8,3,6,0,5,7:11 - 11:3 - 8:11 - 5:11 - 0:0
18239321,2024-04-22 11:35:00,Nikoghosyan Narek - Nazaryan Mushegh,1:3,11:9 - 11:4 - 8:11 - 11:7 - 0:0,3,1,Nikoghosyan Narek,Nazaryan Mushegh,fiurst,Nazaryan Mushegh - Nikoghosyan Narek,72,31,41,10,-10,20,15,19,18,0,2,7,-3,4,0,10,9:11 - 4:11 - 11:8 - 7:11 - 0:0
18239320,2024-04-22 11:25:00,Diaryan Aleksandr - Arutyunov Ruben,0:3,11:8 - 11:7 - 11:6 - 0:0 - 0:0,3,0,Diaryan Aleksandr,Arutyunov Ruben,fiurst,Arutyunov Ruben - Diaryan Aleksandr,54,21,33,12,-12,19,18,17,0,0,3,4,5,0,0,12,8:11 - 7:11 - 6:11 - 0:0 - 0:0
18239311,2024-04-22 11:05:00,Asatryan Murad - Nikoghosyan Narek,3:0,11:8 - 11:1 - 12:10 - 0:0 - 0:0,3,0,Asatryan Murad,Nikoghosyan Narek,fiurst,Asatryan Murad - Nikoghosyan Narek,53,34,19,-15,15,19,12,22,0,0,-3,-10,-2,0,0,-15,11:8 - 11:1 - 12:10 - 0:0 - 0:0
18239310,2024-04-22 10:50:00,Nazaryan Mushegh - Arutyunov Ruben,1:3,13:11 - 8:11 - 11:9 - 11:5 - 0:0,3,1,Nazaryan Mushegh,Arutyunov Ruben,fiurst,Arutyunov Ruben - Nazaryan Mushegh,79,36,43,7,-7,24,19,20,16,0,2,-3,2,6,0,7,11:13 - 11:8 - 9:11 - 5:11 - 0:0
18239308,2024-04-22 10:30:00,Diaryan Aleksandr - Asatryan Murad,3:1,11:7 - 9:11 - 4:11 - 8:11 - 0:0,1,3,Diaryan Aleksandr,Asatryan Murad,fiurst,Asatryan Murad - Diaryan Aleksandr,72,40,32,-8,8,18,20,15,19,0,4,-2,-7,-3,0,-8,7:11 - 11:9 - 11:4 - 11:8 - 0:0
18239300,2024-04-22 10:15:00,Arutyunov Ruben - Nikoghosyan Narek,1:3,8:11 - 6:11 - 11:9 - 4:11 - 0:0,1,3,Arutyunov Ruben,Nikoghosyan Narek,fiurst,Arutyunov Ruben - Nikoghosyan Narek,71,29,42,13,-13,19,17,20,15,0,3,5,-2,7,0,13,8:11 - 6:11 - 11:9 - 4:11 - 0:0
18239296,2024-04-22 10:00:00,Nazaryan Mushegh - Diaryan Aleksandr,0:3,11:8 - 11:8 - 11:8 - 0:0 - 0:0,3,0,Nazaryan Mushegh,Diaryan Aleksandr,fiurst,Diaryan Aleksandr - Nazaryan Mushegh,57,24,33,9,-9,19,19,19,0,0,3,3,3,0,0,9,8:11 - 8:11 - 8:11 - 0:0 - 0:0
18220403,2024-04-21 17:55:00,Petrosyan Davit - Gevorgyan Gegham,3:2,11:7 - 12:14 - 3:11 - 11:5 - 8:11,2,3,Petrosyan Davit,Gevorgyan Gegham,fiurst,Gevorgyan Gegham - Petrosyan Davit,93,48,45,-3,3,18,26,14,16,19,4,-2,-8,6,-3,-3,7:11 - 14:12 - 11:3 - 5:11 - 11:8
18220401,2024-04-21 17:30:00,Avakimyan Davit - Gevorgyan Hayk,3:1,11:4 - 11:7 - 8:11 - 12:10 - 0:0,3,1,Avakimyan Davit,Gevorgyan Hayk,fiurst,Avakimyan Davit - Gevorgyan Hayk,74,42,32,-10,10,15,18,19,22,0,-7,-4,3,-2,0,-10,11:4 - 11:7 - 8:11 - 12:10 - 0:0
18220399,2024-04-21 17:25:00,Mkrtchyan Andranik - Petrosyan Davit,3:2,7:11 - 6:11 - 12:10 - 11:9 - 11:6,3,2,Mkrtchyan Andranik,Petrosyan Davit,fiurst,Mkrtchyan Andranik - Petrosyan Davit,94,47,47,0,0,18,17,22,20,17,4,5,-2,-2,-5,0,7:11 - 6:11 - 12:10 - 11:9 - 11:6
18220398,2024-04-21 17:00:00,Avakimyan Davit - Gevorgyan Gegham,3:1,6:11 - 12:10 - 11:5 - 11:9 - 0:0,3,1,Avakimyan Davit,Gevorgyan Gegham,fiurst,Avakimyan Davit - Gevorgyan Gegham,75,40,35,-5,5,17,22,16,20,0,5,-2,-6,-2,0,-5,6:11 - 12:10 - 11:5 - 11:9 - 0:0
18220397,2024-04-21 16:45:00,Gevorgyan Hayk - Mkrtchyan Andranik,3:1,10:12 - 11:6 - 13:11 - 11:7 - 0:0,3,1,Gevorgyan Hayk,Mkrtchyan Andranik,fiurst,Gevorgyan Hayk - Mkrtchyan Andranik,81,45,36,-9,9,22,17,24,18,0,2,-5,-2,-4,0,-9,10:12 - 11:6 - 13:11 - 11:7 - 0:0
18220387,2024-04-21 16:30:00,Petrosyan Davit - Avakimyan Davit,3:2,11:7 - 11:8 - 7:11 - 6:11 - 8:11,2,3,Petrosyan Davit,Avakimyan Davit,fiurst,Avakimyan Davit - Petrosyan Davit,91,48,43,-5,5,18,19,18,17,19,4,3,-4,-5,-3,-5,7:11 - 8:11 - 11:7 - 11:6 - 11:8
18220383,2024-04-21 16:15:00,Gevorgyan Gegham - Mkrtchyan Andranik,1:3,11:9 - 7:11 - 8:11 - 10:12 - 0:0,1,3,Gevorgyan Gegham,Mkrtchyan Andranik,fiurst,Gevorgyan Gegham - Mkrtchyan Andranik,79,36,43,7,-7,20,18,19,22,0,-2,4,3,2,0,7,11:9 - 7:11 - 8:11 - 10:12 - 0:0
18220382,2024-04-21 16:05:00,Gevorgyan Hayk - Petrosyan Davit,3:1,11:6 - 7:11 - 11:9 - 11:8 - 0:0,3,1,Gevorgyan Hayk,Petrosyan Davit,fiurst,Gevorgyan Hayk - Petrosyan Davit,74,40,34,-6,6,17,18,20,19,0,-5,4,-2,-3,0,-6,11:6 - 7:11 - 11:9 - 11:8 - 0:0
18220378,2024-04-21 15:45:00,Mkrtchyan Andranik - Avakimyan Davit,1:3,12:10 - 11:9 - 10:12 - 11:4 - 0:0,3,1,Mkrtchyan Andranik,Avakimyan Davit,fiurst,Avakimyan Davit - Mkrtchyan Andranik,79,35,44,9,-9,22,20,22,15,0,2,2,-2,7,0,9,10:12 - 9:11 - 12:10 - 4:11 - 0:0
18220362,2024-04-21 15:30:00,Gevorgyan Gegham - Gevorgyan Hayk,1:3,7:11 - 15:13 - 4:11 - 11:13 - 0:0,1,3,Gevorgyan Gegham,Gevorgyan Hayk,fiurst,Gevorgyan Gegham - Gevorgyan Hayk,85,37,48,11,-11,18,28,15,24,0,4,-2,7,2,0,11,7:11 - 15:13 - 4:11 - 11:13 - 0:0
18220020,2024-04-21 15:00:00,Diaryan Aleksandr - Rafayelyan Edgar,1:3,4:11 - 8:11 - 11:8 - 9:11 - 0:0,1,3,Diaryan Aleksandr,Rafayelyan Edgar,fiurst,Diaryan Aleksandr - Rafayelyan Edgar,73,32,41,9,-9,15,19,19,20,0,7,3,-3,2,0,9,4:11 - 8:11 - 11:8 - 9:11 - 0:0
18220018,2024-04-21 14:45:00,Nikoghosyan Narek - Asatryan Murad,3:0,4:11 - 9:11 - 9:11 - 0:0 - 0:0,0,3,Nikoghosyan Narek,Asatryan Murad,fiurst,Asatryan Murad - Nikoghosyan Narek,55,33,22,-11,11,15,20,20,0,0,-7,-2,-2,0,0,-11,11:4 - 11:9 - 11:9 - 0:0 - 0:0
18219999,2024-04-21 14:15:00,Nikoghosyan Narek - Rafayelyan Edgar,1:3,10:12 - 11:9 - 3:11 - 8:11 - 0:0,1,3,Nikoghosyan Narek,Rafayelyan Edgar,fiurst,Nikoghosyan Narek - Rafayelyan Edgar,75,32,43,11,-11,22,20,14,19,0,2,-2,8,3,0,11,10:12 - 11:9 - 3:11 - 8:11 - 0:0
18219997,2024-04-21 14:05:00,Asatryan Murad - Diaryan Aleksandr,3:0,11:7 - 11:6 - 11:6 - 0:0 - 0:0,3,0,Asatryan Murad,Diaryan Aleksandr,fiurst,Asatryan Murad - Diaryan Aleksandr,52,33,19,-14,14,18,17,17,0,0,-4,-5,-5,0,0,-14,11:7 - 11:6 - 11:6 - 0:0 - 0:0
18219988,2024-04-21 13:30:00,Rafayelyan Edgar - Asatryan Murad,1:3,11:5 - 7:11 - 11:9 - 11:7 - 0:0,3,1,Rafayelyan Edgar,Asatryan Murad,fiurst,Asatryan Murad - Rafayelyan Edgar,72,32,40,8,-8,16,18,20,18,0,6,-4,2,4,0,8,5:11 - 11:7 - 9:11 - 7:11 - 0:0
18219983,2024-04-21 13:15:00,Diaryan Aleksandr - Nikoghosyan Narek,1:3,4:11 - 11:8 - 7:11 - 12:14 - 0:0,1,3,Diaryan Aleksandr,Nikoghosyan Narek,fiurst,Diaryan Aleksandr - Nikoghosyan Narek,78,34,44,10,-10,15,19,18,26,0,7,-3,4,2,0,10,4:11 - 11:8 - 7:11 - 12:14 - 0:0
18219947,2024-04-21 12:15:00,Asatryan Murad - Nikoghosyan Narek,3:1,8:11 - 11:9 - 12:10 - 11:7 - 0:0,3,1,Asatryan Murad,Nikoghosyan Narek,fiurst,Asatryan Murad - Nikoghosyan Narek,79,42,37,-5,5,19,20,22,18,0,3,-2,-2,-4,0,-5,8:11 - 11:9 - 12:10 - 11:7 - 0:0
18219938,2024-04-21 12:00:00,Rafayelyan Edgar - Diaryan Aleksandr,0:3,11:9 - 11:7 - 11:7 - 0:0 - 0:0,3,0,Rafayelyan Edgar,Diaryan Aleksandr,fiurst,Diaryan Aleksandr - Rafayelyan Edgar,56,23,33,10,-10,20,18,18,0,0,2,4,4,0,0,10,9:11 - 7:11 - 7:11 - 0:0 - 0:0
18219923,2024-04-21 11:30:00,Rafayelyan Edgar - Nikoghosyan Narek,0:3,11:3 - 11:9 - 11:4 - 0:0 - 0:0,3,0,Rafayelyan Edgar,Nikoghosyan Narek,fiurst,Nikoghosyan Narek - Rafayelyan Edgar,49,16,33,17,-17,14,20,15,0,0,8,2,7,0,0,17,3:11 - 9:11 - 4:11 - 0:0 - 0:0
18219915,2024-04-21 11:05:00,Asatryan Murad - Rafayelyan Edgar,3:1,11:9 - 9:11 - 11:3 - 11:8 - 0:0,3,1,Asatryan Murad,Rafayelyan Edgar,fiurst,Asatryan Murad - Rafayelyan Edgar,73,42,31,-11,11,20,20,14,19,0,-2,2,-8,-3,0,-11,11:9 - 9:11 - 11:3 - 11:8 - 0:0
18219912,2024-04-21 10:50:00,Nikoghosyan Narek - Hovhannesyan Rafik,2:3,11:6 - 11:6 - 10:12 - 5:11 - 11:7,3,2,Nikoghosyan Narek,Hovhannesyan Rafik,fiurst,Hovhannesyan Rafik - Nikoghosyan Narek,90,42,48,6,-6,17,17,22,16,18,5,5,-2,-6,4,6,6:11 - 6:11 - 12:10 - 11:5 - 7:11
18219907,2024-04-21 10:30:00,Diaryan Aleksandr - Asatryan Murad,3:1,9:11 - 11:6 - 4:11 - 9:11 - 0:0,1,3,Diaryan Aleksandr,Asatryan Murad,fiurst,Asatryan Murad - Diaryan Aleksandr,72,39,33,-6,6,20,17,15,20,0,-2,5,-7,-2,0,-6,11:9 - 6:11 - 11:4 - 11:9 - 0:0
18219894,2024-04-21 10:15:00,Hovhannesyan Rafik - Rafayelyan Edgar,1:3,9:11 - 3:11 - 11:9 - 8:11 - 0:0,1,3,Hovhannesyan Rafik,Rafayelyan Edgar,fiurst,Hovhannesyan Rafik - Rafayelyan Edgar,73,31,42,11,-11,20,14,20,19,0,2,8,-2,3,0,11,9:11 - 3:11 - 11:9 - 8:11 - 0:0
18219878,2024-04-21 10:00:00,Nikoghosyan Narek - Diaryan Aleksandr,1:3,4:11 - 11:8 - 12:10 - 11:8 - 0:0,3,1,Nikoghosyan Narek,Diaryan Aleksandr,fiurst,Diaryan Aleksandr - Nikoghosyan Narek,75,37,38,1,-1,15,19,22,19,0,-7,3,2,3,0,1,11:4 - 8:11 - 10:12 - 8:11 - 0:0
18206001,2024-04-20 17:50:00,Gevorgyan Gegham - Soghomonyan Hrayr,1:3,6:11 - 7:11 - 14:12 - 8:11 - 0:0,1,3,Gevorgyan Gegham,Soghomonyan Hrayr,fiurst,Gevorgyan Gegham - Soghomonyan Hrayr,80,35,45,10,-10,17,18,26,19,0,5,4,-2,3,0,10,6:11 - 7:11 - 14:12 - 8:11 - 0:0
18206000,2024-04-20 17:40:00,Mkrtchyan Andranik - Avakimyan Davit,3:1,8:11 - 11:9 - 8:11 - 7:11 - 0:0,1,3,Mkrtchyan Andranik,Avakimyan Davit,fiurst,Avakimyan Davit - Mkrtchyan Andranik,76,42,34,-8,8,19,20,19,18,0,-3,2,-3,-4,0,-8,11:8 - 9:11 - 11:8 - 11:7 - 0:0
18205999,2024-04-20 17:20:00,Gevorgyan Hayk - Gevorgyan Gegham,0:3,11:6 - 11:9 - 11:7 - 0:0 - 0:0,3,0,Gevorgyan Hayk,Gevorgyan Gegham,fiurst,Gevorgyan Gegham - Gevorgyan Hayk,55,22,33,11,-11,17,20,18,0,0,5,2,4,0,0,11,6:11 - 9:11 - 7:11 - 0:0 - 0:0
18205995,2024-04-20 17:00:00,Mkrtchyan Andranik - Soghomonyan Hrayr,2:3,8:11 - 10:12 - 11:7 - 12:10 - 6:11,2,3,Mkrtchyan Andranik,Soghomonyan Hrayr,fiurst,Mkrtchyan Andranik - Soghomonyan Hrayr,98,47,51,4,-4,19,22,18,22,17,3,2,-4,-2,5,4,8:11 - 10:12 - 11:7 - 12:10 - 6:11
18205994,2024-04-20 16:55:00,Avakimyan Davit - Gevorgyan Hayk,1:3,10:12 - 4:11 - 11:8 - 3:11 - 0:0,1,3,Avakimyan Davit,Gevorgyan Hayk,fiurst,Avakimyan Davit - Gevorgyan Hayk,70,28,42,14,-14,22,15,19,14,0,2,7,-3,8,0,14,10:12 - 4:11 - 11:8 - 3:11 - 0:0
18205992,2024-04-20 16:30:00,Gevorgyan Gegham - Mkrtchyan Andranik,1:3,11:5 - 5:11 - 5:11 - 9:11 - 0:0,1,3,Gevorgyan Gegham,Mkrtchyan Andranik,fiurst,Gevorgyan Gegham - Mkrtchyan Andranik,68,30,38,8,-8,16,16,16,20,0,-6,6,6,2,0,8,11:5 - 5:11 - 5:11 - 9:11 - 0:0
18205990,2024-04-20 16:15:00,Soghomonyan Hrayr - Gevorgyan Hayk,3:2,7:11 - 13:15 - 12:10 - 11:8 - 13:15,2,3,Soghomonyan Hrayr,Gevorgyan Hayk,fiurst,Gevorgyan Hayk - Soghomonyan Hrayr,115,59,56,-3,3,18,28,22,19,28,-4,-2,2,3,-2,-3,11:7 - 15:13 - 10:12 - 8:11 - 15:13
18205985,2024-04-20 16:00:00,Avakimyan Davit - Gevorgyan Gegham,3:0,11:9 - 12:10 - 11:8 - 0:0 - 0:0,3,0,Avakimyan Davit,Gevorgyan Gegham,fiurst,Avakimyan Davit - Gevorgyan Gegham,61,34,27,-7,7,20,22,19,0,0,-2,-2,-3,0,0,-7,11:9 - 12:10 - 11:8 - 0:0 - 0:0
18205984,2024-04-20 15:45:00,Gevorgyan Hayk - Mkrtchyan Andranik,0:3,11:13 - 6:11 - 8:11 - 0:0 - 0:0,0,3,Gevorgyan Hayk,Mkrtchyan Andranik,fiurst,Gevorgyan Hayk - Mkrtchyan Andranik,60,25,35,10,-10,24,17,19,0,0,2,5,3,0,0,10,11:13 - 6:11 - 8:11 - 0:0 - 0:0
18205965,2024-04-20 15:30:00,Soghomonyan Hrayr - Avakimyan Davit,2:3,6:11 - 11:7 - 11:8 - 10:12 - 11:5,3,2,Soghomonyan Hrayr,Avakimyan Davit,fiurst,Avakimyan Davit - Soghomonyan Hrayr,92,43,49,6,-6,17,18,19,22,16,-5,4,3,-2,6,6,11:6 - 7:11 - 8:11 - 12:10 - 5:11
18205958,2024-04-20 15:15:00,Arutyunov Ruben - Hovhannesyan Rafik,3:0,11:1 - 11:7 - 11:6 - 0:0 - 0:0,3,0,Arutyunov Ruben,Hovhannesyan Rafik,fiurst,Arutyunov Ruben - Hovhannesyan Rafik,47,33,14,-19,19,12,18,17,0,0,-10,-4,-5,0,0,-19,11:1 - 11:7 - 11:6 - 0:0 - 0:0
18205959,2024-04-20 15:15:00,Nazaryan Mushegh - Diaryan Aleksandr,3:0,6:11 - 5:11 - 5:11 - 0:0 - 0:0,0,3,Nazaryan Mushegh,Diaryan Aleksandr,fiurst,Diaryan Aleksandr - Nazaryan Mushegh,49,33,16,-17,17,17,16,16,0,0,-5,-6,-6,0,0,-17,11:6 - 11:5 - 11:5 - 0:0 - 0:0
18205957,2024-04-20 14:50:00,Rafayelyan Edgar - Nazaryan Mushegh,0:3,11:5 - 11:8 - 11:6 - 0:0 - 0:0,3,0,Rafayelyan Edgar,Nazaryan Mushegh,fiurst,Nazaryan Mushegh - Rafayelyan Edgar,52,19,33,14,-14,16,19,17,0,0,6,3,5,0,0,14,5:11 - 8:11 - 6:11 - 0:0 - 0:0
18205956,2024-04-20 14:45:00,Diaryan Aleksandr - Arutyunov Ruben,0:3,13:11 - 11:8 - 12:10 - 0:0 - 0:0,3,0,Diaryan Aleksandr,Arutyunov Ruben,fiurst,Arutyunov Ruben - Diaryan Aleksandr,65,29,36,7,-7,24,19,22,0,0,2,3,2,0,0,7,11:13 - 8:11 - 10:12 - 0:0 - 0:0
18205954,2024-04-20 14:25:00,Rafayelyan Edgar - Hovhannesyan Rafik,1:3,11:8 - 11:5 - 4:11 - 11:4 - 0:0,3,1,Rafayelyan Edgar,Hovhannesyan Rafik,fiurst,Hovhannesyan Rafik - Rafayelyan Edgar,65,28,37,9,-9,19,16,15,15,0,3,6,-7,7,0,9,8:11 - 5:11 - 11:4 - 4:11 - 0:0
18205951,2024-04-20 14:15:00,Nazaryan Mushegh - Arutyunov Ruben,1:3,11:7 - 11:7 - 9:11 - 11:9 - 0:0,3,1,Nazaryan Mushegh,Arutyunov Ruben,fiurst,Arutyunov Ruben - Nazaryan Mushegh,76,34,42,8,-8,18,18,20,20,0,4,4,-2,2,0,8,7:11 - 7:11 - 11:9 - 9:11 - 0:0
18205949,2024-04-20 13:45:00,Diaryan Aleksandr - Rafayelyan Edgar,1:3,11:9 - 5:11 - 8:11 - 5:11 - 0:0,1,3,Diaryan Aleksandr,Rafayelyan Edgar,fiurst,Diaryan Aleksandr - Rafayelyan Edgar,71,29,42,13,-13,20,16,19,16,0,-2,6,3,6,0,13,11:9 - 5:11 - 8:11 - 5:11 - 0:0
18205946,2024-04-20 13:40:00,Hovhannesyan Rafik - Nazaryan Mushegh,2:3,8:11 - 11:9 - 5:11 - 11:4 - 8:11,2,3,Hovhannesyan Rafik,Nazaryan Mushegh,fiurst,Hovhannesyan Rafik - Nazaryan Mushegh,89,43,46,3,-3,19,20,16,15,19,3,-2,6,-7,3,3,8:11 - 11:9 - 5:11 - 11:4 - 8:11
18205931,2024-04-20 13:15:00,Arutyunov Ruben - Rafayelyan Edgar,0:3,6:11 - 6:11 - 9:11 - 0:0 - 0:0,0,3,Arutyunov Ruben,Rafayelyan Edgar,fiurst,Arutyunov Ruben - Rafayelyan Edgar,54,21,33,12,-12,17,17,20,0,0,5,5,2,0,0,12,6:11 - 6:11 - 9:11 - 0:0 - 0:0
18205929,2024-04-20 13:10:00,Hovhannesyan Rafik - Diaryan Aleksandr,3:2,11:9 - 9:11 - 8:11 - 11:6 - 6:11,2,3,Hovhannesyan Rafik,Diaryan Aleksandr,fiurst,Diaryan Aleksandr - Hovhannesyan Rafik,93,48,45,-3,3,20,20,19,17,17,2,-2,-3,5,-5,-3,9:11 - 11:9 - 11:8 - 6:11 - 11:6
18205927,2024-04-20 12:20:00,Hovhannesyan Rafik - Arutyunov Ruben,1:3,11:9 - 11:7 - 2:11 - 11:8 - 0:0,3,1,Hovhannesyan Rafik,Arutyunov Ruben,fiurst,Arutyunov Ruben - Hovhannesyan Rafik,70,35,35,0,0,20,18,13,19,0,2,4,-9,3,0,0,9:11 - 7:11 - 11:2 - 8:11 - 0:0
18205928,2024-04-20 12:15:00,Nazaryan Mushegh - Rafayelyan Edgar,1:3,11:9 - 6:11 - 6:11 - 5:11 - 0:0,1,3,Nazaryan Mushegh,Rafayelyan Edgar,fiurst,Nazaryan Mushegh - Rafayelyan Edgar,70,28,42,14,-14,20,17,17,16,0,-2,5,5,6,0,14,11:9 - 6:11 - 6:11 - 5:11 - 0:0
18205926,2024-04-20 11:45:00,Diaryan Aleksandr - Nazaryan Mushegh,3:1,11:7 - 11:8 - 5:11 - 11:7 - 0:0,3,1,Diaryan Aleksandr,Nazaryan Mushegh,fiurst,Diaryan Aleksandr - Nazaryan Mushegh,71,38,33,-5,5,18,19,16,18,0,-4,-3,6,-4,0,-5,11:7 - 11:8 - 5:11 - 11:7 - 0:0
18205923,2024-04-20 11:40:00,Hovhannesyan Rafik - Rafayelyan Edgar,2:3,11:7 - 11:8 - 2:11 - 4:11 - 8:11,2,3,Hovhannesyan Rafik,Rafayelyan Edgar,fiurst,Hovhannesyan Rafik - Rafayelyan Edgar,84,36,48,12,-12,18,19,13,15,19,-4,-3,9,7,3,12,11:7 - 11:8 - 2:11 - 4:11 - 8:11
18205920,2024-04-20 11:15:00,Arutyunov Ruben - Diaryan Aleksandr,0:3,5:11 - 5:11 - 8:11 - 0:0 - 0:0,0,3,Arutyunov Ruben,Diaryan Aleksandr,fiurst,Arutyunov Ruben - Diaryan Aleksandr,51,18,33,15,-15,16,16,19,0,0,6,6,3,0,0,15,5:11 - 5:11 - 8:11 - 0:0 - 0:0
18205915,2024-04-20 11:10:00,Nazaryan Mushegh - Hovhannesyan Rafik,3:1,5:11 - 9:11 - 11:7 - 5:11 - 0:0,1,3,Nazaryan Mushegh,Hovhannesyan Rafik,fiurst,Hovhannesyan Rafik - Nazaryan Mushegh,70,40,30,-10,10,16,20,18,16,0,-6,-2,4,-6,0,-10,11:5 - 11:9 - 7:11 - 11:5 - 0:0
18205909,2024-04-20 10:55:00,Rafayelyan Edgar - Diaryan Aleksandr,0:3,11:8 - 11:8 - 12:10 - 0:0 - 0:0,3,0,Rafayelyan Edgar,Diaryan Aleksandr,fiurst,Diaryan Aleksandr - Rafayelyan Edgar,60,26,34,8,-8,19,19,22,0,0,3,3,2,0,0,8,8:11 - 8:11 - 10:12 - 0:0 - 0:0
18205877,2024-04-20 10:30:00,Arutyunov Ruben - Nazaryan Mushegh,3:2,11:7 - 11:5 - 3:11 - 7:11 - 11:7,3,2,Arutyunov Ruben,Nazaryan Mushegh,fiurst,Arutyunov Ruben - Nazaryan Mushegh,84,43,41,-2,2,18,16,14,18,18,-4,-6,8,4,-4,-2,11:7 - 11:5 - 3:11 - 7:11 - 11:7
18205837,2024-04-20 10:15:00,Diaryan Aleksandr - Hovhannesyan Rafik,2:3,9:11 - 6:11 - 12:10 - 11:6 - 10:12,2,3,Diaryan Aleksandr,Hovhannesyan Rafik,fiurst,Diaryan Aleksandr - Hovhannesyan Rafik,98,48,50,2,-2,20,17,22,17,22,2,5,-2,-5,2,2,9:11 - 6:11 - 12:10 - 11:6 - 10:12
18205816,2024-04-20 10:00:00,Rafayelyan Edgar - Arutyunov Ruben,0:3,11:3 - 12:10 - 11:9 - 0:0 - 0:0,3,0,Rafayelyan Edgar,Arutyunov Ruben,fiurst,Arutyunov Ruben - Rafayelyan Edgar,56,22,34,12,-12,14,22,20,0,0,8,2,2,0,0,12,3:11 - 10:12 - 9:11 - 0:0 - 0:0
18181360,2024-04-19 17:45:00,Mkrtchyan Andranik - Petrosyan Davit,3:0,11:4 - 11:9 - 11:6 - 0:0 - 0:0,3,0,Mkrtchyan Andranik,Petrosyan Davit,fiurst,Mkrtchyan Andranik - Petrosyan Davit,52,33,19,-14,14,15,20,17,0,0,-7,-2,-5,0,0,-14,11:4 - 11:9 - 11:6 - 0:0 - 0:0
18181357,2024-04-19 17:30:00,Avakimyan Davit - Hakobyan Eduard,0:3,6:11 - 6:11 - 3:11 - 0:0 - 0:0,0,3,Avakimyan Davit,Hakobyan Eduard,fiurst,Avakimyan Davit - Hakobyan Eduard,48,15,33,18,-18,17,17,14,0,0,5,5,8,0,0,18,6:11 - 6:11 - 3:11 - 0:0 - 0:0
18181343,2024-04-19 17:15:00,Soghomonyan Hrayr - Mkrtchyan Andranik,1:3,9:11 - 11:9 - 11:6 - 11:6 - 0:0,3,1,Soghomonyan Hrayr,Mkrtchyan Andranik,fiurst,Mkrtchyan Andranik - Soghomonyan Hrayr,74,32,42,10,-10,20,20,17,17,0,-2,2,5,5,0,10,11:9 - 9:11 - 6:11 - 6:11 - 0:0
18181340,2024-04-19 17:00:00,Avakimyan Davit - Petrosyan Davit,0:3,9:11 - 9:11 - 8:11 - 0:0 - 0:0,0,3,Avakimyan Davit,Petrosyan Davit,fiurst,Avakimyan Davit - Petrosyan Davit,59,26,33,7,-7,20,20,19,0,0,2,2,3,0,0,7,9:11 - 9:11 - 8:11 - 0:0 - 0:0
18181339,2024-04-19 16:45:00,Hakobyan Eduard - Soghomonyan Hrayr,0:3,8:11 - 7:11 - 1:11 - 0:0 - 0:0,0,3,Hakobyan Eduard,Soghomonyan Hrayr,fiurst,Hakobyan Eduard - Soghomonyan Hrayr,49,16,33,17,-17,19,18,12,0,0,3,4,10,0,0,17,8:11 - 7:11 - 1:11 - 0:0 - 0:0
18181337,2024-04-19 16:40:00,Mkrtchyan Andranik - Avakimyan Davit,2:3,11:6 - 6:11 - 8:11 - 11:6 - 11:8,3,2,Mkrtchyan Andranik,Avakimyan Davit,fiurst,Avakimyan Davit - Mkrtchyan Andranik,89,42,47,5,-5,17,17,19,17,19,5,-5,-3,5,3,5,6:11 - 11:6 - 11:8 - 6:11 - 8:11
18181332,2024-04-19 16:15:00,Petrosyan Davit - Soghomonyan Hrayr,0:3,7:11 - 5:11 - 6:11 - 0:0 - 0:0,0,3,Petrosyan Davit,Soghomonyan Hrayr,fiurst,Petrosyan Davit - Soghomonyan Hrayr,51,18,33,15,-15,18,16,17,0,0,4,6,5,0,0,15,7:11 - 5:11 - 6:11 - 0:0 - 0:0
18181330,2024-04-19 16:10:00,Hakobyan Eduard - Mkrtchyan Andranik,1:3,8:11 - 9:11 - 11:5 - 8:11 - 0:0,1,3,Hakobyan Eduard,Mkrtchyan Andranik,fiurst,Hakobyan Eduard - Mkrtchyan Andranik,74,36,38,2,-2,19,20,16,19,0,3,2,-6,3,0,2,8:11 - 9:11 - 11:5 - 8:11 - 0:0
18181319,2024-04-19 15:55:00,Petrosyan Davit - Hakobyan Eduard,0:3,11:5 - 11:8 - 11:5 - 0:0 - 0:0,3,0,Petrosyan Davit,Hakobyan Eduard,fiurst,Hakobyan Eduard - Petrosyan Davit,51,18,33,15,-15,16,19,16,0,0,6,3,6,0,0,15,5:11 - 8:11 - 5:11 - 0:0 - 0:0
18181323,2024-04-19 15:50:00,Soghomonyan Hrayr - Avakimyan Davit,1:3,11:7 - 11:13 - 11:9 - 11:3 - 0:0,3,1,Soghomonyan Hrayr,Avakimyan Davit,fiurst,Avakimyan Davit - Soghomonyan Hrayr,76,32,44,12,-12,18,24,20,14,0,4,-2,2,8,0,12,7:11 - 13:11 - 9:11 - 3:11 - 0:0
18181314,2024-04-19 15:30:00,Rafayelyan Edgar - Arutyunov Ruben,1:3,6:11 - 11:6 - 13:11 - 11:6 - 0:0,3,1,Rafayelyan Edgar,Arutyunov Ruben,fiurst,Arutyunov Ruben - Rafayelyan Edgar,75,34,41,7,-7,17,17,24,17,0,-5,5,2,5,0,7,11:6 - 6:11 - 11:13 - 6:11 - 0:0
18181303,2024-04-19 15:25:00,Asatryan Murad - Nikoghosyan Narek,2:3,11:9 - 8:11 - 12:10 - 7:11 - 7:11,2,3,Asatryan Murad,Nikoghosyan Narek,fiurst,Asatryan Murad - Nikoghosyan Narek,97,45,52,7,-7,20,19,22,18,18,-2,3,-2,4,4,7,11:9 - 8:11 - 12:10 - 7:11 - 7:11
18181295,2024-04-19 15:00:00,Arutyunov Ruben - Asatryan Murad,0:3,2:11 - 11:13 - 3:11 - 0:0 - 0:0,0,3,Arutyunov Ruben,Asatryan Murad,fiurst,Arutyunov Ruben - Asatryan Murad,51,16,35,19,-19,13,24,14,0,0,9,2,8,0,0,19,2:11 - 11:13 - 3:11 - 0:0 - 0:0
18181301,2024-04-19 15:00:00,Nazaryan Mushegh - Rafayelyan Edgar,0:3,8:11 - 6:11 - 8:11 - 0:0 - 0:0,0,3,Nazaryan Mushegh,Rafayelyan Edgar,fiurst,Nazaryan Mushegh - Rafayelyan Edgar,55,22,33,11,-11,19,17,19,0,0,3,5,3,0,0,11,8:11 - 6:11 - 8:11 - 0:0 - 0:0
18181275,2024-04-19 14:25:00,Rafayelyan Edgar - Asatryan Murad,3:2,11:6 - 11:6 - 10:12 - 9:11 - 9:11,2,3,Rafayelyan Edgar,Asatryan Murad,fiurst,Asatryan Murad - Rafayelyan Edgar,96,46,50,4,-4,17,17,22,20,20,5,5,-2,-2,-2,4,6:11 - 6:11 - 12:10 - 11:9 - 11:9
18181279,2024-04-19 14:25:00,Nazaryan Mushegh - Nikoghosyan Narek,0:3,12:14 - 11:13 - 6:11 - 0:0 - 0:0,0,3,Nazaryan Mushegh,Nikoghosyan Narek,fiurst,Nazaryan Mushegh - Nikoghosyan Narek,67,29,38,9,-9,26,24,17,0,0,2,2,5,0,0,9,12:14 - 11:13 - 6:11 - 0:0 - 0:0
18181262,2024-04-19 13:45:00,Nikoghosyan Narek - Rafayelyan Edgar,2:3,11:7 - 5:11 - 11:7 - 9:11 - 9:11,2,3,Nikoghosyan Narek,Rafayelyan Edgar,fiurst,Nikoghosyan Narek - Rafayelyan Edgar,92,45,47,2,-2,18,16,18,20,20,-4,6,-4,2,2,2,11:7 - 5:11 - 11:7 - 9:11 - 9:11
18181274,2024-04-19 13:45:00,Arutyunov Ruben - Nazaryan Mushegh,1:3,8:11 - 6:11 - 14:12 - 11:13 - 0:0,1,3,Arutyunov Ruben,Nazaryan Mushegh,fiurst,Arutyunov Ruben - Nazaryan Mushegh,86,39,47,8,-8,19,17,26,24,0,3,5,-2,2,0,8,8:11 - 6:11 - 14:12 - 11:13 - 0:0
18181260,2024-04-19 13:20:00,Asatryan Murad - Nazaryan Mushegh,3:1,11:7 - 8:11 - 11:9 - 11:3 - 0:0,3,1,Asatryan Murad,Nazaryan Mushegh,fiurst,Asatryan Murad - Nazaryan Mushegh,71,41,30,-11,11,18,19,20,14,0,-4,3,-2,-8,0,-11,11:7 - 8:11 - 11:9 - 11:3 - 0:0
18181255,2024-04-19 13:10:00,Nikoghosyan Narek - Arutyunov Ruben,3:1,7:11 - 11:9 - 11:13 - 6:11 - 0:0,1,3,Nikoghosyan Narek,Arutyunov Ruben,fiurst,Arutyunov Ruben - Nikoghosyan Narek,79,44,35,-9,9,18,20,24,17,0,-4,2,-2,-5,0,-9,11:7 - 9:11 - 13:11 - 11:6 - 0:0
18181252,2024-04-19 12:40:00,Rafayelyan Edgar - Nazaryan Mushegh,1:3,6:11 - 11:4 - 11:4 - 14:12 - 0:0,3,1,Rafayelyan Edgar,Nazaryan Mushegh,fiurst,Nazaryan Mushegh - Rafayelyan Edgar,73,31,42,11,-11,17,15,15,26,0,-5,7,7,2,0,11,11:6 - 4:11 - 4:11 - 12:14 - 0:0
18181248,2024-04-19 12:05:00,Arutyunov Ruben - Rafayelyan Edgar,3:2,11:6 - 6:11 - 10:12 - 14:12 - 11:6,3,2,Arutyunov Ruben,Rafayelyan Edgar,fiurst,Arutyunov Ruben - Rafayelyan Edgar,99,52,47,-5,5,17,17,22,26,17,-5,5,2,-2,-5,-5,11:6 - 6:11 - 10:12 - 14:12 - 11:6
18181250,2024-04-19 12:05:00,Nikoghosyan Narek - Asatryan Murad,3:1,11:8 - 6:11 - 8:11 - 9:11 - 0:0,1,3,Nikoghosyan Narek,Asatryan Murad,fiurst,Asatryan Murad - Nikoghosyan Narek,75,41,34,-7,7,19,17,19,20,0,3,-5,-3,-2,0,-7,8:11 - 11:6 - 11:8 - 11:9 - 0:0
18181247,2024-04-19 11:35:00,Nikoghosyan Narek - Nazaryan Mushegh,1:3,9:11 - 11:3 - 11:8 - 11:9 - 0:0,3,1,Nikoghosyan Narek,Nazaryan Mushegh,fiurst,Nazaryan Mushegh - Nikoghosyan Narek,73,31,42,11,-11,20,14,19,20,0,-2,8,3,2,0,11,11:9 - 3:11 - 8:11 - 9:11 - 0:0
18181236,2024-04-19 11:30:00,Asatryan Murad - Arutyunov Ruben,1:3,11:6 - 11:9 - 5:11 - 11:6 - 0:0,3,1,Asatryan Murad,Arutyunov Ruben,fiurst,Arutyunov Ruben - Asatryan Murad,70,32,38,6,-6,17,20,16,17,0,5,2,-6,5,0,6,6:11 - 9:11 - 11:5 - 6:11 - 0:0
18181235,2024-04-19 11:00:00,Rafayelyan Edgar - Nikoghosyan Narek,0:3,11:9 - 11:8 - 11:7 - 0:0 - 0:0,3,0,Rafayelyan Edgar,Nikoghosyan Narek,fiurst,Nikoghosyan Narek - Rafayelyan Edgar,57,24,33,9,-9,20,19,18,0,0,2,3,4,0,0,9,9:11 - 8:11 - 7:11 - 0:0 - 0:0
18181233,2024-04-19 10:55:00,Nazaryan Mushegh - Arutyunov Ruben,3:1,7:11 - 14:12 - 9:11 - 3:11 - 0:0,1,3,Nazaryan Mushegh,Arutyunov Ruben,fiurst,Arutyunov Ruben - Nazaryan Mushegh,78,45,33,-12,12,18,26,20,14,0,-4,2,-2,-8,0,-12,11:7 - 12:14 - 11:9 - 11:3 - 0:0
18181227,2024-04-19 10:30:00,Asatryan Murad - Rafayelyan Edgar,3:0,11:8 - 14:12 - 11:8 - 0:0 - 0:0,3,0,Asatryan Murad,Rafayelyan Edgar,fiurst,Asatryan Murad - Rafayelyan Edgar,64,36,28,-8,8,19,26,19,0,0,-3,-2,-3,0,0,-8,11:8 - 14:12 - 11:8 - 0:0 - 0:0
18181223,2024-04-19 10:15:00,Arutyunov Ruben - Nikoghosyan Narek,1:3,9:11 - 7:11 - 11:8 - 10:12 - 0:0,1,3,Arutyunov Ruben,Nikoghosyan Narek,fiurst,Arutyunov Ruben - Nikoghosyan Narek,79,37,42,5,-5,20,18,19,22,0,2,4,-3,2,0,5,9:11 - 7:11 - 11:8 - 10:12 - 0:0
18181209,2024-04-19 10:00:00,Nazaryan Mushegh - Asatryan Murad,3:0,6:11 - 9:11 - 8:11 - 0:0 - 0:0,0,3,Nazaryan Mushegh,Asatryan Murad,fiurst,Asatryan Murad - Nazaryan Mushegh,56,33,23,-10,10,17,20,19,0,0,-5,-2,-3,0,0,-10,11:6 - 11:9 - 11:8 - 0:0 - 0:0
18167667,2024-04-18 17:45:00,Hakobyan Eduard - Mkrtchyan Andranik,3:1,7:11 - 12:10 - 11:7 - 11:5 - 0:0,3,1,Hakobyan Eduard,Mkrtchyan Andranik,fiurst,Hakobyan Eduard - Mkrtchyan Andranik,74,41,33,-8,8,18,22,18,16,0,4,-2,-4,-6,0,-8,7:11 - 12:10 - 11:7 - 11:5 - 0:0
18167666,2024-04-18 17:30:00,Soghomonyan Hrayr - Petrosyan Davit,0:3,11:9 - 11:3 - 11:5 - 0:0 - 0:0,3,0,Soghomonyan Hrayr,Petrosyan Davit,fiurst,Petrosyan Davit - Soghomonyan Hrayr,50,17,33,16,-16,20,14,16,0,0,2,8,6,0,0,16,9:11 - 3:11 - 5:11 - 0:0 - 0:0
18167662,2024-04-18 17:15:00,Avakimyan Davit - Hakobyan Eduard,2:3,11:13 - 11:9 - 11:8 - 7:11 - 9:11,2,3,Avakimyan Davit,Hakobyan Eduard,fiurst,Avakimyan Davit - Hakobyan Eduard,101,49,52,3,-3,24,20,19,18,20,2,-2,-3,4,2,3,11:13 - 11:9 - 11:8 - 7:11 - 9:11
18167649,2024-04-18 17:00:00,Soghomonyan Hrayr - Mkrtchyan Andranik,0:3,11:3 - 11:9 - 11:5 - 0:0 - 0:0,3,0,Soghomonyan Hrayr,Mkrtchyan Andranik,fiurst,Mkrtchyan Andranik - Soghomonyan Hrayr,50,17,33,16,-16,14,20,16,0,0,8,2,6,0,0,16,3:11 - 9:11 - 5:11 - 0:0 - 0:0
18167646,2024-04-18 16:45:00,Petrosyan Davit - Avakimyan Davit,3:1,11:8 - 8:11 - 8:11 - 11:13 - 0:0,1,3,Petrosyan Davit,Avakimyan Davit,fiurst,Avakimyan Davit - Petrosyan Davit,81,43,38,-5,5,19,19,19,24,0,3,-3,-3,-2,0,-5,8:11 - 11:8 - 11:8 - 13:11 - 0:0
18167643,2024-04-18 16:30:00,Hakobyan Eduard - Soghomonyan Hrayr,1:3,12:10 - 5:11 - 5:11 - 7:11 - 0:0,1,3,Hakobyan Eduard,Soghomonyan Hrayr,fiurst,Hakobyan Eduard - Soghomonyan Hrayr,72,29,43,14,-14,22,16,16,18,0,-2,6,6,4,0,14,12:10 - 5:11 - 5:11 - 7:11 - 0:0
18167640,2024-04-18 16:15:00,Mkrtchyan Andranik - Avakimyan Davit,3:1,11:9 - 5:11 - 6:11 - 10:12 - 0:0,1,3,Mkrtchyan Andranik,Avakimyan Davit,fiurst,Avakimyan Davit - Mkrtchyan Andranik,75,43,32,-11,11,20,16,17,22,0,2,-6,-5,-2,0,-11,9:11 - 11:5 - 11:6 - 12:10 - 0:0
18167639,2024-04-18 16:00:00,Petrosyan Davit - Hakobyan Eduard,3:0,9:11 - 8:11 - 10:12 - 0:0 - 0:0,0,3,Petrosyan Davit,Hakobyan Eduard,fiurst,Hakobyan Eduard - Petrosyan Davit,61,34,27,-7,7,20,19,22,0,0,-2,-3,-2,0,0,-7,11:9 - 11:8 - 12:10 - 0:0 - 0:0
18167636,2024-04-18 15:45:00,Avakimyan Davit - Soghomonyan Hrayr,1:3,11:13 - 11:8 - 3:11 - 8:11 - 0:0,1,3,Avakimyan Davit,Soghomonyan Hrayr,fiurst,Avakimyan Davit - Soghomonyan Hrayr,76,33,43,10,-10,24,19,14,19,0,2,-3,8,3,0,10,11:13 - 11:8 - 3:11 - 8:11 - 0:0
18167634,2024-04-18 15:30:00,Mkrtchyan Andranik - Petrosyan Davit,1:3,8:11 - 14:16 - 11:6 - 7:11 - 0:0,1,3,Mkrtchyan Andranik,Petrosyan Davit,fiurst,Mkrtchyan Andranik - Petrosyan Davit,84,40,44,4,-4,19,30,17,18,0,3,2,-5,4,0,4,8:11 - 14:16 - 11:6 - 7:11 - 0:0
18167630,2024-04-18 15:15:00,Asatryan Murad - Diaryan Aleksandr,0:3,6:11 - 10:12 - 3:11 - 0:0 - 0:0,0,3,Asatryan Murad,Diaryan Aleksandr,fiurst,Asatryan Murad - Diaryan Aleksandr,53,19,34,15,-15,17,22,14,0,0,5,2,8,0,0,15,6:11 - 10:12 - 3:11 - 0:0 - 0:0
18167617,2024-04-18 14:50:00,Nikoghosyan Narek - Asatryan Murad,3:1,11:9 - 4:11 - 8:11 - 4:11 - 0:0,1,3,Nikoghosyan Narek,Asatryan Murad,fiurst,Asatryan Murad - Nikoghosyan Narek,69,42,27,-15,15,20,15,19,15,0,2,-7,-3,-7,0,-15,9:11 - 11:4 - 11:8 - 11:4 - 0:0
18167613,2024-04-18 14:15:00,Nikoghosyan Narek - Rafayelyan Edgar,2:3,11:5 - 11:5 - 9:11 - 9:11 - 7:11,2,3,Nikoghosyan Narek,Rafayelyan Edgar,fiurst,Nikoghosyan Narek - Rafayelyan Edgar,90,47,43,-4,4,16,16,20,20,18,-6,-6,2,2,4,-4,11:5 - 11:5 - 9:11 - 9:11 - 7:11
18167608,2024-04-18 13:45:00,Diaryan Aleksandr - Nikoghosyan Narek,3:2,11:4 - 6:11 - 7:11 - 11:4 - 11:7,3,2,Diaryan Aleksandr,Nikoghosyan Narek,fiurst,Diaryan Aleksandr - Nikoghosyan Narek,83,46,37,-9,9,15,17,18,15,18,-7,5,4,-7,-4,-9,11:4 - 6:11 - 7:11 - 11:4 - 11:7
18167603,2024-04-18 13:40:00,Rafayelyan Edgar - Asatryan Murad,1:3,11:8 - 11:8 - 5:11 - 11:5 - 0:0,3,1,Rafayelyan Edgar,Asatryan Murad,fiurst,Asatryan Murad - Rafayelyan Edgar,70,32,38,6,-6,19,19,16,16,0,3,3,-6,6,0,6,8:11 - 8:11 - 11:5 - 5:11 - 0:0
18167591,2024-04-18 13:00:00,Rafayelyan Edgar - Diaryan Aleksandr,1:3,11:8 - 9:11 - 11:4 - 11:8 - 0:0,3,1,Rafayelyan Edgar,Diaryan Aleksandr,fiurst,Diaryan Aleksandr - Rafayelyan Edgar,73,31,42,11,-11,19,20,15,19,0,3,-2,7,3,0,11,8:11 - 11:9 - 4:11 - 8:11 - 0:0
18167587,2024-04-18 12:15:00,Asatryan Murad - Nikoghosyan Narek,3:2,6:11 - 11:5 - 11:4 - 5:11 - 11:3,3,2,Asatryan Murad,Nikoghosyan Narek,fiurst,Asatryan Murad - Nikoghosyan Narek,78,44,34,-10,10,17,16,15,16,14,5,-6,-7,6,-8,-10,6:11 - 11:5 - 11:4 - 5:11 - 11:3
18167577,2024-04-18 12:00:00,Rafayelyan Edgar - Nazaryan Mushegh,0:3,11:4 - 11:9 - 11:7 - 0:0 - 0:0,3,0,Rafayelyan Edgar,Nazaryan Mushegh,fiurst,Nazaryan Mushegh - Rafayelyan Edgar,53,20,33,13,-13,15,20,18,0,0,7,2,4,0,0,13,4:11 - 9:11 - 7:11 - 0:0 - 0:0
18167575,2024-04-18 11:45:00,Diaryan Aleksandr - Asatryan Murad,3:0,7:11 - 2:11 - 9:11 - 0:0 - 0:0,0,3,Diaryan Aleksandr,Asatryan Murad,fiurst,Asatryan Murad - Diaryan Aleksandr,51,33,18,-15,15,18,13,20,0,0,-4,-9,-2,0,0,-15,11:7 - 11:2 - 11:9 - 0:0 - 0:0
18167574,2024-04-18 11:30:00,Rafayelyan Edgar - Nikoghosyan Narek,0:3,11:6 - 11:9 - 11:6 - 0:0 - 0:0,3,0,Rafayelyan Edgar,Nikoghosyan Narek,fiurst,Nikoghosyan Narek - Rafayelyan Edgar,54,21,33,12,-12,17,20,17,0,0,5,2,5,0,0,12,6:11 - 9:11 - 6:11 - 0:0 - 0:0
18167562,2024-04-18 11:20:00,Nazaryan Mushegh - Diaryan Aleksandr,3:0,8:11 - 4:11 - 5:11 - 0:0 - 0:0,0,3,Nazaryan Mushegh,Diaryan Aleksandr,fiurst,Diaryan Aleksandr - Nazaryan Mushegh,50,33,17,-16,16,19,15,16,0,0,-3,-7,-6,0,0,-16,11:8 - 11:4 - 11:5 - 0:0 - 0:0
18167560,2024-04-18 11:00:00,Asatryan Murad - Rafayelyan Edgar,3:1,9:11 - 11:7 - 11:5 - 11:8 - 0:0,3,1,Asatryan Murad,Rafayelyan Edgar,fiurst,Asatryan Murad - Rafayelyan Edgar,73,42,31,-11,11,20,18,16,19,0,2,-4,-6,-3,0,-11,9:11 - 11:7 - 11:5 - 11:8 - 0:0
18167559,2024-04-18 10:50:00,Nikoghosyan Narek - Diaryan Aleksandr,3:0,5:11 - 5:11 - 5:11 - 0:0 - 0:0,0,3,Nikoghosyan Narek,Diaryan Aleksandr,fiurst,Diaryan Aleksandr - Nikoghosyan Narek,48,33,15,-18,18,16,16,16,0,0,-6,-6,-6,0,0,-18,11:5 - 11:5 - 11:5 - 0:0 - 0:0
18167558,2024-04-18 10:30:00,Nazaryan Mushegh - Asatryan Murad,3:0,7:11 - 9:11 - 5:11 - 0:0 - 0:0,0,3,Nazaryan Mushegh,Asatryan Murad,fiurst,Asatryan Murad - Nazaryan Mushegh,54,33,21,-12,12,18,20,16,0,0,-4,-2,-6,0,0,-12,11:7 - 11:9 - 11:5 - 0:0 - 0:0
18167553,2024-04-18 10:15:00,Diaryan Aleksandr - Rafayelyan Edgar,3:0,14:12 - 11:7 - 12:10 - 0:0 - 0:0,3,0,Diaryan Aleksandr,Rafayelyan Edgar,fiurst,Diaryan Aleksandr - Rafayelyan Edgar,66,37,29,-8,8,26,18,22,0,0,-2,-4,-2,0,0,-8,14:12 - 11:7 - 12:10 - 0:0 - 0:0
18167551,2024-04-18 10:00:00,Nikoghosyan Narek - Nazaryan Mushegh,0:3,11:7 - 11:7 - 11:7 - 0:0 - 0:0,3,0,Nikoghosyan Narek,Nazaryan Mushegh,fiurst,Nazaryan Mushegh - Nikoghosyan Narek,54,21,33,12,-12,18,18,18,0,0,4,4,4,0,0,12,7:11 - 7:11 - 7:11 - 0:0 - 0:0
18145996,2024-04-17 17:45:00,Petrosyan Davit - Hakobyan Eduard,2:3,11:6 - 8:11 - 5:11 - 11:9 - 12:10,3,2,Petrosyan Davit,Hakobyan Eduard,fiurst,Hakobyan Eduard - Petrosyan Davit,94,47,47,0,0,17,19,16,20,22,5,-3,-6,2,2,0,6:11 - 11:8 - 11:5 - 9:11 - 10:12
18145994,2024-04-17 17:40:00,Mkrtchyan Andranik - Soghomonyan Hrayr,0:3,4:11 - 2:11 - 7:11 - 0:0 - 0:0,0,3,Mkrtchyan Andranik,Soghomonyan Hrayr,fiurst,Mkrtchyan Andranik - Soghomonyan Hrayr,46,13,33,20,-20,15,13,18,0,0,7,9,4,0,0,20,4:11 - 2:11 - 7:11 - 0:0 - 0:0
18145987,2024-04-17 17:15:00,Gevorgyan Gegham - Petrosyan Davit,0:3,7:11 - 6:11 - 7:11 - 0:0 - 0:0,0,3,Gevorgyan Gegham,Petrosyan Davit,fiurst,Gevorgyan Gegham - Petrosyan Davit,53,20,33,13,-13,18,17,18,0,0,4,5,4,0,0,13,7:11 - 6:11 - 7:11 - 0:0 - 0:0
18145976,2024-04-17 17:05:00,Mkrtchyan Andranik - Hakobyan Eduard,3:2,14:12 - 8:11 - 13:11 - 8:11 - 8:11,2,3,Mkrtchyan Andranik,Hakobyan Eduard,fiurst,Hakobyan Eduard - Mkrtchyan Andranik,107,56,51,-5,5,26,19,24,19,19,2,-3,2,-3,-3,-5,12:14 - 11:8 - 11:13 - 11:8 - 11:8
18145937,2024-04-17 16:45:00,Soghomonyan Hrayr - Gevorgyan Gegham,0:3,16:14 - 11:4 - 11:6 - 0:0 - 0:0,3,0,Soghomonyan Hrayr,Gevorgyan Gegham,fiurst,Gevorgyan Gegham - Soghomonyan Hrayr,62,24,38,14,-14,30,15,17,0,0,2,7,5,0,0,14,14:16 - 4:11 - 6:11 - 0:0 - 0:0
18145923,2024-04-17 16:30:00,Petrosyan Davit - Mkrtchyan Andranik,3:2,11:8 - 3:11 - 11:8 - 6:11 - 9:11,2,3,Petrosyan Davit,Mkrtchyan Andranik,fiurst,Mkrtchyan Andranik - Petrosyan Davit,89,49,40,-9,9,19,14,19,17,20,3,-8,3,-5,-2,-9,8:11 - 11:3 - 8:11 - 11:6 - 11:9
18145917,2024-04-17 16:20:00,Hakobyan Eduard - Gevorgyan Gegham,0:3,11:3 - 11:9 - 11:9 - 0:0 - 0:0,3,0,Hakobyan Eduard,Gevorgyan Gegham,fiurst,Gevorgyan Gegham - Hakobyan Eduard,54,21,33,12,-12,14,20,20,0,0,8,2,2,0,0,12,3:11 - 9:11 - 9:11 - 0:0 - 0:0
18145877,2024-04-17 16:00:00,Soghomonyan Hrayr - Petrosyan Davit,1:3,11:6 - 11:8 - 8:11 - 11:5 - 0:0,3,1,Soghomonyan Hrayr,Petrosyan Davit,fiurst,Petrosyan Davit - Soghomonyan Hrayr,71,30,41,11,-11,17,19,19,16,0,5,3,-3,6,0,11,6:11 - 8:11 - 11:8 - 5:11 - 0:0
18145842,2024-04-17 15:45:00,Gevorgyan Gegham - Mkrtchyan Andranik,0:3,5:11 - 5:11 - 10:12 - 0:0 - 0:0,0,3,Gevorgyan Gegham,Mkrtchyan Andranik,fiurst,Gevorgyan Gegham - Mkrtchyan Andranik,54,20,34,14,-14,16,16,22,0,0,6,6,2,0,0,14,5:11 - 5:11 - 10:12 - 0:0 - 0:0
18145839,2024-04-17 15:30:00,Hakobyan Eduard - Soghomonyan Hrayr,0:3,4:11 - 7:11 - 9:11 - 0:0 - 0:0,0,3,Hakobyan Eduard,Soghomonyan Hrayr,fiurst,Hakobyan Eduard - Soghomonyan Hrayr,53,20,33,13,-13,15,18,20,0,0,7,4,2,0,0,13,4:11 - 7:11 - 9:11 - 0:0 - 0:0
18145829,2024-04-17 15:25:00,Hovhannesyan Rafik - Nazaryan Mushegh,3:1,11:6 - 11:9 - 7:11 - 11:7 - 0:0,3,1,Hovhannesyan Rafik,Nazaryan Mushegh,fiurst,Hovhannesyan Rafik - Nazaryan Mushegh,73,40,33,-7,7,17,20,18,18,0,-5,-2,4,-4,0,-7,11:6 - 11:9 - 7:11 - 11:7 - 0:0
18145824,2024-04-17 15:10:00,Diaryan Aleksandr - Nikoghosyan Narek,3:1,11:6 - 9:11 - 11:3 - 11:3 - 0:0,3,1,Diaryan Aleksandr,Nikoghosyan Narek,fiurst,Diaryan Aleksandr - Nikoghosyan Narek,65,42,23,-19,19,17,20,14,14,0,-5,2,-8,-8,0,-19,11:6 - 9:11 - 11:3 - 11:3 - 0:0
18145823,2024-04-17 15:00:00,Arutyunov Ruben - Hovhannesyan Rafik,3:2,7:11 - 6:11 - 11:8 - 16:14 - 11:6,3,2,Arutyunov Ruben,Hovhannesyan Rafik,fiurst,Arutyunov Ruben - Hovhannesyan Rafik,101,51,50,-1,1,18,17,19,30,17,4,5,-3,-2,-5,-1,7:11 - 6:11 - 11:8 - 16:14 - 11:6
18145821,2024-04-17 14:35:00,Nazaryan Mushegh - Diaryan Aleksandr,3:1,11:6 - 6:11 - 4:11 - 1:11 - 0:0,1,3,Nazaryan Mushegh,Diaryan Aleksandr,fiurst,Diaryan Aleksandr - Nazaryan Mushegh,61,39,22,-17,17,17,17,15,12,0,5,-5,-7,-10,0,-17,6:11 - 11:6 - 11:4 - 11:1 - 0:0
18145809,2024-04-17 14:15:00,Arutyunov Ruben - Nikoghosyan Narek,3:2,11:5 - 8:11 - 12:10 - 11:13 - 11:8,3,2,Arutyunov Ruben,Nikoghosyan Narek,fiurst,Arutyunov Ruben - Nikoghosyan Narek,100,53,47,-6,6,16,19,22,24,19,-6,3,-2,2,-3,-6,11:5 - 8:11 - 12:10 - 11:13 - 11:8
18145807,2024-04-17 14:10:00,Hovhannesyan Rafik - Diaryan Aleksandr,1:3,10:12 - 13:11 - 11:8 - 11:6 - 0:0,3,1,Hovhannesyan Rafik,Diaryan Aleksandr,fiurst,Diaryan Aleksandr - Hovhannesyan Rafik,82,37,45,8,-8,22,24,19,17,0,-2,2,3,5,0,8,12:10 - 11:13 - 8:11 - 6:11 - 0:0
18145806,2024-04-17 13:45:00,Nazaryan Mushegh - Arutyunov Ruben,0:3,11:7 - 12:10 - 11:8 - 0:0 - 0:0,3,0,Nazaryan Mushegh,Arutyunov Ruben,fiurst,Arutyunov Ruben - Nazaryan Mushegh,59,25,34,9,-9,18,22,19,0,0,4,2,3,0,0,9,7:11 - 10:12 - 8:11 - 0:0 - 0:0
18145794,2024-04-17 13:30:00,Nikoghosyan Narek - Hovhannesyan Rafik,2:3,11:7 - 6:11 - 11:7 - 7:11 - 11:5,3,2,Nikoghosyan Narek,Hovhannesyan Rafik,fiurst,Hovhannesyan Rafik - Nikoghosyan Narek,87,41,46,5,-5,18,17,18,18,16,4,-5,4,-4,6,5,7:11 - 11:6 - 7:11 - 11:7 - 5:11
18145793,2024-04-17 13:15:00,Diaryan Aleksandr - Arutyunov Ruben,0:3,11:6 - 11:4 - 11:4 - 0:0 - 0:0,3,0,Diaryan Aleksandr,Arutyunov Ruben,fiurst,Arutyunov Ruben - Diaryan Aleksandr,47,14,33,19,-19,17,15,15,0,0,5,7,7,0,0,19,6:11 - 4:11 - 4:11 - 0:0 - 0:0
18145792,2024-04-17 13:00:00,Nikoghosyan Narek - Nazaryan Mushegh,3:0,8:11 - 7:11 - 11:13 - 0:0 - 0:0,0,3,Nikoghosyan Narek,Nazaryan Mushegh,fiurst,Nazaryan Mushegh - Nikoghosyan Narek,61,35,26,-9,9,19,18,24,0,0,-3,-4,-2,0,0,-9,11:8 - 11:7 - 13:11 - 0:0 - 0:0
18145791,2024-04-17 12:20:00,Hovhannesyan Rafik - Arutyunov Ruben,1:3,3:11 - 11:3 - 13:11 - 11:6 - 0:0,3,1,Hovhannesyan Rafik,Arutyunov Ruben,fiurst,Arutyunov Ruben - Hovhannesyan Rafik,69,31,38,7,-7,14,14,24,17,0,-8,8,2,5,0,7,11:3 - 3:11 - 11:13 - 6:11 - 0:0
18145789,2024-04-17 12:00:00,Nikoghosyan Narek - Diaryan Aleksandr,1:3,13:11 - 5:11 - 11:4 - 11:6 - 0:0,3,1,Nikoghosyan Narek,Diaryan Aleksandr,fiurst,Diaryan Aleksandr - Nikoghosyan Narek,72,32,40,8,-8,24,16,15,17,0,2,-6,7,5,0,8,11:13 - 11:5 - 4:11 - 6:11 - 0:0
18145787,2024-04-17 11:45:00,Nazaryan Mushegh - Hovhannesyan Rafik,3:1,6:11 - 11:8 - 9:11 - 7:11 - 0:0,1,3,Nazaryan Mushegh,Hovhannesyan Rafik,fiurst,Hovhannesyan Rafik - Nazaryan Mushegh,74,41,33,-8,8,17,19,20,18,0,-5,3,-2,-4,0,-8,11:6 - 8:11 - 11:9 - 11:7 - 0:0
18145785,2024-04-17 11:30:00,Nikoghosyan Narek - Arutyunov Ruben,0:3,11:7 - 11:4 - 11:7 - 0:0 - 0:0,3,0,Nikoghosyan Narek,Arutyunov Ruben,fiurst,Arutyunov Ruben - Nikoghosyan Narek,51,18,33,15,-15,18,15,18,0,0,4,7,4,0,0,15,7:11 - 4:11 - 7:11 - 0:0 - 0:0
18145780,2024-04-17 11:15:00,Diaryan Aleksandr - Nazaryan Mushegh,3:0,11:8 - 11:8 - 11:6 - 0:0 - 0:0,3,0,Diaryan Aleksandr,Nazaryan Mushegh,fiurst,Diaryan Aleksandr - Nazaryan Mushegh,55,33,22,-11,11,19,19,17,0,0,-3,-3,-5,0,0,-11,11:8 - 11:8 - 11:6 - 0:0 - 0:0
18145774,2024-04-17 11:00:00,Hovhannesyan Rafik - Nikoghosyan Narek,3:1,12:10 - 11:8 - 8:11 - 11:6 - 0:0,3,1,Hovhannesyan Rafik,Nikoghosyan Narek,fiurst,Hovhannesyan Rafik - Nikoghosyan Narek,77,42,35,-7,7,22,19,19,17,0,-2,-3,3,-5,0,-7,12:10 - 11:8 - 8:11 - 11:6 - 0:0
18145766,2024-04-17 10:45:00,Arutyunov Ruben - Nazaryan Mushegh,3:0,11:7 - 11:7 - 11:7 - 0:0 - 0:0,3,0,Arutyunov Ruben,Nazaryan Mushegh,fiurst,Arutyunov Ruben - Nazaryan Mushegh,54,33,21,-12,12,18,18,18,0,0,-4,-4,-4,0,0,-12,11:7 - 11:7 - 11:7 - 0:0 - 0:0
18145765,2024-04-17 10:30:00,Diaryan Aleksandr - Hovhannesyan Rafik,3:0,12:10 - 11:8 - 11:3 - 0:0 - 0:0,3,0,Diaryan Aleksandr,Hovhannesyan Rafik,fiurst,Diaryan Aleksandr - Hovhannesyan Rafik,55,34,21,-13,13,22,19,14,0,0,-2,-3,-8,0,0,-13,12:10 - 11:8 - 11:3 - 0:0 - 0:0
18145763,2024-04-17 10:15:00,Nazaryan Mushegh - Nikoghosyan Narek,0:3,8:11 - 7:11 - 4:11 - 0:0 - 0:0,0,3,Nazaryan Mushegh,Nikoghosyan Narek,fiurst,Nazaryan Mushegh - Nikoghosyan Narek,52,19,33,14,-14,19,18,15,0,0,3,4,7,0,0,14,8:11 - 7:11 - 4:11 - 0:0 - 0:0
18145761,2024-04-17 10:00:00,Arutyunov Ruben - Diaryan Aleksandr,0:3,9:11 - 4:11 - 1:11 - 0:0 - 0:0,0,3,Arutyunov Ruben,Diaryan Aleksandr,fiurst,Arutyunov Ruben - Diaryan Aleksandr,47,14,33,19,-19,20,15,12,0,0,2,7,10,0,0,19,9:11 - 4:11 - 1:11 - 0:0 - 0:0
18128787,2024-04-16 17:45:00,Avakimyan Davit - Gevorgyan Hayk,1:3,10:12 - 8:11 - 11:9 - 3:11 - 0:0,1,3,Avakimyan Davit,Gevorgyan Hayk,fiurst,Avakimyan Davit - Gevorgyan Hayk,75,32,43,11,-11,22,19,20,14,0,2,3,-2,8,0,11,10:12 - 8:11 - 11:9 - 3:11 - 0:0
18128775,2024-04-16 17:30:00,Hakobyan Eduard - Mkrtchyan Andranik,3:2,9:11 - 5:11 - 16:14 - 12:10 - 11:6,3,2,Hakobyan Eduard,Mkrtchyan Andranik,fiurst,Hakobyan Eduard - Mkrtchyan Andranik,105,53,52,-1,1,20,16,30,22,17,2,6,-2,-2,-5,-1,9:11 - 5:11 - 16:14 - 12:10 - 11:6
18128774,2024-04-16 17:15:00,Soghomonyan Hrayr - Avakimyan Davit,3:0,6:11 - 8:11 - 9:11 - 0:0 - 0:0,0,3,Soghomonyan Hrayr,Avakimyan Davit,fiurst,Avakimyan Davit - Soghomonyan Hrayr,56,33,23,-10,10,17,19,20,0,0,-5,-3,-2,0,0,-10,11:6 - 11:8 - 11:9 - 0:0 - 0:0
18128770,2024-04-16 17:00:00,Hakobyan Eduard - Gevorgyan Hayk,3:0,5:11 - 7:11 - 9:11 - 0:0 - 0:0,0,3,Hakobyan Eduard,Gevorgyan Hayk,fiurst,Gevorgyan Hayk - Hakobyan Eduard,54,33,21,-12,12,16,18,20,0,0,-6,-4,-2,0,0,-12,11:5 - 11:7 - 11:9 - 0:0 - 0:0
18128769,2024-04-16 16:45:00,Mkrtchyan Andranik - Soghomonyan Hrayr,0:3,7:11 - 3:11 - 8:11 - 0:0 - 0:0,0,3,Mkrtchyan Andranik,Soghomonyan Hrayr,fiurst,Mkrtchyan Andranik - Soghomonyan Hrayr,51,18,33,15,-15,18,14,19,0,0,4,8,3,0,0,15,7:11 - 3:11 - 8:11 - 0:0 - 0:0
18128767,2024-04-16 16:30:00,Avakimyan Davit - Hakobyan Eduard,3:1,11:9 - 10:12 - 11:9 - 11:9 - 0:0,3,1,Avakimyan Davit,Hakobyan Eduard,fiurst,Avakimyan Davit - Hakobyan Eduard,82,43,39,-4,4,20,22,20,20,0,-2,2,-2,-2,0,-4,11:9 - 10:12 - 11:9 - 11:9 - 0:0
18128764,2024-04-16 16:15:00,Gevorgyan Hayk - Soghomonyan Hrayr,3:1,11:6 - 11:6 - 10:12 - 14:12 - 0:0,3,1,Gevorgyan Hayk,Soghomonyan Hrayr,fiurst,Gevorgyan Hayk - Soghomonyan Hrayr,82,46,36,-10,10,17,17,22,26,0,-5,-5,2,-2,0,-10,11:6 - 11:6 - 10:12 - 14:12 - 0:0
18128763,2024-04-16 16:00:00,Mkrtchyan Andranik - Avakimyan Davit,3:1,9:11 - 11:3 - 4:11 - 9:11 - 0:0,1,3,Mkrtchyan Andranik,Avakimyan Davit,fiurst,Avakimyan Davit - Mkrtchyan Andranik,69,36,33,-3,3,20,14,15,20,0,-2,8,-7,-2,0,-3,11:9 - 3:11 - 11:4 - 11:9 - 0:0
18128762,2024-04-16 15:45:00,Soghomonyan Hrayr - Hakobyan Eduard,0:3,11:6 - 11:8 - 11:5 - 0:0 - 0:0,3,0,Soghomonyan Hrayr,Hakobyan Eduard,fiurst,Hakobyan Eduard - Soghomonyan Hrayr,52,19,33,14,-14,17,19,16,0,0,5,3,6,0,0,14,6:11 - 8:11 - 5:11 - 0:0 - 0:0
18128759,2024-04-16 15:30:00,Gevorgyan Hayk - Mkrtchyan Andranik,3:2,11:5 - 9:11 - 11:9 - 4:11 - 11:6,3,2,Gevorgyan Hayk,Mkrtchyan Andranik,fiurst,Gevorgyan Hayk - Mkrtchyan Andranik,88,46,42,-4,4,16,20,20,15,17,-6,2,-2,7,-5,-4,11:5 - 9:11 - 11:9 - 4:11 - 11:6
18128747,2024-04-16 15:15:00,Diaryan Aleksandr - Asatryan Murad,3:1,8:11 - 11:3 - 7:11 - 6:11 - 0:0,1,3,Diaryan Aleksandr,Asatryan Murad,fiurst,Asatryan Murad - Diaryan Aleksandr,68,36,32,-4,4,19,14,18,17,0,-3,8,-4,-5,0,-4,11:8 - 3:11 - 11:7 - 11:6 - 0:0
18128746,2024-04-16 15:05:00,Arutyunov Ruben - Hovhannesyan Rafik,3:0,11:6 - 11:9 - 11:5 - 0:0 - 0:0,3,0,Arutyunov Ruben,Hovhannesyan Rafik,fiurst,Arutyunov Ruben - Hovhannesyan Rafik,53,33,20,-13,13,17,20,16,0,0,-5,-2,-6,0,0,-13,11:6 - 11:9 - 11:5 - 0:0 - 0:0
18128742,2024-04-16 14:30:00,Arutyunov Ruben - Diaryan Aleksandr,0:3,7:11 - 9:11 - 8:11 - 0:0 - 0:0,0,3,Arutyunov Ruben,Diaryan Aleksandr,fiurst,Arutyunov Ruben - Diaryan Aleksandr,57,24,33,9,-9,18,20,19,0,0,4,2,3,0,0,9,7:11 - 9:11 - 8:11 - 0:0 - 0:0
18128743,2024-04-16 14:30:00,Hovhannesyan Rafik - Asatryan Murad,3:0,5:11 - 10:12 - 5:11 - 0:0 - 0:0,0,3,Hovhannesyan Rafik,Asatryan Murad,fiurst,Asatryan Murad - Hovhannesyan Rafik,54,34,20,-14,14,16,22,16,0,0,-6,-2,-6,0,0,-14,11:5 - 12:10 - 11:5 - 0:0 - 0:0
18128738,2024-04-16 13:45:00,Arutyunov Ruben - Asatryan Murad,3:2,12:10 - 12:10 - 5:11 - 2:11 - 12:10,3,2,Arutyunov Ruben,Asatryan Murad,fiurst,Arutyunov Ruben - Asatryan Murad,95,43,52,9,-9,22,22,16,13,22,-2,-2,6,9,-2,9,12:10 - 12:10 - 5:11 - 2:11 - 12:10
18128718,2024-04-16 13:30:00,Diaryan Aleksandr - Hovhannesyan Rafik,3:1,11:3 - 12:10 - 4:11 - 11:9 - 0:0,3,1,Diaryan Aleksandr,Hovhannesyan Rafik,fiurst,Diaryan Aleksandr - Hovhannesyan Rafik,71,38,33,-5,5,14,22,15,20,0,-8,-2,7,-2,0,-5,11:3 - 12:10 - 4:11 - 11:9 - 0:0
18128717,2024-04-16 13:00:00,Asatryan Murad - Diaryan Aleksandr,3:0,11:7 - 12:10 - 11:4 - 0:0 - 0:0,3,0,Asatryan Murad,Diaryan Aleksandr,fiurst,Asatryan Murad - Diaryan Aleksandr,55,34,21,-13,13,18,22,15,0,0,-4,-2,-7,0,0,-13,11:7 - 12:10 - 11:4 - 0:0 - 0:0
18128716,2024-04-16 12:25:00,Hovhannesyan Rafik - Arutyunov Ruben,3:1,11:7 - 4:11 - 10:12 - 4:11 - 0:0,1,3,Hovhannesyan Rafik,Arutyunov Ruben,fiurst,Arutyunov Ruben - Hovhannesyan Rafik,70,41,29,-12,12,18,15,22,15,0,4,-7,-2,-7,0,-12,7:11 - 11:4 - 12:10 - 11:4 - 0:0
18128714,2024-04-16 11:45:00,Diaryan Aleksandr - Arutyunov Ruben,2:3,8:11 - 11:6 - 11:5 - 11:13 - 12:10,3,2,Diaryan Aleksandr,Arutyunov Ruben,fiurst,Arutyunov Ruben - Diaryan Aleksandr,98,45,53,8,-8,19,17,16,24,22,-3,5,6,-2,2,8,11:8 - 6:11 - 5:11 - 13:11 - 10:12
18128712,2024-04-16 11:30:00,Asatryan Murad - Hovhannesyan Rafik,3:0,11:3 - 11:5 - 11:6 - 0:0 - 0:0,3,0,Asatryan Murad,Hovhannesyan Rafik,fiurst,Asatryan Murad - Hovhannesyan Rafik,47,33,14,-19,19,14,16,17,0,0,-8,-6,-5,0,0,-19,11:3 - 11:5 - 11:6 - 0:0 - 0:0
18128711,2024-04-16 11:00:00,Asatryan Murad - Arutyunov Ruben,0:3,11:4 - 13:11 - 11:9 - 0:0 - 0:0,3,0,Asatryan Murad,Arutyunov Ruben,fiurst,Arutyunov Ruben - Asatryan Murad,59,24,35,11,-11,15,24,20,0,0,7,2,2,0,0,11,4:11 - 11:13 - 9:11 - 0:0 - 0:0
18128708,2024-04-16 10:45:00,Hovhannesyan Rafik - Diaryan Aleksandr,3:1,4:11 - 6:11 - 12:10 - 4:11 - 0:0,1,3,Hovhannesyan Rafik,Diaryan Aleksandr,fiurst,Diaryan Aleksandr - Hovhannesyan Rafik,69,43,26,-17,17,15,17,22,15,0,-7,-5,2,-7,0,-17,11:4 - 11:6 - 10:12 - 11:4 - 0:0
18128707,2024-04-16 10:15:00,Diaryan Aleksandr - Asatryan Murad,3:0,5:11 - 5:11 - 7:11 - 0:0 - 0:0,0,3,Diaryan Aleksandr,Asatryan Murad,fiurst,Asatryan Murad - Diaryan Aleksandr,50,33,17,-16,16,16,16,18,0,0,-6,-6,-4,0,0,-16,11:5 - 11:5 - 11:7 - 0:0 - 0:0
18128703,2024-04-16 10:00:00,Arutyunov Ruben - Hovhannesyan Rafik,3:0,14:12 - 11:4 - 11:5 - 0:0 - 0:0,3,0,Arutyunov Ruben,Hovhannesyan Rafik,fiurst,Arutyunov Ruben - Hovhannesyan Rafik,57,36,21,-15,15,26,15,16,0,0,-2,-7,-6,0,0,-15,14:12 - 11:4 - 11:5 - 0:0 - 0:0
18105896,2024-04-15 17:55:00,Mkrtchyan Andranik - Soghomonyan Hrayr,3:2,6:11 - 11:6 - 3:11 - 11:6 - 11:9,3,2,Mkrtchyan Andranik,Soghomonyan Hrayr,fiurst,Mkrtchyan Andranik - Soghomonyan Hrayr,85,42,43,1,-1,17,17,14,17,20,5,-5,8,-5,-2,1,6:11 - 11:6 - 3:11 - 11:6 - 11:9
18105891,2024-04-15 17:40:00,Avakimyan Davit - Gevorgyan Hayk,3:2,11:8 - 7:11 - 7:11 - 11:6 - 11:9,3,2,Avakimyan Davit,Gevorgyan Hayk,fiurst,Avakimyan Davit - Gevorgyan Hayk,92,47,45,-2,2,19,18,18,17,20,-3,4,4,-5,-2,-2,11:8 - 7:11 - 7:11 - 11:6 - 11:9
18105890,2024-04-15 17:25:00,Gevorgyan Gegham - Mkrtchyan Andranik,1:3,12:10 - 5:11 - 6:11 - 7:11 - 0:0,1,3,Gevorgyan Gegham,Mkrtchyan Andranik,fiurst,Gevorgyan Gegham - Mkrtchyan Andranik,73,30,43,13,-13,22,16,17,18,0,-2,6,5,4,0,13,12:10 - 5:11 - 6:11 - 7:11 - 0:0
18105888,2024-04-15 17:15:00,Avakimyan Davit - Soghomonyan Hrayr,3:1,11:5 - 9:11 - 12:10 - 14:12 - 0:0,3,1,Avakimyan Davit,Soghomonyan Hrayr,fiurst,Avakimyan Davit - Soghomonyan Hrayr,84,46,38,-8,8,16,20,22,26,0,-6,2,-2,-2,0,-8,11:5 - 9:11 - 12:10 - 14:12 - 0:0
18105879,2024-04-15 16:55:00,Gevorgyan Hayk - Gevorgyan Gegham,1:3,11:5 - 11:9 - 8:11 - 11:9 - 0:0,3,1,Gevorgyan Hayk,Gevorgyan Gegham,fiurst,Gevorgyan Gegham - Gevorgyan Hayk,75,34,41,7,-7,16,20,19,20,0,6,2,-3,2,0,7,5:11 - 9:11 - 11:8 - 9:11 - 0:0
18105874,2024-04-15 16:50:00,Mkrtchyan Andranik - Avakimyan Davit,2:3,8:11 - 11:7 - 13:15 - 11:2 - 11:8,3,2,Mkrtchyan Andranik,Avakimyan Davit,fiurst,Avakimyan Davit - Mkrtchyan Andranik,97,43,54,11,-11,19,18,28,13,19,-3,4,-2,9,3,11,11:8 - 7:11 - 15:13 - 2:11 - 8:11
18105872,2024-04-15 16:15:00,Soghomonyan Hrayr - Gevorgyan Gegham,1:3,11:6 - 10:12 - 12:10 - 12:10 - 0:0,3,1,Soghomonyan Hrayr,Gevorgyan Gegham,fiurst,Gevorgyan Gegham - Soghomonyan Hrayr,83,38,45,7,-7,17,22,22,22,0,5,-2,2,2,0,7,6:11 - 12:10 - 10:12 - 10:12 - 0:0
18105858,2024-04-15 16:10:00,Gevorgyan Hayk - Mkrtchyan Andranik,3:2,11:8 - 4:11 - 9:11 - 12:10 - 11:3,3,2,Gevorgyan Hayk,Mkrtchyan Andranik,fiurst,Gevorgyan Hayk - Mkrtchyan Andranik,90,47,43,-4,4,19,15,20,22,14,-3,7,2,-2,-8,-4,11:8 - 4:11 - 9:11 - 12:10 - 11:3
18105853,2024-04-15 16:00:00,Gevorgyan Gegham - Avakimyan Davit,0:3,11:6 - 11:9 - 11:7 - 0:0 - 0:0,3,0,Gevorgyan Gegham,Avakimyan Davit,fiurst,Avakimyan Davit - Gevorgyan Gegham,55,22,33,11,-11,17,20,18,0,0,5,2,4,0,0,11,6:11 - 9:11 - 7:11 - 0:0 - 0:0
18105838,2024-04-15 15:40:00,Arutyunov Ruben - Asatryan Murad,0:3,12:14 - 10:12 - 8:11 - 0:0 - 0:0,0,3,Arutyunov Ruben,Asatryan Murad,fiurst,Arutyunov Ruben - Asatryan Murad,67,30,37,7,-7,26,22,19,0,0,2,2,3,0,0,7,12:14 - 10:12 - 8:11 - 0:0 - 0:0
18105840,2024-04-15 15:35:00,Soghomonyan Hrayr - Gevorgyan Hayk,1:3,11:8 - 7:11 - 11:7 - 11:5 - 0:0,3,1,Soghomonyan Hrayr,Gevorgyan Hayk,fiurst,Gevorgyan Hayk - Soghomonyan Hrayr,71,31,40,9,-9,19,18,18,16,0,3,-4,4,6,0,9,8:11 - 11:7 - 7:11 - 5:11 - 0:0
18105834,2024-04-15 15:10:00,Diaryan Aleksandr - Rafayelyan Edgar,2:3,11:6 - 8:11 - 11:1 - 8:11 - 8:11,2,3,Diaryan Aleksandr,Rafayelyan Edgar,fiurst,Diaryan Aleksandr - Rafayelyan Edgar,86,46,40,-6,6,17,19,12,19,19,-5,3,-10,3,3,-6,11:6 - 8:11 - 11:1 - 8:11 - 8:11
18105523,2024-04-15 15:05:00,Nikoghosyan Narek - Arutyunov Ruben,1:3,11:7 - 11:8 - 8:11 - 11:8 - 0:0,3,1,Nikoghosyan Narek,Arutyunov Ruben,fiurst,Arutyunov Ruben - Nikoghosyan Narek,75,34,41,7,-7,18,19,19,19,0,4,3,-3,3,0,7,7:11 - 8:11 - 11:8 - 8:11 - 0:0
18105520,2024-04-15 14:35:00,Asatryan Murad - Diaryan Aleksandr,3:0,11:8 - 11:6 - 11:9 - 0:0 - 0:0,3,0,Asatryan Murad,Diaryan Aleksandr,fiurst,Asatryan Murad - Diaryan Aleksandr,56,33,23,-10,10,19,17,20,0,0,-3,-5,-2,0,0,-10,11:8 - 11:6 - 11:9 - 0:0 - 0:0
18105508,2024-04-15 14:30:00,Nikoghosyan Narek - Rafayelyan Edgar,3:2,12:10 - 11:5 - 8:11 - 4:11 - 11:5,3,2,Nikoghosyan Narek,Rafayelyan Edgar,fiurst,Nikoghosyan Narek - Rafayelyan Edgar,88,46,42,-4,4,22,16,19,15,16,-2,-6,3,7,-6,-4,12:10 - 11:5 - 8:11 - 4:11 - 11:5
18105483,2024-04-15 14:00:00,Asatryan Murad - Nikoghosyan Narek,3:0,11:4 - 11:8 - 11:6 - 0:0 - 0:0,3,0,Asatryan Murad,Nikoghosyan Narek,fiurst,Asatryan Murad - Nikoghosyan Narek,51,33,18,-15,15,15,19,17,0,0,-7,-3,-5,0,0,-15,11:4 - 11:8 - 11:6 - 0:0 - 0:0
18105506,2024-04-15 14:00:00,Arutyunov Ruben - Diaryan Aleksandr,1:3,8:11 - 2:11 - 12:10 - 6:11 - 0:0,1,3,Arutyunov Ruben,Diaryan Aleksandr,fiurst,Arutyunov Ruben - Diaryan Aleksandr,71,28,43,15,-15,19,13,22,17,0,3,9,-2,5,0,15,8:11 - 2:11 - 12:10 - 6:11 - 0:0
18105482,2024-04-15 13:40:00,Rafayelyan Edgar - Arutyunov Ruben,0:3,11:2 - 11:6 - 11:8 - 0:0 - 0:0,3,0,Rafayelyan Edgar,Arutyunov Ruben,fiurst,Arutyunov Ruben - Rafayelyan Edgar,49,16,33,17,-17,13,17,19,0,0,9,5,3,0,0,17,2:11 - 6:11 - 8:11 - 0:0 - 0:0
18105477,2024-04-15 13:20:00,Diaryan Aleksandr - Nikoghosyan Narek,2:3,12:10 - 6:11 - 11:5 - 7:11 - 13:15,2,3,Diaryan Aleksandr,Nikoghosyan Narek,fiurst,Diaryan Aleksandr - Nikoghosyan Narek,101,49,52,3,-3,22,17,16,18,28,-2,5,-6,4,2,3,12:10 - 6:11 - 11:5 - 7:11 - 13:15
18105474,2024-04-15 13:00:00,Rafayelyan Edgar - Asatryan Murad,3:2,8:11 - 13:11 - 9:11 - 11:9 - 2:11,2,3,Rafayelyan Edgar,Asatryan Murad,fiurst,Asatryan Murad - Rafayelyan Edgar,96,53,43,-10,10,19,24,20,20,13,-3,2,-2,2,-9,-10,11:8 - 11:13 - 11:9 - 9:11 - 11:2
18105472,2024-04-15 12:40:00,Arutyunov Ruben - Nikoghosyan Narek,0:3,1:11 - 6:11 - 11:13 - 0:0 - 0:0,0,3,Arutyunov Ruben,Nikoghosyan Narek,fiurst,Arutyunov Ruben - Nikoghosyan Narek,53,18,35,17,-17,12,17,24,0,0,10,5,2,0,0,17,1:11 - 6:11 - 11:13 - 0:0 - 0:0
18105470,2024-04-15 12:15:00,Rafayelyan Edgar - Diaryan Aleksandr,0:3,11:6 - 11:7 - 11:9 - 0:0 - 0:0,3,0,Rafayelyan Edgar,Diaryan Aleksandr,fiurst,Diaryan Aleksandr - Rafayelyan Edgar,55,22,33,11,-11,17,18,20,0,0,5,4,2,0,0,11,6:11 - 7:11 - 9:11 - 0:0 - 0:0
18105469,2024-04-15 12:00:00,Asatryan Murad - Arutyunov Ruben,2:3,11:5 - 11:7 - 6:11 - 10:12 - 11:8,3,2,Asatryan Murad,Arutyunov Ruben,fiurst,Arutyunov Ruben - Asatryan Murad,92,43,49,6,-6,16,18,17,22,19,6,4,-5,-2,3,6,5:11 - 7:11 - 11:6 - 12:10 - 8:11
18105468,2024-04-15 11:45:00,Rafayelyan Edgar - Nikoghosyan Narek,1:3,6:11 - 11:4 - 11:9 - 11:6 - 0:0,3,1,Rafayelyan Edgar,Nikoghosyan Narek,fiurst,Nikoghosyan Narek - Rafayelyan Edgar,69,30,39,9,-9,17,15,20,17,0,-5,7,2,5,0,9,11:6 - 4:11 - 9:11 - 6:11 - 0:0
18105467,2024-04-15 11:35:00,Diaryan Aleksandr - Asatryan Murad,3:0,9:11 - 7:11 - 8:11 - 0:0 - 0:0,0,3,Diaryan Aleksandr,Asatryan Murad,fiurst,Asatryan Murad - Diaryan Aleksandr,57,33,24,-9,9,20,18,19,0,0,-2,-4,-3,0,0,-9,11:9 - 11:7 - 11:8 - 0:0 - 0:0
18105464,2024-04-15 11:25:00,Arutyunov Ruben - Rafayelyan Edgar,1:3,11:6 - 3:11 - 8:11 - 8:11 - 0:0,1,3,Arutyunov Ruben,Rafayelyan Edgar,fiurst,Arutyunov Ruben - Rafayelyan Edgar,69,30,39,9,-9,17,14,19,19,0,-5,8,3,3,0,9,11:6 - 3:11 - 8:11 - 8:11 - 0:0
18105456,2024-04-15 10:55:00,Nikoghosyan Narek - Asatryan Murad,3:1,11:9 - 10:12 - 7:11 - 4:11 - 0:0,1,3,Nikoghosyan Narek,Asatryan Murad,fiurst,Asatryan Murad - Nikoghosyan Narek,75,43,32,-11,11,20,22,18,15,0,2,-2,-4,-7,0,-11,9:11 - 12:10 - 11:7 - 11:4 - 0:0
18105444,2024-04-15 10:40:00,Diaryan Aleksandr - Arutyunov Ruben,2:3,9:11 - 12:10 - 11:1 - 6:11 - 13:11,3,2,Diaryan Aleksandr,Arutyunov Ruben,fiurst,Arutyunov Ruben - Diaryan Aleksandr,95,44,51,7,-7,20,22,12,17,24,-2,2,10,-5,2,7,11:9 - 10:12 - 1:11 - 11:6 - 11:13
18105439,2024-04-15 10:15:00,Asatryan Murad - Rafayelyan Edgar,3:2,11:13 - 9:11 - 11:5 - 11:6 - 11:5,3,2,Asatryan Murad,Rafayelyan Edgar,fiurst,Asatryan Murad - Rafayelyan Edgar,93,53,40,-13,13,24,20,16,17,16,2,2,-6,-5,-6,-13,11:13 - 9:11 - 11:5 - 11:6 - 11:5
18105436,2024-04-15 10:00:00,Nikoghosyan Narek - Diaryan Aleksandr,2:3,11:8 - 10:12 - 11:7 - 9:11 - 11:8,3,2,Nikoghosyan Narek,Diaryan Aleksandr,fiurst,Diaryan Aleksandr - Nikoghosyan Narek,98,46,52,6,-6,19,22,18,20,19,3,-2,4,-2,3,6,8:11 - 12:10 - 7:11 - 11:9 - 8:11
18079823,2024-04-14 17:45:00,Hakobyan Eduard - Avakimyan Davit,0:3,11:9 - 14:12 - 11:4 - 0:0 - 0:0,3,0,Hakobyan Eduard,Avakimyan Davit,fiurst,Avakimyan Davit - Hakobyan Eduard,61,25,36,11,-11,20,26,15,0,0,2,2,7,0,0,11,9:11 - 12:14 - 4:11 - 0:0 - 0:0
18079818,2024-04-14 17:30:00,Gevorgyan Hayk - Gevorgyan Gegham,0:3,11:8 - 11:7 - 11:8 - 0:0 - 0:0,3,0,Gevorgyan Hayk,Gevorgyan Gegham,fiurst,Gevorgyan Gegham - Gevorgyan Hayk,56,23,33,10,-10,19,18,19,0,0,3,4,3,0,0,10,8:11 - 7:11 - 8:11 - 0:0 - 0:0
18079811,2024-04-14 17:15:00,Soghomonyan Hrayr - Hakobyan Eduard,0:3,11:3 - 13:11 - 11:4 - 0:0 - 0:0,3,0,Soghomonyan Hrayr,Hakobyan Eduard,fiurst,Hakobyan Eduard - Soghomonyan Hrayr,53,18,35,17,-17,14,24,15,0,0,8,2,7,0,0,17,3:11 - 11:13 - 4:11 - 0:0 - 0:0
18079802,2024-04-14 17:00:00,Gevorgyan Hayk - Avakimyan Davit,0:3,11:5 - 12:10 - 11:9 - 0:0 - 0:0,3,0,Gevorgyan Hayk,Avakimyan Davit,fiurst,Avakimyan Davit - Gevorgyan Hayk,58,24,34,10,-10,16,22,20,0,0,6,2,2,0,0,10,5:11 - 10:12 - 9:11 - 0:0 - 0:0
18079798,2024-04-14 16:45:00,Gevorgyan Gegham - Soghomonyan Hrayr,1:3,11:7 - 12:14 - 4:11 - 8:11 - 0:0,1,3,Gevorgyan Gegham,Soghomonyan Hrayr,fiurst,Gevorgyan Gegham - Soghomonyan Hrayr,78,35,43,8,-8,18,26,15,19,0,-4,2,7,3,0,8,11:7 - 12:14 - 4:11 - 8:11 - 0:0
18079795,2024-04-14 16:30:00,Hakobyan Eduard - Gevorgyan Hayk,3:1,11:8 - 5:11 - 5:11 - 5:11 - 0:0,1,3,Hakobyan Eduard,Gevorgyan Hayk,fiurst,Gevorgyan Hayk - Hakobyan Eduard,67,41,26,-15,15,19,16,16,16,0,3,-6,-6,-6,0,-15,8:11 - 11:5 - 11:5 - 11:5 - 0:0
18079790,2024-04-14 16:15:00,Avakimyan Davit - Soghomonyan Hrayr,2:3,7:11 - 11:5 - 12:10 - 5:11 - 4:11,2,3,Avakimyan Davit,Soghomonyan Hrayr,fiurst,Avakimyan Davit - Soghomonyan Hrayr,87,39,48,9,-9,18,16,22,16,15,4,-6,-2,6,7,9,7:11 - 11:5 - 12:10 - 5:11 - 4:11
18079789,2024-04-14 16:00:00,Gevorgyan Gegham - Hakobyan Eduard,2:3,10:12 - 11:3 - 10:12 - 11:4 - 8:11,2,3,Gevorgyan Gegham,Hakobyan Eduard,fiurst,Gevorgyan Gegham - Hakobyan Eduard,92,50,42,-8,8,22,14,22,15,19,2,-8,2,-7,3,-8,10:12 - 11:3 - 10:12 - 11:4 - 8:11
18079777,2024-04-14 15:45:00,Soghomonyan Hrayr - Gevorgyan Hayk,1:3,9:11 - 13:11 - 11:8 - 11:8 - 0:0,3,1,Soghomonyan Hrayr,Gevorgyan Hayk,fiurst,Gevorgyan Hayk - Soghomonyan Hrayr,82,38,44,6,-6,20,24,19,19,0,-2,2,3,3,0,6,11:9 - 11:13 - 8:11 - 8:11 - 0:0
18079776,2024-04-14 15:30:00,Avakimyan Davit - Gevorgyan Gegham,3:1,11:7 - 11:9 - 10:12 - 11:4 - 0:0,3,1,Avakimyan Davit,Gevorgyan Gegham,fiurst,Avakimyan Davit - Gevorgyan Gegham,75,43,32,-11,11,18,20,22,15,0,-4,-2,2,-7,0,-11,11:7 - 11:9 - 10:12 - 11:4 - 0:0
18079773,2024-04-14 15:00:00,Asatryan Murad - Rafayelyan Edgar,0:3,8:11 - 3:11 - 5:11 - 0:0 - 0:0,0,3,Asatryan Murad,Rafayelyan Edgar,fiurst,Asatryan Murad - Rafayelyan Edgar,49,16,33,17,-17,19,14,16,0,0,3,8,6,0,0,17,8:11 - 3:11 - 5:11 - 0:0 - 0:0
18079772,2024-04-14 14:45:00,Nazaryan Mushegh - Nikoghosyan Narek,3:0,11:8 - 12:10 - 11:7 - 0:0 - 0:0,3,0,Nazaryan Mushegh,Nikoghosyan Narek,fiurst,Nazaryan Mushegh - Nikoghosyan Narek,59,34,25,-9,9,19,22,18,0,0,-3,-2,-4,0,0,-9,11:8 - 12:10 - 11:7 - 0:0 - 0:0
18079766,2024-04-14 14:15:00,Nazaryan Mushegh - Rafayelyan Edgar,1:3,11:7 - 3:11 - 9:11 - 11:13 - 0:0,1,3,Nazaryan Mushegh,Rafayelyan Edgar,fiurst,Nazaryan Mushegh - Rafayelyan Edgar,76,34,42,8,-8,18,14,20,24,0,-4,8,2,2,0,8,11:7 - 3:11 - 9:11 - 11:13 - 0:0
18079763,2024-04-14 14:00:00,Nikoghosyan Narek - Asatryan Murad,3:0,9:11 - 10:12 - 6:11 - 0:0 - 0:0,0,3,Nikoghosyan Narek,Asatryan Murad,fiurst,Asatryan Murad - Nikoghosyan Narek,59,34,25,-9,9,20,22,17,0,0,-2,-2,-5,0,0,-9,11:9 - 12:10 - 11:6 - 0:0 - 0:0
18079751,2024-04-14 13:30:00,Rafayelyan Edgar - Nikoghosyan Narek,1:3,20:18 - 5:11 - 11:7 - 11:2 - 0:0,3,1,Rafayelyan Edgar,Nikoghosyan Narek,fiurst,Nikoghosyan Narek - Rafayelyan Edgar,85,38,47,9,-9,38,16,18,13,0,2,-6,4,9,0,9,18:20 - 11:5 - 7:11 - 2:11 - 0:0
18079750,2024-04-14 13:15:00,Asatryan Murad - Nazaryan Mushegh,3:0,11:8 - 11:4 - 11:5 - 0:0 - 0:0,3,0,Asatryan Murad,Nazaryan Mushegh,fiurst,Asatryan Murad - Nazaryan Mushegh,50,33,17,-16,16,19,15,16,0,0,-3,-7,-6,0,0,-16,11:8 - 11:4 - 11:5 - 0:0 - 0:0
18079742,2024-04-14 12:15:00,Nikoghosyan Narek - Nazaryan Mushegh,0:3,11:9 - 11:6 - 11:8 - 0:0 - 0:0,3,0,Nikoghosyan Narek,Nazaryan Mushegh,fiurst,Nazaryan Mushegh - Nikoghosyan Narek,56,23,33,10,-10,20,17,19,0,0,2,5,3,0,0,10,9:11 - 6:11 - 8:11 - 0:0 - 0:0
18079730,2024-04-14 12:00:00,Rafayelyan Edgar - Asatryan Murad,3:1,11:13 - 11:9 - 9:11 - 7:11 - 0:0,1,3,Rafayelyan Edgar,Asatryan Murad,fiurst,Asatryan Murad - Rafayelyan Edgar,82,44,38,-6,6,24,20,20,18,0,-2,2,-2,-4,0,-6,13:11 - 9:11 - 11:9 - 11:7 - 0:0
18079724,2024-04-14 11:30:00,Rafayelyan Edgar - Nazaryan Mushegh,0:3,11:6 - 11:6 - 11:8 - 0:0 - 0:0,3,0,Rafayelyan Edgar,Nazaryan Mushegh,fiurst,Nazaryan Mushegh - Rafayelyan Edgar,53,20,33,13,-13,17,17,19,0,0,5,5,3,0,0,13,6:11 - 6:11 - 8:11 - 0:0 - 0:0
18079707,2024-04-14 11:10:00,Nikoghosyan Narek - Rafayelyan Edgar,1:3,11:7 - 2:11 - 10:12 - 4:11 - 0:0,1,3,Nikoghosyan Narek,Rafayelyan Edgar,fiurst,Nikoghosyan Narek - Rafayelyan Edgar,68,27,41,14,-14,18,13,22,15,0,-4,9,2,7,0,14,11:7 - 2:11 - 10:12 - 4:11 - 0:0
18079691,2024-04-14 10:30:00,Asatryan Murad - Nikoghosyan Narek,3:2,11:4 - 11:8 - 9:11 - 6:11 - 19:17,3,2,Asatryan Murad,Nikoghosyan Narek,fiurst,Asatryan Murad - Nikoghosyan Narek,107,56,51,-5,5,15,19,20,17,36,-7,-3,2,5,-2,-5,11:4 - 11:8 - 9:11 - 6:11 - 19:17
18079687,2024-04-14 10:00:00,Nazaryan Mushegh - Asatryan Murad,3:0,7:11 - 3:11 - 8:11 - 0:0 - 0:0,0,3,Nazaryan Mushegh,Asatryan Murad,fiurst,Asatryan Murad - Nazaryan Mushegh,51,33,18,-15,15,18,14,19,0,0,-4,-8,-3,0,0,-15,11:7 - 11:3 - 11:8 - 0:0 - 0:0
18062422,2024-04-13 17:45:00,Gevorgyan Hayk - Hakobyan Eduard,2:3,7:11 - 8:11 - 11:9 - 11:7 - 3:11,2,3,Gevorgyan Hayk,Hakobyan Eduard,fiurst,Gevorgyan Hayk - Hakobyan Eduard,89,40,49,9,-9,18,19,20,18,14,4,3,-2,-4,8,9,7:11 - 8:11 - 11:9 - 11:7 - 3:11
18062410,2024-04-13 17:30:00,Avakimyan Davit - Gevorgyan Gegham,3:1,11:9 - 4:11 - 11:5 - 11:8 - 0:0,3,1,Avakimyan Davit,Gevorgyan Gegham,fiurst,Avakimyan Davit - Gevorgyan Gegham,70,37,33,-4,4,20,15,16,19,0,-2,7,-6,-3,0,-4,11:9 - 4:11 - 11:5 - 11:8 - 0:0
18062409,2024-04-13 17:15:00,Soghomonyan Hrayr - Gevorgyan Hayk,3:0,10:12 - 6:11 - 1:11 - 0:0 - 0:0,0,3,Soghomonyan Hrayr,Gevorgyan Hayk,fiurst,Gevorgyan Hayk - Soghomonyan Hrayr,51,34,17,-17,17,22,17,12,0,0,-2,-5,-10,0,0,-17,12:10 - 11:6 - 11:1 - 0:0 - 0:0
18062406,2024-04-13 17:00:00,Avakimyan Davit - Hakobyan Eduard,3:1,11:8 - 9:11 - 15:13 - 12:10 - 0:0,3,1,Avakimyan Davit,Hakobyan Eduard,fiurst,Avakimyan Davit - Hakobyan Eduard,89,47,42,-5,5,19,20,28,22,0,-3,2,-2,-2,0,-5,11:8 - 9:11 - 15:13 - 12:10 - 0:0
18062404,2024-04-13 16:45:00,Gevorgyan Gegham - Soghomonyan Hrayr,0:3,6:11 - 7:11 - 5:11 - 0:0 - 0:0,0,3,Gevorgyan Gegham,Soghomonyan Hrayr,fiurst,Gevorgyan Gegham - Soghomonyan Hrayr,51,18,33,15,-15,17,18,16,0,0,5,4,6,0,0,15,6:11 - 7:11 - 5:11 - 0:0 - 0:0
18062399,2024-04-13 16:30:00,Gevorgyan Hayk - Avakimyan Davit,1:3,11:3 - 11:7 - 14:16 - 13:11 - 0:0,3,1,Gevorgyan Hayk,Avakimyan Davit,fiurst,Avakimyan Davit - Gevorgyan Hayk,86,37,49,12,-12,14,18,30,24,0,8,4,-2,2,0,12,3:11 - 7:11 - 16:14 - 11:13 - 0:0
18062396,2024-04-13 16:15:00,Hakobyan Eduard - Soghomonyan Hrayr,0:3,10:12 - 8:11 - 4:11 - 0:0 - 0:0,0,3,Hakobyan Eduard,Soghomonyan Hrayr,fiurst,Hakobyan Eduard - Soghomonyan Hrayr,56,22,34,12,-12,22,19,15,0,0,2,3,7,0,0,12,10:12 - 8:11 - 4:11 - 0:0 - 0:0
18062383,2024-04-13 16:00:00,Gevorgyan Gegham - Gevorgyan Hayk,0:3,6:11 - 5:11 - 8:11 - 0:0 - 0:0,0,3,Gevorgyan Gegham,Gevorgyan Hayk,fiurst,Gevorgyan Gegham - Gevorgyan Hayk,52,19,33,14,-14,17,16,19,0,0,5,6,3,0,0,14,6:11 - 5:11 - 8:11 - 0:0 - 0:0
18062381,2024-04-13 15:45:00,Soghomonyan Hrayr - Avakimyan Davit,2:3,11:8 - 9:11 - 11:7 - 9:11 - 11:1,3,2,Soghomonyan Hrayr,Avakimyan Davit,fiurst,Avakimyan Davit - Soghomonyan Hrayr,89,38,51,13,-13,19,20,18,20,12,3,-2,4,-2,10,13,8:11 - 11:9 - 7:11 - 11:9 - 1:11
18062376,2024-04-13 15:30:00,Hakobyan Eduard - Gevorgyan Gegham,1:3,11:8 - 11:9 - 9:11 - 11:1 - 0:0,3,1,Hakobyan Eduard,Gevorgyan Gegham,fiurst,Gevorgyan Gegham - Hakobyan Eduard,71,29,42,13,-13,19,20,20,12,0,3,2,-2,10,0,13,8:11 - 9:11 - 11:9 - 1:11 - 0:0
18062374,2024-04-13 15:25:00,Diaryan Aleksandr - Rafayelyan Edgar,2:3,6:11 - 11:5 - 12:10 - 14:16 - 5:11,2,3,Diaryan Aleksandr,Rafayelyan Edgar,fiurst,Diaryan Aleksandr - Rafayelyan Edgar,101,48,53,5,-5,17,16,22,30,16,5,-6,-2,2,6,5,6:11 - 11:5 - 12:10 - 14:16 - 5:11
18062371,2024-04-13 15:00:00,Arutyunov Ruben - Nazaryan Mushegh,0:3,9:11 - 9:11 - 5:11 - 0:0 - 0:0,0,3,Arutyunov Ruben,Nazaryan Mushegh,fiurst,Arutyunov Ruben - Nazaryan Mushegh,56,23,33,10,-10,20,20,16,0,0,2,2,6,0,0,10,9:11 - 9:11 - 5:11 - 0:0 - 0:0
18062369,2024-04-13 14:50:00,Hovhannesyan Rafik - Diaryan Aleksandr,3:2,5:11 - 11:8 - 8:11 - 11:9 - 4:11,2,3,Hovhannesyan Rafik,Diaryan Aleksandr,fiurst,Diaryan Aleksandr - Hovhannesyan Rafik,89,50,39,-11,11,16,19,19,20,15,-6,3,-3,2,-7,-11,11:5 - 8:11 - 11:8 - 9:11 - 11:4
18062359,2024-04-13 14:30:00,Hovhannesyan Rafik - Nazaryan Mushegh,3:1,11:4 - 13:15 - 11:8 - 11:5 - 0:0,3,1,Hovhannesyan Rafik,Nazaryan Mushegh,fiurst,Hovhannesyan Rafik - Nazaryan Mushegh,78,46,32,-14,14,15,28,19,16,0,-7,2,-3,-6,0,-14,11:4 - 13:15 - 11:8 - 11:5 - 0:0
18062364,2024-04-13 14:30:00,Rafayelyan Edgar - Arutyunov Ruben,0:3,11:4 - 11:6 - 11:8 - 0:0 - 0:0,3,0,Rafayelyan Edgar,Arutyunov Ruben,fiurst,Arutyunov Ruben - Rafayelyan Edgar,51,18,33,15,-15,15,17,19,0,0,7,5,3,0,0,15,4:11 - 6:11 - 8:11 - 0:0 - 0:0
18062329,2024-04-13 14:00:00,Diaryan Aleksandr - Arutyunov Ruben,1:3,11:7 - 6:11 - 11:4 - 11:7 - 0:0,3,1,Diaryan Aleksandr,Arutyunov Ruben,fiurst,Arutyunov Ruben - Diaryan Aleksandr,68,29,39,10,-10,18,17,15,18,0,4,-5,7,4,0,10,7:11 - 11:6 - 4:11 - 7:11 - 0:0
18062324,2024-04-13 13:45:00,Rafayelyan Edgar - Hovhannesyan Rafik,2:3,9:11 - 8:11 - 11:8 - 11:7 - 11:7,3,2,Rafayelyan Edgar,Hovhannesyan Rafik,fiurst,Hovhannesyan Rafik - Rafayelyan Edgar,94,44,50,6,-6,20,19,19,18,18,-2,-3,3,4,4,6,11:9 - 11:8 - 8:11 - 7:11 - 7:11
18062319,2024-04-13 13:30:00,Nazaryan Mushegh - Diaryan Aleksandr,3:0,5:11 - 8:11 - 7:11 - 0:0 - 0:0,0,3,Nazaryan Mushegh,Diaryan Aleksandr,fiurst,Diaryan Aleksandr - Nazaryan Mushegh,53,33,20,-13,13,16,19,18,0,0,-6,-3,-4,0,0,-13,11:5 - 11:8 - 11:7 - 0:0 - 0:0
18062313,2024-04-13 13:15:00,Arutyunov Ruben - Hovhannesyan Rafik,3:0,11:8 - 11:5 - 11:9 - 0:0 - 0:0,3,0,Arutyunov Ruben,Hovhannesyan Rafik,fiurst,Arutyunov Ruben - Hovhannesyan Rafik,55,33,22,-11,11,19,16,20,0,0,-3,-6,-2,0,0,-11,11:8 - 11:5 - 11:9 - 0:0 - 0:0
18062310,2024-04-13 13:00:00,Nazaryan Mushegh - Rafayelyan Edgar,1:3,11:6 - 7:11 - 6:11 - 5:11 - 0:0,1,3,Nazaryan Mushegh,Rafayelyan Edgar,fiurst,Nazaryan Mushegh - Rafayelyan Edgar,68,29,39,10,-10,17,18,17,16,0,-5,4,5,6,0,10,11:6 - 7:11 - 6:11 - 5:11 - 0:0
18062295,2024-04-13 12:25:00,Diaryan Aleksandr - Hovhannesyan Rafik,3:0,11:8 - 11:9 - 11:6 - 0:0 - 0:0,3,0,Diaryan Aleksandr,Hovhannesyan Rafik,fiurst,Diaryan Aleksandr - Hovhannesyan Rafik,56,33,23,-10,10,19,20,17,0,0,-3,-2,-5,0,0,-10,11:8 - 11:9 - 11:6 - 0:0 - 0:0
18062281,2024-04-13 12:00:00,Nazaryan Mushegh - Arutyunov Ruben,1:3,11:8 - 11:7 - 6:11 - 11:8 - 0:0,3,1,Nazaryan Mushegh,Arutyunov Ruben,fiurst,Arutyunov Ruben - Nazaryan Mushegh,73,34,39,5,-5,19,18,17,19,0,3,4,-5,3,0,5,8:11 - 7:11 - 11:6 - 8:11 - 0:0
18062280,2024-04-13 11:45:00,Rafayelyan Edgar - Diaryan Aleksandr,3:2,9:11 - 11:6 - 8:11 - 11:3 - 9:11,2,3,Rafayelyan Edgar,Diaryan Aleksandr,fiurst,Diaryan Aleksandr - Rafayelyan Edgar,90,42,48,6,-6,20,17,19,14,20,-2,5,-3,8,-2,6,11:9 - 6:11 - 11:8 - 3:11 - 11:9
18062278,2024-04-13 11:30:00,Nazaryan Mushegh - Hovhannesyan Rafik,0:3,11:5 - 11:8 - 11:7 - 0:0 - 0:0,3,0,Nazaryan Mushegh,Hovhannesyan Rafik,fiurst,Hovhannesyan Rafik - Nazaryan Mushegh,53,20,33,13,-13,16,19,18,0,0,6,3,4,0,0,13,5:11 - 8:11 - 7:11 - 0:0 - 0:0
18062249,2024-04-13 11:15:00,Arutyunov Ruben - Rafayelyan Edgar,0:3,8:11 - 8:11 - 7:11 - 0:0 - 0:0,0,3,Arutyunov Ruben,Rafayelyan Edgar,fiurst,Arutyunov Ruben - Rafayelyan Edgar,56,23,33,10,-10,19,19,18,0,0,3,3,4,0,0,10,8:11 - 8:11 - 7:11 - 0:0 - 0:0
18062213,2024-04-13 11:00:00,Diaryan Aleksandr - Nazaryan Mushegh,3:0,11:7 - 11:5 - 11:8 - 0:0 - 0:0,3,0,Diaryan Aleksandr,Nazaryan Mushegh,fiurst,Diaryan Aleksandr - Nazaryan Mushegh,53,33,20,-13,13,18,16,19,0,0,-4,-6,-3,0,0,-13,11:7 - 11:5 - 11:8 - 0:0 - 0:0
18062211,2024-04-13 10:45:00,Hovhannesyan Rafik - Rafayelyan Edgar,0:3,1:11 - 7:11 - 8:11 - 0:0 - 0:0,0,3,Hovhannesyan Rafik,Rafayelyan Edgar,fiurst,Hovhannesyan Rafik - Rafayelyan Edgar,49,16,33,17,-17,12,18,19,0,0,10,4,3,0,0,17,1:11 - 7:11 - 8:11 - 0:0 - 0:0
18062209,2024-04-13 10:30:00,Arutyunov Ruben - Diaryan Aleksandr,0:3,1:11 - 3:11 - 11:13 - 0:0 - 0:0,0,3,Arutyunov Ruben,Diaryan Aleksandr,fiurst,Arutyunov Ruben - Diaryan Aleksandr,50,15,35,20,-20,12,14,24,0,0,10,8,2,0,0,20,1:11 - 3:11 - 11:13 - 0:0 - 0:0
18062198,2024-04-13 10:15:00,Rafayelyan Edgar - Nazaryan Mushegh,0:3,11:9 - 11:6 - 11:9 - 0:0 - 0:0,3,0,Rafayelyan Edgar,Nazaryan Mushegh,fiurst,Nazaryan Mushegh - Rafayelyan Edgar,57,24,33,9,-9,20,17,20,0,0,2,5,2,0,0,9,9:11 - 6:11 - 9:11 - 0:0 - 0:0
18062197,2024-04-13 10:00:00,Hovhannesyan Rafik - Arutyunov Ruben,3:0,11:13 - 3:11 - 4:11 - 0:0 - 0:0,0,3,Hovhannesyan Rafik,Arutyunov Ruben,fiurst,Arutyunov Ruben - Hovhannesyan Rafik,53,35,18,-17,17,24,14,15,0,0,-2,-8,-7,0,0,-17,13:11 - 11:3 - 11:4 - 0:0 - 0:0
18045752,2024-04-12 17:45:00,Soghomonyan Hrayr - Gevorgyan Gegham,1:3,3:11 - 11:5 - 12:10 - 15:13 - 0:0,3,1,Soghomonyan Hrayr,Gevorgyan Gegham,fiurst,Gevorgyan Gegham - Soghomonyan Hrayr,80,39,41,2,-2,14,16,22,28,0,-8,6,2,2,0,2,11:3 - 5:11 - 10:12 - 13:15 - 0:0
18045739,2024-04-12 17:30:00,Hakobyan Eduard - Mkrtchyan Andranik,3:0,11:7 - 12:10 - 11:9 - 0:0 - 0:0,3,0,Hakobyan Eduard,Mkrtchyan Andranik,fiurst,Hakobyan Eduard - Mkrtchyan Andranik,60,34,26,-8,8,18,22,20,0,0,-4,-2,-2,0,0,-8,11:7 - 12:10 - 11:9 - 0:0 - 0:0
18045735,2024-04-12 17:15:00,Avakimyan Davit - Soghomonyan Hrayr,3:1,11:7 - 15:13 - 11:13 - 11:8 - 0:0,3,1,Avakimyan Davit,Soghomonyan Hrayr,fiurst,Avakimyan Davit - Soghomonyan Hrayr,89,48,41,-7,7,18,28,24,19,0,-4,-2,2,-3,0,-7,11:7 - 15:13 - 11:13 - 11:8 - 0:0
18045723,2024-04-12 17:00:00,Hakobyan Eduard - Gevorgyan Gegham,0:3,11:8 - 14:12 - 11:5 - 0:0 - 0:0,3,0,Hakobyan Eduard,Gevorgyan Gegham,fiurst,Gevorgyan Gegham - Hakobyan Eduard,61,25,36,11,-11,19,26,16,0,0,3,2,6,0,0,11,8:11 - 12:14 - 5:11 - 0:0 - 0:0
18045722,2024-04-12 16:45:00,Mkrtchyan Andranik - Avakimyan Davit,3:0,2:11 - 8:11 - 9:11 - 0:0 - 0:0,0,3,Mkrtchyan Andranik,Avakimyan Davit,fiurst,Avakimyan Davit - Mkrtchyan Andranik,52,33,19,-14,14,13,19,20,0,0,-9,-3,-2,0,0,-14,11:2 - 11:8 - 11:9 - 0:0 - 0:0
18045718,2024-04-12 16:35:00,Soghomonyan Hrayr - Hakobyan Eduard,0:3,11:3 - 11:5 - 11:8 - 0:0 - 0:0,3,0,Soghomonyan Hrayr,Hakobyan Eduard,fiurst,Hakobyan Eduard - Soghomonyan Hrayr,49,16,33,17,-17,14,16,19,0,0,8,6,3,0,0,17,3:11 - 5:11 - 8:11 - 0:0 - 0:0
18045714,2024-04-12 16:15:00,Gevorgyan Gegham - Avakimyan Davit,3:1,11:8 - 8:11 - 3:11 - 4:11 - 0:0,1,3,Gevorgyan Gegham,Avakimyan Davit,fiurst,Avakimyan Davit - Gevorgyan Gegham,67,41,26,-15,15,19,19,14,15,0,3,-3,-8,-7,0,-15,8:11 - 11:8 - 11:3 - 11:4 - 0:0
18045713,2024-04-12 16:00:00,Mkrtchyan Andranik - Soghomonyan Hrayr,0:3,9:11 - 7:11 - 9:11 - 0:0 - 0:0,0,3,Mkrtchyan Andranik,Soghomonyan Hrayr,fiurst,Mkrtchyan Andranik - Soghomonyan Hrayr,58,25,33,8,-8,20,18,20,0,0,2,4,2,0,0,8,9:11 - 7:11 - 9:11 - 0:0 - 0:0
18045708,2024-04-12 15:50:00,Avakimyan Davit - Hakobyan Eduard,1:3,11:8 - 10:12 - 4:11 - 8:11 - 0:0,1,3,Avakimyan Davit,Hakobyan Eduard,fiurst,Avakimyan Davit - Hakobyan Eduard,75,33,42,9,-9,19,22,15,19,0,-3,2,7,3,0,9,11:8 - 10:12 - 4:11 - 8:11 - 0:0
18045704,2024-04-12 15:30:00,Arutyunov Ruben - Hovhannesyan Rafik,3:2,7:11 - 9:11 - 11:3 - 11:8 - 11:7,3,2,Arutyunov Ruben,Hovhannesyan Rafik,fiurst,Arutyunov Ruben - Hovhannesyan Rafik,89,49,40,-9,9,18,20,14,19,18,4,2,-8,-3,-4,-9,7:11 - 9:11 - 11:3 - 11:8 - 11:7
18045705,2024-04-12 15:30:00,Gevorgyan Gegham - Mkrtchyan Andranik,1:3,5:11 - 2:11 - 11:6 - 6:11 - 0:0,1,3,Gevorgyan Gegham,Mkrtchyan Andranik,fiurst,Gevorgyan Gegham - Mkrtchyan Andranik,63,24,39,15,-15,16,13,17,17,0,6,9,-5,5,0,15,5:11 - 2:11 - 11:6 - 6:11 - 0:0
18045701,2024-04-12 15:05:00,Nikoghosyan Narek - Asatryan Murad,3:0,5:11 - 9:11 - 5:11 - 0:0 - 0:0,0,3,Nikoghosyan Narek,Asatryan Murad,fiurst,Asatryan Murad - Nikoghosyan Narek,52,33,19,-14,14,16,20,16,0,0,-6,-2,-6,0,0,-14,11:5 - 11:9 - 11:5 - 0:0 - 0:0
18045690,2024-04-12 15:05:00,Rafayelyan Edgar - Arutyunov Ruben,0:3,11:5 - 11:7 - 12:10 - 0:0 - 0:0,3,0,Rafayelyan Edgar,Arutyunov Ruben,fiurst,Arutyunov Ruben - Rafayelyan Edgar,56,22,34,12,-12,16,18,22,0,0,6,4,2,0,0,12,5:11 - 7:11 - 10:12 - 0:0 - 0:0
18045688,2024-04-12 14:35:00,Hovhannesyan Rafik - Nikoghosyan Narek,2:3,9:11 - 12:10 - 11:9 - 7:11 - 7:11,2,3,Hovhannesyan Rafik,Nikoghosyan Narek,fiurst,Hovhannesyan Rafik - Nikoghosyan Narek,98,46,52,6,-6,20,22,20,18,18,2,-2,-2,4,4,6,9:11 - 12:10 - 11:9 - 7:11 - 7:11
18045686,2024-04-12 14:20:00,Rafayelyan Edgar - Asatryan Murad,2:3,11:8 - 5:11 - 5:11 - 14:12 - 11:9,3,2,Rafayelyan Edgar,Asatryan Murad,fiurst,Asatryan Murad - Rafayelyan Edgar,97,51,46,-5,5,19,16,16,26,20,3,-6,-6,2,2,-5,8:11 - 11:5 - 11:5 - 12:14 - 9:11
18045685,2024-04-12 14:10:00,Arutyunov Ruben - Nikoghosyan Narek,1:3,8:11 - 11:6 - 7:11 - 10:12 - 0:0,1,3,Arutyunov Ruben,Nikoghosyan Narek,fiurst,Arutyunov Ruben - Nikoghosyan Narek,76,36,40,4,-4,19,17,18,22,0,3,-5,4,2,0,4,8:11 - 11:6 - 7:11 - 10:12 - 0:0
18045677,2024-04-12 13:45:00,Hovhannesyan Rafik - Rafayelyan Edgar,0:3,10:12 - 9:11 - 12:14 - 0:0 - 0:0,0,3,Hovhannesyan Rafik,Rafayelyan Edgar,fiurst,Hovhannesyan Rafik - Rafayelyan Edgar,68,31,37,6,-6,22,20,26,0,0,2,2,2,0,0,6,10:12 - 9:11 - 12:14 - 0:0 - 0:0
18045664,2024-04-12 13:30:00,Asatryan Murad - Arutyunov Ruben,2:3,5:11 - 14:12 - 11:6 - 9:11 - 11:6,3,2,Asatryan Murad,Arutyunov Ruben,fiurst,Arutyunov Ruben - Asatryan Murad,96,46,50,4,-4,16,26,17,20,17,-6,2,5,-2,5,4,11:5 - 12:14 - 6:11 - 11:9 - 6:11
18045663,2024-04-12 13:15:00,Nikoghosyan Narek - Rafayelyan Edgar,1:3,11:13 - 11:5 - 8:11 - 7:11 - 0:0,1,3,Nikoghosyan Narek,Rafayelyan Edgar,fiurst,Nikoghosyan Narek - Rafayelyan Edgar,77,37,40,3,-3,24,16,19,18,0,2,-6,3,4,0,3,11:13 - 11:5 - 8:11 - 7:11 - 0:0
18045658,2024-04-12 13:00:00,Asatryan Murad - Hovhannesyan Rafik,3:0,11:7 - 11:7 - 11:7 - 0:0 - 0:0,3,0,Asatryan Murad,Hovhannesyan Rafik,fiurst,Asatryan Murad - Hovhannesyan Rafik,54,33,21,-12,12,18,18,18,0,0,-4,-4,-4,0,0,-12,11:7 - 11:7 - 11:7 - 0:0 - 0:0
18045657,2024-04-12 12:20:00,Arutyunov Ruben - Rafayelyan Edgar,1:3,13:11 - 9:11 - 9:11 - 8:11 - 0:0,1,3,Arutyunov Ruben,Rafayelyan Edgar,fiurst,Arutyunov Ruben - Rafayelyan Edgar,83,39,44,5,-5,24,20,20,19,0,-2,2,2,3,0,5,13:11 - 9:11 - 9:11 - 8:11 - 0:0
18045656,2024-04-12 12:00:00,Asatryan Murad - Nikoghosyan Narek,3:0,11:4 - 11:8 - 11:5 - 0:0 - 0:0,3,0,Asatryan Murad,Nikoghosyan Narek,fiurst,Asatryan Murad - Nikoghosyan Narek,50,33,17,-16,16,15,19,16,0,0,-7,-3,-6,0,0,-16,11:4 - 11:8 - 11:5 - 0:0 - 0:0
18045653,2024-04-12 11:55:00,Hovhannesyan Rafik - Arutyunov Ruben,3:0,5:11 - 7:11 - 4:11 - 0:0 - 0:0,0,3,Hovhannesyan Rafik,Arutyunov Ruben,fiurst,Arutyunov Ruben - Hovhannesyan Rafik,49,33,16,-17,17,16,18,15,0,0,-6,-4,-7,0,0,-17,11:5 - 11:7 - 11:4 - 0:0 - 0:0
18045632,2024-04-12 11:30:00,Asatryan Murad - Rafayelyan Edgar,3:0,11:7 - 11:7 - 11:7 - 0:0 - 0:0,3,0,Asatryan Murad,Rafayelyan Edgar,fiurst,Asatryan Murad - Rafayelyan Edgar,54,33,21,-12,12,18,18,18,0,0,-4,-4,-4,0,0,-12,11:7 - 11:7 - 11:7 - 0:0 - 0:0
18045625,2024-04-12 11:15:00,Nikoghosyan Narek - Hovhannesyan Rafik,3:1,11:7 - 7:11 - 7:11 - 7:11 - 0:0,1,3,Nikoghosyan Narek,Hovhannesyan Rafik,fiurst,Hovhannesyan Rafik - Nikoghosyan Narek,72,40,32,-8,8,18,18,18,18,0,4,-4,-4,-4,0,-8,7:11 - 11:7 - 11:7 - 11:7 - 0:0
18045624,2024-04-12 11:05:00,Arutyunov Ruben - Asatryan Murad,1:3,2:11 - 12:14 - 11:3 - 8:11 - 0:0,1,3,Arutyunov Ruben,Asatryan Murad,fiurst,Arutyunov Ruben - Asatryan Murad,72,33,39,6,-6,13,26,14,19,0,9,2,-8,3,0,6,2:11 - 12:14 - 11:3 - 8:11 - 0:0
18045621,2024-04-12 10:45:00,Rafayelyan Edgar - Hovhannesyan Rafik,0:3,11:6 - 11:4 - 11:9 - 0:0 - 0:0,3,0,Rafayelyan Edgar,Hovhannesyan Rafik,fiurst,Hovhannesyan Rafik - Rafayelyan Edgar,52,19,33,14,-14,17,15,20,0,0,5,7,2,0,0,14,6:11 - 4:11 - 9:11 - 0:0 - 0:0
18045620,2024-04-12 10:30:00,Nikoghosyan Narek - Arutyunov Ruben,1:3,4:11 - 11:7 - 11:4 - 11:4 - 0:0,3,1,Nikoghosyan Narek,Arutyunov Ruben,fiurst,Arutyunov Ruben - Nikoghosyan Narek,63,26,37,11,-11,15,18,15,15,0,-7,4,7,7,0,11,11:4 - 7:11 - 4:11 - 4:11 - 0:0
18045618,2024-04-12 10:15:00,Hovhannesyan Rafik - Asatryan Murad,3:1,11:7 - 5:11 - 8:11 - 8:11 - 0:0,1,3,Hovhannesyan Rafik,Asatryan Murad,fiurst,Asatryan Murad - Hovhannesyan Rafik,72,40,32,-8,8,18,16,19,19,0,4,-6,-3,-3,0,-8,7:11 - 11:5 - 11:8 - 11:8 - 0:0
18045616,2024-04-12 10:00:00,Rafayelyan Edgar - Nikoghosyan Narek,3:0,6:11 - 10:12 - 8:11 - 0:0 - 0:0,0,3,Rafayelyan Edgar,Nikoghosyan Narek,fiurst,Nikoghosyan Narek - Rafayelyan Edgar,58,34,24,-10,10,17,22,19,0,0,-5,-2,-3,0,0,-10,11:6 - 12:10 - 11:8 - 0:0 - 0:0
18022171,2024-04-11 17:45:00,Gevorgyan Gegham - Soghomonyan Hrayr,2:3,11:5 - 3:11 - 13:11 - 4:11 - 6:11,2,3,Gevorgyan Gegham,Soghomonyan Hrayr,fiurst,Gevorgyan Gegham - Soghomonyan Hrayr,86,37,49,12,-12,16,14,24,15,17,-6,8,-2,7,5,12,11:5 - 3:11 - 13:11 - 4:11 - 6:11
18022160,2024-04-11 17:30:00,Avakimyan Davit - Gevorgyan Hayk,1:3,8:11 - 11:6 - 3:11 - 4:11 - 0:0,1,3,Avakimyan Davit,Gevorgyan Hayk,fiurst,Avakimyan Davit - Gevorgyan Hayk,65,26,39,13,-13,19,17,14,15,0,3,-5,8,7,0,13,8:11 - 11:6 - 3:11 - 4:11 - 0:0
18022158,2024-04-11 17:15:00,Hakobyan Eduard - Gevorgyan Gegham,3:2,11:5 - 5:11 - 11:5 - 10:12 - 9:11,2,3,Hakobyan Eduard,Gevorgyan Gegham,fiurst,Gevorgyan Gegham - Hakobyan Eduard,90,44,46,2,-2,16,16,16,22,20,6,-6,6,-2,-2,2,5:11 - 11:5 - 5:11 - 12:10 - 11:9
18022157,2024-04-11 17:00:00,Avakimyan Davit - Soghomonyan Hrayr,3:1,5:11 - 11:9 - 11:6 - 13:11 - 0:0,3,1,Avakimyan Davit,Soghomonyan Hrayr,fiurst,Avakimyan Davit - Soghomonyan Hrayr,77,40,37,-3,3,16,20,17,24,0,6,-2,-5,-2,0,-3,5:11 - 11:9 - 11:6 - 13:11 - 0:0
18022156,2024-04-11 16:45:00,Gevorgyan Hayk - Hakobyan Eduard,1:3,11:6 - 9:11 - 9:11 - 11:13 - 0:0,1,3,Gevorgyan Hayk,Hakobyan Eduard,fiurst,Gevorgyan Hayk - Hakobyan Eduard,81,40,41,1,-1,17,20,20,24,0,-5,2,2,2,0,1,11:6 - 9:11 - 9:11 - 11:13 - 0:0
18022154,2024-04-11 16:30:00,Gevorgyan Gegham - Avakimyan Davit,3:2,9:11 - 3:11 - 11:8 - 11:5 - 6:11,2,3,Gevorgyan Gegham,Avakimyan Davit,fiurst,Avakimyan Davit - Gevorgyan Gegham,86,46,40,-6,6,20,14,19,16,17,-2,-8,3,6,-5,-6,11:9 - 11:3 - 8:11 - 5:11 - 11:6
18022152,2024-04-11 16:15:00,Soghomonyan Hrayr - Hakobyan Eduard,0:3,11:3 - 11:7 - 11:5 - 0:0 - 0:0,3,0,Soghomonyan Hrayr,Hakobyan Eduard,fiurst,Hakobyan Eduard - Soghomonyan Hrayr,48,15,33,18,-18,14,18,16,0,0,8,4,6,0,0,18,3:11 - 7:11 - 5:11 - 0:0 - 0:0
18022151,2024-04-11 16:05:00,Mkrtchyan Andranik - Gevorgyan Gegham,0:3,11:8 - 11:7 - 12:10 - 0:0 - 0:0,3,0,Mkrtchyan Andranik,Gevorgyan Gegham,fiurst,Gevorgyan Gegham - Mkrtchyan Andranik,59,25,34,9,-9,19,18,22,0,0,3,4,2,0,0,9,8:11 - 7:11 - 10:12 - 0:0 - 0:0
18022150,2024-04-11 15:45:00,Hakobyan Eduard - Avakimyan Davit,0:3,11:7 - 11:4 - 11:6 - 0:0 - 0:0,3,0,Hakobyan Eduard,Avakimyan Davit,fiurst,Avakimyan Davit - Hakobyan Eduard,50,17,33,16,-16,18,15,17,0,0,4,7,5,0,0,16,7:11 - 4:11 - 6:11 - 0:0 - 0:0
18022149,2024-04-11 15:30:00,Soghomonyan Hrayr - Mkrtchyan Andranik,3:1,7:11 - 11:8 - 8:11 - 6:11 - 0:0,1,3,Soghomonyan Hrayr,Mkrtchyan Andranik,fiurst,Mkrtchyan Andranik - Soghomonyan Hrayr,73,41,32,-9,9,18,19,19,17,0,-4,3,-3,-5,0,-9,11:7 - 8:11 - 11:8 - 11:6 - 0:0
18022137,2024-04-11 15:15:00,Rafayelyan Edgar - Nikoghosyan Narek,0:3,11:8 - 12:10 - 11:9 - 0:0 - 0:0,3,0,Rafayelyan Edgar,Nikoghosyan Narek,fiurst,Nikoghosyan Narek - Rafayelyan Edgar,61,27,34,7,-7,19,22,20,0,0,3,2,2,0,0,7,8:11 - 10:12 - 9:11 - 0:0 - 0:0
18022136,2024-04-11 15:00:00,Nazaryan Mushegh - Diaryan Aleksandr,3:0,8:11 - 2:11 - 6:11 - 0:0 - 0:0,0,3,Nazaryan Mushegh,Diaryan Aleksandr,fiurst,Diaryan Aleksandr - Nazaryan Mushegh,49,33,16,-17,17,19,13,17,0,0,-3,-9,-5,0,0,-17,11:8 - 11:2 - 11:6 - 0:0 - 0:0
18022132,2024-04-11 14:45:00,Nikoghosyan Narek - Nazaryan Mushegh,0:3,11:7 - 11:8 - 11:9 - 0:0 - 0:0,3,0,Nikoghosyan Narek,Nazaryan Mushegh,fiurst,Nazaryan Mushegh - Nikoghosyan Narek,57,24,33,9,-9,18,19,20,0,0,4,3,2,0,0,9,7:11 - 8:11 - 9:11 - 0:0 - 0:0
18022134,2024-04-11 14:45:00,Asatryan Murad - Rafayelyan Edgar,3:0,11:4 - 11:8 - 11:9 - 0:0 - 0:0,3,0,Asatryan Murad,Rafayelyan Edgar,fiurst,Asatryan Murad - Rafayelyan Edgar,54,33,21,-12,12,15,19,20,0,0,-7,-3,-2,0,0,-12,11:4 - 11:8 - 11:9 - 0:0 - 0:0
18022129,2024-04-11 14:25:00,Asatryan Murad - Diaryan Aleksandr,3:1,11:9 - 3:11 - 11:6 - 11:6 - 0:0,3,1,Asatryan Murad,Diaryan Aleksandr,fiurst,Asatryan Murad - Diaryan Aleksandr,68,36,32,-4,4,20,14,17,17,0,-2,8,-5,-5,0,-4,11:9 - 3:11 - 11:6 - 11:6 - 0:0
18022128,2024-04-11 14:20:00,Rafayelyan Edgar - Nazaryan Mushegh,0:3,11:6 - 11:8 - 11:8 - 0:0 - 0:0,3,0,Rafayelyan Edgar,Nazaryan Mushegh,fiurst,Nazaryan Mushegh - Rafayelyan Edgar,55,22,33,11,-11,17,19,19,0,0,5,3,3,0,0,11,6:11 - 8:11 - 8:11 - 0:0 - 0:0
18022125,2024-04-11 13:45:00,Diaryan Aleksandr - Rafayelyan Edgar,2:3,6:11 - 11:7 - 11:7 - 7:11 - 6:11,2,3,Diaryan Aleksandr,Rafayelyan Edgar,fiurst,Diaryan Aleksandr - Rafayelyan Edgar,88,41,47,6,-6,17,18,18,18,17,5,-4,-4,4,5,6,6:11 - 11:7 - 11:7 - 7:11 - 6:11
18022127,2024-04-11 13:45:00,Nikoghosyan Narek - Asatryan Murad,3:0,4:11 - 6:11 - 4:11 - 0:0 - 0:0,0,3,Nikoghosyan Narek,Asatryan Murad,fiurst,Asatryan Murad - Nikoghosyan Narek,47,33,14,-19,19,15,17,15,0,0,-7,-5,-7,0,0,-19,11:4 - 11:6 - 11:4 - 0:0 - 0:0
18022122,2024-04-11 13:15:00,Nazaryan Mushegh - Asatryan Murad,3:0,7:11 - 5:11 - 10:12 - 0:0 - 0:0,0,3,Nazaryan Mushegh,Asatryan Murad,fiurst,Asatryan Murad - Nazaryan Mushegh,56,34,22,-12,12,18,16,22,0,0,-4,-6,-2,0,0,-12,11:7 - 11:5 - 12:10 - 0:0 - 0:0
18022111,2024-04-11 13:00:00,Diaryan Aleksandr - Nikoghosyan Narek,3:2,7:11 - 11:4 - 9:11 - 11:7 - 14:12,3,2,Diaryan Aleksandr,Nikoghosyan Narek,fiurst,Diaryan Aleksandr - Nikoghosyan Narek,97,52,45,-7,7,18,15,20,18,26,4,-7,2,-4,-2,-7,7:11 - 11:4 - 9:11 - 11:7 - 14:12
18022110,2024-04-11 12:15:00,Rafayelyan Edgar - Asatryan Murad,3:2,14:12 - 4:11 - 5:11 - 11:8 - 8:11,2,3,Rafayelyan Edgar,Asatryan Murad,fiurst,Asatryan Murad - Rafayelyan Edgar,95,53,42,-11,11,26,15,16,19,19,2,-7,-6,3,-3,-11,12:14 - 11:4 - 11:5 - 8:11 - 11:8
18022108,2024-04-11 12:10:00,Diaryan Aleksandr - Nazaryan Mushegh,3:0,11:5 - 11:8 - 11:8 - 0:0 - 0:0,3,0,Diaryan Aleksandr,Nazaryan Mushegh,fiurst,Diaryan Aleksandr - Nazaryan Mushegh,54,33,21,-12,12,16,19,19,0,0,-6,-3,-3,0,0,-12,11:5 - 11:8 - 11:8 - 0:0 - 0:0
18022106,2024-04-11 11:50:00,Nikoghosyan Narek - Rafayelyan Edgar,0:3,11:13 - 2:11 - 6:11 - 0:0 - 0:0,0,3,Nikoghosyan Narek,Rafayelyan Edgar,fiurst,Nikoghosyan Narek - Rafayelyan Edgar,54,19,35,16,-16,24,13,17,0,0,2,9,5,0,0,16,11:13 - 2:11 - 6:11 - 0:0 - 0:0
18022105,2024-04-11 11:30:00,Diaryan Aleksandr - Asatryan Murad,3:2,7:11 - 9:11 - 11:5 - 11:8 - 4:11,2,3,Diaryan Aleksandr,Asatryan Murad,fiurst,Asatryan Murad - Diaryan Aleksandr,88,46,42,-4,4,18,20,16,19,15,-4,-2,6,3,-7,-4,11:7 - 11:9 - 5:11 - 8:11 - 11:4
18022103,2024-04-11 11:20:00,Nazaryan Mushegh - Nikoghosyan Narek,0:3,11:13 - 7:11 - 7:11 - 0:0 - 0:0,0,3,Nazaryan Mushegh,Nikoghosyan Narek,fiurst,Nazaryan Mushegh - Nikoghosyan Narek,60,25,35,10,-10,24,18,18,0,0,2,4,4,0,0,10,11:13 - 7:11 - 7:11 - 0:0 - 0:0
18022102,2024-04-11 11:00:00,Rafayelyan Edgar - Diaryan Aleksandr,2:3,11:9 - 11:6 - 6:11 - 11:13 - 13:11,3,2,Rafayelyan Edgar,Diaryan Aleksandr,fiurst,Diaryan Aleksandr - Rafayelyan Edgar,102,50,52,2,-2,20,17,17,24,24,2,5,-5,-2,2,2,9:11 - 6:11 - 11:6 - 13:11 - 11:13
18022088,2024-04-11 10:50:00,Asatryan Murad - Nikoghosyan Narek,3:0,11:8 - 11:7 - 11:4 - 0:0 - 0:0,3,0,Asatryan Murad,Nikoghosyan Narek,fiurst,Asatryan Murad - Nikoghosyan Narek,52,33,19,-14,14,19,18,15,0,0,-3,-4,-7,0,0,-14,11:8 - 11:7 - 11:4 - 0:0 - 0:0
18022087,2024-04-11 10:30:00,Nazaryan Mushegh - Rafayelyan Edgar,0:3,6:11 - 8:11 - 5:11 - 0:0 - 0:0,0,3,Nazaryan Mushegh,Rafayelyan Edgar,fiurst,Nazaryan Mushegh - Rafayelyan Edgar,52,19,33,14,-14,17,19,16,0,0,5,3,6,0,0,14,6:11 - 8:11 - 5:11 - 0:0 - 0:0
18022085,2024-04-11 10:15:00,Nikoghosyan Narek - Diaryan Aleksandr,1:3,11:9 - 11:4 - 10:12 - 11:8 - 0:0,3,1,Nikoghosyan Narek,Diaryan Aleksandr,fiurst,Diaryan Aleksandr - Nikoghosyan Narek,76,33,43,10,-10,20,15,22,19,0,2,7,-2,3,0,10,9:11 - 4:11 - 12:10 - 8:11 - 0:0
18022080,2024-04-11 10:00:00,Asatryan Murad - Nazaryan Mushegh,3:0,11:6 - 11:7 - 11:1 - 0:0 - 0:0,3,0,Asatryan Murad,Nazaryan Mushegh,fiurst,Asatryan Murad - Nazaryan Mushegh,47,33,14,-19,19,17,18,12,0,0,-5,-4,-10,0,0,-19,11:6 - 11:7 - 11:1 - 0:0 - 0:0
18004882,2024-04-10 17:45:00,Mkrtchyan Andranik - Gevorgyan Gegham,0:3,11:9 - 11:6 - 11:8 - 0:0 - 0:0,3,0,Mkrtchyan Andranik,Gevorgyan Gegham,fiurst,Gevorgyan Gegham - Mkrtchyan Andranik,56,23,33,10,-10,20,17,19,0,0,2,5,3,0,0,10,9:11 - 6:11 - 8:11 - 0:0 - 0:0
18004867,2024-04-10 17:30:00,Petrosyan Davit - Soghomonyan Hrayr,3:0,11:8 - 14:12 - 11:5 - 0:0 - 0:0,3,0,Petrosyan Davit,Soghomonyan Hrayr,fiurst,Petrosyan Davit - Soghomonyan Hrayr,61,36,25,-11,11,19,26,16,0,0,-3,-2,-6,0,0,-11,11:8 - 14:12 - 11:5 - 0:0 - 0:0
18004865,2024-04-10 17:15:00,Avakimyan Davit - Mkrtchyan Andranik,3:2,7:11 - 11:7 - 9:11 - 11:4 - 11:8,3,2,Avakimyan Davit,Mkrtchyan Andranik,fiurst,Avakimyan Davit - Mkrtchyan Andranik,90,49,41,-8,8,18,18,20,15,19,4,-4,2,-7,-3,-8,7:11 - 11:7 - 9:11 - 11:4 - 11:8
18004838,2024-04-10 17:05:00,Petrosyan Davit - Gevorgyan Gegham,0:3,11:2 - 11:4 - 11:8 - 0:0 - 0:0,3,0,Petrosyan Davit,Gevorgyan Gegham,fiurst,Gevorgyan Gegham - Petrosyan Davit,47,14,33,19,-19,13,15,19,0,0,9,7,3,0,0,19,2:11 - 4:11 - 8:11 - 0:0 - 0:0
18004809,2024-04-10 16:45:00,Soghomonyan Hrayr - Avakimyan Davit,2:3,13:11 - 6:11 - 9:11 - 11:7 - 11:3,3,2,Soghomonyan Hrayr,Avakimyan Davit,fiurst,Avakimyan Davit - Soghomonyan Hrayr,93,43,50,7,-7,24,17,20,18,14,2,-5,-2,4,8,7,11:13 - 11:6 - 11:9 - 7:11 - 3:11
18004797,2024-04-10 16:35:00,Mkrtchyan Andranik - Petrosyan Davit,3:0,11:4 - 11:4 - 11:5 - 0:0 - 0:0,3,0,Mkrtchyan Andranik,Petrosyan Davit,fiurst,Mkrtchyan Andranik - Petrosyan Davit,46,33,13,-20,20,15,15,16,0,0,-7,-7,-6,0,0,-20,11:4 - 11:4 - 11:5 - 0:0 - 0:0
18004796,2024-04-10 16:15:00,Gevorgyan Gegham - Avakimyan Davit,3:1,13:11 - 8:11 - 7:11 - 10:12 - 0:0,1,3,Gevorgyan Gegham,Avakimyan Davit,fiurst,Avakimyan Davit - Gevorgyan Gegham,83,45,38,-7,7,24,19,18,22,0,2,-3,-4,-2,0,-7,11:13 - 11:8 - 11:7 - 12:10 - 0:0
18004794,2024-04-10 16:00:00,Soghomonyan Hrayr - Mkrtchyan Andranik,3:2,11:6 - 12:10 - 9:11 - 9:11 - 5:11,2,3,Soghomonyan Hrayr,Mkrtchyan Andranik,fiurst,Mkrtchyan Andranik - Soghomonyan Hrayr,95,49,46,-3,3,17,22,20,20,16,5,2,-2,-2,-6,-3,6:11 - 10:12 - 11:9 - 11:9 - 11:5
18004792,2024-04-10 15:50:00,Avakimyan Davit - Petrosyan Davit,3:1,11:6 - 8:11 - 11:7 - 11:7 - 0:0,3,1,Avakimyan Davit,Petrosyan Davit,fiurst,Avakimyan Davit - Petrosyan Davit,72,41,31,-10,10,17,19,18,18,0,-5,3,-4,-4,0,-10,11:6 - 8:11 - 11:7 - 11:7 - 0:0
18004788,2024-04-10 15:35:00,Nazaryan Mushegh - Papyan Karen,2:3,5:11 - 11:7 - 11:2 - 5:11 - 7:11,2,3,Nazaryan Mushegh,Papyan Karen,fiurst,Nazaryan Mushegh - Papyan Karen,81,39,42,3,-3,16,18,13,16,18,6,-4,-9,6,4,3,5:11 - 11:7 - 11:2 - 5:11 - 7:11
18004791,2024-04-10 15:30:00,Gevorgyan Gegham - Soghomonyan Hrayr,0:3,11:13 - 4:11 - 4:11 - 0:0 - 0:0,0,3,Gevorgyan Gegham,Soghomonyan Hrayr,fiurst,Gevorgyan Gegham - Soghomonyan Hrayr,54,19,35,16,-16,24,15,15,0,0,2,7,7,0,0,16,11:13 - 4:11 - 4:11 - 0:0 - 0:0
18004781,2024-04-10 15:10:00,Arutyunov Ruben - Nazaryan Mushegh,3:1,14:12 - 7:11 - 11:7 - 11:6 - 0:0,3,1,Arutyunov Ruben,Nazaryan Mushegh,fiurst,Arutyunov Ruben - Nazaryan Mushegh,79,43,36,-7,7,26,18,18,17,0,-2,4,-4,-5,0,-7,14:12 - 7:11 - 11:7 - 11:6 - 0:0
18004784,2024-04-10 15:00:00,Asatryan Murad - Diaryan Aleksandr,0:3,5:11 - 9:11 - 5:11 - 0:0 - 0:0,0,3,Asatryan Murad,Diaryan Aleksandr,fiurst,Asatryan Murad - Diaryan Aleksandr,52,19,33,14,-14,16,20,16,0,0,6,2,6,0,0,14,5:11 - 9:11 - 5:11 - 0:0 - 0:0
18004767,2024-04-10 14:30:00,Arutyunov Ruben - Diaryan Aleksandr,2:3,12:10 - 11:7 - 5:11 - 2:11 - 6:11,2,3,Arutyunov Ruben,Diaryan Aleksandr,fiurst,Arutyunov Ruben - Diaryan Aleksandr,86,36,50,14,-14,22,18,16,13,17,-2,-4,6,9,5,14,12:10 - 11:7 - 5:11 - 2:11 - 6:11
18004770,2024-04-10 14:30:00,Papyan Karen - Asatryan Murad,0:3,13:11 - 11:6 - 11:8 - 0:0 - 0:0,3,0,Papyan Karen,Asatryan Murad,fiurst,Asatryan Murad - Papyan Karen,60,25,35,10,-10,24,17,19,0,0,2,5,3,0,0,10,11:13 - 6:11 - 8:11 - 0:0 - 0:0
18004765,2024-04-10 14:05:00,Nazaryan Mushegh - Asatryan Murad,3:0,3:11 - 6:11 - 3:11 - 0:0 - 0:0,0,3,Nazaryan Mushegh,Asatryan Murad,fiurst,Asatryan Murad - Nazaryan Mushegh,45,33,12,-21,21,14,17,14,0,0,-8,-5,-8,0,0,-21,11:3 - 11:6 - 11:3 - 0:0 - 0:0
18004762,2024-04-10 13:50:00,Papyan Karen - Arutyunov Ruben,3:1,14:12 - 8:11 - 7:11 - 9:11 - 0:0,1,3,Papyan Karen,Arutyunov Ruben,fiurst,Arutyunov Ruben - Papyan Karen,83,45,38,-7,7,26,19,18,20,0,2,-3,-4,-2,0,-7,12:14 - 11:8 - 11:7 - 11:9 - 0:0
18004750,2024-04-10 13:35:00,Diaryan Aleksandr - Nazaryan Mushegh,3:0,11:5 - 11:5 - 11:9 - 0:0 - 0:0,3,0,Diaryan Aleksandr,Nazaryan Mushegh,fiurst,Diaryan Aleksandr - Nazaryan Mushegh,52,33,19,-14,14,16,16,20,0,0,-6,-6,-2,0,0,-14,11:5 - 11:5 - 11:9 - 0:0 - 0:0
18004748,2024-04-10 13:15:00,Asatryan Murad - Arutyunov Ruben,0:3,16:14 - 11:6 - 11:7 - 0:0 - 0:0,3,0,Asatryan Murad,Arutyunov Ruben,fiurst,Arutyunov Ruben - Asatryan Murad,65,27,38,11,-11,30,17,18,0,0,2,5,4,0,0,11,14:16 - 6:11 - 7:11 - 0:0 - 0:0
18004744,2024-04-10 13:00:00,Diaryan Aleksandr - Papyan Karen,3:2,12:10 - 10:12 - 11:5 - 10:12 - 11:6,3,2,Diaryan Aleksandr,Papyan Karen,fiurst,Diaryan Aleksandr - Papyan Karen,99,54,45,-9,9,22,22,16,22,17,-2,2,-6,2,-5,-9,12:10 - 10:12 - 11:5 - 10:12 - 11:6
18004742,2024-04-10 12:15:00,Nazaryan Mushegh - Arutyunov Ruben,3:0,9:11 - 4:11 - 5:11 - 0:0 - 0:0,0,3,Nazaryan Mushegh,Arutyunov Ruben,fiurst,Arutyunov Ruben - Nazaryan Mushegh,51,33,18,-15,15,20,15,16,0,0,-2,-7,-6,0,0,-15,11:9 - 11:4 - 11:5 - 0:0 - 0:0
18004739,2024-04-10 12:00:00,Diaryan Aleksandr - Asatryan Murad,3:1,5:11 - 11:8 - 4:11 - 7:11 - 0:0,1,3,Diaryan Aleksandr,Asatryan Murad,fiurst,Asatryan Murad - Diaryan Aleksandr,68,41,27,-14,14,16,19,15,18,0,-6,3,-7,-4,0,-14,11:5 - 8:11 - 11:4 - 11:7 - 0:0
18004736,2024-04-10 11:45:00,Papyan Karen - Nazaryan Mushegh,0:3,11:9 - 11:9 - 11:8 - 0:0 - 0:0,3,0,Papyan Karen,Nazaryan Mushegh,fiurst,Nazaryan Mushegh - Papyan Karen,59,26,33,7,-7,20,20,19,0,0,2,2,3,0,0,7,9:11 - 9:11 - 8:11 - 0:0 - 0:0
18004735,2024-04-10 11:30:00,Diaryan Aleksandr - Arutyunov Ruben,0:3,11:8 - 11:6 - 11:8 - 0:0 - 0:0,3,0,Diaryan Aleksandr,Arutyunov Ruben,fiurst,Arutyunov Ruben - Diaryan Aleksandr,55,22,33,11,-11,19,17,19,0,0,3,5,3,0,0,11,8:11 - 6:11 - 8:11 - 0:0 - 0:0
18004734,2024-04-10 11:25:00,Asatryan Murad - Papyan Karen,3:0,11:6 - 11:6 - 11:5 - 0:0 - 0:0,3,0,Asatryan Murad,Papyan Karen,fiurst,Asatryan Murad - Papyan Karen,50,33,17,-16,16,17,17,16,0,0,-5,-5,-6,0,0,-16,11:6 - 11:6 - 11:5 - 0:0 - 0:0
18004732,2024-04-10 11:05:00,Nazaryan Mushegh - Diaryan Aleksandr,3:0,5:11 - 7:11 - 4:11 - 0:0 - 0:0,0,3,Nazaryan Mushegh,Diaryan Aleksandr,fiurst,Diaryan Aleksandr - Nazaryan Mushegh,49,33,16,-17,17,16,18,15,0,0,-6,-4,-7,0,0,-17,11:5 - 11:7 - 11:4 - 0:0 - 0:0
18004720,2024-04-10 10:45:00,Arutyunov Ruben - Papyan Karen,3:2,12:10 - 11:7 - 9:11 - 10:12 - 11:8,3,2,Arutyunov Ruben,Papyan Karen,fiurst,Arutyunov Ruben - Papyan Karen,101,53,48,-5,5,22,18,20,22,19,-2,-4,2,2,-3,-5,12:10 - 11:7 - 9:11 - 10:12 - 11:8
18004719,2024-04-10 10:35:00,Asatryan Murad - Nazaryan Mushegh,3:0,11:7 - 11:6 - 11:2 - 0:0 - 0:0,3,0,Asatryan Murad,Nazaryan Mushegh,fiurst,Asatryan Murad - Nazaryan Mushegh,48,33,15,-18,18,18,17,13,0,0,-4,-5,-9,0,0,-18,11:7 - 11:6 - 11:2 - 0:0 - 0:0
18004716,2024-04-10 10:15:00,Papyan Karen - Diaryan Aleksandr,3:1,3:11 - 11:4 - 4:11 - 3:11 - 0:0,1,3,Papyan Karen,Diaryan Aleksandr,fiurst,Diaryan Aleksandr - Papyan Karen,58,37,21,-16,16,14,15,15,14,0,-8,7,-7,-8,0,-16,11:3 - 4:11 - 11:4 - 11:3 - 0:0
18004713,2024-04-10 10:00:00,Arutyunov Ruben - Asatryan Murad,1:3,5:11 - 7:11 - 11:7 - 7:11 - 0:0,1,3,Arutyunov Ruben,Asatryan Murad,fiurst,Arutyunov Ruben - Asatryan Murad,70,30,40,10,-10,16,18,18,18,0,6,4,-4,4,0,10,5:11 - 7:11 - 11:7 - 7:11 - 0:0
17987422,2024-04-09 17:45:00,Gevorgyan Hayk - Mkrtchyan Andranik,3:1,7:11 - 11:7 - 11:4 - 11:3 - 0:0,3,1,Gevorgyan Hayk,Mkrtchyan Andranik,fiurst,Gevorgyan Hayk - Mkrtchyan Andranik,65,40,25,-15,15,18,18,15,14,0,4,-4,-7,-8,0,-15,7:11 - 11:7 - 11:4 - 11:3 - 0:0
17987410,2024-04-09 17:30:00,Hakobyan Eduard - Gevorgyan Gegham,3:1,6:11 - 13:11 - 9:11 - 9:11 - 0:0,1,3,Hakobyan Eduard,Gevorgyan Gegham,fiurst,Gevorgyan Gegham - Hakobyan Eduard,81,44,37,-7,7,17,24,20,20,0,-5,2,-2,-2,0,-7,11:6 - 11:13 - 11:9 - 11:9 - 0:0
17987409,2024-04-09 17:20:00,Soghomonyan Hrayr - Gevorgyan Hayk,0:3,11:7 - 11:2 - 11:8 - 0:0 - 0:0,3,0,Soghomonyan Hrayr,Gevorgyan Hayk,fiurst,Gevorgyan Hayk - Soghomonyan Hrayr,50,17,33,16,-16,18,13,19,0,0,4,9,3,0,0,16,7:11 - 2:11 - 8:11 - 0:0 - 0:0
17987403,2024-04-09 17:00:00,Hakobyan Eduard - Mkrtchyan Andranik,3:2,9:11 - 11:8 - 7:11 - 11:5 - 14:12,3,2,Hakobyan Eduard,Mkrtchyan Andranik,fiurst,Hakobyan Eduard - Mkrtchyan Andranik,99,52,47,-5,5,20,19,18,16,26,2,-3,4,-6,-2,-5,9:11 - 11:8 - 7:11 - 11:5 - 14:12
17987398,2024-04-09 16:55:00,Gevorgyan Gegham - Soghomonyan Hrayr,0:3,9:11 - 9:11 - 9:11 - 0:0 - 0:0,0,3,Gevorgyan Gegham,Soghomonyan Hrayr,fiurst,Gevorgyan Gegham - Soghomonyan Hrayr,60,27,33,6,-6,20,20,20,0,0,2,2,2,0,0,6,9:11 - 9:11 - 9:11 - 0:0 - 0:0
17987396,2024-04-09 16:30:00,Gevorgyan Hayk - Hakobyan Eduard,3:0,11:7 - 11:9 - 11:8 - 0:0 - 0:0,3,0,Gevorgyan Hayk,Hakobyan Eduard,fiurst,Gevorgyan Hayk - Hakobyan Eduard,57,33,24,-9,9,18,20,19,0,0,-4,-2,-3,0,0,-9,11:7 - 11:9 - 11:8 - 0:0 - 0:0
17987391,2024-04-09 16:15:00,Mkrtchyan Andranik - Soghomonyan Hrayr,2:3,12:14 - 11:2 - 11:3 - 8:11 - 11:13,2,3,Mkrtchyan Andranik,Soghomonyan Hrayr,fiurst,Mkrtchyan Andranik - Soghomonyan Hrayr,96,53,43,-10,10,26,13,14,19,24,2,-9,-8,3,2,-10,12:14 - 11:2 - 11:3 - 8:11 - 11:13
17987389,2024-04-09 16:00:00,Gevorgyan Gegham - Gevorgyan Hayk,0:3,7:11 - 5:11 - 3:11 - 0:0 - 0:0,0,3,Gevorgyan Gegham,Gevorgyan Hayk,fiurst,Gevorgyan Gegham - Gevorgyan Hayk,48,15,33,18,-18,18,16,14,0,0,4,6,8,0,0,18,7:11 - 5:11 - 3:11 - 0:0 - 0:0
17987382,2024-04-09 15:45:00,Soghomonyan Hrayr - Hakobyan Eduard,1:3,11:7 - 9:11 - 11:5 - 12:10 - 0:0,3,1,Soghomonyan Hrayr,Hakobyan Eduard,fiurst,Hakobyan Eduard - Soghomonyan Hrayr,76,33,43,10,-10,18,20,16,22,0,4,-2,6,2,0,10,7:11 - 11:9 - 5:11 - 10:12 - 0:0
17987371,2024-04-09 15:35:00,Mkrtchyan Andranik - Gevorgyan Gegham,1:3,11:6 - 11:5 - 8:11 - 11:6 - 0:0,3,1,Mkrtchyan Andranik,Gevorgyan Gegham,fiurst,Gevorgyan Gegham - Mkrtchyan Andranik,69,28,41,13,-13,17,16,19,17,0,5,6,-3,5,0,13,6:11 - 5:11 - 11:8 - 6:11 - 0:0
17987367,2024-04-09 15:15:00,Papyan Karen - Arutyunov Ruben,3:2,11:1 - 11:13 - 5:11 - 11:7 - 6:11,2,3,Papyan Karen,Arutyunov Ruben,fiurst,Arutyunov Ruben - Papyan Karen,87,43,44,1,-1,12,24,16,18,17,10,-2,-6,4,-5,1,1:11 - 13:11 - 11:5 - 7:11 - 11:6
17987368,2024-04-09 15:15:00,Diaryan Aleksandr - Rafayelyan Edgar,1:3,11:6 - 7:11 - 10:12 - 9:11 - 0:0,1,3,Diaryan Aleksandr,Rafayelyan Edgar,fiurst,Diaryan Aleksandr - Rafayelyan Edgar,77,37,40,3,-3,17,18,22,20,0,-5,4,2,2,0,3,11:6 - 7:11 - 10:12 - 9:11 - 0:0
17987365,2024-04-09 14:55:00,Nikoghosyan Narek - Diaryan Aleksandr,0:3,12:10 - 11:2 - 11:8 - 0:0 - 0:0,3,0,Nikoghosyan Narek,Diaryan Aleksandr,fiurst,Diaryan Aleksandr - Nikoghosyan Narek,54,20,34,14,-14,22,13,19,0,0,2,9,3,0,0,14,10:12 - 2:11 - 8:11 - 0:0 - 0:0
17987364,2024-04-09 14:40:00,Rafayelyan Edgar - Papyan Karen,3:2,11:4 - 6:11 - 11:8 - 7:11 - 11:13,2,3,Rafayelyan Edgar,Papyan Karen,fiurst,Papyan Karen - Rafayelyan Edgar,93,47,46,-1,1,15,17,19,18,24,7,-5,3,-4,-2,-1,4:11 - 11:6 - 8:11 - 11:7 - 13:11
17987361,2024-04-09 14:30:00,Nikoghosyan Narek - Arutyunov Ruben,1:3,11:3 - 11:8 - 6:11 - 11:0 - 0:0,3,1,Nikoghosyan Narek,Arutyunov Ruben,fiurst,Arutyunov Ruben - Nikoghosyan Narek,61,22,39,17,-17,14,19,17,11,0,8,3,-5,11,0,17,3:11 - 8:11 - 11:6 - 0:11 - 0:0
17987346,2024-04-09 14:00:00,Rafayelyan Edgar - Nikoghosyan Narek,3:1,11:5 - 10:12 - 6:11 - 4:11 - 0:0,1,3,Rafayelyan Edgar,Nikoghosyan Narek,fiurst,Nikoghosyan Narek - Rafayelyan Edgar,70,39,31,-8,8,16,22,17,15,0,6,-2,-5,-7,0,-8,5:11 - 12:10 - 11:6 - 11:4 - 0:0
17987360,2024-04-09 14:00:00,Diaryan Aleksandr - Papyan Karen,1:3,6:11 - 9:11 - 11:7 - 8:11 - 0:0,1,3,Diaryan Aleksandr,Papyan Karen,fiurst,Diaryan Aleksandr - Papyan Karen,74,34,40,6,-6,17,20,18,19,0,5,2,-4,3,0,6,6:11 - 9:11 - 11:7 - 8:11 - 0:0
17987345,2024-04-09 13:40:00,Arutyunov Ruben - Diaryan Aleksandr,3:1,5:11 - 11:3 - 11:6 - 11:7 - 0:0,3,1,Arutyunov Ruben,Diaryan Aleksandr,fiurst,Arutyunov Ruben - Diaryan Aleksandr,65,38,27,-11,11,16,14,17,18,0,6,-8,-5,-4,0,-11,5:11 - 11:3 - 11:6 - 11:7 - 0:0
17987340,2024-04-09 13:15:00,Papyan Karen - Nikoghosyan Narek,1:3,12:10 - 4:11 - 12:10 - 12:10 - 0:0,3,1,Papyan Karen,Nikoghosyan Narek,fiurst,Nikoghosyan Narek - Papyan Karen,81,41,40,-1,1,22,15,22,22,0,2,-7,2,2,0,-1,10:12 - 11:4 - 10:12 - 10:12 - 0:0
17987335,2024-04-09 13:00:00,Arutyunov Ruben - Rafayelyan Edgar,2:3,11:9 - 11:3 - 8:11 - 7:11 - 5:11,2,3,Arutyunov Ruben,Rafayelyan Edgar,fiurst,Arutyunov Ruben - Rafayelyan Edgar,87,42,45,3,-3,20,14,19,18,16,-2,-8,3,4,6,3,11:9 - 11:3 - 8:11 - 7:11 - 5:11
17987334,2024-04-09 12:20:00,Diaryan Aleksandr - Nikoghosyan Narek,2:3,11:4 - 6:11 - 7:11 - 11:5 - 10:12,2,3,Diaryan Aleksandr,Nikoghosyan Narek,fiurst,Diaryan Aleksandr - Nikoghosyan Narek,88,45,43,-2,2,15,17,18,16,22,-7,5,4,-6,2,-2,11:4 - 6:11 - 7:11 - 11:5 - 10:12
17987332,2024-04-09 12:15:00,Arutyunov Ruben - Papyan Karen,3:1,5:11 - 12:10 - 11:2 - 11:6 - 0:0,3,1,Arutyunov Ruben,Papyan Karen,fiurst,Arutyunov Ruben - Papyan Karen,68,39,29,-10,10,16,22,13,17,0,6,-2,-9,-5,0,-10,5:11 - 12:10 - 11:2 - 11:6 - 0:0
17987331,2024-04-09 11:50:00,Rafayelyan Edgar - Diaryan Aleksandr,3:0,3:11 - 8:11 - 10:12 - 0:0 - 0:0,0,3,Rafayelyan Edgar,Diaryan Aleksandr,fiurst,Diaryan Aleksandr - Rafayelyan Edgar,55,34,21,-13,13,14,19,22,0,0,-8,-3,-2,0,0,-13,11:3 - 11:8 - 12:10 - 0:0 - 0:0
17987319,2024-04-09 11:40:00,Arutyunov Ruben - Nikoghosyan Narek,3:2,12:10 - 7:11 - 5:11 - 11:8 - 11:1,3,2,Arutyunov Ruben,Nikoghosyan Narek,fiurst,Arutyunov Ruben - Nikoghosyan Narek,87,46,41,-5,5,22,18,16,19,12,-2,4,6,-3,-10,-5,12:10 - 7:11 - 5:11 - 11:8 - 11:1
17987315,2024-04-09 11:20:00,Papyan Karen - Rafayelyan Edgar,1:3,8:11 - 11:9 - 8:11 - 14:16 - 0:0,1,3,Papyan Karen,Rafayelyan Edgar,fiurst,Papyan Karen - Rafayelyan Edgar,88,41,47,6,-6,19,20,19,30,0,3,-2,3,2,0,6,8:11 - 11:9 - 8:11 - 14:16 - 0:0
17987306,2024-04-09 11:05:00,Diaryan Aleksandr - Arutyunov Ruben,1:3,11:6 - 11:6 - 6:11 - 13:11 - 0:0,3,1,Diaryan Aleksandr,Arutyunov Ruben,fiurst,Arutyunov Ruben - Diaryan Aleksandr,75,34,41,7,-7,17,17,17,24,0,5,5,-5,2,0,7,6:11 - 6:11 - 11:6 - 11:13 - 0:0
17987304,2024-04-09 10:45:00,Nikoghosyan Narek - Rafayelyan Edgar,0:3,8:11 - 9:11 - 5:11 - 0:0 - 0:0,0,3,Nikoghosyan Narek,Rafayelyan Edgar,fiurst,Nikoghosyan Narek - Rafayelyan Edgar,55,22,33,11,-11,19,20,16,0,0,3,2,6,0,0,11,8:11 - 9:11 - 5:11 - 0:0 - 0:0
17987303,2024-04-09 10:35:00,Papyan Karen - Diaryan Aleksandr,3:0,8:11 - 5:11 - 9:11 - 0:0 - 0:0,0,3,Papyan Karen,Diaryan Aleksandr,fiurst,Diaryan Aleksandr - Papyan Karen,55,33,22,-11,11,19,16,20,0,0,-3,-6,-2,0,0,-11,11:8 - 11:5 - 11:9 - 0:0 - 0:0
17987300,2024-04-09 10:15:00,Rafayelyan Edgar - Arutyunov Ruben,1:3,11:7 - 8:11 - 11:4 - 11:8 - 0:0,3,1,Rafayelyan Edgar,Arutyunov Ruben,fiurst,Arutyunov Ruben - Rafayelyan Edgar,71,30,41,11,-11,18,19,15,19,0,4,-3,7,3,0,11,7:11 - 11:8 - 4:11 - 8:11 - 0:0
17987256,2024-04-09 10:00:00,Nikoghosyan Narek - Papyan Karen,1:3,8:11 - 9:11 - 11:8 - 8:11 - 0:0,1,3,Nikoghosyan Narek,Papyan Karen,fiurst,Nikoghosyan Narek - Papyan Karen,77,36,41,5,-5,19,20,19,19,0,3,2,-3,3,0,5,8:11 - 9:11 - 11:8 - 8:11 - 0:0
17966507,2024-04-08 17:45:00,Petrosyan Davit - Hakobyan Eduard,3:0,5:11 - 6:11 - 5:11 - 0:0 - 0:0,0,3,Petrosyan Davit,Hakobyan Eduard,fiurst,Hakobyan Eduard - Petrosyan Davit,49,33,16,-17,17,16,17,16,0,0,-6,-5,-6,0,0,-17,11:5 - 11:6 - 11:5 - 0:0 - 0:0
17966497,2024-04-08 17:35:00,Soghomonyan Hrayr - Gevorgyan Hayk,2:3,12:10 - 11:9 - 4:11 - 9:11 - 11:6,3,2,Soghomonyan Hrayr,Gevorgyan Hayk,fiurst,Gevorgyan Hayk - Soghomonyan Hrayr,94,47,47,0,0,22,20,15,20,17,2,2,-7,-2,5,0,10:12 - 9:11 - 11:4 - 11:9 - 6:11
17966495,2024-04-08 17:15:00,Avakimyan Davit - Petrosyan Davit,3:0,11:9 - 11:8 - 11:4 - 0:0 - 0:0,3,0,Avakimyan Davit,Petrosyan Davit,fiurst,Avakimyan Davit - Petrosyan Davit,54,33,21,-12,12,20,19,15,0,0,-2,-3,-7,0,0,-12,11:9 - 11:8 - 11:4 - 0:0 - 0:0
17966493,2024-04-08 17:00:00,Soghomonyan Hrayr - Hakobyan Eduard,1:3,12:10 - 11:6 - 7:11 - 11:8 - 0:0,3,1,Soghomonyan Hrayr,Hakobyan Eduard,fiurst,Hakobyan Eduard - Soghomonyan Hrayr,76,35,41,6,-6,22,17,18,19,0,2,5,-4,3,0,6,10:12 - 6:11 - 11:7 - 8:11 - 0:0
17966491,2024-04-08 16:45:00,Gevorgyan Hayk - Avakimyan Davit,1:3,11:9 - 10:12 - 11:8 - 11:3 - 0:0,3,1,Gevorgyan Hayk,Avakimyan Davit,fiurst,Avakimyan Davit - Gevorgyan Hayk,75,32,43,11,-11,20,22,19,14,0,2,-2,3,8,0,11,9:11 - 12:10 - 8:11 - 3:11 - 0:0
17966490,2024-04-08 16:30:00,Petrosyan Davit - Soghomonyan Hrayr,3:0,11:4 - 11:8 - 11:5 - 0:0 - 0:0,3,0,Petrosyan Davit,Soghomonyan Hrayr,fiurst,Petrosyan Davit - Soghomonyan Hrayr,50,33,17,-16,16,15,19,16,0,0,-7,-3,-6,0,0,-16,11:4 - 11:8 - 11:5 - 0:0 - 0:0
17966487,2024-04-08 16:25:00,Hakobyan Eduard - Avakimyan Davit,0:3,11:6 - 11:7 - 11:7 - 0:0 - 0:0,3,0,Hakobyan Eduard,Avakimyan Davit,fiurst,Avakimyan Davit - Hakobyan Eduard,53,20,33,13,-13,17,18,18,0,0,5,4,4,0,0,13,6:11 - 7:11 - 7:11 - 0:0 - 0:0
17966485,2024-04-08 16:05:00,Avakimyan Davit - Soghomonyan Hrayr,3:2,12:10 - 8:11 - 7:11 - 11:5 - 11:4,3,2,Avakimyan Davit,Soghomonyan Hrayr,fiurst,Avakimyan Davit - Soghomonyan Hrayr,90,49,41,-8,8,22,19,18,16,15,-2,3,4,-6,-7,-8,12:10 - 8:11 - 7:11 - 11:5 - 11:4
17966486,2024-04-08 16:00:00,Gevorgyan Hayk - Petrosyan Davit,3:0,11:7 - 11:4 - 11:5 - 0:0 - 0:0,3,0,Gevorgyan Hayk,Petrosyan Davit,fiurst,Gevorgyan Hayk - Petrosyan Davit,49,33,16,-17,17,18,15,16,0,0,-4,-7,-6,0,0,-17,11:7 - 11:4 - 11:5 - 0:0 - 0:0
17966481,2024-04-08 15:30:00,Nikoghosyan Narek - Arutyunov Ruben,3:2,11:9 - 8:11 - 8:11 - 11:8 - 9:11,2,3,Nikoghosyan Narek,Arutyunov Ruben,fiurst,Arutyunov Ruben - Nikoghosyan Narek,97,50,47,-3,3,20,19,19,19,20,2,-3,-3,3,-2,-3,9:11 - 11:8 - 11:8 - 8:11 - 11:9
17966483,2024-04-08 15:30:00,Hakobyan Eduard - Gevorgyan Hayk,3:0,6:11 - 5:11 - 4:11 - 0:0 - 0:0,0,3,Hakobyan Eduard,Gevorgyan Hayk,fiurst,Gevorgyan Hayk - Hakobyan Eduard,48,33,15,-18,18,17,16,15,0,0,-5,-6,-7,0,0,-18,11:6 - 11:5 - 11:4 - 0:0 - 0:0
17966471,2024-04-08 15:10:00,Hovhannesyan Rafik - Rafayelyan Edgar,0:3,4:11 - 8:11 - 7:11 - 0:0 - 0:0,0,3,Hovhannesyan Rafik,Rafayelyan Edgar,fiurst,Hovhannesyan Rafik - Rafayelyan Edgar,52,19,33,14,-14,15,19,18,0,0,7,3,4,0,0,14,4:11 - 8:11 - 7:11 - 0:0 - 0:0
17966467,2024-04-08 14:50:00,Diaryan Aleksandr - Nikoghosyan Narek,3:2,11:9 - 13:11 - 5:11 - 8:11 - 11:8,3,2,Diaryan Aleksandr,Nikoghosyan Narek,fiurst,Diaryan Aleksandr - Nikoghosyan Narek,98,48,50,2,-2,20,24,16,19,19,-2,-2,6,3,-3,2,11:9 - 13:11 - 5:11 - 8:11 - 11:8
17966431,2024-04-08 14:40:00,Arutyunov Ruben - Hovhannesyan Rafik,3:1,11:6 - 9:11 - 15:13 - 14:12 - 0:0,3,1,Arutyunov Ruben,Hovhannesyan Rafik,fiurst,Arutyunov Ruben - Hovhannesyan Rafik,91,49,42,-7,7,17,20,28,26,0,-5,2,-2,-2,0,-7,11:6 - 9:11 - 15:13 - 14:12 - 0:0
17966428,2024-04-08 14:25:00,Diaryan Aleksandr - Rafayelyan Edgar,1:3,11:9 - 2:11 - 6:11 - 7:11 - 0:0,1,3,Diaryan Aleksandr,Rafayelyan Edgar,fiurst,Diaryan Aleksandr - Rafayelyan Edgar,68,26,42,16,-16,20,13,17,18,0,-2,9,5,4,0,16,11:9 - 2:11 - 6:11 - 7:11 - 0:0
17966420,2024-04-08 14:00:00,Nikoghosyan Narek - Hovhannesyan Rafik,2:3,11:8 - 9:11 - 11:4 - 10:12 - 13:11,3,2,Nikoghosyan Narek,Hovhannesyan Rafik,fiurst,Hovhannesyan Rafik - Nikoghosyan Narek,100,46,54,8,-8,19,20,15,22,24,3,-2,7,-2,2,8,8:11 - 11:9 - 4:11 - 12:10 - 11:13
17966411,2024-04-08 13:45:00,Arutyunov Ruben - Diaryan Aleksandr,1:3,12:14 - 8:11 - 12:10 - 12:14 - 0:0,1,3,Arutyunov Ruben,Diaryan Aleksandr,fiurst,Arutyunov Ruben - Diaryan Aleksandr,93,44,49,5,-5,26,19,22,26,0,2,3,-2,2,0,5,12:14 - 8:11 - 12:10 - 12:14 - 0:0
17966397,2024-04-08 13:30:00,Rafayelyan Edgar - Nikoghosyan Narek,2:3,11:7 - 11:8 - 6:11 - 7:11 - 11:6,3,2,Rafayelyan Edgar,Nikoghosyan Narek,fiurst,Nikoghosyan Narek - Rafayelyan Edgar,89,43,46,3,-3,18,19,17,18,17,4,3,-5,-4,5,3,7:11 - 8:11 - 11:6 - 11:7 - 6:11
17966381,2024-04-08 13:15:00,Hovhannesyan Rafik - Diaryan Aleksandr,3:0,12:14 - 8:11 - 6:11 - 0:0 - 0:0,0,3,Hovhannesyan Rafik,Diaryan Aleksandr,fiurst,Diaryan Aleksandr - Hovhannesyan Rafik,62,36,26,-10,10,26,19,17,0,0,-2,-3,-5,0,0,-10,14:12 - 11:8 - 11:6 - 0:0 - 0:0
17966232,2024-04-08 13:00:00,Rafayelyan Edgar - Arutyunov Ruben,0:3,11:8 - 11:8 - 11:8 - 0:0 - 0:0,3,0,Rafayelyan Edgar,Arutyunov Ruben,fiurst,Arutyunov Ruben - Rafayelyan Edgar,57,24,33,9,-9,19,19,19,0,0,3,3,3,0,0,9,8:11 - 8:11 - 8:11 - 0:0 - 0:0
17966231,2024-04-08 12:35:00,Nikoghosyan Narek - Diaryan Aleksandr,3:2,7:11 - 2:11 - 11:5 - 12:10 - 7:11,2,3,Nikoghosyan Narek,Diaryan Aleksandr,fiurst,Diaryan Aleksandr - Nikoghosyan Narek,87,48,39,-9,9,18,13,16,22,18,-4,-9,6,2,-4,-9,11:7 - 11:2 - 5:11 - 10:12 - 11:7
17966229,2024-04-08 12:20:00,Rafayelyan Edgar - Hovhannesyan Rafik,0:3,15:13 - 11:8 - 12:10 - 0:0 - 0:0,3,0,Rafayelyan Edgar,Hovhannesyan Rafik,fiurst,Hovhannesyan Rafik - Rafayelyan Edgar,69,31,38,7,-7,28,19,22,0,0,2,3,2,0,0,7,13:15 - 8:11 - 10:12 - 0:0 - 0:0
17966224,2024-04-08 12:00:00,Arutyunov Ruben - Nikoghosyan Narek,3:2,4:11 - 11:5 - 8:11 - 11:7 - 11:5,3,2,Arutyunov Ruben,Nikoghosyan Narek,fiurst,Arutyunov Ruben - Nikoghosyan Narek,84,45,39,-6,6,15,16,19,18,16,7,-6,3,-4,-6,-6,4:11 - 11:5 - 8:11 - 11:7 - 11:5
17966223,2024-04-08 11:55:00,Rafayelyan Edgar - Diaryan Aleksandr,1:3,6:11 - 11:6 - 11:6 - 11:6 - 0:0,3,1,Rafayelyan Edgar,Diaryan Aleksandr,fiurst,Diaryan Aleksandr - Rafayelyan Edgar,68,29,39,10,-10,17,17,17,17,0,-5,5,5,5,0,10,11:6 - 6:11 - 6:11 - 6:11 - 0:0
17966220,2024-04-08 11:30:00,Hovhannesyan Rafik - Arutyunov Ruben,3:0,11:13 - 6:11 - 9:11 - 0:0 - 0:0,0,3,Hovhannesyan Rafik,Arutyunov Ruben,fiurst,Arutyunov Ruben - Hovhannesyan Rafik,61,35,26,-9,9,24,17,20,0,0,-2,-5,-2,0,0,-9,13:11 - 11:6 - 11:9 - 0:0 - 0:0
17966217,2024-04-08 11:15:00,Nikoghosyan Narek - Rafayelyan Edgar,2:3,11:8 - 13:11 - 11:13 - 6:11 - 4:11,2,3,Nikoghosyan Narek,Rafayelyan Edgar,fiurst,Nikoghosyan Narek - Rafayelyan Edgar,99,45,54,9,-9,19,24,24,17,15,-3,-2,2,5,7,9,11:8 - 13:11 - 11:13 - 6:11 - 4:11
17966216,2024-04-08 10:45:00,Diaryan Aleksandr - Arutyunov Ruben,2:3,7:11 - 13:11 - 13:11 - 10:12 - 11:6,3,2,Diaryan Aleksandr,Arutyunov Ruben,fiurst,Arutyunov Ruben - Diaryan Aleksandr,105,51,54,3,-3,18,24,24,22,17,-4,2,2,-2,5,3,11:7 - 11:13 - 11:13 - 12:10 - 6:11
17966215,2024-04-08 10:40:00,Hovhannesyan Rafik - Nikoghosyan Narek,2:3,11:3 - 7:11 - 7:11 - 11:5 - 9:11,2,3,Hovhannesyan Rafik,Nikoghosyan Narek,fiurst,Hovhannesyan Rafik - Nikoghosyan Narek,86,45,41,-4,4,14,18,18,16,20,-8,4,4,-6,2,-4,11:3 - 7:11 - 7:11 - 11:5 - 9:11
17966212,2024-04-08 10:15:00,Arutyunov Ruben - Rafayelyan Edgar,0:3,6:11 - 4:11 - 3:11 - 0:0 - 0:0,0,3,Arutyunov Ruben,Rafayelyan Edgar,fiurst,Arutyunov Ruben - Rafayelyan Edgar,46,13,33,20,-20,17,15,14,0,0,5,7,8,0,0,20,6:11 - 4:11 - 3:11 - 0:0 - 0:0
17966211,2024-04-08 10:00:00,Diaryan Aleksandr - Hovhannesyan Rafik,3:1,11:13 - 11:9 - 11:4 - 11:9 - 0:0,3,1,Diaryan Aleksandr,Hovhannesyan Rafik,fiurst,Diaryan Aleksandr - Hovhannesyan Rafik,79,44,35,-9,9,24,20,15,20,0,2,-2,-7,-2,0,-9,11:13 - 11:9 - 11:4 - 11:9 - 0:0
17949479,2024-04-07 17:45:00,Gevorgyan Hayk - Avakimyan Davit,3:2,10:12 - 8:11 - 11:6 - 11:7 - 9:11,2,3,Gevorgyan Hayk,Avakimyan Davit,fiurst,Avakimyan Davit - Gevorgyan Hayk,96,47,49,2,-2,22,19,17,18,20,-2,-3,5,4,-2,2,12:10 - 11:8 - 6:11 - 7:11 - 11:9
17949466,2024-04-07 17:30:00,Mkrtchyan Andranik - Petrosyan Davit,3:2,11:6 - 10:12 - 11:9 - 6:11 - 11:9,3,2,Mkrtchyan Andranik,Petrosyan Davit,fiurst,Mkrtchyan Andranik - Petrosyan Davit,96,49,47,-2,2,17,22,20,17,20,-5,2,-2,5,-2,-2,11:6 - 10:12 - 11:9 - 6:11 - 11:9
17949460,2024-04-07 17:15:00,Gevorgyan Gegham - Gevorgyan Hayk,0:3,7:11 - 7:11 - 6:11 - 0:0 - 0:0,0,3,Gevorgyan Gegham,Gevorgyan Hayk,fiurst,Gevorgyan Gegham - Gevorgyan Hayk,53,20,33,13,-13,18,18,17,0,0,4,4,5,0,0,13,7:11 - 7:11 - 6:11 - 0:0 - 0:0
17949458,2024-04-07 17:05:00,Mkrtchyan Andranik - Avakimyan Davit,1:3,7:11 - 11:3 - 11:6 - 11:4 - 0:0,3,1,Mkrtchyan Andranik,Avakimyan Davit,fiurst,Avakimyan Davit - Mkrtchyan Andranik,64,24,40,16,-16,18,14,17,15,0,-4,8,5,7,0,16,11:7 - 3:11 - 6:11 - 4:11 - 0:0
17949454,2024-04-07 16:45:00,Petrosyan Davit - Gevorgyan Gegham,2:3,8:11 - 7:11 - 13:11 - 11:7 - 11:7,3,2,Petrosyan Davit,Gevorgyan Gegham,fiurst,Gevorgyan Gegham - Petrosyan Davit,97,47,50,3,-3,19,18,24,18,18,-3,-4,2,4,4,3,11:8 - 11:7 - 11:13 - 7:11 - 7:11
17949434,2024-04-07 16:40:00,Gevorgyan Hayk - Mkrtchyan Andranik,3:0,11:6 - 11:9 - 11:6 - 0:0 - 0:0,3,0,Gevorgyan Hayk,Mkrtchyan Andranik,fiurst,Gevorgyan Hayk - Mkrtchyan Andranik,54,33,21,-12,12,17,20,17,0,0,-5,-2,-5,0,0,-12,11:6 - 11:9 - 11:6 - 0:0 - 0:0
17949429,2024-04-07 16:15:00,Avakimyan Davit - Gevorgyan Gegham,1:3,4:11 - 5:11 - 11:5 - 6:11 - 0:0,1,3,Avakimyan Davit,Gevorgyan Gegham,fiurst,Avakimyan Davit - Gevorgyan Gegham,64,26,38,12,-12,15,16,16,17,0,7,6,-6,5,0,12,4:11 - 5:11 - 11:5 - 6:11 - 0:0
17949416,2024-04-07 16:00:00,Petrosyan Davit - Gevorgyan Hayk,1:3,4:11 - 11:7 - 11:3 - 11:5 - 0:0,3,1,Petrosyan Davit,Gevorgyan Hayk,fiurst,Gevorgyan Hayk - Petrosyan Davit,63,26,37,11,-11,15,18,14,16,0,-7,4,8,6,0,11,11:4 - 7:11 - 3:11 - 5:11 - 0:0
17949410,2024-04-07 15:45:00,Gevorgyan Gegham - Mkrtchyan Andranik,1:3,12:10 - 9:11 - 7:11 - 8:11 - 0:0,1,3,Gevorgyan Gegham,Mkrtchyan Andranik,fiurst,Gevorgyan Gegham - Mkrtchyan Andranik,79,36,43,7,-7,22,20,18,19,0,-2,2,4,3,0,7,12:10 - 9:11 - 7:11 - 8:11 - 0:0
17949400,2024-04-07 15:30:00,Avakimyan Davit - Petrosyan Davit,0:3,6:11 - 8:11 - 8:11 - 0:0 - 0:0,0,3,Avakimyan Davit,Petrosyan Davit,fiurst,Avakimyan Davit - Petrosyan Davit,55,22,33,11,-11,17,19,19,0,0,5,3,3,0,0,11,6:11 - 8:11 - 8:11 - 0:0 - 0:0
17949382,2024-04-07 15:15:00,Hovhannesyan Rafik - Asatryan Murad,3:0,6:11 - 9:11 - 6:11 - 0:0 - 0:0,0,3,Hovhannesyan Rafik,Asatryan Murad,fiurst,Asatryan Murad - Hovhannesyan Rafik,54,33,21,-12,12,17,20,17,0,0,-5,-2,-5,0,0,-12,11:6 - 11:9 - 11:6 - 0:0 - 0:0
17949380,2024-04-07 15:00:00,Papyan Karen - Nikoghosyan Narek,2:3,9:11 - 11:8 - 11:9 - 7:11 - 11:5,3,2,Papyan Karen,Nikoghosyan Narek,fiurst,Nikoghosyan Narek - Papyan Karen,93,44,49,5,-5,20,19,20,18,16,-2,3,2,-4,6,5,11:9 - 8:11 - 9:11 - 11:7 - 5:11
17949378,2024-04-07 14:55:00,Nazaryan Mushegh - Hovhannesyan Rafik,3:1,8:11 - 11:5 - 9:11 - 5:11 - 0:0,1,3,Nazaryan Mushegh,Hovhannesyan Rafik,fiurst,Hovhannesyan Rafik - Nazaryan Mushegh,71,38,33,-5,5,19,16,20,16,0,-3,6,-2,-6,0,-5,11:8 - 5:11 - 11:9 - 11:5 - 0:0
17949373,2024-04-07 14:30:00,Asatryan Murad - Papyan Karen,3:0,11:8 - 11:6 - 11:5 - 0:0 - 0:0,3,0,Asatryan Murad,Papyan Karen,fiurst,Asatryan Murad - Papyan Karen,52,33,19,-14,14,19,17,16,0,0,-3,-5,-6,0,0,-14,11:8 - 11:6 - 11:5 - 0:0 - 0:0
17949366,2024-04-07 14:20:00,Nazaryan Mushegh - Nikoghosyan Narek,1:3,7:11 - 10:12 - 11:5 - 6:11 - 0:0,1,3,Nazaryan Mushegh,Nikoghosyan Narek,fiurst,Nazaryan Mushegh - Nikoghosyan Narek,73,34,39,5,-5,18,22,16,17,0,4,2,-6,5,0,5,7:11 - 10:12 - 11:5 - 6:11 - 0:0
17949364,2024-04-07 14:10:00,Hovhannesyan Rafik - Papyan Karen,3:1,11:6 - 11:4 - 3:11 - 11:4 - 0:0,3,1,Hovhannesyan Rafik,Papyan Karen,fiurst,Hovhannesyan Rafik - Papyan Karen,61,36,25,-11,11,17,15,14,15,0,-5,-7,8,-7,0,-11,11:6 - 11:4 - 3:11 - 11:4 - 0:0
17949361,2024-04-07 13:50:00,Asatryan Murad - Nazaryan Mushegh,3:0,11:5 - 11:7 - 12:10 - 0:0 - 0:0,3,0,Asatryan Murad,Nazaryan Mushegh,fiurst,Asatryan Murad - Nazaryan Mushegh,56,34,22,-12,12,16,18,22,0,0,-6,-4,-2,0,0,-12,11:5 - 11:7 - 12:10 - 0:0 - 0:0
17949334,2024-04-07 13:30:00,Nikoghosyan Narek - Hovhannesyan Rafik,3:1,11:13 - 11:6 - 9:11 - 11:13 - 0:0,1,3,Nikoghosyan Narek,Hovhannesyan Rafik,fiurst,Hovhannesyan Rafik - Nikoghosyan Narek,85,43,42,-1,1,24,17,20,24,0,-2,5,-2,-2,0,-1,13:11 - 6:11 - 11:9 - 13:11 - 0:0
17949328,2024-04-07 13:15:00,Papyan Karen - Nazaryan Mushegh,3:1,11:13 - 8:11 - 11:8 - 10:12 - 0:0,1,3,Papyan Karen,Nazaryan Mushegh,fiurst,Nazaryan Mushegh - Papyan Karen,84,44,40,-4,4,24,19,19,22,0,-2,-3,3,-2,0,-4,13:11 - 11:8 - 8:11 - 12:10 - 0:0
17949323,2024-04-07 13:00:00,Nikoghosyan Narek - Asatryan Murad,3:1,11:7 - 8:11 - 7:11 - 9:11 - 0:0,1,3,Nikoghosyan Narek,Asatryan Murad,fiurst,Asatryan Murad - Nikoghosyan Narek,75,40,35,-5,5,18,19,18,20,0,4,-3,-4,-2,0,-5,7:11 - 11:8 - 11:7 - 11:9 - 0:0
17949310,2024-04-07 12:25:00,Hovhannesyan Rafik - Nazaryan Mushegh,3:1,10:12 - 11:8 - 11:7 - 11:7 - 0:0,3,1,Hovhannesyan Rafik,Nazaryan Mushegh,fiurst,Hovhannesyan Rafik - Nazaryan Mushegh,77,43,34,-9,9,22,19,18,18,0,2,-3,-4,-4,0,-9,10:12 - 11:8 - 11:7 - 11:7 - 0:0
17949297,2024-04-07 12:00:00,Nikoghosyan Narek - Papyan Karen,3:1,9:11 - 11:7 - 11:3 - 12:10 - 0:0,3,1,Nikoghosyan Narek,Papyan Karen,fiurst,Nikoghosyan Narek - Papyan Karen,74,43,31,-12,12,20,18,14,22,0,2,-4,-8,-2,0,-12,9:11 - 11:7 - 11:3 - 12:10 - 0:0
17949290,2024-04-07 11:50:00,Asatryan Murad - Hovhannesyan Rafik,3:0,11:7 - 11:9 - 11:2 - 0:0 - 0:0,3,0,Asatryan Murad,Hovhannesyan Rafik,fiurst,Asatryan Murad - Hovhannesyan Rafik,51,33,18,-15,15,18,20,13,0,0,-4,-2,-9,0,0,-15,11:7 - 11:9 - 11:2 - 0:0 - 0:0
17949284,2024-04-07 11:30:00,Nikoghosyan Narek - Nazaryan Mushegh,0:3,11:5 - 11:8 - 11:8 - 0:0 - 0:0,3,0,Nikoghosyan Narek,Nazaryan Mushegh,fiurst,Nazaryan Mushegh - Nikoghosyan Narek,54,21,33,12,-12,16,19,19,0,0,6,3,3,0,0,12,5:11 - 8:11 - 8:11 - 0:0 - 0:0
17949278,2024-04-07 11:20:00,Papyan Karen - Asatryan Murad,3:1,9:11 - 7:11 - 11:8 - 1:11 - 0:0,1,3,Papyan Karen,Asatryan Murad,fiurst,Asatryan Murad - Papyan Karen,69,41,28,-13,13,20,18,19,12,0,-2,-4,3,-10,0,-13,11:9 - 11:7 - 8:11 - 11:1 - 0:0
17949273,2024-04-07 11:00:00,Hovhannesyan Rafik - Nikoghosyan Narek,3:2,11:6 - 8:11 - 11:6 - 13:15 - 11:4,3,2,Hovhannesyan Rafik,Nikoghosyan Narek,fiurst,Hovhannesyan Rafik - Nikoghosyan Narek,96,54,42,-12,12,17,19,17,28,15,-5,3,-5,2,-7,-12,11:6 - 8:11 - 11:6 - 13:15 - 11:4
17949237,2024-04-07 10:50:00,Nazaryan Mushegh - Asatryan Murad,3:0,9:11 - 4:11 - 3:11 - 0:0 - 0:0,0,3,Nazaryan Mushegh,Asatryan Murad,fiurst,Asatryan Murad - Nazaryan Mushegh,49,33,16,-17,17,20,15,14,0,0,-2,-7,-8,0,0,-17,11:9 - 11:4 - 11:3 - 0:0 - 0:0
17949236,2024-04-07 10:30:00,Papyan Karen - Hovhannesyan Rafik,1:3,11:6 - 11:9 - 12:14 - 12:10 - 0:0,3,1,Papyan Karen,Hovhannesyan Rafik,fiurst,Hovhannesyan Rafik - Papyan Karen,85,39,46,7,-7,17,20,26,22,0,5,2,-2,2,0,7,6:11 - 9:11 - 14:12 - 10:12 - 0:0
17949233,2024-04-07 10:15:00,Asatryan Murad - Nikoghosyan Narek,3:1,11:6 - 10:12 - 11:9 - 13:11 - 0:0,3,1,Asatryan Murad,Nikoghosyan Narek,fiurst,Asatryan Murad - Nikoghosyan Narek,83,45,38,-7,7,17,22,20,24,0,-5,2,-2,-2,0,-7,11:6 - 10:12 - 11:9 - 13:11 - 0:0
17949218,2024-04-07 10:00:00,Nazaryan Mushegh - Papyan Karen,2:3,8:11 - 13:11 - 11:6 - 8:11 - 8:11,2,3,Nazaryan Mushegh,Papyan Karen,fiurst,Nazaryan Mushegh - Papyan Karen,98,48,50,2,-2,19,24,17,19,19,3,-2,-5,3,3,2,8:11 - 13:11 - 11:6 - 8:11 - 8:11
17932880,2024-04-06 17:45:00,Hakobyan Eduard - Soghomonyan Hrayr,1:3,4:11 - 6:11 - 11:8 - 5:11 - 0:0,1,3,Hakobyan Eduard,Soghomonyan Hrayr,fiurst,Hakobyan Eduard - Soghomonyan Hrayr,67,26,41,15,-15,15,17,19,16,0,7,5,-3,6,0,15,4:11 - 6:11 - 11:8 - 5:11 - 0:0
17932878,2024-04-06 17:30:00,Avakimyan Davit - Gevorgyan Gegham,0:3,9:11 - 11:13 - 8:11 - 0:0 - 0:0,0,3,Avakimyan Davit,Gevorgyan Gegham,fiurst,Avakimyan Davit - Gevorgyan Gegham,63,28,35,7,-7,20,24,19,0,0,2,2,3,0,0,7,9:11 - 11:13 - 8:11 - 0:0 - 0:0
17932877,2024-04-06 17:15:00,Mkrtchyan Andranik - Hakobyan Eduard,3:1,5:11 - 7:11 - 12:10 - 7:11 - 0:0,1,3,Mkrtchyan Andranik,Hakobyan Eduard,fiurst,Hakobyan Eduard - Mkrtchyan Andranik,74,43,31,-12,12,16,18,22,18,0,-6,-4,2,-4,0,-12,11:5 - 11:7 - 10:12 - 11:7 - 0:0
17932873,2024-04-06 17:00:00,Avakimyan Davit - Soghomonyan Hrayr,1:3,5:11 - 11:8 - 3:11 - 6:11 - 0:0,1,3,Avakimyan Davit,Soghomonyan Hrayr,fiurst,Avakimyan Davit - Soghomonyan Hrayr,66,25,41,16,-16,16,19,14,17,0,6,-3,8,5,0,16,5:11 - 11:8 - 3:11 - 6:11 - 0:0
17932870,2024-04-06 16:45:00,Gevorgyan Gegham - Mkrtchyan Andranik,0:3,7:11 - 6:11 - 7:11 - 0:0 - 0:0,0,3,Gevorgyan Gegham,Mkrtchyan Andranik,fiurst,Gevorgyan Gegham - Mkrtchyan Andranik,53,20,33,13,-13,18,17,18,0,0,4,5,4,0,0,13,7:11 - 6:11 - 7:11 - 0:0 - 0:0
17932867,2024-04-06 16:30:00,Hakobyan Eduard - Avakimyan Davit,0:3,11:8 - 12:10 - 11:7 - 0:0 - 0:0,3,0,Hakobyan Eduard,Avakimyan Davit,fiurst,Avakimyan Davit - Hakobyan Eduard,59,25,34,9,-9,19,22,18,0,0,3,2,4,0,0,9,8:11 - 10:12 - 7:11 - 0:0 - 0:0
17932865,2024-04-06 16:15:00,Soghomonyan Hrayr - Mkrtchyan Andranik,0:3,14:12 - 12:10 - 13:11 - 0:0 - 0:0,3,0,Soghomonyan Hrayr,Mkrtchyan Andranik,fiurst,Mkrtchyan Andranik - Soghomonyan Hrayr,72,33,39,6,-6,26,22,24,0,0,2,2,2,0,0,6,12:14 - 10:12 - 11:13 - 0:0 - 0:0
17932456,2024-04-06 16:10:00,Gevorgyan Gegham - Hakobyan Eduard,1:3,6:11 - 4:11 - 14:12 - 8:11 - 0:0,1,3,Gevorgyan Gegham,Hakobyan Eduard,fiurst,Gevorgyan Gegham - Hakobyan Eduard,77,32,45,13,-13,17,15,26,19,0,5,7,-2,3,0,13,6:11 - 4:11 - 14:12 - 8:11 - 0:0
17932441,2024-04-06 15:45:00,Mkrtchyan Andranik - Avakimyan Davit,0:3,11:6 - 11:2 - 11:9 - 0:0 - 0:0,3,0,Mkrtchyan Andranik,Avakimyan Davit,fiurst,Avakimyan Davit - Mkrtchyan Andranik,50,17,33,16,-16,17,13,20,0,0,5,9,2,0,0,16,6:11 - 2:11 - 9:11 - 0:0 - 0:0
17932439,2024-04-06 15:40:00,Soghomonyan Hrayr - Gevorgyan Gegham,0:3,11:6 - 11:8 - 11:8 - 0:0 - 0:0,3,0,Soghomonyan Hrayr,Gevorgyan Gegham,fiurst,Gevorgyan Gegham - Soghomonyan Hrayr,55,22,33,11,-11,17,19,19,0,0,5,3,3,0,0,11,6:11 - 8:11 - 8:11 - 0:0 - 0:0
17932437,2024-04-06 15:15:00,Nazaryan Mushegh - Papyan Karen,2:3,10:12 - 11:7 - 11:5 - 10:12 - 10:12,2,3,Nazaryan Mushegh,Papyan Karen,fiurst,Nazaryan Mushegh - Papyan Karen,100,52,48,-4,4,22,18,16,22,22,2,-4,-6,2,2,-4,10:12 - 11:7 - 11:5 - 10:12 - 10:12
17932432,2024-04-06 15:05:00,Diaryan Aleksandr - Asatryan Murad,3:2,10:12 - 11:9 - 11:9 - 7:11 - 8:11,2,3,Diaryan Aleksandr,Asatryan Murad,fiurst,Asatryan Murad - Diaryan Aleksandr,99,52,47,-5,5,22,20,20,18,19,-2,2,2,-4,-3,-5,12:10 - 9:11 - 9:11 - 11:7 - 11:8
17932430,2024-04-06 14:50:00,Rafayelyan Edgar - Nazaryan Mushegh,3:0,8:11 - 7:11 - 9:11 - 0:0 - 0:0,0,3,Rafayelyan Edgar,Nazaryan Mushegh,fiurst,Nazaryan Mushegh - Rafayelyan Edgar,57,33,24,-9,9,19,18,20,0,0,-3,-4,-2,0,0,-9,11:8 - 11:7 - 11:9 - 0:0 - 0:0
17932428,2024-04-06 14:30:00,Papyan Karen - Diaryan Aleksandr,3:1,18:16 - 7:11 - 6:11 - 4:11 - 0:0,1,3,Papyan Karen,Diaryan Aleksandr,fiurst,Diaryan Aleksandr - Papyan Karen,84,49,35,-14,14,34,18,17,15,0,2,-4,-5,-7,0,-14,16:18 - 11:7 - 11:6 - 11:4 - 0:0
17932427,2024-04-06 14:15:00,Rafayelyan Edgar - Asatryan Murad,2:3,11:5 - 9:11 - 11:9 - 10:12 - 11:5,3,2,Rafayelyan Edgar,Asatryan Murad,fiurst,Asatryan Murad - Rafayelyan Edgar,94,42,52,10,-10,16,20,20,22,16,6,-2,2,-2,6,10,5:11 - 11:9 - 9:11 - 12:10 - 5:11
17932421,2024-04-06 14:00:00,Nazaryan Mushegh - Diaryan Aleksandr,3:0,7:11 - 4:11 - 7:11 - 0:0 - 0:0,0,3,Nazaryan Mushegh,Diaryan Aleksandr,fiurst,Diaryan Aleksandr - Nazaryan Mushegh,51,33,18,-15,15,18,15,18,0,0,-4,-7,-4,0,0,-15,11:7 - 11:4 - 11:7 - 0:0 - 0:0
17932419,2024-04-06 13:50:00,Papyan Karen - Rafayelyan Edgar,3:2,7:11 - 11:7 - 3:11 - 11:8 - 11:8,3,2,Papyan Karen,Rafayelyan Edgar,fiurst,Papyan Karen - Rafayelyan Edgar,88,43,45,2,-2,18,18,14,19,19,4,-4,8,-3,-3,2,7:11 - 11:7 - 3:11 - 11:8 - 11:8
17932410,2024-04-06 13:30:00,Asatryan Murad - Nazaryan Mushegh,3:0,11:4 - 11:9 - 11:3 - 0:0 - 0:0,3,0,Asatryan Murad,Nazaryan Mushegh,fiurst,Asatryan Murad - Nazaryan Mushegh,49,33,16,-17,17,15,20,14,0,0,-7,-2,-8,0,0,-17,11:4 - 11:9 - 11:3 - 0:0 - 0:0
17932405,2024-04-06 13:15:00,Diaryan Aleksandr - Rafayelyan Edgar,3:2,11:8 - 11:2 - 10:12 - 11:13 - 12:10,3,2,Diaryan Aleksandr,Rafayelyan Edgar,fiurst,Diaryan Aleksandr - Rafayelyan Edgar,100,55,45,-10,10,19,13,22,24,22,-3,-9,2,2,-2,-10,11:8 - 11:2 - 10:12 - 11:13 - 12:10
17932400,2024-04-06 13:10:00,Asatryan Murad - Papyan Karen,3:0,11:5 - 11:9 - 11:2 - 0:0 - 0:0,3,0,Asatryan Murad,Papyan Karen,fiurst,Asatryan Murad - Papyan Karen,49,33,16,-17,17,16,20,13,0,0,-6,-2,-9,0,0,-17,11:5 - 11:9 - 11:2 - 0:0 - 0:0
17932395,2024-04-06 12:20:00,Nazaryan Mushegh - Rafayelyan Edgar,3:0,11:7 - 11:9 - 11:8 - 0:0 - 0:0,3,0,Nazaryan Mushegh,Rafayelyan Edgar,fiurst,Nazaryan Mushegh - Rafayelyan Edgar,57,33,24,-9,9,18,20,19,0,0,-4,-2,-3,0,0,-9,11:7 - 11:9 - 11:8 - 0:0 - 0:0
17932392,2024-04-06 12:00:00,Asatryan Murad - Diaryan Aleksandr,0:3,12:14 - 9:11 - 8:11 - 0:0 - 0:0,0,3,Asatryan Murad,Diaryan Aleksandr,fiurst,Asatryan Murad - Diaryan Aleksandr,65,29,36,7,-7,26,20,19,0,0,2,2,3,0,0,7,12:14 - 9:11 - 8:11 - 0:0 - 0:0
17932374,2024-04-06 11:50:00,Papyan Karen - Nazaryan Mushegh,1:3,11:9 - 13:11 - 11:13 - 11:8 - 0:0,3,1,Papyan Karen,Nazaryan Mushegh,fiurst,Nazaryan Mushegh - Papyan Karen,87,41,46,5,-5,20,24,24,19,0,2,2,-2,3,0,5,9:11 - 11:13 - 13:11 - 8:11 - 0:0
17932366,2024-04-06 11:40:00,Asatryan Murad - Rafayelyan Edgar,3:0,11:5 - 11:9 - 11:8 - 0:0 - 0:0,3,0,Asatryan Murad,Rafayelyan Edgar,fiurst,Asatryan Murad - Rafayelyan Edgar,55,33,22,-11,11,16,20,19,0,0,-6,-2,-3,0,0,-11,11:5 - 11:9 - 11:8 - 0:0 - 0:0
17932364,2024-04-06 11:20:00,Diaryan Aleksandr - Papyan Karen,2:3,11:6 - 11:8 - 8:11 - 12:14 - 9:11,2,3,Diaryan Aleksandr,Papyan Karen,fiurst,Diaryan Aleksandr - Papyan Karen,101,51,50,-1,1,17,19,19,26,20,-5,-3,3,2,2,-1,11:6 - 11:8 - 8:11 - 12:14 - 9:11
17932363,2024-04-06 11:05:00,Nazaryan Mushegh - Asatryan Murad,3:2,15:13 - 11:8 - 6:11 - 7:11 - 5:11,2,3,Nazaryan Mushegh,Asatryan Murad,fiurst,Asatryan Murad - Nazaryan Mushegh,98,54,44,-10,10,28,19,17,18,16,2,3,-5,-4,-6,-10,13:15 - 8:11 - 11:6 - 11:7 - 11:5
17932357,2024-04-06 10:55:00,Rafayelyan Edgar - Papyan Karen,0:3,11:7 - 11:5 - 11:5 - 0:0 - 0:0,3,0,Rafayelyan Edgar,Papyan Karen,fiurst,Papyan Karen - Rafayelyan Edgar,50,17,33,16,-16,18,16,16,0,0,4,6,6,0,0,16,7:11 - 5:11 - 5:11 - 0:0 - 0:0
17932350,2024-04-06 10:30:00,Diaryan Aleksandr - Nazaryan Mushegh,3:1,12:10 - 8:11 - 11:8 - 11:4 - 0:0,3,1,Diaryan Aleksandr,Nazaryan Mushegh,fiurst,Diaryan Aleksandr - Nazaryan Mushegh,75,42,33,-9,9,22,19,19,15,0,-2,3,-3,-7,0,-9,12:10 - 8:11 - 11:8 - 11:4 - 0:0
17932346,2024-04-06 10:15:00,Papyan Karen - Asatryan Murad,3:2,7:11 - 11:7 - 5:11 - 11:6 - 6:11,2,3,Papyan Karen,Asatryan Murad,fiurst,Asatryan Murad - Papyan Karen,86,46,40,-6,6,18,18,16,17,17,-4,4,-6,5,-5,-6,11:7 - 7:11 - 11:5 - 6:11 - 11:6
17932344,2024-04-06 10:00:00,Rafayelyan Edgar - Diaryan Aleksandr,3:1,6:11 - 5:11 - 11:5 - 8:11 - 0:0,1,3,Rafayelyan Edgar,Diaryan Aleksandr,fiurst,Diaryan Aleksandr - Rafayelyan Edgar,68,38,30,-8,8,17,16,16,19,0,-5,-6,6,-3,0,-8,11:6 - 11:5 - 5:11 - 11:8 - 0:0
17913772,2024-04-05 17:45:00,Soghomonyan Hrayr - Gevorgyan Hayk,2:3,11:5 - 7:11 - 11:7 - 6:11 - 11:8,3,2,Soghomonyan Hrayr,Gevorgyan Hayk,fiurst,Gevorgyan Hayk - Soghomonyan Hrayr,88,42,46,4,-4,16,18,18,17,19,6,-4,4,-5,3,4,5:11 - 11:7 - 7:11 - 11:6 - 8:11
17913771,2024-04-05 17:30:00,Mkrtchyan Andranik - Hakobyan Eduard,3:1,6:11 - 8:11 - 11:9 - 10:12 - 0:0,1,3,Mkrtchyan Andranik,Hakobyan Eduard,fiurst,Hakobyan Eduard - Mkrtchyan Andranik,78,43,35,-8,8,17,19,20,22,0,-5,-3,2,-2,0,-8,11:6 - 11:8 - 9:11 - 12:10 - 0:0
17913769,2024-04-05 17:15:00,Petrosyan Davit - Soghomonyan Hrayr,1:3,11:8 - 6:11 - 10:12 - 10:12 - 0:0,1,3,Petrosyan Davit,Soghomonyan Hrayr,fiurst,Petrosyan Davit - Soghomonyan Hrayr,80,37,43,6,-6,19,17,22,22,0,-3,5,2,2,0,6,11:8 - 6:11 - 10:12 - 10:12 - 0:0
17913768,2024-04-05 17:10:00,Mkrtchyan Andranik - Gevorgyan Hayk,3:2,11:7 - 8:11 - 5:11 - 11:6 - 9:11,2,3,Mkrtchyan Andranik,Gevorgyan Hayk,fiurst,Gevorgyan Hayk - Mkrtchyan Andranik,90,46,44,-2,2,18,19,16,17,20,4,-3,-6,5,-2,-2,7:11 - 11:8 - 11:5 - 6:11 - 11:9
17913765,2024-04-05 16:50:00,Hakobyan Eduard - Petrosyan Davit,3:1,4:11 - 11:9 - 11:8 - 11:8 - 0:0,3,1,Hakobyan Eduard,Petrosyan Davit,fiurst,Hakobyan Eduard - Petrosyan Davit,73,37,36,-1,1,15,20,19,19,0,7,-2,-3,-3,0,-1,4:11 - 11:9 - 11:8 - 11:8 - 0:0
17913762,2024-04-05 16:30:00,Soghomonyan Hrayr - Mkrtchyan Andranik,3:2,11:8 - 9:11 - 9:11 - 11:6 - 8:11,2,3,Soghomonyan Hrayr,Mkrtchyan Andranik,fiurst,Mkrtchyan Andranik - Soghomonyan Hrayr,95,47,48,1,-1,19,20,20,17,19,3,-2,-2,5,-3,1,8:11 - 11:9 - 11:9 - 6:11 - 11:8
17913761,2024-04-05 16:15:00,Gevorgyan Hayk - Petrosyan Davit,3:2,9:11 - 7:11 - 13:11 - 11:5 - 11:3,3,2,Gevorgyan Hayk,Petrosyan Davit,fiurst,Gevorgyan Hayk - Petrosyan Davit,92,51,41,-10,10,20,18,24,16,14,2,4,-2,-6,-8,-10,9:11 - 7:11 - 13:11 - 11:5 - 11:3
17913759,2024-04-05 16:05:00,Hakobyan Eduard - Soghomonyan Hrayr,0:3,8:11 - 9:11 - 7:11 - 0:0 - 0:0,0,3,Hakobyan Eduard,Soghomonyan Hrayr,fiurst,Hakobyan Eduard - Soghomonyan Hrayr,57,24,33,9,-9,19,20,18,0,0,3,2,4,0,0,9,8:11 - 9:11 - 7:11 - 0:0 - 0:0
17913749,2024-04-05 15:55:00,Gevorgyan Hayk - Hakobyan Eduard,0:3,7:11 - 6:11 - 7:11 - 0:0 - 0:0,0,3,Gevorgyan Hayk,Hakobyan Eduard,fiurst,Gevorgyan Hayk - Hakobyan Eduard,53,20,33,13,-13,18,17,18,0,0,4,5,4,0,0,13,7:11 - 6:11 - 7:11 - 0:0 - 0:0
17913756,2024-04-05 15:45:00,Petrosyan Davit - Mkrtchyan Andranik,3:0,8:11 - 7:11 - 12:14 - 0:0 - 0:0,0,3,Petrosyan Davit,Mkrtchyan Andranik,fiurst,Mkrtchyan Andranik - Petrosyan Davit,63,36,27,-9,9,19,18,26,0,0,-3,-4,-2,0,0,-9,11:8 - 11:7 - 14:12 - 0:0 - 0:0
17913733,2024-04-05 15:20:00,Nikoghosyan Narek - Arutyunov Ruben,0:3,11:9 - 11:4 - 11:7 - 0:0 - 0:0,3,0,Nikoghosyan Narek,Arutyunov Ruben,fiurst,Arutyunov Ruben - Nikoghosyan Narek,53,20,33,13,-13,20,15,18,0,0,2,7,4,0,0,13,9:11 - 4:11 - 7:11 - 0:0 - 0:0
17913729,2024-04-05 15:05:00,Papyan Karen - Rafayelyan Edgar,0:3,9:11 - 3:11 - 6:11 - 0:0 - 0:0,0,3,Papyan Karen,Rafayelyan Edgar,fiurst,Papyan Karen - Rafayelyan Edgar,51,18,33,15,-15,20,14,17,0,0,2,8,5,0,0,15,9:11 - 3:11 - 6:11 - 0:0 - 0:0
17913722,2024-04-05 14:45:00,Hovhannesyan Rafik - Nikoghosyan Narek,2:3,11:7 - 14:12 - 6:11 - 6:11 - 8:11,2,3,Hovhannesyan Rafik,Nikoghosyan Narek,fiurst,Hovhannesyan Rafik - Nikoghosyan Narek,97,45,52,7,-7,18,26,17,17,19,-4,-2,5,5,3,7,11:7 - 14:12 - 6:11 - 6:11 - 8:11
17913721,2024-04-05 14:35:00,Arutyunov Ruben - Papyan Karen,1:3,8:11 - 11:8 - 6:11 - 10:12 - 0:0,1,3,Arutyunov Ruben,Papyan Karen,fiurst,Arutyunov Ruben - Papyan Karen,77,35,42,7,-7,19,19,17,22,0,3,-3,5,2,0,7,8:11 - 11:8 - 6:11 - 10:12 - 0:0
17913715,2024-04-05 14:25:00,Hovhannesyan Rafik - Rafayelyan Edgar,0:3,5:11 - 6:11 - 4:11 - 0:0 - 0:0,0,3,Hovhannesyan Rafik,Rafayelyan Edgar,fiurst,Hovhannesyan Rafik - Rafayelyan Edgar,48,15,33,18,-18,16,17,15,0,0,6,5,7,0,0,18,5:11 - 6:11 - 4:11 - 0:0 - 0:0
17913714,2024-04-05 14:00:00,Nikoghosyan Narek - Papyan Karen,1:3,7:11 - 10:12 - 11:9 - 3:11 - 0:0,1,3,Nikoghosyan Narek,Papyan Karen,fiurst,Nikoghosyan Narek - Papyan Karen,74,31,43,12,-12,18,22,20,14,0,4,2,-2,8,0,12,7:11 - 10:12 - 11:9 - 3:11 - 0:0
17913711,2024-04-05 13:45:00,Arutyunov Ruben - Hovhannesyan Rafik,3:1,7:11 - 12:10 - 11:2 - 12:10 - 0:0,3,1,Arutyunov Ruben,Hovhannesyan Rafik,fiurst,Arutyunov Ruben - Hovhannesyan Rafik,75,42,33,-9,9,18,22,13,22,0,4,-2,-9,-2,0,-9,7:11 - 12:10 - 11:2 - 12:10 - 0:0
17913698,2024-04-05 13:30:00,Rafayelyan Edgar - Nikoghosyan Narek,0:3,11:3 - 11:4 - 11:4 - 0:0 - 0:0,3,0,Rafayelyan Edgar,Nikoghosyan Narek,fiurst,Nikoghosyan Narek - Rafayelyan Edgar,44,11,33,22,-22,14,15,15,0,0,8,7,7,0,0,22,3:11 - 4:11 - 4:11 - 0:0 - 0:0
17913696,2024-04-05 13:15:00,Papyan Karen - Hovhannesyan Rafik,0:3,11:8 - 11:8 - 11:8 - 0:0 - 0:0,3,0,Papyan Karen,Hovhannesyan Rafik,fiurst,Hovhannesyan Rafik - Papyan Karen,57,24,33,9,-9,19,19,19,0,0,3,3,3,0,0,9,8:11 - 8:11 - 8:11 - 0:0 - 0:0
17913695,2024-04-05 13:00:00,Rafayelyan Edgar - Arutyunov Ruben,1:3,11:8 - 5:11 - 11:8 - 11:7 - 0:0,3,1,Rafayelyan Edgar,Arutyunov Ruben,fiurst,Arutyunov Ruben - Rafayelyan Edgar,72,34,38,4,-4,19,16,19,18,0,3,-6,3,4,0,4,8:11 - 11:5 - 8:11 - 7:11 - 0:0
17913694,2024-04-05 12:35:00,Nikoghosyan Narek - Hovhannesyan Rafik,0:3,11:3 - 11:9 - 11:6 - 0:0 - 0:0,3,0,Nikoghosyan Narek,Hovhannesyan Rafik,fiurst,Hovhannesyan Rafik - Nikoghosyan Narek,51,18,33,15,-15,14,20,17,0,0,8,2,5,0,0,15,3:11 - 9:11 - 6:11 - 0:0 - 0:0
17913693,2024-04-05 12:10:00,Rafayelyan Edgar - Papyan Karen,0:3,11:9 - 11:5 - 11:6 - 0:0 - 0:0,3,0,Rafayelyan Edgar,Papyan Karen,fiurst,Papyan Karen - Rafayelyan Edgar,53,20,33,13,-13,20,16,17,0,0,2,6,5,0,0,13,9:11 - 5:11 - 6:11 - 0:0 - 0:0
17913689,2024-04-05 11:55:00,Arutyunov Ruben - Nikoghosyan Narek,3:2,5:11 - 7:11 - 11:6 - 12:10 - 14:12,3,2,Arutyunov Ruben,Nikoghosyan Narek,fiurst,Arutyunov Ruben - Nikoghosyan Narek,99,49,50,1,-1,16,18,17,22,26,6,4,-5,-2,-2,1,5:11 - 7:11 - 11:6 - 12:10 - 14:12
17913686,2024-04-05 11:45:00,Rafayelyan Edgar - Hovhannesyan Rafik,1:3,10:12 - 11:6 - 11:9 - 11:4 - 0:0,3,1,Rafayelyan Edgar,Hovhannesyan Rafik,fiurst,Hovhannesyan Rafik - Rafayelyan Edgar,74,31,43,12,-12,22,17,20,15,0,-2,5,2,7,0,12,12:10 - 6:11 - 9:11 - 4:11 - 0:0
17913683,2024-04-05 11:20:00,Papyan Karen - Arutyunov Ruben,3:2,3:11 - 11:9 - 7:11 - 11:9 - 4:11,2,3,Papyan Karen,Arutyunov Ruben,fiurst,Arutyunov Ruben - Papyan Karen,87,51,36,-15,15,14,20,18,20,15,-8,2,-4,2,-7,-15,11:3 - 9:11 - 11:7 - 9:11 - 11:4
17913645,2024-04-05 11:15:00,Nikoghosyan Narek - Rafayelyan Edgar,3:1,12:14 - 11:8 - 11:7 - 15:13 - 0:0,3,1,Nikoghosyan Narek,Rafayelyan Edgar,fiurst,Nikoghosyan Narek - Rafayelyan Edgar,91,49,42,-7,7,26,19,18,28,0,2,-3,-4,-2,0,-7,12:14 - 11:8 - 11:7 - 15:13 - 0:0
17913643,2024-04-05 10:45:00,Hovhannesyan Rafik - Arutyunov Ruben,2:3,11:2 - 10:12 - 4:11 - 12:10 - 11:4,3,2,Hovhannesyan Rafik,Arutyunov Ruben,fiurst,Arutyunov Ruben - Hovhannesyan Rafik,87,39,48,9,-9,13,22,15,22,15,9,-2,-7,2,7,9,2:11 - 12:10 - 11:4 - 10:12 - 4:11
17913641,2024-04-05 10:30:00,Papyan Karen - Nikoghosyan Narek,3:2,11:7 - 5:11 - 6:11 - 15:13 - 10:12,2,3,Papyan Karen,Nikoghosyan Narek,fiurst,Nikoghosyan Narek - Papyan Karen,101,54,47,-7,7,18,16,17,28,22,4,-6,-5,2,-2,-7,7:11 - 11:5 - 11:6 - 13:15 - 12:10
17913624,2024-04-05 10:15:00,Arutyunov Ruben - Rafayelyan Edgar,0:3,10:12 - 5:11 - 6:11 - 0:0 - 0:0,0,3,Arutyunov Ruben,Rafayelyan Edgar,fiurst,Arutyunov Ruben - Rafayelyan Edgar,55,21,34,13,-13,22,16,17,0,0,2,6,5,0,0,13,10:12 - 5:11 - 6:11 - 0:0 - 0:0
17913623,2024-04-05 10:00:00,Hovhannesyan Rafik - Papyan Karen,1:3,11:6 - 10:12 - 8:11 - 0:11 - 0:0,1,3,Hovhannesyan Rafik,Papyan Karen,fiurst,Hovhannesyan Rafik - Papyan Karen,69,29,40,11,-11,17,22,19,11,0,-5,2,3,11,0,11,11:6 - 10:12 - 8:11 - 0:11 - 0:0
17891699,2024-04-04 17:45:00,Mkrtchyan Andranik - Petrosyan Davit,3:1,6:11 - 11:5 - 11:5 - 11:4 - 0:0,3,1,Mkrtchyan Andranik,Petrosyan Davit,fiurst,Mkrtchyan Andranik - Petrosyan Davit,64,39,25,-14,14,17,16,16,15,0,5,-6,-6,-7,0,-14,6:11 - 11:5 - 11:5 - 11:4 - 0:0
17891696,2024-04-04 17:40:00,Gevorgyan Gegham - Gevorgyan Hayk,2:3,11:6 - 8:11 - 11:5 - 8:11 - 3:11,2,3,Gevorgyan Gegham,Gevorgyan Hayk,fiurst,Gevorgyan Gegham - Gevorgyan Hayk,85,41,44,3,-3,17,19,16,19,14,-5,3,-6,3,8,3,11:6 - 8:11 - 11:5 - 8:11 - 3:11
17891694,2024-04-04 17:15:00,Avakimyan Davit - Mkrtchyan Andranik,1:3,11:9 - 4:11 - 10:12 - 6:11 - 0:0,1,3,Avakimyan Davit,Mkrtchyan Andranik,fiurst,Avakimyan Davit - Mkrtchyan Andranik,74,31,43,12,-12,20,15,22,17,0,-2,7,2,5,0,12,11:9 - 4:11 - 10:12 - 6:11 - 0:0
17891691,2024-04-04 17:00:00,Gevorgyan Gegham - Petrosyan Davit,2:3,7:11 - 9:11 - 11:6 - 11:8 - 9:11,2,3,Gevorgyan Gegham,Petrosyan Davit,fiurst,Gevorgyan Gegham - Petrosyan Davit,94,47,47,0,0,18,20,17,19,20,4,2,-5,-3,2,0,7:11 - 9:11 - 11:6 - 11:8 - 9:11
17891684,2024-04-04 16:45:00,Gevorgyan Hayk - Avakimyan Davit,0:3,11:9 - 11:5 - 11:2 - 0:0 - 0:0,3,0,Gevorgyan Hayk,Avakimyan Davit,fiurst,Avakimyan Davit - Gevorgyan Hayk,49,16,33,17,-17,20,16,13,0,0,2,6,9,0,0,17,9:11 - 5:11 - 2:11 - 0:0 - 0:0
17891680,2024-04-04 16:30:00,Mkrtchyan Andranik - Gevorgyan Gegham,1:3,11:9 - 9:11 - 11:4 - 12:10 - 0:0,3,1,Mkrtchyan Andranik,Gevorgyan Gegham,fiurst,Gevorgyan Gegham - Mkrtchyan Andranik,77,34,43,9,-9,20,20,15,22,0,2,-2,7,2,0,9,9:11 - 11:9 - 4:11 - 10:12 - 0:0
17891675,2024-04-04 16:15:00,Petrosyan Davit - Avakimyan Davit,1:3,8:11 - 11:9 - 11:5 - 14:12 - 0:0,3,1,Petrosyan Davit,Avakimyan Davit,fiurst,Avakimyan Davit - Petrosyan Davit,81,37,44,7,-7,19,20,16,26,0,-3,2,6,2,0,7,11:8 - 9:11 - 5:11 - 12:14 - 0:0
17891662,2024-04-04 16:00:00,Gevorgyan Hayk - Mkrtchyan Andranik,3:1,12:10 - 13:11 - 9:11 - 11:9 - 0:0,3,1,Gevorgyan Hayk,Mkrtchyan Andranik,fiurst,Gevorgyan Hayk - Mkrtchyan Andranik,86,45,41,-4,4,22,24,20,20,0,-2,-2,2,-2,0,-4,12:10 - 13:11 - 9:11 - 11:9 - 0:0
17891661,2024-04-04 15:45:00,Avakimyan Davit - Gevorgyan Gegham,1:3,6:11 - 12:10 - 4:11 - 9:11 - 0:0,1,3,Avakimyan Davit,Gevorgyan Gegham,fiurst,Avakimyan Davit - Gevorgyan Gegham,74,31,43,12,-12,17,22,15,20,0,5,-2,7,2,0,12,6:11 - 12:10 - 4:11 - 9:11 - 0:0
17891660,2024-04-04 15:30:00,Petrosyan Davit - Gevorgyan Hayk,3:1,11:6 - 8:11 - 6:11 - 3:11 - 0:0,1,3,Petrosyan Davit,Gevorgyan Hayk,fiurst,Gevorgyan Hayk - Petrosyan Davit,67,39,28,-11,11,17,19,17,14,0,5,-3,-5,-8,0,-11,6:11 - 11:8 - 11:6 - 11:3 - 0:0
17891293,2024-04-04 15:15:00,Asatryan Murad - Nazaryan Mushegh,3:0,11:5 - 11:3 - 11:4 - 0:0 - 0:0,3,0,Asatryan Murad,Nazaryan Mushegh,fiurst,Asatryan Murad - Nazaryan Mushegh,45,33,12,-21,21,16,14,15,0,0,-6,-8,-7,0,0,-21,11:5 - 11:3 - 11:4 - 0:0 - 0:0
17891292,2024-04-04 15:00:00,Hovhannesyan Rafik - Arutyunov Ruben,3:1,12:10 - 6:11 - 4:11 - 8:11 - 0:0,1,3,Hovhannesyan Rafik,Arutyunov Ruben,fiurst,Arutyunov Ruben - Hovhannesyan Rafik,73,43,30,-13,13,22,17,15,19,0,2,-5,-7,-3,0,-13,10:12 - 11:6 - 11:4 - 11:8 - 0:0
17891290,2024-04-04 14:50:00,Nikoghosyan Narek - Asatryan Murad,3:0,10:12 - 10:12 - 4:11 - 0:0 - 0:0,0,3,Nikoghosyan Narek,Asatryan Murad,fiurst,Asatryan Murad - Nikoghosyan Narek,59,35,24,-11,11,22,22,15,0,0,-2,-2,-7,0,0,-11,12:10 - 12:10 - 11:4 - 0:0 - 0:0
17891287,2024-04-04 14:35:00,Nazaryan Mushegh - Hovhannesyan Rafik,3:0,6:11 - 8:11 - 6:11 - 0:0 - 0:0,0,3,Nazaryan Mushegh,Hovhannesyan Rafik,fiurst,Hovhannesyan Rafik - Nazaryan Mushegh,53,33,20,-13,13,17,19,17,0,0,-5,-3,-5,0,0,-13,11:6 - 11:8 - 11:6 - 0:0 - 0:0
17891285,2024-04-04 14:15:00,Nikoghosyan Narek - Arutyunov Ruben,1:3,6:11 - 11:7 - 12:10 - 11:8 - 0:0,3,1,Nikoghosyan Narek,Arutyunov Ruben,fiurst,Arutyunov Ruben - Nikoghosyan Narek,76,36,40,4,-4,17,18,22,19,0,-5,4,2,3,0,4,11:6 - 7:11 - 10:12 - 8:11 - 0:0
17891282,2024-04-04 14:00:00,Asatryan Murad - Hovhannesyan Rafik,3:0,11:8 - 11:5 - 12:10 - 0:0 - 0:0,3,0,Asatryan Murad,Hovhannesyan Rafik,fiurst,Asatryan Murad - Hovhannesyan Rafik,57,34,23,-11,11,19,16,22,0,0,-3,-6,-2,0,0,-11,11:8 - 11:5 - 12:10 - 0:0 - 0:0
17891268,2024-04-04 13:45:00,Arutyunov Ruben - Asatryan Murad,1:3,11:4 - 4:11 - 4:11 - 3:11 - 0:0,1,3,Arutyunov Ruben,Asatryan Murad,fiurst,Arutyunov Ruben - Asatryan Murad,59,22,37,15,-15,15,15,15,14,0,-7,7,7,8,0,15,11:4 - 4:11 - 4:11 - 3:11 - 0:0
17891278,2024-04-04 13:45:00,Nazaryan Mushegh - Nikoghosyan Narek,0:3,8:11 - 10:12 - 3:11 - 0:0 - 0:0,0,3,Nazaryan Mushegh,Nikoghosyan Narek,fiurst,Nazaryan Mushegh - Nikoghosyan Narek,55,21,34,13,-13,19,22,14,0,0,3,2,8,0,0,13,8:11 - 10:12 - 3:11 - 0:0 - 0:0
17891251,2024-04-04 13:15:00,Hovhannesyan Rafik - Nikoghosyan Narek,0:3,8:11 - 7:11 - 6:11 - 0:0 - 0:0,0,3,Hovhannesyan Rafik,Nikoghosyan Narek,fiurst,Hovhannesyan Rafik - Nikoghosyan Narek,54,21,33,12,-12,19,18,17,0,0,3,4,5,0,0,12,8:11 - 7:11 - 6:11 - 0:0 - 0:0
17891249,2024-04-04 13:10:00,Arutyunov Ruben - Nazaryan Mushegh,3:1,11:8 - 11:7 - 8:11 - 11:7 - 0:0,3,1,Arutyunov Ruben,Nazaryan Mushegh,fiurst,Arutyunov Ruben - Nazaryan Mushegh,74,41,33,-8,8,19,18,19,18,0,-3,-4,3,-4,0,-8,11:8 - 11:7 - 8:11 - 11:7 - 0:0
17891244,2024-04-04 12:25:00,Arutyunov Ruben - Hovhannesyan Rafik,3:1,11:5 - 10:12 - 11:1 - 11:6 - 0:0,3,1,Arutyunov Ruben,Hovhannesyan Rafik,fiurst,Arutyunov Ruben - Hovhannesyan Rafik,67,43,24,-19,19,16,22,12,17,0,-6,2,-10,-5,0,-19,11:5 - 10:12 - 11:1 - 11:6 - 0:0
17891245,2024-04-04 12:25:00,Asatryan Murad - Nikoghosyan Narek,3:1,11:3 - 7:11 - 11:8 - 11:8 - 0:0,3,1,Asatryan Murad,Nikoghosyan Narek,fiurst,Asatryan Murad - Nikoghosyan Narek,70,40,30,-10,10,14,18,19,19,0,-8,4,-3,-3,0,-10,11:3 - 7:11 - 11:8 - 11:8 - 0:0
17891242,2024-04-04 12:05:00,Nazaryan Mushegh - Asatryan Murad,3:1,8:11 - 11:9 - 5:11 - 3:11 - 0:0,1,3,Nazaryan Mushegh,Asatryan Murad,fiurst,Asatryan Murad - Nazaryan Mushegh,69,42,27,-15,15,19,20,16,14,0,-3,2,-6,-8,0,-15,11:8 - 9:11 - 11:5 - 11:3 - 0:0
17891230,2024-04-04 11:35:00,Arutyunov Ruben - Nikoghosyan Narek,3:2,13:11 - 9:11 - 11:6 - 6:11 - 11:9,3,2,Arutyunov Ruben,Nikoghosyan Narek,fiurst,Arutyunov Ruben - Nikoghosyan Narek,98,50,48,-2,2,24,20,17,17,20,-2,2,-5,5,-2,-2,13:11 - 9:11 - 11:6 - 6:11 - 11:9
17891226,2024-04-04 11:30:00,Hovhannesyan Rafik - Nazaryan Mushegh,3:2,5:11 - 15:13 - 6:11 - 11:8 - 11:3,3,2,Hovhannesyan Rafik,Nazaryan Mushegh,fiurst,Hovhannesyan Rafik - Nazaryan Mushegh,94,48,46,-2,2,16,28,17,19,14,6,-2,5,-3,-8,-2,5:11 - 15:13 - 6:11 - 11:8 - 11:3
17891225,2024-04-04 11:00:00,Asatryan Murad - Arutyunov Ruben,0:3,11:4 - 11:7 - 11:9 - 0:0 - 0:0,3,0,Asatryan Murad,Arutyunov Ruben,fiurst,Arutyunov Ruben - Asatryan Murad,53,20,33,13,-13,15,18,20,0,0,7,4,2,0,0,13,4:11 - 7:11 - 9:11 - 0:0 - 0:0
17891223,2024-04-04 10:50:00,Nikoghosyan Narek - Nazaryan Mushegh,2:3,7:11 - 10:12 - 11:7 - 11:8 - 11:9,3,2,Nikoghosyan Narek,Nazaryan Mushegh,fiurst,Nazaryan Mushegh - Nikoghosyan Narek,97,47,50,3,-3,18,22,18,19,20,-4,-2,4,3,2,3,11:7 - 12:10 - 7:11 - 8:11 - 9:11
17891222,2024-04-04 10:40:00,Hovhannesyan Rafik - Asatryan Murad,3:0,9:11 - 10:12 - 10:12 - 0:0 - 0:0,0,3,Hovhannesyan Rafik,Asatryan Murad,fiurst,Asatryan Murad - Hovhannesyan Rafik,64,35,29,-6,6,20,22,22,0,0,-2,-2,-2,0,0,-6,11:9 - 12:10 - 12:10 - 0:0 - 0:0
17891219,2024-04-04 10:15:00,Nazaryan Mushegh - Arutyunov Ruben,1:3,14:12 - 5:11 - 13:11 - 11:4 - 0:0,3,1,Nazaryan Mushegh,Arutyunov Ruben,fiurst,Arutyunov Ruben - Nazaryan Mushegh,81,38,43,5,-5,26,16,24,15,0,2,-6,2,7,0,5,12:14 - 11:5 - 11:13 - 4:11 - 0:0
17891218,2024-04-04 10:00:00,Nikoghosyan Narek - Hovhannesyan Rafik,2:3,11:9 - 13:11 - 9:11 - 11:13 - 11:9,3,2,Nikoghosyan Narek,Hovhannesyan Rafik,fiurst,Hovhannesyan Rafik - Nikoghosyan Narek,108,53,55,2,-2,20,24,20,24,20,2,2,-2,-2,2,2,9:11 - 11:13 - 11:9 - 13:11 - 9:11
17877617,2024-04-03 17:45:00,Hakobyian Eduard - Gevorgyan Gegham,0:3,11:9 - 11:8 - 11:9 - 0:0 - 0:0,3,0,Hakobyian Eduard,Gevorgyan Gegham,fiurst,Gevorgyan Gegham - Hakobyian Eduard,59,26,33,7,-7,20,19,20,0,0,2,3,2,0,0,7,9:11 - 8:11 - 9:11 - 0:0 - 0:0
17877602,2024-04-03 17:30:00,Soghomonyan Hrayr - Avakimyan Davit,0:3,11:4 - 12:10 - 11:4 - 0:0 - 0:0,3,0,Soghomonyan Hrayr,Avakimyan Davit,fiurst,Avakimyan Davit - Soghomonyan Hrayr,52,18,34,16,-16,15,22,15,0,0,7,2,7,0,0,16,4:11 - 10:12 - 4:11 - 0:0 - 0:0
17877600,2024-04-03 17:15:00,Petrosyan Davit - Hakobyian Eduard,1:3,11:7 - 13:11 - 5:11 - 11:7 - 0:0,3,1,Petrosyan Davit,Hakobyian Eduard,fiurst,Hakobyian Eduard - Petrosyan Davit,76,36,40,4,-4,18,24,16,18,0,4,2,-6,4,0,4,7:11 - 11:13 - 11:5 - 7:11 - 0:0
17877596,2024-04-03 17:00:00,Soghomonyan Hrayr - Gevorgyan Gegham,0:3,11:7 - 11:8 - 11:9 - 0:0 - 0:0,3,0,Soghomonyan Hrayr,Gevorgyan Gegham,fiurst,Gevorgyan Gegham - Soghomonyan Hrayr,57,24,33,9,-9,18,19,20,0,0,4,3,2,0,0,9,7:11 - 8:11 - 9:11 - 0:0 - 0:0
17877594,2024-04-03 16:45:00,Avakimyan Davit - Petrosyan Davit,3:2,5:11 - 2:11 - 11:9 - 11:7 - 11:5,3,2,Avakimyan Davit,Petrosyan Davit,fiurst,Avakimyan Davit - Petrosyan Davit,83,40,43,3,-3,16,13,20,18,16,6,9,-2,-4,-6,3,5:11 - 2:11 - 11:9 - 11:7 - 11:5
17877593,2024-04-03 16:30:00,Hakobyian Eduard - Soghomonyan Hrayr,0:3,6:11 - 6:11 - 7:11 - 0:0 - 0:0,0,3,Hakobyian Eduard,Soghomonyan Hrayr,fiurst,Hakobyian Eduard - Soghomonyan Hrayr,52,19,33,14,-14,17,17,18,0,0,5,5,4,0,0,14,6:11 - 6:11 - 7:11 - 0:0 - 0:0
17877589,2024-04-03 16:15:00,Gevorgyan Gegham - Petrosyan Davit,0:3,6:11 - 5:11 - 3:11 - 0:0 - 0:0,0,3,Gevorgyan Gegham,Petrosyan Davit,fiurst,Gevorgyan Gegham - Petrosyan Davit,47,14,33,19,-19,17,16,14,0,0,5,6,8,0,0,19,6:11 - 5:11 - 3:11 - 0:0 - 0:0
17877588,2024-04-03 16:00:00,Avakimyan Davit - Hakobyian Eduard,2:3,6:11 - 11:9 - 11:9 - 9:11 - 6:11,2,3,Avakimyan Davit,Hakobyian Eduard,fiurst,Avakimyan Davit - Hakobyian Eduard,94,43,51,8,-8,17,20,20,20,17,5,-2,-2,2,5,8,6:11 - 11:9 - 11:9 - 9:11 - 6:11
17877587,2024-04-03 15:45:00,Petrosyan Davit - Soghomonyan Hrayr,0:3,8:11 - 2:11 - 4:11 - 0:0 - 0:0,0,3,Petrosyan Davit,Soghomonyan Hrayr,fiurst,Petrosyan Davit - Soghomonyan Hrayr,47,14,33,19,-19,19,13,15,0,0,3,9,7,0,0,19,8:11 - 2:11 - 4:11 - 0:0 - 0:0
17877582,2024-04-03 15:30:00,Gevorgyan Gegham - Avakimyan Davit,3:2,11:9 - 8:11 - 8:11 - 11:7 - 8:11,2,3,Gevorgyan Gegham,Avakimyan Davit,fiurst,Avakimyan Davit - Gevorgyan Gegham,95,49,46,-3,3,20,19,19,18,19,2,-3,-3,4,-3,-3,9:11 - 11:8 - 11:8 - 7:11 - 11:8
17877574,2024-04-03 15:25:00,Rafayelyan Edgar - Diaryan Aleksandr,2:3,9:11 - 11:5 - 7:11 - 11:8 - 12:10,3,2,Rafayelyan Edgar,Diaryan Aleksandr,fiurst,Diaryan Aleksandr - Rafayelyan Edgar,95,45,50,5,-5,20,16,18,19,22,-2,6,-4,3,2,5,11:9 - 5:11 - 11:7 - 8:11 - 10:12
17877570,2024-04-03 15:10:00,Arutyunov Ruben - Rafayelyan Edgar,0:3,7:11 - 5:11 - 8:11 - 0:0 - 0:0,0,3,Arutyunov Ruben,Rafayelyan Edgar,fiurst,Arutyunov Ruben - Rafayelyan Edgar,53,20,33,13,-13,18,16,19,0,0,4,6,3,0,0,13,7:11 - 5:11 - 8:11 - 0:0 - 0:0
17877572,2024-04-03 15:10:00,Nikoghosyan Narek - Papyan Karen,3:0,11:5 - 11:7 - 14:12 - 0:0 - 0:0,3,0,Nikoghosyan Narek,Papyan Karen,fiurst,Nikoghosyan Narek - Papyan Karen,60,36,24,-12,12,16,18,26,0,0,-6,-4,-2,0,0,-12,11:5 - 11:7 - 14:12 - 0:0 - 0:0
17877566,2024-04-03 14:35:00,Arutyunov Ruben - Papyan Karen,3:2,13:15 - 11:9 - 11:6 - 12:14 - 15:13,3,2,Arutyunov Ruben,Papyan Karen,fiurst,Arutyunov Ruben - Papyan Karen,119,62,57,-5,5,28,20,17,26,28,2,-2,-5,2,-2,-5,13:15 - 11:9 - 11:6 - 12:14 - 15:13
17877567,2024-04-03 14:30:00,Diaryan Aleksandr - Nikoghosyan Narek,2:3,11:3 - 11:3 - 6:11 - 6:11 - 9:11,2,3,Diaryan Aleksandr,Nikoghosyan Narek,fiurst,Diaryan Aleksandr - Nikoghosyan Narek,82,43,39,-4,4,14,14,17,17,20,-8,-8,5,5,2,-4,11:3 - 11:3 - 6:11 - 6:11 - 9:11
17877562,2024-04-03 14:00:00,Diaryan Aleksandr - Arutyunov Ruben,1:3,9:11 - 14:12 - 11:7 - 11:7 - 0:0,3,1,Diaryan Aleksandr,Arutyunov Ruben,fiurst,Arutyunov Ruben - Diaryan Aleksandr,82,37,45,8,-8,20,26,18,18,0,-2,2,4,4,0,8,11:9 - 12:14 - 7:11 - 7:11 - 0:0
17877563,2024-04-03 14:00:00,Rafayelyan Edgar - Nikoghosyan Narek,3:0,5:11 - 8:11 - 5:11 - 0:0 - 0:0,0,3,Rafayelyan Edgar,Nikoghosyan Narek,fiurst,Nikoghosyan Narek - Rafayelyan Edgar,51,33,18,-15,15,16,19,16,0,0,-6,-3,-6,0,0,-15,11:5 - 11:8 - 11:5 - 0:0 - 0:0
17877561,2024-04-03 13:30:00,Papyan Karen - Rafayelyan Edgar,0:3,5:11 - 5:11 - 5:11 - 0:0 - 0:0,0,3,Papyan Karen,Rafayelyan Edgar,fiurst,Papyan Karen - Rafayelyan Edgar,48,15,33,18,-18,16,16,16,0,0,6,6,6,0,0,18,5:11 - 5:11 - 5:11 - 0:0 - 0:0
17877475,2024-04-03 13:15:00,Nikoghosyan Narek - Arutyunov Ruben,1:3,11:8 - 12:14 - 11:6 - 12:10 - 0:0,3,1,Nikoghosyan Narek,Arutyunov Ruben,fiurst,Arutyunov Ruben - Nikoghosyan Narek,84,38,46,8,-8,19,26,17,22,0,3,-2,5,2,0,8,8:11 - 14:12 - 6:11 - 10:12 - 0:0
17877463,2024-04-03 13:00:00,Papyan Karen - Diaryan Aleksandr,3:0,13:15 - 8:11 - 3:11 - 0:0 - 0:0,0,3,Papyan Karen,Diaryan Aleksandr,fiurst,Diaryan Aleksandr - Papyan Karen,61,37,24,-13,13,28,19,14,0,0,-2,-3,-8,0,0,-13,15:13 - 11:8 - 11:3 - 0:0 - 0:0
17877462,2024-04-03 12:15:00,Rafayelyan Edgar - Arutyunov Ruben,1:3,11:7 - 6:11 - 11:1 - 13:11 - 0:0,3,1,Rafayelyan Edgar,Arutyunov Ruben,fiurst,Arutyunov Ruben - Rafayelyan Edgar,71,30,41,11,-11,18,17,12,24,0,4,-5,10,2,0,11,7:11 - 11:6 - 1:11 - 11:13 - 0:0
17877461,2024-04-03 12:10:00,Papyan Karen - Nikoghosyan Narek,2:3,13:11 - 11:9 - 6:11 - 9:11 - 11:7,3,2,Papyan Karen,Nikoghosyan Narek,fiurst,Nikoghosyan Narek - Papyan Karen,99,49,50,1,-1,24,20,17,20,18,2,2,-5,-2,4,1,11:13 - 9:11 - 11:6 - 11:9 - 7:11
17877460,2024-04-03 11:45:00,Diaryan Aleksandr - Rafayelyan Edgar,1:3,10:12 - 9:11 - 11:9 - 8:11 - 0:0,1,3,Diaryan Aleksandr,Rafayelyan Edgar,fiurst,Diaryan Aleksandr - Rafayelyan Edgar,81,38,43,5,-5,22,20,20,19,0,2,2,-2,3,0,5,10:12 - 9:11 - 11:9 - 8:11 - 0:0
17877458,2024-04-03 11:35:00,Papyan Karen - Arutyunov Ruben,1:3,11:9 - 13:11 - 7:11 - 11:8 - 0:0,3,1,Papyan Karen,Arutyunov Ruben,fiurst,Arutyunov Ruben - Papyan Karen,81,39,42,3,-3,20,24,18,19,0,2,2,-4,3,0,3,9:11 - 11:13 - 11:7 - 8:11 - 0:0
17877457,2024-04-03 11:15:00,Nikoghosyan Narek - Diaryan Aleksandr,0:3,11:1 - 11:7 - 11:4 - 0:0 - 0:0,3,0,Nikoghosyan Narek,Diaryan Aleksandr,fiurst,Diaryan Aleksandr - Nikoghosyan Narek,45,12,33,21,-21,12,18,15,0,0,10,4,7,0,0,21,1:11 - 7:11 - 4:11 - 0:0 - 0:0
17877447,2024-04-03 11:10:00,Rafayelyan Edgar - Papyan Karen,0:3,11:8 - 11:9 - 11:6 - 0:0 - 0:0,3,0,Rafayelyan Edgar,Papyan Karen,fiurst,Papyan Karen - Rafayelyan Edgar,56,23,33,10,-10,19,20,17,0,0,3,2,5,0,0,10,8:11 - 9:11 - 6:11 - 0:0 - 0:0
17877445,2024-04-03 10:50:00,Arutyunov Ruben - Diaryan Aleksandr,1:3,7:11 - 11:7 - 1:11 - 4:11 - 0:0,1,3,Arutyunov Ruben,Diaryan Aleksandr,fiurst,Arutyunov Ruben - Diaryan Aleksandr,63,23,40,17,-17,18,18,12,15,0,4,-4,10,7,0,17,7:11 - 11:7 - 1:11 - 4:11 - 0:0
17877443,2024-04-03 10:40:00,Nikoghosyan Narek - Rafayelyan Edgar,1:3,11:13 - 10:12 - 11:8 - 8:11 - 0:0,1,3,Nikoghosyan Narek,Rafayelyan Edgar,fiurst,Nikoghosyan Narek - Rafayelyan Edgar,84,40,44,4,-4,24,22,19,19,0,2,2,-3,3,0,4,11:13 - 10:12 - 11:8 - 8:11 - 0:0
17877432,2024-04-03 10:15:00,Diaryan Aleksandr - Papyan Karen,3:1,11:7 - 10:12 - 11:3 - 11:9 - 0:0,3,1,Diaryan Aleksandr,Papyan Karen,fiurst,Diaryan Aleksandr - Papyan Karen,74,43,31,-12,12,18,22,14,20,0,-4,2,-8,-2,0,-12,11:7 - 10:12 - 11:3 - 11:9 - 0:0
17877429,2024-04-03 10:10:00,Arutyunov Ruben - Nikoghosyan Narek,3:2,8:11 - 8:11 - 11:6 - 11:7 - 12:10,3,2,Arutyunov Ruben,Nikoghosyan Narek,fiurst,Arutyunov Ruben - Nikoghosyan Narek,95,50,45,-5,5,19,19,17,18,22,3,3,-5,-4,-2,-5,8:11 - 8:11 - 11:6 - 11:7 - 12:10
17850456,2024-04-02 17:45:00,Miroyan Hakob - Babakhanyan Artak,0:3,11:9 - 11:3 - 11:9 - 0:0 - 0:0,3,0,Miroyan Hakob,Babakhanyan Artak,fiurst,Babakhanyan Artak - Miroyan Hakob,54,21,33,12,-12,20,14,20,0,0,2,8,2,0,0,12,9:11 - 3:11 - 9:11 - 0:0 - 0:0
17850454,2024-04-02 17:30:00,Petrosyan Karen - Karakhanyan Mher,3:1,11:8 - 5:11 - 6:11 - 6:11 - 0:0,1,3,Petrosyan Karen,Karakhanyan Mher,fiurst,Karakhanyan Mher - Petrosyan Karen,69,41,28,-13,13,19,16,17,17,0,3,-6,-5,-5,0,-13,8:11 - 11:5 - 11:6 - 11:6 - 0:0
17850451,2024-04-02 17:15:00,Grigoryan Erik - Miroyan Hakob,3:0,11:6 - 11:6 - 11:7 - 0:0 - 0:0,3,0,Grigoryan Erik,Miroyan Hakob,fiurst,Grigoryan Erik - Miroyan Hakob,52,33,19,-14,14,17,17,18,0,0,-5,-5,-4,0,0,-14,11:6 - 11:6 - 11:7 - 0:0 - 0:0
17850435,2024-04-02 17:00:00,Babakhanyan Artak - Darbinyan Armen,1:3,8:11 - 11:7 - 6:11 - 14:16 - 0:0,1,3,Babakhanyan Artak,Darbinyan Armen,fiurst,Babakhanyan Artak - Darbinyan Armen,84,39,45,6,-6,19,18,17,30,0,3,-4,5,2,0,6,8:11 - 11:7 - 6:11 - 14:16 - 0:0
17850432,2024-04-02 16:45:00,Karakhanyan Mher - Miroyan Hakob,0:3,5:11 - 6:11 - 6:11 - 0:0 - 0:0,0,3,Karakhanyan Mher,Miroyan Hakob,fiurst,Karakhanyan Mher - Miroyan Hakob,50,17,33,16,-16,16,17,17,0,0,6,5,5,0,0,16,5:11 - 6:11 - 6:11 - 0:0 - 0:0
17850429,2024-04-02 16:30:00,Darbinyan Armen - Petrosyan Karen,3:0,12:10 - 11:7 - 11:9 - 0:0 - 0:0,3,0,Darbinyan Armen,Petrosyan Karen,fiurst,Darbinyan Armen - Petrosyan Karen,60,34,26,-8,8,22,18,20,0,0,-2,-4,-2,0,0,-8,12:10 - 11:7 - 11:9 - 0:0 - 0:0
17850406,2024-04-02 16:15:00,Grigoryan Erik - Babakhanyan Artak,1:3,6:11 - 11:1 - 11:9 - 11:8 - 0:0,3,1,Grigoryan Erik,Babakhanyan Artak,fiurst,Babakhanyan Artak - Grigoryan Erik,68,29,39,10,-10,17,12,20,19,0,-5,10,2,3,0,10,11:6 - 1:11 - 9:11 - 8:11 - 0:0
17850402,2024-04-02 16:00:00,Miroyan Hakob - Darbinyan Armen,3:1,11:8 - 9:11 - 8:11 - 8:11 - 0:0,1,3,Miroyan Hakob,Darbinyan Armen,fiurst,Darbinyan Armen - Miroyan Hakob,77,41,36,-5,5,19,20,19,19,0,3,-2,-3,-3,0,-5,8:11 - 11:9 - 11:8 - 11:8 - 0:0
17850401,2024-04-02 15:45:00,Grigoryan Erik - Karakhanyan Mher,3:0,11:2 - 11:6 - 11:9 - 0:0 - 0:0,3,0,Grigoryan Erik,Karakhanyan Mher,fiurst,Grigoryan Erik - Karakhanyan Mher,50,33,17,-16,16,13,17,20,0,0,-9,-5,-2,0,0,-16,11:2 - 11:6 - 11:9 - 0:0 - 0:0
17850389,2024-04-02 15:30:00,Babakhanyan Artak - Petrosyan Karen,3:0,11:5 - 12:10 - 11:7 - 0:0 - 0:0,3,0,Babakhanyan Artak,Petrosyan Karen,fiurst,Babakhanyan Artak - Petrosyan Karen,56,34,22,-12,12,16,22,18,0,0,-6,-2,-4,0,0,-12,11:5 - 12:10 - 11:7 - 0:0 - 0:0
17843495,2024-04-02 15:15:00,Gevorgyan Hayk - Gevorgyan Gegham,0:3,11:3 - 11:7 - 11:9 - 0:0 - 0:0,3,0,Gevorgyan Hayk,Gevorgyan Gegham,fiurst,Gevorgyan Gegham - Gevorgyan Hayk,52,19,33,14,-14,14,18,20,0,0,8,4,2,0,0,14,3:11 - 7:11 - 9:11 - 0:0 - 0:0
17843491,2024-04-02 15:00:00,Petrosyan Davit - Hakobyian Eduard,3:0,11:13 - 9:11 - 7:11 - 0:0 - 0:0,0,3,Petrosyan Davit,Hakobyian Eduard,fiurst,Hakobyian Eduard - Petrosyan Davit,62,35,27,-8,8,24,20,18,0,0,-2,-2,-4,0,0,-8,13:11 - 11:9 - 11:7 - 0:0 - 0:0
17843490,2024-04-02 14:45:00,Mkrtchyan Andranik - Gevorgyan Hayk,2:3,4:11 - 4:11 - 11:7 - 11:3 - 11:3,3,2,Mkrtchyan Andranik,Gevorgyan Hayk,fiurst,Gevorgyan Hayk - Mkrtchyan Andranik,76,35,41,6,-6,15,15,18,14,14,-7,-7,4,8,8,6,11:4 - 11:4 - 7:11 - 3:11 - 3:11
17843487,2024-04-02 14:30:00,Gevorgyan Gegham - Petrosyan Davit,3:0,11:4 - 11:9 - 11:9 - 0:0 - 0:0,3,0,Gevorgyan Gegham,Petrosyan Davit,fiurst,Gevorgyan Gegham - Petrosyan Davit,55,33,22,-11,11,15,20,20,0,0,-7,-2,-2,0,0,-11,11:4 - 11:9 - 11:9 - 0:0 - 0:0
17843486,2024-04-02 14:15:00,Mkrtchyan Andranik - Hakobyian Eduard,3:1,8:11 - 9:11 - 11:9 - 7:11 - 0:0,1,3,Mkrtchyan Andranik,Hakobyian Eduard,fiurst,Hakobyian Eduard - Mkrtchyan Andranik,77,42,35,-7,7,19,20,20,18,0,-3,-2,2,-4,0,-7,11:8 - 11:9 - 9:11 - 11:7 - 0:0
17843473,2024-04-02 14:00:00,Gevorgyan Hayk - Petrosyan Davit,3:0,11:9 - 11:4 - 11:6 - 0:0 - 0:0,3,0,Gevorgyan Hayk,Petrosyan Davit,fiurst,Gevorgyan Hayk - Petrosyan Davit,52,33,19,-14,14,20,15,17,0,0,-2,-7,-5,0,0,-14,11:9 - 11:4 - 11:6 - 0:0 - 0:0
17843471,2024-04-02 13:45:00,Gevorgyan Gegham - Mkrtchyan Andranik,1:3,11:9 - 10:12 - 8:11 - 9:11 - 0:0,1,3,Gevorgyan Gegham,Mkrtchyan Andranik,fiurst,Gevorgyan Gegham - Mkrtchyan Andranik,81,38,43,5,-5,20,22,19,20,0,-2,2,3,2,0,5,11:9 - 10:12 - 8:11 - 9:11 - 0:0
17843470,2024-04-02 13:30:00,Hakobyian Eduard - Gevorgyan Hayk,0:3,12:10 - 11:4 - 11:8 - 0:0 - 0:0,3,0,Hakobyian Eduard,Gevorgyan Hayk,fiurst,Gevorgyan Hayk - Hakobyian Eduard,56,22,34,12,-12,22,15,19,0,0,2,7,3,0,0,12,10:12 - 4:11 - 8:11 - 0:0 - 0:0
17843468,2024-04-02 13:15:00,Petrosyan Davit - Mkrtchyan Andranik,3:0,5:11 - 8:11 - 7:11 - 0:0 - 0:0,0,3,Petrosyan Davit,Mkrtchyan Andranik,fiurst,Mkrtchyan Andranik - Petrosyan Davit,53,33,20,-13,13,16,19,18,0,0,-6,-3,-4,0,0,-13,11:5 - 11:8 - 11:7 - 0:0 - 0:0
17843465,2024-04-02 13:00:00,Hakobyian Eduard - Gevorgyan Gegham,2:3,8:11 - 11:7 - 11:13 - 11:4 - 11:5,3,2,Hakobyian Eduard,Gevorgyan Gegham,fiurst,Gevorgyan Gegham - Hakobyian Eduard,92,40,52,12,-12,19,18,24,15,16,-3,4,-2,7,6,12,11:8 - 7:11 - 13:11 - 4:11 - 5:11
17843463,2024-04-02 12:30:00,Gevorgyan Hayk - Mkrtchyan Andranik,1:3,11:7 - 7:11 - 5:11 - 5:11 - 0:0,1,3,Gevorgyan Hayk,Mkrtchyan Andranik,fiurst,Gevorgyan Hayk - Mkrtchyan Andranik,68,28,40,12,-12,18,18,16,16,0,-4,4,6,6,0,12,11:7 - 7:11 - 5:11 - 5:11 - 0:0
17843462,2024-04-02 12:00:00,Hakobyian Eduard - Petrosyan Davit,3:0,11:2 - 11:8 - 11:9 - 0:0 - 0:0,3,0,Hakobyian Eduard,Petrosyan Davit,fiurst,Hakobyian Eduard - Petrosyan Davit,52,33,19,-14,14,13,19,20,0,0,-9,-3,-2,0,0,-14,11:2 - 11:8 - 11:9 - 0:0 - 0:0
17843461,2024-04-02 11:50:00,Gevorgyan Gegham - Gevorgyan Hayk,2:3,11:9 - 8:11 - 6:11 - 15:13 - 6:11,2,3,Gevorgyan Gegham,Gevorgyan Hayk,fiurst,Gevorgyan Gegham - Gevorgyan Hayk,101,46,55,9,-9,20,19,17,28,17,-2,3,5,-2,5,9,11:9 - 8:11 - 6:11 - 15:13 - 6:11
17843456,2024-04-02 11:30:00,Hakobyian Eduard - Mkrtchyan Andranik,3:1,11:8 - 11:9 - 9:11 - 11:4 - 0:0,3,1,Hakobyian Eduard,Mkrtchyan Andranik,fiurst,Hakobyian Eduard - Mkrtchyan Andranik,74,42,32,-10,10,19,20,20,15,0,-3,-2,2,-7,0,-10,11:8 - 11:9 - 9:11 - 11:4 - 0:0
17843446,2024-04-02 11:20:00,Petrosyan Davit - Gevorgyan Gegham,3:1,11:9 - 8:11 - 10:12 - 8:11 - 0:0,1,3,Petrosyan Davit,Gevorgyan Gegham,fiurst,Gevorgyan Gegham - Petrosyan Davit,80,43,37,-6,6,20,19,22,19,0,2,-3,-2,-3,0,-6,9:11 - 11:8 - 12:10 - 11:8 - 0:0
17843410,2024-04-02 11:00:00,Gevorgyan Hayk - Hakobyian Eduard,3:2,11:8 - 7:11 - 11:6 - 8:11 - 14:12,3,2,Gevorgyan Hayk,Hakobyian Eduard,fiurst,Gevorgyan Hayk - Hakobyian Eduard,99,51,48,-3,3,19,18,17,19,26,-3,4,-5,3,-2,-3,11:8 - 7:11 - 11:6 - 8:11 - 14:12
17843374,2024-04-02 10:45:00,Mkrtchyan Andranik - Gevorgyan Gegham,1:3,5:11 - 13:11 - 17:15 - 14:12 - 0:0,3,1,Mkrtchyan Andranik,Gevorgyan Gegham,fiurst,Gevorgyan Gegham - Mkrtchyan Andranik,98,49,49,0,0,16,24,32,26,0,-6,2,2,2,0,0,11:5 - 11:13 - 15:17 - 12:14 - 0:0
17843335,2024-04-02 10:30:00,Petrosyan Davit - Gevorgyan Hayk,3:1,3:11 - 6:11 - 11:5 - 3:11 - 0:0,1,3,Petrosyan Davit,Gevorgyan Hayk,fiurst,Gevorgyan Hayk - Petrosyan Davit,61,38,23,-15,15,14,17,16,14,0,-8,-5,6,-8,0,-15,11:3 - 11:6 - 5:11 - 11:3 - 0:0
17843322,2024-04-02 10:15:00,Gevorgyan Gegham - Hakobyian Eduard,3:2,8:11 - 12:10 - 11:7 - 4:11 - 11:3,3,2,Gevorgyan Gegham,Hakobyian Eduard,fiurst,Gevorgyan Gegham - Hakobyian Eduard,88,46,42,-4,4,19,22,18,15,14,3,-2,-4,7,-8,-4,8:11 - 12:10 - 11:7 - 4:11 - 11:3
17843320,2024-04-02 10:00:00,Mkrtchyan Andranik - Petrosyan Davit,3:0,11:7 - 11:7 - 11:7 - 0:0 - 0:0,3,0,Mkrtchyan Andranik,Petrosyan Davit,fiurst,Mkrtchyan Andranik - Petrosyan Davit,54,33,21,-12,12,18,18,18,0,0,-4,-4,-4,0,0,-12,11:7 - 11:7 - 11:7 - 0:0 - 0:0
17825357,2024-04-01 17:45:00,Mkrtchyan Andranik - Hakobyian Eduard,2:3,9:11 - 7:11 - 12:10 - 11:3 - 11:4,3,2,Mkrtchyan Andranik,Hakobyian Eduard,fiurst,Hakobyian Eduard - Mkrtchyan Andranik,89,39,50,11,-11,20,18,22,14,15,-2,-4,2,8,7,11,11:9 - 11:7 - 10:12 - 3:11 - 4:11
17825354,2024-04-01 17:30:00,Petrosyan Davit - Gevorgyan Hayk,3:0,10:12 - 4:11 - 3:11 - 0:0 - 0:0,0,3,Petrosyan Davit,Gevorgyan Hayk,fiurst,Gevorgyan Hayk - Petrosyan Davit,51,34,17,-17,17,22,15,14,0,0,-2,-7,-8,0,0,-17,12:10 - 11:4 - 11:3 - 0:0 - 0:0
17825353,2024-04-01 17:15:00,Soghomonyan Hrayr - Mkrtchyan Andranik,1:3,11:7 - 10:12 - 12:10 - 11:8 - 0:0,3,1,Soghomonyan Hrayr,Mkrtchyan Andranik,fiurst,Mkrtchyan Andranik - Soghomonyan Hrayr,81,37,44,7,-7,18,22,22,19,0,4,-2,2,3,0,7,7:11 - 12:10 - 10:12 - 8:11 - 0:0
17825349,2024-04-01 17:00:00,Petrosyan Davit - Hakobyian Eduard,3:0,11:13 - 8:11 - 8:11 - 0:0 - 0:0,0,3,Petrosyan Davit,Hakobyian Eduard,fiurst,Hakobyian Eduard - Petrosyan Davit,62,35,27,-8,8,24,19,19,0,0,-2,-3,-3,0,0,-8,13:11 - 11:8 - 11:8 - 0:0 - 0:0
17825347,2024-04-01 16:45:00,Gevorgyan Hayk - Soghomonyan Hrayr,1:3,7:11 - 8:11 - 11:9 - 7:11 - 0:0,1,3,Gevorgyan Hayk,Soghomonyan Hrayr,fiurst,Gevorgyan Hayk - Soghomonyan Hrayr,75,33,42,9,-9,18,19,20,18,0,4,3,-2,4,0,9,7:11 - 8:11 - 11:9 - 7:11 - 0:0
17825345,2024-04-01 16:30:00,Mkrtchyan Andranik - Petrosyan Davit,3:0,11:9 - 11:8 - 11:4 - 0:0 - 0:0,3,0,Mkrtchyan Andranik,Petrosyan Davit,fiurst,Mkrtchyan Andranik - Petrosyan Davit,54,33,21,-12,12,20,19,15,0,0,-2,-3,-7,0,0,-12,11:9 - 11:8 - 11:4 - 0:0 - 0:0
17825331,2024-04-01 16:15:00,Hakobyian Eduard - Soghomonyan Hrayr,1:3,11:5 - 10:12 - 9:11 - 9:11 - 0:0,1,3,Hakobyian Eduard,Soghomonyan Hrayr,fiurst,Hakobyian Eduard - Soghomonyan Hrayr,78,39,39,0,0,16,22,20,20,0,-6,2,2,2,0,0,11:5 - 10:12 - 9:11 - 9:11 - 0:0
17825329,2024-04-01 16:05:00,Gevorgyan Hayk - Mkrtchyan Andranik,0:3,3:11 - 9:11 - 8:11 - 0:0 - 0:0,0,3,Gevorgyan Hayk,Mkrtchyan Andranik,fiurst,Gevorgyan Hayk - Mkrtchyan Andranik,53,20,33,13,-13,14,20,19,0,0,8,2,3,0,0,13,3:11 - 9:11 - 8:11 - 0:0 - 0:0
17825325,2024-04-01 15:45:00,Soghomonyan Hrayr - Petrosyan Davit,0:3,11:3 - 11:8 - 11:5 - 0:0 - 0:0,3,0,Soghomonyan Hrayr,Petrosyan Davit,fiurst,Petrosyan Davit - Soghomonyan Hrayr,49,16,33,17,-17,14,19,16,0,0,8,3,6,0,0,17,3:11 - 8:11 - 5:11 - 0:0 - 0:0
17825324,2024-04-01 15:30:00,Hakobyian Eduard - Gevorgyan Hayk,2:3,4:11 - 12:10 - 11:9 - 5:11 - 14:12,3,2,Hakobyian Eduard,Gevorgyan Hayk,fiurst,Gevorgyan Hayk - Hakobyian Eduard,99,53,46,-7,7,15,22,20,16,26,-7,2,2,-6,2,-7,11:4 - 10:12 - 9:11 - 11:5 - 12:14
17825319,2024-04-01 15:15:00,Nikoghosyan Narek - Arutyunov Ruben,3:0,9:11 - 9:11 - 8:11 - 0:0 - 0:0,0,3,Nikoghosyan Narek,Arutyunov Ruben,fiurst,Arutyunov Ruben - Nikoghosyan Narek,59,33,26,-7,7,20,20,19,0,0,-2,-2,-3,0,0,-7,11:9 - 11:9 - 11:8 - 0:0 - 0:0
17825315,2024-04-01 15:00:00,Rafayelyan Edgar - Diaryan Aleksandr,2:3,11:6 - 9:11 - 11:9 - 2:11 - 13:11,3,2,Rafayelyan Edgar,Diaryan Aleksandr,fiurst,Diaryan Aleksandr - Rafayelyan Edgar,94,48,46,-2,2,17,20,20,13,24,5,-2,2,-9,2,-2,6:11 - 11:9 - 9:11 - 11:2 - 11:13
17825313,2024-04-01 14:45:00,Papyan Karen - Nikoghosyan Narek,3:1,5:11 - 12:10 - 7:11 - 7:11 - 0:0,1,3,Papyan Karen,Nikoghosyan Narek,fiurst,Nikoghosyan Narek - Papyan Karen,74,43,31,-12,12,16,22,18,18,0,-6,2,-4,-4,0,-12,11:5 - 10:12 - 11:7 - 11:7 - 0:0
17825311,2024-04-01 14:30:00,Arutyunov Ruben - Rafayelyan Edgar,1:3,11:7 - 9:11 - 7:11 - 7:11 - 0:0,1,3,Arutyunov Ruben,Rafayelyan Edgar,fiurst,Arutyunov Ruben - Rafayelyan Edgar,74,34,40,6,-6,18,20,18,18,0,-4,2,4,4,0,6,11:7 - 9:11 - 7:11 - 7:11 - 0:0
17825306,2024-04-01 14:15:00,Papyan Karen - Diaryan Aleksandr,3:0,10:12 - 14:16 - 5:11 - 0:0 - 0:0,0,3,Papyan Karen,Diaryan Aleksandr,fiurst,Diaryan Aleksandr - Papyan Karen,68,39,29,-10,10,22,30,16,0,0,-2,-2,-6,0,0,-10,12:10 - 16:14 - 11:5 - 0:0 - 0:0
17825288,2024-04-01 14:00:00,Nikoghosyan Narek - Rafayelyan Edgar,1:3,11:13 - 9:11 - 11:3 - 5:11 - 0:0,1,3,Nikoghosyan Narek,Rafayelyan Edgar,fiurst,Nikoghosyan Narek - Rafayelyan Edgar,74,36,38,2,-2,24,20,14,16,0,2,2,-8,6,0,2,11:13 - 9:11 - 11:3 - 5:11 - 0:0
17825287,2024-04-01 13:55:00,Arutyunov Ruben - Papyan Karen,3:1,1:11 - 11:9 - 11:8 - 11:6 - 0:0,3,1,Arutyunov Ruben,Papyan Karen,fiurst,Arutyunov Ruben - Papyan Karen,68,34,34,0,0,12,20,19,17,0,10,-2,-3,-5,0,0,1:11 - 11:9 - 11:8 - 11:6 - 0:0
17825286,2024-04-01 13:40:00,Diaryan Aleksandr - Nikoghosyan Narek,3:0,11:9 - 11:7 - 11:6 - 0:0 - 0:0,3,0,Diaryan Aleksandr,Nikoghosyan Narek,fiurst,Diaryan Aleksandr - Nikoghosyan Narek,55,33,22,-11,11,20,18,17,0,0,-2,-4,-5,0,0,-11,11:9 - 11:7 - 11:6 - 0:0 - 0:0
17825284,2024-04-01 13:15:00,Rafayelyan Edgar - Papyan Karen,3:1,5:11 - 11:8 - 8:11 - 6:11 - 0:0,1,3,Rafayelyan Edgar,Papyan Karen,fiurst,Papyan Karen - Rafayelyan Edgar,71,41,30,-11,11,16,19,19,17,0,-6,3,-3,-5,0,-11,11:5 - 8:11 - 11:8 - 11:6 - 0:0
17825282,2024-04-01 13:10:00,Diaryan Aleksandr - Arutyunov Ruben,2:3,11:6 - 13:11 - 8:11 - 10:12 - 11:7,3,2,Diaryan Aleksandr,Arutyunov Ruben,fiurst,Arutyunov Ruben - Diaryan Aleksandr,100,47,53,6,-6,17,24,19,22,18,5,2,-3,-2,4,6,6:11 - 11:13 - 11:8 - 12:10 - 7:11
17825281,2024-04-01 12:20:00,Nikoghosyan Narek - Papyan Karen,0:3,7:11 - 10:12 - 11:13 - 0:0 - 0:0,0,3,Nikoghosyan Narek,Papyan Karen,fiurst,Nikoghosyan Narek - Papyan Karen,64,28,36,8,-8,18,22,24,0,0,4,2,2,0,0,8,7:11 - 10:12 - 11:13 - 0:0 - 0:0
17825277,2024-04-01 12:10:00,Diaryan Aleksandr - Rafayelyan Edgar,2:3,4:11 - 11:7 - 11:9 - 9:11 - 8:11,2,3,Diaryan Aleksandr,Rafayelyan Edgar,fiurst,Diaryan Aleksandr - Rafayelyan Edgar,92,43,49,6,-6,15,18,20,20,19,7,-4,-2,2,3,6,4:11 - 11:7 - 11:9 - 9:11 - 8:11
17825263,2024-04-01 12:00:00,Arutyunov Ruben - Nikoghosyan Narek,0:3,8:11 - 9:11 - 4:11 - 0:0 - 0:0,0,3,Arutyunov Ruben,Nikoghosyan Narek,fiurst,Arutyunov Ruben - Nikoghosyan Narek,54,21,33,12,-12,19,20,15,0,0,3,2,7,0,0,12,8:11 - 9:11 - 4:11 - 0:0 - 0:0
17825261,2024-04-01 11:45:00,Diaryan Aleksandr - Papyan Karen,3:0,11:5 - 11:4 - 11:7 - 0:0 - 0:0,3,0,Diaryan Aleksandr,Papyan Karen,fiurst,Diaryan Aleksandr - Papyan Karen,49,33,16,-17,17,16,15,18,0,0,-6,-7,-4,0,0,-17,11:5 - 11:4 - 11:7 - 0:0 - 0:0
17825259,2024-04-01 11:25:00,Rafayelyan Edgar - Arutyunov Ruben,1:3,11:7 - 11:9 - 9:11 - 11:5 - 0:0,3,1,Rafayelyan Edgar,Arutyunov Ruben,fiurst,Arutyunov Ruben - Rafayelyan Edgar,74,32,42,10,-10,18,20,20,16,0,4,2,-2,6,0,10,7:11 - 9:11 - 11:9 - 5:11 - 0:0
17825255,2024-04-01 11:10:00,Nikoghosyan Narek - Diaryan Aleksandr,3:2,11:3 - 7:11 - 7:11 - 11:7 - 4:11,2,3,Nikoghosyan Narek,Diaryan Aleksandr,fiurst,Diaryan Aleksandr - Nikoghosyan Narek,83,43,40,-3,3,14,18,18,18,15,8,-4,-4,4,-7,-3,3:11 - 11:7 - 11:7 - 7:11 - 11:4
17825254,2024-04-01 10:55:00,Papyan Karen - Arutyunov Ruben,3:1,9:11 - 11:9 - 6:11 - 3:11 - 0:0,1,3,Papyan Karen,Arutyunov Ruben,fiurst,Arutyunov Ruben - Papyan Karen,71,42,29,-13,13,20,20,17,14,0,-2,2,-5,-8,0,-13,11:9 - 9:11 - 11:6 - 11:3 - 0:0
17825251,2024-04-01 10:30:00,Rafayelyan Edgar - Nikoghosyan Narek,2:3,11:8 - 8:11 - 9:11 - 11:7 - 11:3,3,2,Rafayelyan Edgar,Nikoghosyan Narek,fiurst,Nikoghosyan Narek - Rafayelyan Edgar,90,40,50,10,-10,19,19,20,18,14,3,-3,-2,4,8,10,8:11 - 11:8 - 11:9 - 7:11 - 3:11
17825247,2024-04-01 10:15:00,Arutyunov Ruben - Diaryan Aleksandr,2:3,11:6 - 5:11 - 5:11 - 11:9 - 7:11,2,3,Arutyunov Ruben,Diaryan Aleksandr,fiurst,Arutyunov Ruben - Diaryan Aleksandr,87,39,48,9,-9,17,16,16,20,18,-5,6,6,-2,4,9,11:6 - 5:11 - 5:11 - 11:9 - 7:11
17825246,2024-04-01 10:00:00,Papyan Karen - Rafayelyan Edgar,0:3,7:11 - 7:11 - 8:11 - 0:0 - 0:0,0,3,Papyan Karen,Rafayelyan Edgar,fiurst,Papyan Karen - Rafayelyan Edgar,55,22,33,11,-11,18,18,19,0,0,4,4,3,0,0,11,7:11 - 7:11 - 8:11 - 0:0 - 0:0
17805864,2024-03-31 17:45:00,Gevorgyan Gegham - Soghomonyan Hrayr,2:3,11:5 - 12:10 - 10:12 - 5:11 - 7:11,2,3,Gevorgyan Gegham,Soghomonyan Hrayr,fiurst,Gevorgyan Gegham - Soghomonyan Hrayr,94,45,49,4,-4,16,22,22,16,18,-6,-2,2,6,4,4,11:5 - 12:10 - 10:12 - 5:11 - 7:11
17805863,2024-03-31 17:15:00,Hakobyian Eduard - Soghomonyan Hrayr,0:3,4:11 - 11:13 - 7:11 - 0:0 - 0:0,0,3,Hakobyian Eduard,Soghomonyan Hrayr,fiurst,Hakobyian Eduard - Soghomonyan Hrayr,57,22,35,13,-13,15,24,18,0,0,7,2,4,0,0,13,4:11 - 11:13 - 7:11 - 0:0 - 0:0
17805862,2024-03-31 17:00:00,Gevorgyan Hayk - Gevorgyan Gegham,0:3,11:8 - 11:7 - 11:8 - 0:0 - 0:0,3,0,Gevorgyan Hayk,Gevorgyan Gegham,fiurst,Gevorgyan Gegham - Gevorgyan Hayk,56,23,33,10,-10,19,18,19,0,0,3,4,3,0,0,10,8:11 - 7:11 - 8:11 - 0:0 - 0:0
17805850,2024-03-31 16:30:00,Gevorgyan Hayk - Soghomonyan Hrayr,3:1,5:11 - 11:4 - 11:4 - 12:10 - 0:0,3,1,Gevorgyan Hayk,Soghomonyan Hrayr,fiurst,Gevorgyan Hayk - Soghomonyan Hrayr,68,39,29,-10,10,16,15,15,22,0,6,-7,-7,-2,0,-10,5:11 - 11:4 - 11:4 - 12:10 - 0:0
17805848,2024-03-31 16:15:00,Gevorgyan Gegham - Hakobyian Eduard,0:3,7:11 - 4:11 - 9:11 - 0:0 - 0:0,0,3,Gevorgyan Gegham,Hakobyian Eduard,fiurst,Gevorgyan Gegham - Hakobyian Eduard,53,20,33,13,-13,18,15,20,0,0,4,7,2,0,0,13,7:11 - 4:11 - 9:11 - 0:0 - 0:0
17805844,2024-03-31 15:45:00,Hakobyian Eduard - Gevorgyan Hayk,3:1,7:11 - 11:9 - 12:14 - 5:11 - 0:0,1,3,Hakobyian Eduard,Gevorgyan Hayk,fiurst,Gevorgyan Hayk - Hakobyian Eduard,80,45,35,-10,10,18,20,26,16,0,-4,2,-2,-6,0,-10,11:7 - 9:11 - 14:12 - 11:5 - 0:0
17805843,2024-03-31 15:30:00,Soghomonyan Hrayr - Gevorgyan Gegham,3:1,8:11 - 11:2 - 8:11 - 11:13 - 0:0,1,3,Soghomonyan Hrayr,Gevorgyan Gegham,fiurst,Gevorgyan Gegham - Soghomonyan Hrayr,75,37,38,1,-1,19,13,19,24,0,-3,9,-3,-2,0,1,11:8 - 2:11 - 11:8 - 13:11 - 0:0
17805841,2024-03-31 15:15:00,Papyan Karen - Rafayelyan Edgar,0:3,8:11 - 2:11 - 3:11 - 0:0 - 0:0,0,3,Papyan Karen,Rafayelyan Edgar,fiurst,Papyan Karen - Rafayelyan Edgar,46,13,33,20,-20,19,13,14,0,0,3,9,8,0,0,20,8:11 - 2:11 - 3:11 - 0:0 - 0:0
17805821,2024-03-31 15:05:00,Nazaryan Mushegh - Nikoghosyan Narek,3:0,11:8 - 11:8 - 11:7 - 0:0 - 0:0,3,0,Nazaryan Mushegh,Nikoghosyan Narek,fiurst,Nazaryan Mushegh - Nikoghosyan Narek,56,33,23,-10,10,19,19,18,0,0,-3,-3,-4,0,0,-10,11:8 - 11:8 - 11:7 - 0:0 - 0:0
17805816,2024-03-31 14:45:00,Asatryan Murad - Papyan Karen,3:0,11:7 - 11:9 - 11:8 - 0:0 - 0:0,3,0,Asatryan Murad,Papyan Karen,fiurst,Asatryan Murad - Papyan Karen,57,33,24,-9,9,18,20,19,0,0,-4,-2,-3,0,0,-9,11:7 - 11:9 - 11:8 - 0:0 - 0:0
17805813,2024-03-31 14:35:00,Rafayelyan Edgar - Nazaryan Mushegh,1:3,11:6 - 11:8 - 8:11 - 11:9 - 0:0,3,1,Rafayelyan Edgar,Nazaryan Mushegh,fiurst,Nazaryan Mushegh - Rafayelyan Edgar,75,34,41,7,-7,17,19,19,20,0,5,3,-3,2,0,7,6:11 - 8:11 - 11:8 - 9:11 - 0:0
17805811,2024-03-31 14:20:00,Asatryan Murad - Nikoghosyan Narek,3:0,11:4 - 11:8 - 11:3 - 0:0 - 0:0,3,0,Asatryan Murad,Nikoghosyan Narek,fiurst,Asatryan Murad - Nikoghosyan Narek,48,33,15,-18,18,15,19,14,0,0,-7,-3,-8,0,0,-18,11:4 - 11:8 - 11:3 - 0:0 - 0:0
17805808,2024-03-31 14:05:00,Papyan Karen - Nazaryan Mushegh,3:1,11:4 - 8:11 - 7:11 - 7:11 - 0:0,1,3,Papyan Karen,Nazaryan Mushegh,fiurst,Nazaryan Mushegh - Papyan Karen,70,37,33,-4,4,15,19,18,18,0,7,-3,-4,-4,0,-4,4:11 - 11:8 - 11:7 - 11:7 - 0:0
17805807,2024-03-31 13:45:00,Rafayelyan Edgar - Asatryan Murad,3:1,8:11 - 9:11 - 11:3 - 9:11 - 0:0,1,3,Rafayelyan Edgar,Asatryan Murad,fiurst,Asatryan Murad - Rafayelyan Edgar,73,36,37,1,-1,19,20,14,20,0,-3,-2,8,-2,0,1,11:8 - 11:9 - 3:11 - 11:9 - 0:0
17805795,2024-03-31 13:40:00,Nikoghosyan Narek - Papyan Karen,1:3,8:11 - 11:8 - 9:11 - 11:13 - 0:0,1,3,Nikoghosyan Narek,Papyan Karen,fiurst,Nikoghosyan Narek - Papyan Karen,82,39,43,4,-4,19,19,20,24,0,3,-3,2,2,0,4,8:11 - 11:8 - 9:11 - 11:13 - 0:0
17805792,2024-03-31 13:15:00,Nazaryan Mushegh - Asatryan Murad,3:0,8:11 - 9:11 - 7:11 - 0:0 - 0:0,0,3,Nazaryan Mushegh,Asatryan Murad,fiurst,Asatryan Murad - Nazaryan Mushegh,57,33,24,-9,9,19,20,18,0,0,-3,-2,-4,0,0,-9,11:8 - 11:9 - 11:7 - 0:0 - 0:0
17805771,2024-03-31 13:00:00,Nikoghosyan Narek - Rafayelyan Edgar,1:3,12:10 - 9:11 - 5:11 - 5:11 - 0:0,1,3,Nikoghosyan Narek,Rafayelyan Edgar,fiurst,Nikoghosyan Narek - Rafayelyan Edgar,74,31,43,12,-12,22,20,16,16,0,-2,2,6,6,0,12,12:10 - 9:11 - 5:11 - 5:11 - 0:0
17805767,2024-03-31 12:25:00,Papyan Karen - Asatryan Murad,3:0,6:11 - 9:11 - 5:11 - 0:0 - 0:0,0,3,Papyan Karen,Asatryan Murad,fiurst,Asatryan Murad - Papyan Karen,53,33,20,-13,13,17,20,16,0,0,-5,-2,-6,0,0,-13,11:6 - 11:9 - 11:5 - 0:0 - 0:0
17805763,2024-03-31 12:15:00,Nikoghosyan Narek - Nazaryan Mushegh,3:0,7:11 - 6:11 - 9:11 - 0:0 - 0:0,0,3,Nikoghosyan Narek,Nazaryan Mushegh,fiurst,Nazaryan Mushegh - Nikoghosyan Narek,55,33,22,-11,11,18,17,20,0,0,-4,-5,-2,0,0,-11,11:7 - 11:6 - 11:9 - 0:0 - 0:0
17805757,2024-03-31 12:00:00,Rafayelyan Edgar - Papyan Karen,3:0,6:11 - 11:13 - 6:11 - 0:0 - 0:0,0,3,Rafayelyan Edgar,Papyan Karen,fiurst,Papyan Karen - Rafayelyan Edgar,58,35,23,-12,12,17,24,17,0,0,-5,-2,-5,0,0,-12,11:6 - 13:11 - 11:6 - 0:0 - 0:0
17805743,2024-03-31 11:40:00,Nikoghosyan Narek - Asatryan Murad,3:1,6:11 - 8:11 - 11:9 - 9:11 - 0:0,1,3,Nikoghosyan Narek,Asatryan Murad,fiurst,Asatryan Murad - Nikoghosyan Narek,76,42,34,-8,8,17,19,20,20,0,-5,-3,2,-2,0,-8,11:6 - 11:8 - 9:11 - 11:9 - 0:0
17805740,2024-03-31 11:15:00,Nazaryan Mushegh - Rafayelyan Edgar,3:2,12:10 - 7:11 - 13:15 - 11:7 - 11:7,3,2,Nazaryan Mushegh,Rafayelyan Edgar,fiurst,Nazaryan Mushegh - Rafayelyan Edgar,104,54,50,-4,4,22,18,28,18,18,-2,4,2,-4,-4,-4,12:10 - 7:11 - 13:15 - 11:7 - 11:7
17805737,2024-03-31 11:00:00,Papyan Karen - Nikoghosyan Narek,2:3,11:6 - 11:7 - 7:11 - 11:13 - 11:9,3,2,Papyan Karen,Nikoghosyan Narek,fiurst,Nikoghosyan Narek - Papyan Karen,97,46,51,5,-5,17,18,18,24,20,5,4,-4,-2,2,5,6:11 - 7:11 - 11:7 - 13:11 - 9:11
17805735,2024-03-31 10:55:00,Asatryan Murad - Rafayelyan Edgar,3:0,11:4 - 11:6 - 11:9 - 0:0 - 0:0,3,0,Asatryan Murad,Rafayelyan Edgar,fiurst,Asatryan Murad - Rafayelyan Edgar,52,33,19,-14,14,15,17,20,0,0,-7,-5,-2,0,0,-14,11:4 - 11:6 - 11:9 - 0:0 - 0:0
17805720,2024-03-31 10:30:00,Nazaryan Mushegh - Papyan Karen,3:0,11:8 - 11:9 - 15:13 - 0:0 - 0:0,3,0,Nazaryan Mushegh,Papyan Karen,fiurst,Nazaryan Mushegh - Papyan Karen,67,37,30,-7,7,19,20,28,0,0,-3,-2,-2,0,0,-7,11:8 - 11:9 - 15:13 - 0:0 - 0:0
17805719,2024-03-31 10:15:00,Rafayelyan Edgar - Nikoghosyan Narek,2:3,11:6 - 9:11 - 11:3 - 11:13 - 11:7,3,2,Rafayelyan Edgar,Nikoghosyan Narek,fiurst,Nikoghosyan Narek - Rafayelyan Edgar,93,40,53,13,-13,17,20,14,24,18,5,-2,8,-2,4,13,6:11 - 11:9 - 3:11 - 13:11 - 7:11
17805716,2024-03-31 10:00:00,Asatryan Murad - Nazaryan Mushegh,3:1,7:11 - 11:5 - 11:9 - 11:6 - 0:0,3,1,Asatryan Murad,Nazaryan Mushegh,fiurst,Asatryan Murad - Nazaryan Mushegh,71,40,31,-9,9,18,16,20,17,0,4,-6,-2,-5,0,-9,7:11 - 11:5 - 11:9 - 11:6 - 0:0
17786621,2024-03-30 17:45:00,Soghomonyan Hrayr - Gevorgyan Gegham,2:3,13:11 - 4:11 - 6:11 - 11:3 - 12:10,3,2,Soghomonyan Hrayr,Gevorgyan Gegham,fiurst,Gevorgyan Gegham - Soghomonyan Hrayr,92,46,46,0,0,24,15,17,14,22,2,-7,-5,8,2,0,11:13 - 11:4 - 11:6 - 3:11 - 10:12
17786618,2024-03-30 17:30:00,Hakobyian Eduard - Mkrtchyan Andranik,3:0,11:4 - 11:7 - 11:5 - 0:0 - 0:0,3,0,Hakobyian Eduard,Mkrtchyan Andranik,fiurst,Hakobyian Eduard - Mkrtchyan Andranik,49,33,16,-17,17,15,18,16,0,0,-7,-4,-6,0,0,-17,11:4 - 11:7 - 11:5 - 0:0 - 0:0
17786617,2024-03-30 17:15:00,Gevorgyan Hayk - Soghomonyan Hrayr,0:3,10:12 - 8:11 - 8:11 - 0:0 - 0:0,0,3,Gevorgyan Hayk,Soghomonyan Hrayr,fiurst,Gevorgyan Hayk - Soghomonyan Hrayr,60,26,34,8,-8,22,19,19,0,0,2,3,3,0,0,8,10:12 - 8:11 - 8:11 - 0:0 - 0:0
17786604,2024-03-30 17:00:00,Hakobyian Eduard - Gevorgyan Gegham,2:3,8:11 - 11:6 - 11:8 - 9:11 - 11:5,3,2,Hakobyian Eduard,Gevorgyan Gegham,fiurst,Gevorgyan Gegham - Hakobyian Eduard,91,41,50,9,-9,19,17,19,20,16,-3,5,3,-2,6,9,11:8 - 6:11 - 8:11 - 11:9 - 5:11
17786601,2024-03-30 16:45:00,Mkrtchyan Andranik - Gevorgyan Hayk,0:3,11:8 - 11:8 - 11:6 - 0:0 - 0:0,3,0,Mkrtchyan Andranik,Gevorgyan Hayk,fiurst,Gevorgyan Hayk - Mkrtchyan Andranik,55,22,33,11,-11,19,19,17,0,0,3,3,5,0,0,11,8:11 - 8:11 - 6:11 - 0:0 - 0:0
17786600,2024-03-30 16:30:00,Soghomonyan Hrayr - Hakobyian Eduard,1:3,12:10 - 7:11 - 11:5 - 11:2 - 0:0,3,1,Soghomonyan Hrayr,Hakobyian Eduard,fiurst,Hakobyian Eduard - Soghomonyan Hrayr,69,28,41,13,-13,22,18,16,13,0,2,-4,6,9,0,13,10:12 - 11:7 - 5:11 - 2:11 - 0:0
17786599,2024-03-30 16:20:00,Gevorgyan Gegham - Gevorgyan Hayk,3:0,11:7 - 11:7 - 11:9 - 0:0 - 0:0,3,0,Gevorgyan Gegham,Gevorgyan Hayk,fiurst,Gevorgyan Gegham - Gevorgyan Hayk,56,33,23,-10,10,18,18,20,0,0,-4,-4,-2,0,0,-10,11:7 - 11:7 - 11:9 - 0:0 - 0:0
17786596,2024-03-30 16:00:00,Mkrtchyan Andranik - Soghomonyan Hrayr,0:3,4:11 - 8:11 - 4:11 - 0:0 - 0:0,0,3,Mkrtchyan Andranik,Soghomonyan Hrayr,fiurst,Mkrtchyan Andranik - Soghomonyan Hrayr,49,16,33,17,-17,15,19,15,0,0,7,3,7,0,0,17,4:11 - 8:11 - 4:11 - 0:0 - 0:0
17786595,2024-03-30 15:45:00,Gevorgyan Hayk - Hakobyian Eduard,2:3,11:13 - 2:11 - 11:7 - 11:7 - 3:11,2,3,Gevorgyan Hayk,Hakobyian Eduard,fiurst,Gevorgyan Hayk - Hakobyian Eduard,87,38,49,11,-11,24,13,18,18,14,2,9,-4,-4,8,11,11:13 - 2:11 - 11:7 - 11:7 - 3:11
17786594,2024-03-30 15:30:00,Gevorgyan Gegham - Mkrtchyan Andranik,1:3,6:11 - 11:8 - 7:11 - 8:11 - 0:0,1,3,Gevorgyan Gegham,Mkrtchyan Andranik,fiurst,Gevorgyan Gegham - Mkrtchyan Andranik,73,32,41,9,-9,17,19,18,19,0,5,-3,4,3,0,9,6:11 - 11:8 - 7:11 - 8:11 - 0:0
17786592,2024-03-30 15:20:00,Nikoghosyan Narek - Hovhannesyan Rafik,1:3,11:6 - 11:9 - 7:11 - 11:7 - 0:0,3,1,Nikoghosyan Narek,Hovhannesyan Rafik,fiurst,Hovhannesyan Rafik - Nikoghosyan Narek,73,33,40,7,-7,17,20,18,18,0,5,2,-4,4,0,7,6:11 - 9:11 - 11:7 - 7:11 - 0:0
17786590,2024-03-30 15:05:00,Diaryan Aleksandr - Asatryan Murad,3:1,7:11 - 11:5 - 7:11 - 7:11 - 0:0,1,3,Diaryan Aleksandr,Asatryan Murad,fiurst,Asatryan Murad - Diaryan Aleksandr,70,38,32,-6,6,18,16,18,18,0,-4,6,-4,-4,0,-6,11:7 - 5:11 - 11:7 - 11:7 - 0:0
17786576,2024-03-30 14:55:00,Nazaryan Mushegh - Nikoghosyan Narek,1:3,11:8 - 6:11 - 7:11 - 4:11 - 0:0,1,3,Nazaryan Mushegh,Nikoghosyan Narek,fiurst,Nazaryan Mushegh - Nikoghosyan Narek,69,28,41,13,-13,19,17,18,15,0,-3,5,4,7,0,13,11:8 - 6:11 - 7:11 - 4:11 - 0:0
17786575,2024-03-30 14:40:00,Hovhannesyan Rafik - Diaryan Aleksandr,3:0,4:11 - 5:11 - 8:11 - 0:0 - 0:0,0,3,Hovhannesyan Rafik,Diaryan Aleksandr,fiurst,Diaryan Aleksandr - Hovhannesyan Rafik,50,33,17,-16,16,15,16,19,0,0,-7,-6,-3,0,0,-16,11:4 - 11:5 - 11:8 - 0:0 - 0:0
17786572,2024-03-30 14:25:00,Nazaryan Mushegh - Asatryan Murad,3:1,5:11 - 8:11 - 11:6 - 6:11 - 0:0,1,3,Nazaryan Mushegh,Asatryan Murad,fiurst,Asatryan Murad - Nazaryan Mushegh,69,39,30,-9,9,16,19,17,17,0,-6,-3,5,-5,0,-9,11:5 - 11:8 - 6:11 - 11:6 - 0:0
17786566,2024-03-30 14:00:00,Hovhannesyan Rafik - Nazaryan Mushegh,0:3,11:13 - 9:11 - 5:11 - 0:0 - 0:0,0,3,Hovhannesyan Rafik,Nazaryan Mushegh,fiurst,Hovhannesyan Rafik - Nazaryan Mushegh,60,25,35,10,-10,24,20,16,0,0,2,2,6,0,0,10,11:13 - 9:11 - 5:11 - 0:0 - 0:0
17786571,2024-03-30 14:00:00,Nikoghosyan Narek - Diaryan Aleksandr,3:1,10:12 - 8:11 - 11:7 - 21:23 - 0:0,1,3,Nikoghosyan Narek,Diaryan Aleksandr,fiurst,Diaryan Aleksandr - Nikoghosyan Narek,103,53,50,-3,3,22,19,18,44,0,-2,-3,4,-2,0,-3,12:10 - 11:8 - 7:11 - 23:21 - 0:0
17786564,2024-03-30 13:30:00,Asatryan Murad - Nikoghosyan Narek,3:0,11:5 - 11:1 - 11:3 - 0:0 - 0:0,3,0,Asatryan Murad,Nikoghosyan Narek,fiurst,Asatryan Murad - Nikoghosyan Narek,42,33,9,-24,24,16,12,14,0,0,-6,-10,-8,0,0,-24,11:5 - 11:1 - 11:3 - 0:0 - 0:0
17786553,2024-03-30 13:15:00,Diaryan Aleksandr - Nazaryan Mushegh,3:2,11:13 - 9:11 - 11:6 - 11:7 - 11:4,3,2,Diaryan Aleksandr,Nazaryan Mushegh,fiurst,Diaryan Aleksandr - Nazaryan Mushegh,94,53,41,-12,12,24,20,17,18,15,2,2,-5,-4,-7,-12,11:13 - 9:11 - 11:6 - 11:7 - 11:4
17786551,2024-03-30 13:10:00,Asatryan Murad - Hovhannesyan Rafik,3:0,11:4 - 11:6 - 11:8 - 0:0 - 0:0,3,0,Asatryan Murad,Hovhannesyan Rafik,fiurst,Asatryan Murad - Hovhannesyan Rafik,51,33,18,-15,15,15,17,19,0,0,-7,-5,-3,0,0,-15,11:4 - 11:6 - 11:8 - 0:0 - 0:0
17786549,2024-03-30 12:15:00,Nikoghosyan Narek - Nazaryan Mushegh,2:3,6:11 - 11:8 - 9:11 - 11:6 - 11:8,3,2,Nikoghosyan Narek,Nazaryan Mushegh,fiurst,Nazaryan Mushegh - Nikoghosyan Narek,92,44,48,4,-4,17,19,20,17,19,-5,3,-2,5,3,4,11:6 - 8:11 - 11:9 - 6:11 - 8:11
17786546,2024-03-30 12:00:00,Asatryan Murad - Diaryan Aleksandr,3:1,11:2 - 11:6 - 4:11 - 11:4 - 0:0,3,1,Asatryan Murad,Diaryan Aleksandr,fiurst,Asatryan Murad - Diaryan Aleksandr,60,37,23,-14,14,13,17,15,15,0,-9,-5,7,-7,0,-14,11:2 - 11:6 - 4:11 - 11:4 - 0:0
17786543,2024-03-30 11:50:00,Hovhannesyan Rafik - Nikoghosyan Narek,3:1,11:5 - 15:13 - 8:11 - 11:9 - 0:0,3,1,Hovhannesyan Rafik,Nikoghosyan Narek,fiurst,Hovhannesyan Rafik - Nikoghosyan Narek,83,45,38,-7,7,16,28,19,20,0,-6,-2,3,-2,0,-7,11:5 - 15:13 - 8:11 - 11:9 - 0:0
17786540,2024-03-30 11:30:00,Asatryan Murad - Nazaryan Mushegh,3:1,8:11 - 11:4 - 11:8 - 11:5 - 0:0,3,1,Asatryan Murad,Nazaryan Mushegh,fiurst,Asatryan Murad - Nazaryan Mushegh,69,41,28,-13,13,19,15,19,16,0,3,-7,-3,-6,0,-13,8:11 - 11:4 - 11:8 - 11:5 - 0:0
17786538,2024-03-30 11:20:00,Diaryan Aleksandr - Hovhannesyan Rafik,3:0,11:6 - 11:5 - 11:3 - 0:0 - 0:0,3,0,Diaryan Aleksandr,Hovhannesyan Rafik,fiurst,Diaryan Aleksandr - Hovhannesyan Rafik,47,33,14,-19,19,17,16,14,0,0,-5,-6,-8,0,0,-19,11:6 - 11:5 - 11:3 - 0:0 - 0:0
17786526,2024-03-30 11:05:00,Nikoghosyan Narek - Asatryan Murad,3:1,5:11 - 11:9 - 5:11 - 10:12 - 0:0,1,3,Nikoghosyan Narek,Asatryan Murad,fiurst,Asatryan Murad - Nikoghosyan Narek,74,43,31,-12,12,16,20,16,22,0,-6,2,-6,-2,0,-12,11:5 - 9:11 - 11:5 - 12:10 - 0:0
17786524,2024-03-30 10:45:00,Nazaryan Mushegh - Hovhannesyan Rafik,3:1,8:11 - 8:11 - 11:6 - 8:11 - 0:0,1,3,Nazaryan Mushegh,Hovhannesyan Rafik,fiurst,Hovhannesyan Rafik - Nazaryan Mushegh,74,39,35,-4,4,19,19,17,19,0,-3,-3,5,-3,0,-4,11:8 - 11:8 - 6:11 - 11:8 - 0:0
17786521,2024-03-30 10:30:00,Diaryan Aleksandr - Nikoghosyan Narek,3:1,11:6 - 11:9 - 8:11 - 11:9 - 0:0,3,1,Diaryan Aleksandr,Nikoghosyan Narek,fiurst,Diaryan Aleksandr - Nikoghosyan Narek,76,41,35,-6,6,17,20,19,20,0,-5,-2,3,-2,0,-6,11:6 - 11:9 - 8:11 - 11:9 - 0:0
17786520,2024-03-30 10:15:00,Hovhannesyan Rafik - Asatryan Murad,3:0,7:11 - 6:11 - 3:11 - 0:0 - 0:0,0,3,Hovhannesyan Rafik,Asatryan Murad,fiurst,Asatryan Murad - Hovhannesyan Rafik,49,33,16,-17,17,18,17,14,0,0,-4,-5,-8,0,0,-17,11:7 - 11:6 - 11:3 - 0:0 - 0:0
17786508,2024-03-30 10:00:00,Nazaryan Mushegh - Diaryan Aleksandr,3:0,7:11 - 6:11 - 8:11 - 0:0 - 0:0,0,3,Nazaryan Mushegh,Diaryan Aleksandr,fiurst,Diaryan Aleksandr - Nazaryan Mushegh,54,33,21,-12,12,18,17,19,0,0,-4,-5,-3,0,0,-12,11:7 - 11:6 - 11:8 - 0:0 - 0:0
17770877,2024-03-29 17:45:00,Mkrtchyan Andranik - Petrosyan Davit,3:2,11:7 - 11:7 - 10:12 - 7:11 - 11:9,3,2,Mkrtchyan Andranik,Petrosyan Davit,fiurst,Mkrtchyan Andranik - Petrosyan Davit,96,50,46,-4,4,18,18,22,18,20,-4,-4,2,4,-2,-4,11:7 - 11:7 - 10:12 - 7:11 - 11:9
17770870,2024-03-29 17:30:00,Hakobyian Eduard - Gevorgyan Hayk,2:3,8:11 - 11:4 - 8:11 - 11:6 - 11:6,3,2,Hakobyian Eduard,Gevorgyan Hayk,fiurst,Gevorgyan Hayk - Hakobyian Eduard,87,38,49,11,-11,19,15,19,17,17,-3,7,-3,5,5,11,11:8 - 4:11 - 11:8 - 6:11 - 6:11
17770864,2024-03-29 17:15:00,Gevorgyan Gegham - Mkrtchyan Andranik,3:1,11:8 - 11:8 - 6:11 - 11:7 - 0:0,3,1,Gevorgyan Gegham,Mkrtchyan Andranik,fiurst,Gevorgyan Gegham - Mkrtchyan Andranik,73,39,34,-5,5,19,19,17,18,0,-3,-3,5,-4,0,-5,11:8 - 11:8 - 6:11 - 11:7 - 0:0
17770857,2024-03-29 17:00:00,Hakobyian Eduard - Petrosyan Davit,3:1,12:10 - 11:5 - 12:14 - 11:8 - 0:0,3,1,Hakobyian Eduard,Petrosyan Davit,fiurst,Hakobyian Eduard - Petrosyan Davit,83,46,37,-9,9,22,16,26,19,0,-2,-6,2,-3,0,-9,12:10 - 11:5 - 12:14 - 11:8 - 0:0
17770840,2024-03-29 16:55:00,Gevorgyan Hayk - Gevorgyan Gegham,0:3,11:6 - 11:3 - 11:5 - 0:0 - 0:0,3,0,Gevorgyan Hayk,Gevorgyan Gegham,fiurst,Gevorgyan Gegham - Gevorgyan Hayk,47,14,33,19,-19,17,14,16,0,0,5,8,6,0,0,19,6:11 - 3:11 - 5:11 - 0:0 - 0:0
17770837,2024-03-29 16:35:00,Mkrtchyan Andranik - Hakobyian Eduard,3:2,11:9 - 12:14 - 10:12 - 12:10 - 8:11,2,3,Mkrtchyan Andranik,Hakobyian Eduard,fiurst,Hakobyian Eduard - Mkrtchyan Andranik,109,56,53,-3,3,20,26,22,22,19,2,-2,-2,2,-3,-3,9:11 - 14:12 - 12:10 - 10:12 - 11:8
17770833,2024-03-29 16:20:00,Petrosyan Davit - Gevorgyan Gegham,2:3,4:11 - 11:7 - 6:11 - 11:4 - 11:8,3,2,Petrosyan Davit,Gevorgyan Gegham,fiurst,Gevorgyan Gegham - Petrosyan Davit,84,41,43,2,-2,15,18,17,15,19,-7,4,-5,7,3,2,11:4 - 7:11 - 11:6 - 4:11 - 8:11
17770829,2024-03-29 16:00:00,Gevorgyan Hayk - Mkrtchyan Andranik,3:2,6:11 - 11:6 - 10:12 - 11:9 - 11:8,3,2,Gevorgyan Hayk,Mkrtchyan Andranik,fiurst,Gevorgyan Hayk - Mkrtchyan Andranik,95,49,46,-3,3,17,17,22,20,19,5,-5,2,-2,-3,-3,6:11 - 11:6 - 10:12 - 11:9 - 11:8
17770826,2024-03-29 15:45:00,Gevorgyan Gegham - Hakobyian Eduard,2:3,7:11 - 12:10 - 11:6 - 8:11 - 5:11,2,3,Gevorgyan Gegham,Hakobyian Eduard,fiurst,Gevorgyan Gegham - Hakobyian Eduard,92,43,49,6,-6,18,22,17,19,16,4,-2,-5,3,6,6,7:11 - 12:10 - 11:6 - 8:11 - 5:11
17770813,2024-03-29 15:30:00,Petrosyan Davit - Gevorgyan Hayk,3:1,3:11 - 9:11 - 13:11 - 8:11 - 0:0,1,3,Petrosyan Davit,Gevorgyan Hayk,fiurst,Gevorgyan Hayk - Petrosyan Davit,77,44,33,-11,11,14,20,24,19,0,-8,-2,2,-3,0,-11,11:3 - 11:9 - 11:13 - 11:8 - 0:0
17770811,2024-03-29 15:15:00,Nazaryan Mushegh - Papyan Karen,2:3,11:6 - 11:13 - 11:7 - 13:15 - 9:11,2,3,Nazaryan Mushegh,Papyan Karen,fiurst,Nazaryan Mushegh - Papyan Karen,107,55,52,-3,3,17,24,18,28,20,-5,2,-4,2,2,-3,11:6 - 11:13 - 11:7 - 13:15 - 9:11
17770807,2024-03-29 15:10:00,Hovhannesyan Rafik - Arutyunov Ruben,3:0,6:11 - 5:11 - 6:11 - 0:0 - 0:0,0,3,Hovhannesyan Rafik,Arutyunov Ruben,fiurst,Arutyunov Ruben - Hovhannesyan Rafik,50,33,17,-16,16,17,16,17,0,0,-5,-6,-5,0,0,-16,11:6 - 11:5 - 11:6 - 0:0 - 0:0
17770792,2024-03-29 14:45:00,Diaryan Aleksandr - Nazaryan Mushegh,3:0,11:7 - 11:9 - 11:3 - 0:0 - 0:0,3,0,Diaryan Aleksandr,Nazaryan Mushegh,fiurst,Diaryan Aleksandr - Nazaryan Mushegh,52,33,19,-14,14,18,20,14,0,0,-4,-2,-8,0,0,-14,11:7 - 11:9 - 11:3 - 0:0 - 0:0
17770790,2024-03-29 14:40:00,Papyan Karen - Hovhannesyan Rafik,1:3,11:8 - 12:10 - 10:12 - 13:11 - 0:0,3,1,Papyan Karen,Hovhannesyan Rafik,fiurst,Hovhannesyan Rafik - Papyan Karen,87,41,46,5,-5,19,22,22,24,0,3,2,-2,2,0,5,8:11 - 10:12 - 12:10 - 11:13 - 0:0
17770785,2024-03-29 14:15:00,Diaryan Aleksandr - Arutyunov Ruben,0:3,11:8 - 11:6 - 11:4 - 0:0 - 0:0,3,0,Diaryan Aleksandr,Arutyunov Ruben,fiurst,Arutyunov Ruben - Diaryan Aleksandr,51,18,33,15,-15,19,17,15,0,0,3,5,7,0,0,15,8:11 - 6:11 - 4:11 - 0:0 - 0:0
17770779,2024-03-29 14:05:00,Nazaryan Mushegh - Hovhannesyan Rafik,3:1,6:11 - 9:11 - 11:7 - 5:11 - 0:0,1,3,Nazaryan Mushegh,Hovhannesyan Rafik,fiurst,Hovhannesyan Rafik - Nazaryan Mushegh,71,40,31,-9,9,17,20,18,16,0,-5,-2,4,-6,0,-9,11:6 - 11:9 - 7:11 - 11:5 - 0:0
17770772,2024-03-29 13:50:00,Papyan Karen - Diaryan Aleksandr,1:3,11:7 - 9:11 - 13:11 - 12:10 - 0:0,3,1,Papyan Karen,Diaryan Aleksandr,fiurst,Diaryan Aleksandr - Papyan Karen,84,39,45,6,-6,18,20,24,22,0,4,-2,2,2,0,6,7:11 - 11:9 - 11:13 - 10:12 - 0:0
17770767,2024-03-29 13:35:00,Arutyunov Ruben - Nazaryan Mushegh,3:0,11:6 - 11:9 - 11:9 - 0:0 - 0:0,3,0,Arutyunov Ruben,Nazaryan Mushegh,fiurst,Arutyunov Ruben - Nazaryan Mushegh,57,33,24,-9,9,17,20,20,0,0,-5,-2,-2,0,0,-9,11:6 - 11:9 - 11:9 - 0:0 - 0:0
17770750,2024-03-29 13:15:00,Hovhannesyan Rafik - Diaryan Aleksandr,3:0,8:11 - 11:13 - 9:11 - 0:0 - 0:0,0,3,Hovhannesyan Rafik,Diaryan Aleksandr,fiurst,Diaryan Aleksandr - Hovhannesyan Rafik,63,35,28,-7,7,19,24,20,0,0,-3,-2,-2,0,0,-7,11:8 - 13:11 - 11:9 - 0:0 - 0:0
17770740,2024-03-29 13:10:00,Arutyunov Ruben - Papyan Karen,3:0,11:4 - 11:7 - 11:9 - 0:0 - 0:0,3,0,Arutyunov Ruben,Papyan Karen,fiurst,Arutyunov Ruben - Papyan Karen,53,33,20,-13,13,15,18,20,0,0,-7,-4,-2,0,0,-13,11:4 - 11:7 - 11:9 - 0:0 - 0:0
17770739,2024-03-29 12:25:00,Nazaryan Mushegh - Diaryan Aleksandr,3:0,9:11 - 5:11 - 4:11 - 0:0 - 0:0,0,3,Nazaryan Mushegh,Diaryan Aleksandr,fiurst,Diaryan Aleksandr - Nazaryan Mushegh,51,33,18,-15,15,20,16,15,0,0,-2,-6,-7,0,0,-15,11:9 - 11:5 - 11:4 - 0:0 - 0:0
17770738,2024-03-29 12:10:00,Arutyunov Ruben - Hovhannesyan Rafik,3:0,11:5 - 12:10 - 11:4 - 0:0 - 0:0,3,0,Arutyunov Ruben,Hovhannesyan Rafik,fiurst,Arutyunov Ruben - Hovhannesyan Rafik,53,34,19,-15,15,16,22,15,0,0,-6,-2,-7,0,0,-15,11:5 - 12:10 - 11:4 - 0:0 - 0:0
17770717,2024-03-29 11:55:00,Papyan Karen - Nazaryan Mushegh,2:3,11:9 - 9:11 - 7:11 - 11:7 - 11:9,3,2,Papyan Karen,Nazaryan Mushegh,fiurst,Nazaryan Mushegh - Papyan Karen,96,47,49,2,-2,20,20,18,18,20,2,-2,-4,4,2,2,9:11 - 11:9 - 11:7 - 7:11 - 9:11
17770674,2024-03-29 11:40:00,Arutyunov Ruben - Diaryan Aleksandr,0:3,9:11 - 8:11 - 9:11 - 0:0 - 0:0,0,3,Arutyunov Ruben,Diaryan Aleksandr,fiurst,Arutyunov Ruben - Diaryan Aleksandr,59,26,33,7,-7,20,19,20,0,0,2,3,2,0,0,7,9:11 - 8:11 - 9:11 - 0:0 - 0:0
17770639,2024-03-29 11:20:00,Hovhannesyan Rafik - Papyan Karen,2:3,7:11 - 11:13 - 11:8 - 11:7 - 8:11,2,3,Hovhannesyan Rafik,Papyan Karen,fiurst,Hovhannesyan Rafik - Papyan Karen,98,48,50,2,-2,18,24,19,18,19,4,2,-3,-4,3,2,7:11 - 11:13 - 11:8 - 11:7 - 8:11
17770638,2024-03-29 11:00:00,Nazaryan Mushegh - Arutyunov Ruben,3:2,11:5 - 8:11 - 5:11 - 14:12 - 10:12,2,3,Nazaryan Mushegh,Arutyunov Ruben,fiurst,Arutyunov Ruben - Nazaryan Mushegh,99,51,48,-3,3,16,19,16,26,22,6,-3,-6,2,-2,-3,5:11 - 11:8 - 11:5 - 12:14 - 12:10
17770635,2024-03-29 10:45:00,Diaryan Aleksandr - Papyan Karen,1:3,10:12 - 11:9 - 8:11 - 9:11 - 0:0,1,3,Diaryan Aleksandr,Papyan Karen,fiurst,Diaryan Aleksandr - Papyan Karen,81,38,43,5,-5,22,20,19,20,0,2,-2,3,2,0,5,10:12 - 11:9 - 8:11 - 9:11 - 0:0
17770619,2024-03-29 10:30:00,Hovhannesyan Rafik - Nazaryan Mushegh,1:3,10:12 - 7:11 - 11:7 - 7:11 - 0:0,1,3,Hovhannesyan Rafik,Nazaryan Mushegh,fiurst,Hovhannesyan Rafik - Nazaryan Mushegh,76,35,41,6,-6,22,18,18,18,0,2,4,-4,4,0,6,10:12 - 7:11 - 11:7 - 7:11 - 0:0
17770602,2024-03-29 10:15:00,Papyan Karen - Arutyunov Ruben,0:3,12:10 - 11:9 - 11:9 - 0:0 - 0:0,3,0,Papyan Karen,Arutyunov Ruben,fiurst,Arutyunov Ruben - Papyan Karen,62,28,34,6,-6,22,20,20,0,0,2,2,2,0,0,6,10:12 - 9:11 - 9:11 - 0:0 - 0:0
17770589,2024-03-29 10:00:00,Diaryan Aleksandr - Hovhannesyan Rafik,0:3,10:12 - 8:11 - 8:11 - 0:0 - 0:0,0,3,Diaryan Aleksandr,Hovhannesyan Rafik,fiurst,Diaryan Aleksandr - Hovhannesyan Rafik,60,26,34,8,-8,22,19,19,0,0,2,3,3,0,0,8,10:12 - 8:11 - 8:11 - 0:0 - 0:0
17751551,2024-03-28 17:45:00,Hakobyian Eduard - Gevorgyan Hayk,2:3,12:10 - 11:5 - 3:11 - 14:16 - 11:8,3,2,Hakobyian Eduard,Gevorgyan Hayk,fiurst,Gevorgyan Hayk - Hakobyian Eduard,101,50,51,1,-1,22,16,14,30,19,2,6,-8,-2,3,1,10:12 - 5:11 - 11:3 - 16:14 - 8:11
17751549,2024-03-28 17:30:00,Gevorgyan Gegham - Petrosyan Davit,0:3,8:11 - 6:11 - 7:11 - 0:0 - 0:0,0,3,Gevorgyan Gegham,Petrosyan Davit,fiurst,Gevorgyan Gegham - Petrosyan Davit,54,21,33,12,-12,19,17,18,0,0,3,5,4,0,0,12,8:11 - 6:11 - 7:11 - 0:0 - 0:0
17751548,2024-03-28 17:15:00,Soghomonyan Hrayr - Hakobyian Eduard,0:3,11:9 - 11:7 - 11:8 - 0:0 - 0:0,3,0,Soghomonyan Hrayr,Hakobyian Eduard,fiurst,Hakobyian Eduard - Soghomonyan Hrayr,57,24,33,9,-9,20,18,19,0,0,2,4,3,0,0,9,9:11 - 7:11 - 8:11 - 0:0 - 0:0
17751546,2024-03-28 17:05:00,Gevorgyan Gegham - Gevorgyan Hayk,1:3,11:6 - 6:11 - 4:11 - 11:13 - 0:0,1,3,Gevorgyan Gegham,Gevorgyan Hayk,fiurst,Gevorgyan Gegham - Gevorgyan Hayk,73,32,41,9,-9,17,17,15,24,0,-5,5,7,2,0,9,11:6 - 6:11 - 4:11 - 11:13 - 0:0
17751544,2024-03-28 16:45:00,Petrosyan Davit - Soghomonyan Hrayr,2:3,11:8 - 8:11 - 7:11 - 11:2 - 9:11,2,3,Petrosyan Davit,Soghomonyan Hrayr,fiurst,Petrosyan Davit - Soghomonyan Hrayr,89,46,43,-3,3,19,19,18,13,20,-3,3,4,-9,2,-3,11:8 - 8:11 - 7:11 - 11:2 - 9:11
17751543,2024-03-28 16:30:00,Hakobyian Eduard - Gevorgyan Gegham,2:3,6:11 - 11:3 - 11:7 - 6:11 - 11:6,3,2,Hakobyian Eduard,Gevorgyan Gegham,fiurst,Gevorgyan Gegham - Hakobyian Eduard,83,38,45,7,-7,17,14,18,17,17,-5,8,4,-5,5,7,11:6 - 3:11 - 7:11 - 11:6 - 6:11
17751530,2024-03-28 16:25:00,Gevorgyan Hayk - Soghomonyan Hrayr,0:3,6:11 - 9:11 - 9:11 - 0:0 - 0:0,0,3,Gevorgyan Hayk,Soghomonyan Hrayr,fiurst,Gevorgyan Hayk - Soghomonyan Hrayr,57,24,33,9,-9,17,20,20,0,0,5,2,2,0,0,9,6:11 - 9:11 - 9:11 - 0:0 - 0:0
17751529,2024-03-28 16:00:00,Petrosyan Davit - Hakobyian Eduard,3:2,10:12 - 15:13 - 7:11 - 11:4 - 8:11,2,3,Petrosyan Davit,Hakobyian Eduard,fiurst,Hakobyian Eduard - Petrosyan Davit,102,51,51,0,0,22,28,18,15,19,-2,2,-4,7,-3,0,12:10 - 13:15 - 11:7 - 4:11 - 11:8
17751488,2024-03-28 15:55:00,Soghomonyan Hrayr - Gevorgyan Gegham,1:3,11:4 - 11:8 - 11:13 - 13:11 - 0:0,3,1,Soghomonyan Hrayr,Gevorgyan Gegham,fiurst,Gevorgyan Gegham - Soghomonyan Hrayr,82,36,46,10,-10,15,19,24,24,0,7,3,-2,2,0,10,4:11 - 8:11 - 13:11 - 11:13 - 0:0
17751464,2024-03-28 15:30:00,Arutyunov Ruben - Rafayelyan Edgar,1:3,8:11 - 9:11 - 11:7 - 9:11 - 0:0,1,3,Arutyunov Ruben,Rafayelyan Edgar,fiurst,Arutyunov Ruben - Rafayelyan Edgar,77,37,40,3,-3,19,20,18,20,0,3,2,-4,2,0,3,8:11 - 9:11 - 11:7 - 9:11 - 0:0
17751487,2024-03-28 15:30:00,Gevorgyan Hayk - Petrosyan Davit,1:3,10:12 - 3:11 - 11:7 - 9:11 - 0:0,1,3,Gevorgyan Hayk,Petrosyan Davit,fiurst,Gevorgyan Hayk - Petrosyan Davit,74,33,41,8,-8,22,14,18,20,0,2,8,-4,2,0,8,10:12 - 3:11 - 11:7 - 9:11 - 0:0
17751463,2024-03-28 15:15:00,Papyan Karen - Diaryan Aleksandr,0:3,11:4 - 11:9 - 12:10 - 0:0 - 0:0,3,0,Papyan Karen,Diaryan Aleksandr,fiurst,Diaryan Aleksandr - Papyan Karen,57,23,34,11,-11,15,20,22,0,0,7,2,2,0,0,11,4:11 - 9:11 - 10:12 - 0:0 - 0:0
17751461,2024-03-28 15:00:00,Nikoghosyan Narek - Arutyunov Ruben,0:3,12:10 - 11:8 - 11:7 - 0:0 - 0:0,3,0,Nikoghosyan Narek,Arutyunov Ruben,fiurst,Arutyunov Ruben - Nikoghosyan Narek,59,25,34,9,-9,22,19,18,0,0,2,3,4,0,0,9,10:12 - 8:11 - 7:11 - 0:0 - 0:0
17751460,2024-03-28 14:50:00,Rafayelyan Edgar - Papyan Karen,1:3,12:10 - 9:11 - 11:3 - 11:3 - 0:0,3,1,Rafayelyan Edgar,Papyan Karen,fiurst,Papyan Karen - Rafayelyan Edgar,70,27,43,16,-16,22,20,14,14,0,2,-2,8,8,0,16,10:12 - 11:9 - 3:11 - 3:11 - 0:0
17751455,2024-03-28 14:20:00,Arutyunov Ruben - Papyan Karen,3:2,11:8 - 9:11 - 11:13 - 14:12 - 11:7,3,2,Arutyunov Ruben,Papyan Karen,fiurst,Arutyunov Ruben - Papyan Karen,107,56,51,-5,5,19,20,24,26,18,-3,2,2,-2,-4,-5,11:8 - 9:11 - 11:13 - 14:12 - 11:7
17751457,2024-03-28 14:15:00,Nikoghosyan Narek - Diaryan Aleksandr,3:2,3:11 - 11:2 - 6:11 - 11:7 - 8:11,2,3,Nikoghosyan Narek,Diaryan Aleksandr,fiurst,Diaryan Aleksandr - Nikoghosyan Narek,81,42,39,-3,3,14,13,17,18,19,-8,9,-5,4,-3,-3,11:3 - 2:11 - 11:6 - 7:11 - 11:8
17751453,2024-03-28 13:45:00,Diaryan Aleksandr - Arutyunov Ruben,1:3,11:7 - 11:6 - 6:11 - 11:9 - 0:0,3,1,Diaryan Aleksandr,Arutyunov Ruben,fiurst,Arutyunov Ruben - Diaryan Aleksandr,72,33,39,6,-6,18,17,17,20,0,4,5,-5,2,0,6,7:11 - 6:11 - 11:6 - 9:11 - 0:0
17751454,2024-03-28 13:45:00,Rafayelyan Edgar - Nikoghosyan Narek,0:3,11:4 - 11:5 - 11:6 - 0:0 - 0:0,3,0,Rafayelyan Edgar,Nikoghosyan Narek,fiurst,Nikoghosyan Narek - Rafayelyan Edgar,48,15,33,18,-18,15,16,17,0,0,7,6,5,0,0,18,4:11 - 5:11 - 6:11 - 0:0 - 0:0
17751451,2024-03-28 13:25:00,Papyan Karen - Nikoghosyan Narek,1:3,11:3 - 5:11 - 11:5 - 11:9 - 0:0,3,1,Papyan Karen,Nikoghosyan Narek,fiurst,Nikoghosyan Narek - Papyan Karen,66,28,38,10,-10,14,16,16,20,0,8,-6,6,2,0,10,3:11 - 11:5 - 5:11 - 9:11 - 0:0
17751449,2024-03-28 13:00:00,Diaryan Aleksandr - Rafayelyan Edgar,2:3,10:12 - 13:11 - 8:11 - 11:7 - 9:11,2,3,Diaryan Aleksandr,Rafayelyan Edgar,fiurst,Diaryan Aleksandr - Rafayelyan Edgar,103,51,52,1,-1,22,24,19,18,20,2,-2,3,-4,2,1,10:12 - 13:11 - 8:11 - 11:7 - 9:11
17751445,2024-03-28 12:25:00,Arutyunov Ruben - Nikoghosyan Narek,3:2,7:11 - 9:11 - 11:9 - 12:10 - 13:11,3,2,Arutyunov Ruben,Nikoghosyan Narek,fiurst,Arutyunov Ruben - Nikoghosyan Narek,104,52,52,0,0,18,20,20,22,24,4,2,-2,-2,-2,0,7:11 - 9:11 - 11:9 - 12:10 - 13:11
17751443,2024-03-28 12:20:00,Diaryan Aleksandr - Papyan Karen,3:0,11:6 - 15:13 - 11:1 - 0:0 - 0:0,3,0,Diaryan Aleksandr,Papyan Karen,fiurst,Diaryan Aleksandr - Papyan Karen,57,37,20,-17,17,17,28,12,0,0,-5,-2,-10,0,0,-17,11:6 - 15:13 - 11:1 - 0:0 - 0:0
17751439,2024-03-28 11:45:00,Rafayelyan Edgar - Arutyunov Ruben,3:1,11:13 - 8:11 - 13:11 - 5:11 - 0:0,1,3,Rafayelyan Edgar,Arutyunov Ruben,fiurst,Arutyunov Ruben - Rafayelyan Edgar,83,46,37,-9,9,24,19,24,16,0,-2,-3,2,-6,0,-9,13:11 - 11:8 - 11:13 - 11:5 - 0:0
17751438,2024-03-28 11:40:00,Diaryan Aleksandr - Nikoghosyan Narek,2:3,9:11 - 11:8 - 12:10 - 15:17 - 8:11,2,3,Diaryan Aleksandr,Nikoghosyan Narek,fiurst,Diaryan Aleksandr - Nikoghosyan Narek,112,55,57,2,-2,20,19,22,32,19,2,-3,-2,2,3,2,9:11 - 11:8 - 12:10 - 15:17 - 8:11
17751437,2024-03-28 11:20:00,Papyan Karen - Rafayelyan Edgar,1:3,4:11 - 8:11 - 12:10 - 11:13 - 0:0,1,3,Papyan Karen,Rafayelyan Edgar,fiurst,Papyan Karen - Rafayelyan Edgar,80,35,45,10,-10,15,19,22,24,0,7,3,-2,2,0,10,4:11 - 8:11 - 12:10 - 11:13 - 0:0
17751434,2024-03-28 11:15:00,Arutyunov Ruben - Diaryan Aleksandr,1:3,8:11 - 11:8 - 5:11 - 2:11 - 0:0,1,3,Arutyunov Ruben,Diaryan Aleksandr,fiurst,Arutyunov Ruben - Diaryan Aleksandr,67,26,41,15,-15,19,19,16,13,0,3,-3,6,9,0,15,8:11 - 11:8 - 5:11 - 2:11 - 0:0
17751431,2024-03-28 10:45:00,Nikoghosyan Narek - Rafayelyan Edgar,0:3,8:11 - 4:11 - 8:11 - 0:0 - 0:0,0,3,Nikoghosyan Narek,Rafayelyan Edgar,fiurst,Nikoghosyan Narek - Rafayelyan Edgar,53,20,33,13,-13,19,15,19,0,0,3,7,3,0,0,13,8:11 - 4:11 - 8:11 - 0:0 - 0:0
17751418,2024-03-28 10:40:00,Papyan Karen - Arutyunov Ruben,1:3,15:13 - 11:5 - 13:15 - 11:8 - 0:0,3,1,Papyan Karen,Arutyunov Ruben,fiurst,Arutyunov Ruben - Papyan Karen,91,41,50,9,-9,28,16,28,19,0,2,6,-2,3,0,9,13:15 - 5:11 - 15:13 - 8:11 - 0:0
17751417,2024-03-28 10:15:00,Rafayelyan Edgar - Diaryan Aleksandr,0:3,11:8 - 11:9 - 11:5 - 0:0 - 0:0,3,0,Rafayelyan Edgar,Diaryan Aleksandr,fiurst,Diaryan Aleksandr - Rafayelyan Edgar,55,22,33,11,-11,19,20,16,0,0,3,2,6,0,0,11,8:11 - 9:11 - 5:11 - 0:0 - 0:0
17751409,2024-03-28 10:00:00,Nikoghosyan Narek - Papyan Karen,2:3,11:7 - 5:11 - 7:11 - 11:5 - 3:11,2,3,Nikoghosyan Narek,Papyan Karen,fiurst,Nikoghosyan Narek - Papyan Karen,82,37,45,8,-8,18,16,18,16,14,-4,6,4,-6,8,8,11:7 - 5:11 - 7:11 - 11:5 - 3:11
17728075,2024-03-27 17:45:00,Mkrtchyan Andranik - Gevorgyan Gegham,3:0,6:11 - 6:11 - 8:11 - 0:0 - 0:0,0,3,Mkrtchyan Andranik,Gevorgyan Gegham,fiurst,Gevorgyan Gegham - Mkrtchyan Andranik,53,33,20,-13,13,17,17,19,0,0,-5,-5,-3,0,0,-13,11:6 - 11:6 - 11:8 - 0:0 - 0:0
17728068,2024-03-27 17:30:00,Gevorgyan Hayk - Mkrtchyan Andranik,3:0,11:8 - 11:4 - 11:6 - 0:0 - 0:0,3,0,Gevorgyan Hayk,Mkrtchyan Andranik,fiurst,Gevorgyan Hayk - Mkrtchyan Andranik,51,33,18,-15,15,19,15,17,0,0,-3,-7,-5,0,0,-15,11:8 - 11:4 - 11:6 - 0:0 - 0:0
17728073,2024-03-27 17:30:00,Soghomonyan Hrayr - Petrosyan Davit,0:3,12:10 - 11:8 - 11:6 - 0:0 - 0:0,3,0,Soghomonyan Hrayr,Petrosyan Davit,fiurst,Petrosyan Davit - Soghomonyan Hrayr,58,24,34,10,-10,22,19,17,0,0,2,3,5,0,0,10,10:12 - 8:11 - 6:11 - 0:0 - 0:0
17728066,2024-03-27 17:05:00,Soghomonyan Hrayr - Gevorgyan Gegham,1:3,11:4 - 9:11 - 11:4 - 11:9 - 0:0,3,1,Soghomonyan Hrayr,Gevorgyan Gegham,fiurst,Gevorgyan Gegham - Soghomonyan Hrayr,70,28,42,14,-14,15,20,15,20,0,7,-2,7,2,0,14,4:11 - 11:9 - 4:11 - 9:11 - 0:0
17728064,2024-03-27 16:55:00,Petrosyan Davit - Gevorgyan Hayk,3:1,8:11 - 10:12 - 11:7 - 9:11 - 0:0,1,3,Petrosyan Davit,Gevorgyan Hayk,fiurst,Gevorgyan Hayk - Petrosyan Davit,79,41,38,-3,3,19,22,18,20,0,-3,-2,4,-2,0,-3,11:8 - 12:10 - 7:11 - 11:9 - 0:0
17728060,2024-03-27 16:30:00,Gevorgyan Gegham - Gevorgyan Hayk,0:3,7:11 - 8:11 - 8:11 - 0:0 - 0:0,0,3,Gevorgyan Gegham,Gevorgyan Hayk,fiurst,Gevorgyan Gegham - Gevorgyan Hayk,56,23,33,10,-10,18,19,19,0,0,4,3,3,0,0,10,7:11 - 8:11 - 8:11 - 0:0 - 0:0
17728061,2024-03-27 16:30:00,Mkrtchyan Andranik - Soghomonyan Hrayr,0:3,5:11 - 8:11 - 9:11 - 0:0 - 0:0,0,3,Mkrtchyan Andranik,Soghomonyan Hrayr,fiurst,Mkrtchyan Andranik - Soghomonyan Hrayr,55,22,33,11,-11,16,19,20,0,0,6,3,2,0,0,11,5:11 - 8:11 - 9:11 - 0:0 - 0:0
17728058,2024-03-27 16:05:00,Petrosyan Davit - Mkrtchyan Andranik,2:3,12:10 - 8:11 - 11:4 - 5:11 - 11:9,3,2,Petrosyan Davit,Mkrtchyan Andranik,fiurst,Mkrtchyan Andranik - Petrosyan Davit,92,45,47,2,-2,22,19,15,16,20,2,-3,7,-6,2,2,10:12 - 11:8 - 4:11 - 11:5 - 9:11
17728047,2024-03-27 15:50:00,Gevorgyan Hayk - Soghomonyan Hrayr,3:2,7:11 - 11:5 - 13:11 - 9:11 - 11:8,3,2,Gevorgyan Hayk,Soghomonyan Hrayr,fiurst,Gevorgyan Hayk - Soghomonyan Hrayr,97,51,46,-5,5,18,16,24,20,19,4,-6,-2,2,-3,-5,7:11 - 11:5 - 13:11 - 9:11 - 11:8
17728046,2024-03-27 15:35:00,Gevorgyan Gegham - Petrosyan Davit,2:3,11:3 - 11:7 - 3:11 - 6:11 - 7:11,2,3,Gevorgyan Gegham,Petrosyan Davit,fiurst,Gevorgyan Gegham - Petrosyan Davit,81,38,43,5,-5,14,18,14,17,18,-8,-4,8,5,4,5,11:3 - 11:7 - 3:11 - 6:11 - 7:11
17728044,2024-03-27 15:25:00,Asatryan Murad - Nikoghosyan Narek,3:1,9:11 - 11:4 - 11:9 - 11:8 - 0:0,3,1,Asatryan Murad,Nikoghosyan Narek,fiurst,Asatryan Murad - Nikoghosyan Narek,74,42,32,-10,10,20,15,20,19,0,2,-7,-2,-3,0,-10,9:11 - 11:4 - 11:9 - 11:8 - 0:0
17728037,2024-03-27 15:20:00,Rafayelyan Edgar - Nazaryan Mushegh,0:3,11:7 - 11:6 - 11:5 - 0:0 - 0:0,3,0,Rafayelyan Edgar,Nazaryan Mushegh,fiurst,Nazaryan Mushegh - Rafayelyan Edgar,51,18,33,15,-15,18,17,16,0,0,4,5,6,0,0,15,7:11 - 6:11 - 5:11 - 0:0 - 0:0
17728034,2024-03-27 15:00:00,Hovhannesyan Rafik - Asatryan Murad,3:0,7:11 - 9:11 - 12:14 - 0:0 - 0:0,0,3,Hovhannesyan Rafik,Asatryan Murad,fiurst,Asatryan Murad - Hovhannesyan Rafik,64,36,28,-8,8,18,20,26,0,0,-4,-2,-2,0,0,-8,11:7 - 11:9 - 14:12 - 0:0 - 0:0
17728033,2024-03-27 14:40:00,Nikoghosyan Narek - Rafayelyan Edgar,2:3,11:9 - 3:11 - 11:6 - 11:13 - 9:11,2,3,Nikoghosyan Narek,Rafayelyan Edgar,fiurst,Nikoghosyan Narek - Rafayelyan Edgar,95,45,50,5,-5,20,14,17,24,20,-2,8,-5,2,2,5,11:9 - 3:11 - 11:6 - 11:13 - 9:11
17728031,2024-03-27 14:30:00,Hovhannesyan Rafik - Nazaryan Mushegh,3:1,11:9 - 6:11 - 11:5 - 17:15 - 0:0,3,1,Hovhannesyan Rafik,Nazaryan Mushegh,fiurst,Hovhannesyan Rafik - Nazaryan Mushegh,85,45,40,-5,5,20,17,16,32,0,-2,5,-6,-2,0,-5,11:9 - 6:11 - 11:5 - 17:15 - 0:0
17728025,2024-03-27 14:00:00,Asatryan Murad - Rafayelyan Edgar,3:1,11:6 - 11:4 - 7:11 - 11:2 - 0:0,3,1,Asatryan Murad,Rafayelyan Edgar,fiurst,Asatryan Murad - Rafayelyan Edgar,63,40,23,-17,17,17,15,18,13,0,-5,-7,4,-9,0,-17,11:6 - 11:4 - 7:11 - 11:2 - 0:0
17728015,2024-03-27 13:55:00,Nikoghosyan Narek - Hovhannesyan Rafik,1:3,8:11 - 12:10 - 11:7 - 11:8 - 0:0,3,1,Nikoghosyan Narek,Hovhannesyan Rafik,fiurst,Hovhannesyan Rafik - Nikoghosyan Narek,78,36,42,6,-6,19,22,18,19,0,-3,2,4,3,0,6,11:8 - 10:12 - 7:11 - 8:11 - 0:0
17728011,2024-03-27 13:40:00,Nazaryan Mushegh - Asatryan Murad,3:0,7:11 - 4:11 - 5:11 - 0:0 - 0:0,0,3,Nazaryan Mushegh,Asatryan Murad,fiurst,Asatryan Murad - Nazaryan Mushegh,49,33,16,-17,17,18,15,16,0,0,-4,-7,-6,0,0,-17,11:7 - 11:4 - 11:5 - 0:0 - 0:0
17727983,2024-03-27 13:15:00,Rafayelyan Edgar - Hovhannesyan Rafik,1:3,11:5 - 8:11 - 11:2 - 11:4 - 0:0,3,1,Rafayelyan Edgar,Hovhannesyan Rafik,fiurst,Hovhannesyan Rafik - Rafayelyan Edgar,63,22,41,19,-19,16,19,13,15,0,6,-3,9,7,0,19,5:11 - 11:8 - 2:11 - 4:11 - 0:0
17727982,2024-03-27 13:00:00,Nazaryan Mushegh - Nikoghosyan Narek,2:3,7:11 - 11:7 - 11:6 - 8:11 - 6:11,2,3,Nazaryan Mushegh,Nikoghosyan Narek,fiurst,Nazaryan Mushegh - Nikoghosyan Narek,89,43,46,3,-3,18,18,17,19,17,4,-4,-5,3,5,3,7:11 - 11:7 - 11:6 - 8:11 - 6:11
17727978,2024-03-27 12:35:00,Asatryan Murad - Hovhannesyan Rafik,3:0,11:6 - 11:2 - 11:3 - 0:0 - 0:0,3,0,Asatryan Murad,Hovhannesyan Rafik,fiurst,Asatryan Murad - Hovhannesyan Rafik,44,33,11,-22,22,17,13,14,0,0,-5,-9,-8,0,0,-22,11:6 - 11:2 - 11:3 - 0:0 - 0:0
17727953,2024-03-27 12:10:00,Nikoghosyan Narek - Asatryan Murad,3:1,6:11 - 11:9 - 7:11 - 5:11 - 0:0,1,3,Nikoghosyan Narek,Asatryan Murad,fiurst,Asatryan Murad - Nikoghosyan Narek,71,42,29,-13,13,17,20,18,16,0,-5,2,-4,-6,0,-13,11:6 - 9:11 - 11:7 - 11:5 - 0:0
17727957,2024-03-27 12:10:00,Nazaryan Mushegh - Rafayelyan Edgar,2:3,11:3 - 11:8 - 10:12 - 7:11 - 8:11,2,3,Nazaryan Mushegh,Rafayelyan Edgar,fiurst,Nazaryan Mushegh - Rafayelyan Edgar,92,47,45,-2,2,14,19,22,18,19,-8,-3,2,4,3,-2,11:3 - 11:8 - 10:12 - 7:11 - 8:11
17727950,2024-03-27 11:30:00,Nazaryan Mushegh - Hovhannesyan Rafik,0:3,12:10 - 11:5 - 11:6 - 0:0 - 0:0,3,0,Nazaryan Mushegh,Hovhannesyan Rafik,fiurst,Hovhannesyan Rafik - Nazaryan Mushegh,55,21,34,13,-13,22,16,17,0,0,2,6,5,0,0,13,10:12 - 5:11 - 6:11 - 0:0 - 0:0
17727947,2024-03-27 11:25:00,Rafayelyan Edgar - Nikoghosyan Narek,2:3,13:11 - 11:13 - 11:8 - 6:11 - 13:11,3,2,Rafayelyan Edgar,Nikoghosyan Narek,fiurst,Nikoghosyan Narek - Rafayelyan Edgar,108,54,54,0,0,24,24,19,17,24,2,-2,3,-5,2,0,11:13 - 13:11 - 8:11 - 11:6 - 11:13
17727941,2024-03-27 11:00:00,Asatryan Murad - Nazaryan Mushegh,3:0,11:2 - 11:8 - 11:2 - 0:0 - 0:0,3,0,Asatryan Murad,Nazaryan Mushegh,fiurst,Asatryan Murad - Nazaryan Mushegh,45,33,12,-21,21,13,19,13,0,0,-9,-3,-9,0,0,-21,11:2 - 11:8 - 11:2 - 0:0 - 0:0
17727938,2024-03-27 10:45:00,Hovhannesyan Rafik - Nikoghosyan Narek,2:3,11:6 - 11:9 - 8:11 - 3:11 - 9:11,2,3,Hovhannesyan Rafik,Nikoghosyan Narek,fiurst,Hovhannesyan Rafik - Nikoghosyan Narek,90,42,48,6,-6,17,20,19,14,20,-5,-2,3,8,2,6,11:6 - 11:9 - 8:11 - 3:11 - 9:11
17727937,2024-03-27 10:30:00,Rafayelyan Edgar - Asatryan Murad,3:1,9:11 - 11:8 - 7:11 - 10:12 - 0:0,1,3,Rafayelyan Edgar,Asatryan Murad,fiurst,Asatryan Murad - Rafayelyan Edgar,79,42,37,-5,5,20,19,18,22,0,-2,3,-4,-2,0,-5,11:9 - 8:11 - 11:7 - 12:10 - 0:0
17727934,2024-03-27 10:15:00,Nikoghosyan Narek - Nazaryan Mushegh,0:3,11:5 - 14:12 - 11:9 - 0:0 - 0:0,3,0,Nikoghosyan Narek,Nazaryan Mushegh,fiurst,Nazaryan Mushegh - Nikoghosyan Narek,62,26,36,10,-10,16,26,20,0,0,6,2,2,0,0,10,5:11 - 12:14 - 9:11 - 0:0 - 0:0
17727933,2024-03-27 10:00:00,Hovhannesyan Rafik - Rafayelyan Edgar,3:2,11:4 - 4:11 - 7:11 - 11:9 - 11:5,3,2,Hovhannesyan Rafik,Rafayelyan Edgar,fiurst,Hovhannesyan Rafik - Rafayelyan Edgar,84,44,40,-4,4,15,15,18,20,16,-7,7,4,-2,-6,-4,11:4 - 4:11 - 7:11 - 11:9 - 11:5
17711732,2024-03-26 17:50:00,Gevorgyan Hayk - Mkrtchyan Andranik,3:2,11:4 - 12:10 - 13:15 - 6:11 - 12:10,3,2,Gevorgyan Hayk,Mkrtchyan Andranik,fiurst,Gevorgyan Hayk - Mkrtchyan Andranik,104,54,50,-4,4,15,22,28,17,22,-7,-2,2,5,-2,-4,11:4 - 12:10 - 13:15 - 6:11 - 12:10
17711728,2024-03-26 17:40:00,Soghomonyan Hrayr - Karakhanyan Mher,1:3,5:11 - 11:7 - 11:6 - 11:9 - 0:0,3,1,Soghomonyan Hrayr,Karakhanyan Mher,fiurst,Karakhanyan Mher - Soghomonyan Hrayr,71,33,38,5,-5,16,18,17,20,0,-6,4,5,2,0,5,11:5 - 7:11 - 6:11 - 9:11 - 0:0
17711724,2024-03-26 17:15:00,Gevorgyan Gegham - Gevorgyan Hayk,2:3,9:11 - 11:6 - 11:8 - 7:11 - 7:11,2,3,Gevorgyan Gegham,Gevorgyan Hayk,fiurst,Gevorgyan Gegham - Gevorgyan Hayk,92,45,47,2,-2,20,17,19,18,18,2,-5,-3,4,4,2,9:11 - 11:6 - 11:8 - 7:11 - 7:11
17711723,2024-03-26 17:00:00,Soghomonyan Hrayr - Mkrtchyan Andranik,2:3,13:15 - 11:9 - 7:11 - 11:7 - 13:11,3,2,Soghomonyan Hrayr,Mkrtchyan Andranik,fiurst,Mkrtchyan Andranik - Soghomonyan Hrayr,108,53,55,2,-2,28,20,18,18,24,-2,2,-4,4,2,2,15:13 - 9:11 - 11:7 - 7:11 - 11:13
17711722,2024-03-26 16:45:00,Karakhanyan Mher - Gevorgyan Gegham,3:0,7:11 - 8:11 - 8:11 - 0:0 - 0:0,0,3,Karakhanyan Mher,Gevorgyan Gegham,fiurst,Gevorgyan Gegham - Karakhanyan Mher,56,33,23,-10,10,18,19,19,0,0,-4,-3,-3,0,0,-10,11:7 - 11:8 - 11:8 - 0:0 - 0:0
17711721,2024-03-26 16:30:00,Gevorgyan Hayk - Soghomonyan Hrayr,0:3,5:11 - 10:12 - 8:11 - 0:0 - 0:0,0,3,Gevorgyan Hayk,Soghomonyan Hrayr,fiurst,Gevorgyan Hayk - Soghomonyan Hrayr,57,23,34,11,-11,16,22,19,0,0,6,2,3,0,0,11,5:11 - 10:12 - 8:11 - 0:0 - 0:0
17711713,2024-03-26 16:15:00,Mkrtchyan Andranik - Gevorgyan Gegham,1:3,8:11 - 12:10 - 11:9 - 11:9 - 0:0,3,1,Mkrtchyan Andranik,Gevorgyan Gegham,fiurst,Gevorgyan Gegham - Mkrtchyan Andranik,81,39,42,3,-3,19,22,20,20,0,-3,2,2,2,0,3,11:8 - 10:12 - 9:11 - 9:11 - 0:0
17711704,2024-03-26 16:05:00,Karakhanyan Mher - Gevorgyan Hayk,3:1,11:9 - 3:11 - 6:11 - 6:11 - 0:0,1,3,Karakhanyan Mher,Gevorgyan Hayk,fiurst,Gevorgyan Hayk - Karakhanyan Mher,68,42,26,-16,16,20,14,17,17,0,2,-8,-5,-5,0,-16,9:11 - 11:3 - 11:6 - 11:6 - 0:0
17711702,2024-03-26 15:45:00,Gevorgyan Gegham - Soghomonyan Hrayr,0:3,5:11 - 8:11 - 9:11 - 0:0 - 0:0,0,3,Gevorgyan Gegham,Soghomonyan Hrayr,fiurst,Gevorgyan Gegham - Soghomonyan Hrayr,55,22,33,11,-11,16,19,20,0,0,6,3,2,0,0,11,5:11 - 8:11 - 9:11 - 0:0 - 0:0
17711700,2024-03-26 15:30:00,Mkrtchyan Andranik - Karakhanyan Mher,0:3,13:11 - 11:5 - 11:5 - 0:0 - 0:0,3,0,Mkrtchyan Andranik,Karakhanyan Mher,fiurst,Karakhanyan Mher - Mkrtchyan Andranik,56,21,35,14,-14,24,16,16,0,0,2,6,6,0,0,14,11:13 - 5:11 - 5:11 - 0:0 - 0:0
17711687,2024-03-26 15:15:00,Nazaryan Mushegh - Hovhannesyan Rafik,3:0,6:11 - 9:11 - 8:11 - 0:0 - 0:0,0,3,Nazaryan Mushegh,Hovhannesyan Rafik,fiurst,Hovhannesyan Rafik - Nazaryan Mushegh,56,33,23,-10,10,17,20,19,0,0,-5,-2,-3,0,0,-10,11:6 - 11:9 - 11:8 - 0:0 - 0:0
17711685,2024-03-26 15:10:00,Nikoghosyan Narek - Diaryan Aleksandr,0:3,12:10 - 11:7 - 12:10 - 0:0 - 0:0,3,0,Nikoghosyan Narek,Diaryan Aleksandr,fiurst,Diaryan Aleksandr - Nikoghosyan Narek,62,27,35,8,-8,22,18,22,0,0,2,4,2,0,0,8,10:12 - 7:11 - 10:12 - 0:0 - 0:0
17711684,2024-03-26 14:45:00,Rafayelyan Edgar - Nazaryan Mushegh,0:3,11:8 - 11:5 - 11:8 - 0:0 - 0:0,3,0,Rafayelyan Edgar,Nazaryan Mushegh,fiurst,Nazaryan Mushegh - Rafayelyan Edgar,54,21,33,12,-12,19,16,19,0,0,3,6,3,0,0,12,8:11 - 5:11 - 8:11 - 0:0 - 0:0
17711682,2024-03-26 14:35:00,Hovhannesyan Rafik - Nikoghosyan Narek,1:3,9:11 - 9:11 - 11:9 - 8:11 - 0:0,1,3,Hovhannesyan Rafik,Nikoghosyan Narek,fiurst,Hovhannesyan Rafik - Nikoghosyan Narek,79,37,42,5,-5,20,20,20,19,0,2,2,-2,3,0,5,9:11 - 9:11 - 11:9 - 8:11 - 0:0
17711679,2024-03-26 14:15:00,Rafayelyan Edgar - Diaryan Aleksandr,0:3,11:9 - 11:6 - 14:12 - 0:0 - 0:0,3,0,Rafayelyan Edgar,Diaryan Aleksandr,fiurst,Diaryan Aleksandr - Rafayelyan Edgar,63,27,36,9,-9,20,17,26,0,0,2,5,2,0,0,9,9:11 - 6:11 - 12:14 - 0:0 - 0:0
17711677,2024-03-26 14:00:00,Nazaryan Mushegh - Nikoghosyan Narek,0:3,7:11 - 8:11 - 7:11 - 0:0 - 0:0,0,3,Nazaryan Mushegh,Nikoghosyan Narek,fiurst,Nazaryan Mushegh - Nikoghosyan Narek,55,22,33,11,-11,18,19,18,0,0,4,3,4,0,0,11,7:11 - 8:11 - 7:11 - 0:0 - 0:0
17711676,2024-03-26 13:45:00,Hovhannesyan Rafik - Rafayelyan Edgar,0:3,7:11 - 7:11 - 7:11 - 0:0 - 0:0,0,3,Hovhannesyan Rafik,Rafayelyan Edgar,fiurst,Hovhannesyan Rafik - Rafayelyan Edgar,54,21,33,12,-12,18,18,18,0,0,4,4,4,0,0,12,7:11 - 7:11 - 7:11 - 0:0 - 0:0
17711675,2024-03-26 13:30:00,Diaryan Aleksandr - Nazaryan Mushegh,3:0,11:6 - 11:6 - 11:8 - 0:0 - 0:0,3,0,Diaryan Aleksandr,Nazaryan Mushegh,fiurst,Diaryan Aleksandr - Nazaryan Mushegh,53,33,20,-13,13,17,17,19,0,0,-5,-5,-3,0,0,-13,11:6 - 11:6 - 11:8 - 0:0 - 0:0
17711674,2024-03-26 13:15:00,Nikoghosyan Narek - Rafayelyan Edgar,0:3,4:11 - 9:11 - 12:14 - 0:0 - 0:0,0,3,Nikoghosyan Narek,Rafayelyan Edgar,fiurst,Nikoghosyan Narek - Rafayelyan Edgar,61,25,36,11,-11,15,20,26,0,0,7,2,2,0,0,11,4:11 - 9:11 - 12:14 - 0:0 - 0:0
17711666,2024-03-26 13:10:00,Diaryan Aleksandr - Hovhannesyan Rafik,3:0,11:8 - 11:6 - 11:6 - 0:0 - 0:0,3,0,Diaryan Aleksandr,Hovhannesyan Rafik,fiurst,Diaryan Aleksandr - Hovhannesyan Rafik,53,33,20,-13,13,19,17,17,0,0,-3,-5,-5,0,0,-13,11:8 - 11:6 - 11:6 - 0:0 - 0:0
17711660,2024-03-26 12:20:00,Nazaryan Mushegh - Rafayelyan Edgar,1:3,8:11 - 5:11 - 11:7 - 4:11 - 0:0,1,3,Nazaryan Mushegh,Rafayelyan Edgar,fiurst,Nazaryan Mushegh - Rafayelyan Edgar,68,28,40,12,-12,19,16,18,15,0,3,6,-4,7,0,12,8:11 - 5:11 - 11:7 - 4:11 - 0:0
17711657,2024-03-26 12:00:00,Diaryan Aleksandr - Nikoghosyan Narek,3:2,11:6 - 6:11 - 11:9 - 5:11 - 11:9,3,2,Diaryan Aleksandr,Nikoghosyan Narek,fiurst,Diaryan Aleksandr - Nikoghosyan Narek,90,44,46,2,-2,17,17,20,16,20,-5,5,-2,6,-2,2,11:6 - 6:11 - 11:9 - 5:11 - 11:9
17711654,2024-03-26 11:50:00,Hovhannesyan Rafik - Nazaryan Mushegh,3:2,11:6 - 7:11 - 8:11 - 12:10 - 17:15,3,2,Hovhannesyan Rafik,Nazaryan Mushegh,fiurst,Hovhannesyan Rafik - Nazaryan Mushegh,108,55,53,-2,2,17,18,19,22,32,-5,4,3,-2,-2,-2,11:6 - 7:11 - 8:11 - 12:10 - 17:15
17711643,2024-03-26 11:30:00,Diaryan Aleksandr - Rafayelyan Edgar,1:3,9:11 - 5:11 - 11:5 - 5:11 - 0:0,1,3,Diaryan Aleksandr,Rafayelyan Edgar,fiurst,Diaryan Aleksandr - Rafayelyan Edgar,68,30,38,8,-8,20,16,16,16,0,2,6,-6,6,0,8,9:11 - 5:11 - 11:5 - 5:11 - 0:0
17711641,2024-03-26 11:15:00,Nikoghosyan Narek - Hovhannesyan Rafik,0:3,11:9 - 11:4 - 11:7 - 0:0 - 0:0,3,0,Nikoghosyan Narek,Hovhannesyan Rafik,fiurst,Hovhannesyan Rafik - Nikoghosyan Narek,53,20,33,13,-13,20,15,18,0,0,2,7,4,0,0,13,9:11 - 4:11 - 7:11 - 0:0 - 0:0
17711640,2024-03-26 11:05:00,Nazaryan Mushegh - Diaryan Aleksandr,3:0,9:11 - 12:14 - 4:11 - 0:0 - 0:0,0,3,Nazaryan Mushegh,Diaryan Aleksandr,fiurst,Diaryan Aleksandr - Nazaryan Mushegh,61,36,25,-11,11,20,26,15,0,0,-2,-2,-7,0,0,-11,11:9 - 14:12 - 11:4 - 0:0 - 0:0
17711631,2024-03-26 10:45:00,Rafayelyan Edgar - Hovhannesyan Rafik,2:3,11:8 - 8:11 - 3:11 - 11:8 - 11:4,3,2,Rafayelyan Edgar,Hovhannesyan Rafik,fiurst,Hovhannesyan Rafik - Rafayelyan Edgar,86,42,44,2,-2,19,19,14,19,15,3,-3,-8,3,7,2,8:11 - 11:8 - 11:3 - 8:11 - 4:11
17711619,2024-03-26 10:30:00,Nikoghosyan Narek - Nazaryan Mushegh,1:3,11:9 - 11:8 - 11:13 - 11:8 - 0:0,3,1,Nikoghosyan Narek,Nazaryan Mushegh,fiurst,Nazaryan Mushegh - Nikoghosyan Narek,82,38,44,6,-6,20,19,24,19,0,2,3,-2,3,0,6,9:11 - 8:11 - 13:11 - 8:11 - 0:0
17711617,2024-03-26 10:15:00,Hovhannesyan Rafik - Diaryan Aleksandr,3:0,7:11 - 6:11 - 6:11 - 0:0 - 0:0,0,3,Hovhannesyan Rafik,Diaryan Aleksandr,fiurst,Diaryan Aleksandr - Hovhannesyan Rafik,52,33,19,-14,14,18,17,17,0,0,-4,-5,-5,0,0,-14,11:7 - 11:6 - 11:6 - 0:0 - 0:0
17711604,2024-03-26 10:00:00,Rafayelyan Edgar - Nikoghosyan Narek,0:3,16:14 - 11:7 - 11:9 - 0:0 - 0:0,3,0,Rafayelyan Edgar,Nikoghosyan Narek,fiurst,Nikoghosyan Narek - Rafayelyan Edgar,68,30,38,8,-8,30,18,20,0,0,2,4,2,0,0,8,14:16 - 7:11 - 9:11 - 0:0 - 0:0
17693411,2024-03-25 17:50:00,Mkrtchyan Andranik - Petrosyan Davit,0:3,7:11 - 19:21 - 9:11 - 0:0 - 0:0,0,3,Mkrtchyan Andranik,Petrosyan Davit,fiurst,Mkrtchyan Andranik - Petrosyan Davit,78,35,43,8,-8,18,40,20,0,0,4,2,2,0,0,8,7:11 - 19:21 - 9:11 - 0:0 - 0:0
17693404,2024-03-25 17:35:00,Gevorgyan Hayk - Avakimyan Davit,3:1,9:11 - 6:11 - 11:7 - 9:11 - 0:0,1,3,Gevorgyan Hayk,Avakimyan Davit,fiurst,Avakimyan Davit - Gevorgyan Hayk,75,40,35,-5,5,20,17,18,20,0,-2,-5,4,-2,0,-5,11:9 - 11:6 - 7:11 - 11:9 - 0:0
17693383,2024-03-25 17:15:00,Soghomonyan Hrayr - Mkrtchyan Andranik,1:3,3:11 - 11:8 - 12:10 - 11:5 - 0:0,3,1,Soghomonyan Hrayr,Mkrtchyan Andranik,fiurst,Mkrtchyan Andranik - Soghomonyan Hrayr,71,34,37,3,-3,14,19,22,16,0,-8,3,2,6,0,3,11:3 - 8:11 - 10:12 - 5:11 - 0:0
17693371,2024-03-25 17:05:00,Gevorgyan Hayk - Petrosyan Davit,3:1,11:5 - 6:11 - 11:1 - 11:6 - 0:0,3,1,Gevorgyan Hayk,Petrosyan Davit,fiurst,Gevorgyan Hayk - Petrosyan Davit,62,39,23,-16,16,16,17,12,17,0,-6,5,-10,-5,0,-16,11:5 - 6:11 - 11:1 - 11:6 - 0:0
17693365,2024-03-25 16:45:00,Avakimyan Davit - Soghomonyan Hrayr,0:3,4:11 - 6:11 - 2:11 - 0:0 - 0:0,0,3,Avakimyan Davit,Soghomonyan Hrayr,fiurst,Avakimyan Davit - Soghomonyan Hrayr,45,12,33,21,-21,15,17,13,0,0,7,5,9,0,0,21,4:11 - 6:11 - 2:11 - 0:0 - 0:0
17693363,2024-03-25 16:35:00,Mkrtchyan Andranik - Gevorgyan Hayk,2:3,12:10 - 6:11 - 13:11 - 8:11 - 11:3,3,2,Mkrtchyan Andranik,Gevorgyan Hayk,fiurst,Gevorgyan Hayk - Mkrtchyan Andranik,96,46,50,4,-4,22,17,24,19,14,2,-5,2,-3,8,4,10:12 - 11:6 - 11:13 - 11:8 - 3:11
17693361,2024-03-25 16:15:00,Petrosyan Davit - Soghomonyan Hrayr,1:3,4:11 - 9:11 - 11:9 - 3:11 - 0:0,1,3,Petrosyan Davit,Soghomonyan Hrayr,fiurst,Petrosyan Davit - Soghomonyan Hrayr,69,27,42,15,-15,15,20,20,14,0,7,2,-2,8,0,15,4:11 - 9:11 - 11:9 - 3:11 - 0:0
17693358,2024-03-25 16:05:00,Avakimyan Davit - Mkrtchyan Andranik,3:0,11:5 - 11:9 - 11:9 - 0:0 - 0:0,3,0,Avakimyan Davit,Mkrtchyan Andranik,fiurst,Avakimyan Davit - Mkrtchyan Andranik,56,33,23,-10,10,16,20,20,0,0,-6,-2,-2,0,0,-10,11:5 - 11:9 - 11:9 - 0:0 - 0:0
17693357,2024-03-25 15:45:00,Soghomonyan Hrayr - Gevorgyan Hayk,2:3,8:11 - 11:4 - 11:9 - 8:11 - 11:6,3,2,Soghomonyan Hrayr,Gevorgyan Hayk,fiurst,Gevorgyan Hayk - Soghomonyan Hrayr,90,41,49,8,-8,19,15,20,19,17,-3,7,2,-3,5,8,11:8 - 4:11 - 9:11 - 11:8 - 6:11
17693345,2024-03-25 15:35:00,Petrosyan Davit - Avakimyan Davit,1:3,11:4 - 11:9 - 9:11 - 11:8 - 0:0,3,1,Petrosyan Davit,Avakimyan Davit,fiurst,Avakimyan Davit - Petrosyan Davit,74,32,42,10,-10,15,20,20,19,0,7,2,-2,3,0,10,4:11 - 9:11 - 11:9 - 8:11 - 0:0
17693343,2024-03-25 15:05:00,Rafayelyan Edgar - Asatryan Murad,3:2,11:8 - 10:12 - 5:11 - 11:7 - 9:11,2,3,Rafayelyan Edgar,Asatryan Murad,fiurst,Asatryan Murad - Rafayelyan Edgar,95,49,46,-3,3,19,22,16,18,20,3,-2,-6,4,-2,-3,8:11 - 12:10 - 11:5 - 7:11 - 11:9
17693341,2024-03-25 14:45:00,Nikoghosyan Narek - Diaryan Aleksandr,3:0,13:15 - 2:11 - 9:11 - 0:0 - 0:0,0,3,Nikoghosyan Narek,Diaryan Aleksandr,fiurst,Diaryan Aleksandr - Nikoghosyan Narek,61,37,24,-13,13,28,13,20,0,0,-2,-9,-2,0,0,-13,15:13 - 11:2 - 11:9 - 0:0 - 0:0
17693337,2024-03-25 14:15:00,Nikoghosyan Narek - Asatryan Murad,3:0,9:11 - 10:12 - 6:11 - 0:0 - 0:0,0,3,Nikoghosyan Narek,Asatryan Murad,fiurst,Asatryan Murad - Nikoghosyan Narek,59,34,25,-9,9,20,22,17,0,0,-2,-2,-5,0,0,-9,11:9 - 12:10 - 11:6 - 0:0 - 0:0
17693336,2024-03-25 14:10:00,Diaryan Aleksandr - Rafayelyan Edgar,0:3,8:11 - 8:11 - 8:11 - 0:0 - 0:0,0,3,Diaryan Aleksandr,Rafayelyan Edgar,fiurst,Diaryan Aleksandr - Rafayelyan Edgar,57,24,33,9,-9,19,19,19,0,0,3,3,3,0,0,9,8:11 - 8:11 - 8:11 - 0:0 - 0:0
17693322,2024-03-25 13:30:00,Asatryan Murad - Diaryan Aleksandr,3:2,7:11 - 11:5 - 12:10 - 11:13 - 11:8,3,2,Asatryan Murad,Diaryan Aleksandr,fiurst,Asatryan Murad - Diaryan Aleksandr,99,52,47,-5,5,18,16,22,24,19,4,-6,-2,2,-3,-5,7:11 - 11:5 - 12:10 - 11:13 - 11:8
17693318,2024-03-25 13:15:00,Rafayelyan Edgar - Nikoghosyan Narek,2:3,6:11 - 12:10 - 11:5 - 12:14 - 11:8,3,2,Rafayelyan Edgar,Nikoghosyan Narek,fiurst,Nikoghosyan Narek - Rafayelyan Edgar,100,48,52,4,-4,17,22,16,26,19,-5,2,6,-2,3,4,11:6 - 10:12 - 5:11 - 14:12 - 8:11
17693311,2024-03-25 12:15:00,Diaryan Aleksandr - Nikoghosyan Narek,0:3,9:11 - 9:11 - 5:11 - 0:0 - 0:0,0,3,Diaryan Aleksandr,Nikoghosyan Narek,fiurst,Diaryan Aleksandr - Nikoghosyan Narek,56,23,33,10,-10,20,20,16,0,0,2,2,6,0,0,10,9:11 - 9:11 - 5:11 - 0:0 - 0:0
17693306,2024-03-25 12:00:00,Asatryan Murad - Rafayelyan Edgar,3:0,11:4 - 12:10 - 12:10 - 0:0 - 0:0,3,0,Asatryan Murad,Rafayelyan Edgar,fiurst,Asatryan Murad - Rafayelyan Edgar,59,35,24,-11,11,15,22,22,0,0,-7,-2,-2,0,0,-11,11:4 - 12:10 - 12:10 - 0:0 - 0:0
17693297,2024-03-25 11:30:00,Asatryan Murad - Nikoghosyan Narek,3:0,11:6 - 12:10 - 11:6 - 0:0 - 0:0,3,0,Asatryan Murad,Nikoghosyan Narek,fiurst,Asatryan Murad - Nikoghosyan Narek,56,34,22,-12,12,17,22,17,0,0,-5,-2,-5,0,0,-12,11:6 - 12:10 - 11:6 - 0:0 - 0:0
17693289,2024-03-25 11:05:00,Diaryan Aleksandr - Asatryan Murad,3:0,6:11 - 6:11 - 2:11 - 0:0 - 0:0,0,3,Diaryan Aleksandr,Asatryan Murad,fiurst,Asatryan Murad - Diaryan Aleksandr,47,33,14,-19,19,17,17,13,0,0,-5,-5,-9,0,0,-19,11:6 - 11:6 - 11:2 - 0:0 - 0:0
17693285,2024-03-25 10:40:00,Rafayelyan Edgar - Diaryan Aleksandr,1:3,11:9 - 10:12 - 11:6 - 11:9 - 0:0,3,1,Rafayelyan Edgar,Diaryan Aleksandr,fiurst,Diaryan Aleksandr - Rafayelyan Edgar,79,36,43,7,-7,20,22,17,20,0,2,-2,5,2,0,7,9:11 - 12:10 - 6:11 - 9:11 - 0:0
17693261,2024-03-25 10:00:00,Nikoghosyan Narek - Rafayelyan Edgar,1:3,9:11 - 8:11 - 11:7 - 10:12 - 0:0,1,3,Nikoghosyan Narek,Rafayelyan Edgar,fiurst,Nikoghosyan Narek - Rafayelyan Edgar,79,38,41,3,-3,20,19,18,22,0,2,3,-4,2,0,3,9:11 - 8:11 - 11:7 - 10:12 - 0:0
17673800,2024-03-24 17:45:00,Gevorgyan Gegham - Soghomonyan Hrayr,0:3,6:11 - 4:11 - 9:11 - 0:0 - 0:0,0,3,Gevorgyan Gegham,Soghomonyan Hrayr,fiurst,Gevorgyan Gegham - Soghomonyan Hrayr,52,19,33,14,-14,17,15,20,0,0,5,7,2,0,0,14,6:11 - 4:11 - 9:11 - 0:0 - 0:0
17673797,2024-03-24 17:35:00,Mkrtchyan Andranik - Petrosyan Davit,3:0,11:9 - 11:4 - 11:5 - 0:0 - 0:0,3,0,Mkrtchyan Andranik,Petrosyan Davit,fiurst,Mkrtchyan Andranik - Petrosyan Davit,51,33,18,-15,15,20,15,16,0,0,-2,-7,-6,0,0,-15,11:9 - 11:4 - 11:5 - 0:0 - 0:0
17673794,2024-03-24 17:15:00,Gevorgyan Hayk - Gevorgyan Gegham,0:3,11:4 - 11:2 - 11:6 - 0:0 - 0:0,3,0,Gevorgyan Hayk,Gevorgyan Gegham,fiurst,Gevorgyan Gegham - Gevorgyan Hayk,45,12,33,21,-21,15,13,17,0,0,7,9,5,0,0,21,4:11 - 2:11 - 6:11 - 0:0 - 0:0
17673783,2024-03-24 17:00:00,Mkrtchyan Andranik - Soghomonyan Hrayr,1:3,7:11 - 8:11 - 11:8 - 4:11 - 0:0,1,3,Mkrtchyan Andranik,Soghomonyan Hrayr,fiurst,Mkrtchyan Andranik - Soghomonyan Hrayr,71,30,41,11,-11,18,19,19,15,0,4,3,-3,7,0,11,7:11 - 8:11 - 11:8 - 4:11 - 0:0
17673756,2024-03-24 16:45:00,Petrosyan Davit - Gevorgyan Hayk,3:0,7:11 - 4:11 - 9:11 - 0:0 - 0:0,0,3,Petrosyan Davit,Gevorgyan Hayk,fiurst,Gevorgyan Hayk - Petrosyan Davit,53,33,20,-13,13,18,15,20,0,0,-4,-7,-2,0,0,-13,11:7 - 11:4 - 11:9 - 0:0 - 0:0
17673753,2024-03-24 16:30:00,Gevorgyan Gegham - Mkrtchyan Andranik,1:3,9:11 - 11:7 - 11:13 - 6:11 - 0:0,1,3,Gevorgyan Gegham,Mkrtchyan Andranik,fiurst,Gevorgyan Gegham - Mkrtchyan Andranik,79,37,42,5,-5,20,18,24,17,0,2,-4,2,5,0,5,9:11 - 11:7 - 11:13 - 6:11 - 0:0
17673751,2024-03-24 16:15:00,Soghomonyan Hrayr - Gevorgyan Hayk,1:3,6:11 - 11:9 - 11:4 - 12:10 - 0:0,3,1,Soghomonyan Hrayr,Gevorgyan Hayk,fiurst,Gevorgyan Hayk - Soghomonyan Hrayr,74,34,40,6,-6,17,20,15,22,0,-5,2,7,2,0,6,11:6 - 9:11 - 4:11 - 10:12 - 0:0
17673746,2024-03-24 16:05:00,Petrosyan Davit - Gevorgyan Gegham,0:3,11:7 - 11:9 - 11:7 - 0:0 - 0:0,3,0,Petrosyan Davit,Gevorgyan Gegham,fiurst,Gevorgyan Gegham - Petrosyan Davit,56,23,33,10,-10,18,20,18,0,0,4,2,4,0,0,10,7:11 - 9:11 - 7:11 - 0:0 - 0:0
17673733,2024-03-24 15:45:00,Gevorgyan Hayk - Mkrtchyan Andranik,1:3,14:12 - 4:11 - 8:11 - 9:11 - 0:0,1,3,Gevorgyan Hayk,Mkrtchyan Andranik,fiurst,Gevorgyan Hayk - Mkrtchyan Andranik,80,35,45,10,-10,26,15,19,20,0,-2,7,3,2,0,10,14:12 - 4:11 - 8:11 - 9:11 - 0:0
17673729,2024-03-24 15:40:00,Soghomonyan Hrayr - Petrosyan Davit,0:3,11:7 - 13:11 - 11:7 - 0:0 - 0:0,3,0,Soghomonyan Hrayr,Petrosyan Davit,fiurst,Petrosyan Davit - Soghomonyan Hrayr,60,25,35,10,-10,18,24,18,0,0,4,2,4,0,0,10,7:11 - 11:13 - 7:11 - 0:0 - 0:0
17673728,2024-03-24 15:20:00,Hovhannesyan Rafik - Nikoghosyan Narek,3:1,8:11 - 13:11 - 11:8 - 11:5 - 0:0,3,1,Hovhannesyan Rafik,Nikoghosyan Narek,fiurst,Hovhannesyan Rafik - Nikoghosyan Narek,78,43,35,-8,8,19,24,19,16,0,3,-2,-3,-6,0,-8,8:11 - 13:11 - 11:8 - 11:5 - 0:0
17673727,2024-03-24 15:20:00,Diaryan Aleksandr - Nazaryan Mushegh,3:0,11:7 - 11:9 - 11:5 - 0:0 - 0:0,3,0,Diaryan Aleksandr,Nazaryan Mushegh,fiurst,Diaryan Aleksandr - Nazaryan Mushegh,54,33,21,-12,12,18,20,16,0,0,-4,-2,-6,0,0,-12,11:7 - 11:9 - 11:5 - 0:0 - 0:0
17673725,2024-03-24 14:45:00,Asatryan Murad - Hovhannesyan Rafik,3:1,9:11 - 11:6 - 11:7 - 11:5 - 0:0,3,1,Asatryan Murad,Hovhannesyan Rafik,fiurst,Asatryan Murad - Hovhannesyan Rafik,71,42,29,-13,13,20,17,18,16,0,2,-5,-4,-6,0,-13,9:11 - 11:6 - 11:7 - 11:5 - 0:0
17673714,2024-03-24 14:30:00,Nikoghosyan Narek - Diaryan Aleksandr,3:2,8:11 - 12:14 - 11:9 - 11:7 - 5:11,2,3,Nikoghosyan Narek,Diaryan Aleksandr,fiurst,Diaryan Aleksandr - Nikoghosyan Narek,99,52,47,-5,5,19,26,20,18,16,-3,-2,2,4,-6,-5,11:8 - 14:12 - 9:11 - 7:11 - 11:5
17673712,2024-03-24 14:15:00,Asatryan Murad - Nazaryan Mushegh,3:1,11:6 - 11:8 - 10:12 - 11:4 - 0:0,3,1,Asatryan Murad,Nazaryan Mushegh,fiurst,Asatryan Murad - Nazaryan Mushegh,73,43,30,-13,13,17,19,22,15,0,-5,-3,2,-7,0,-13,11:6 - 11:8 - 10:12 - 11:4 - 0:0
17673696,2024-03-24 14:00:00,Hovhannesyan Rafik - Diaryan Aleksandr,3:0,4:11 - 18:20 - 10:12 - 0:0 - 0:0,0,3,Hovhannesyan Rafik,Diaryan Aleksandr,fiurst,Diaryan Aleksandr - Hovhannesyan Rafik,75,43,32,-11,11,15,38,22,0,0,-7,-2,-2,0,0,-11,11:4 - 20:18 - 12:10 - 0:0 - 0:0
17673693,2024-03-24 13:45:00,Nikoghosyan Narek - Asatryan Murad,3:1,11:9 - 7:11 - 4:11 - 8:11 - 0:0,1,3,Nikoghosyan Narek,Asatryan Murad,fiurst,Asatryan Murad - Nikoghosyan Narek,72,42,30,-12,12,20,18,15,19,0,2,-4,-7,-3,0,-12,9:11 - 11:7 - 11:4 - 11:8 - 0:0
17673688,2024-03-24 13:30:00,Nazaryan Mushegh - Hovhannesyan Rafik,0:3,11:8 - 11:9 - 12:10 - 0:0 - 0:0,3,0,Nazaryan Mushegh,Hovhannesyan Rafik,fiurst,Hovhannesyan Rafik - Nazaryan Mushegh,61,27,34,7,-7,19,20,22,0,0,3,2,2,0,0,7,8:11 - 9:11 - 10:12 - 0:0 - 0:0
17673686,2024-03-24 13:15:00,Diaryan Aleksandr - Asatryan Murad,3:1,11:9 - 4:11 - 7:11 - 8:11 - 0:0,1,3,Diaryan Aleksandr,Asatryan Murad,fiurst,Asatryan Murad - Diaryan Aleksandr,72,42,30,-12,12,20,15,18,19,0,2,-7,-4,-3,0,-12,9:11 - 11:4 - 11:7 - 11:8 - 0:0
17673684,2024-03-24 13:00:00,Nazaryan Mushegh - Nikoghosyan Narek,3:0,11:8 - 11:6 - 13:11 - 0:0 - 0:0,3,0,Nazaryan Mushegh,Nikoghosyan Narek,fiurst,Nazaryan Mushegh - Nikoghosyan Narek,60,35,25,-10,10,19,17,24,0,0,-3,-5,-2,0,0,-10,11:8 - 11:6 - 13:11 - 0:0 - 0:0
17673677,2024-03-24 12:25:00,Hovhannesyan Rafik - Asatryan Murad,3:0,7:11 - 6:11 - 5:11 - 0:0 - 0:0,0,3,Hovhannesyan Rafik,Asatryan Murad,fiurst,Asatryan Murad - Hovhannesyan Rafik,51,33,18,-15,15,18,17,16,0,0,-4,-5,-6,0,0,-15,11:7 - 11:6 - 11:5 - 0:0 - 0:0
17673664,2024-03-24 12:10:00,Nikoghosyan Narek - Hovhannesyan Rafik,0:3,11:9 - 11:3 - 11:6 - 0:0 - 0:0,3,0,Nikoghosyan Narek,Hovhannesyan Rafik,fiurst,Hovhannesyan Rafik - Nikoghosyan Narek,51,18,33,15,-15,20,14,17,0,0,2,8,5,0,0,15,9:11 - 3:11 - 6:11 - 0:0 - 0:0
17673665,2024-03-24 12:05:00,Nazaryan Mushegh - Diaryan Aleksandr,3:1,5:11 - 8:11 - 11:9 - 7:11 - 0:0,1,3,Nazaryan Mushegh,Diaryan Aleksandr,fiurst,Diaryan Aleksandr - Nazaryan Mushegh,73,42,31,-11,11,16,19,20,18,0,-6,-3,2,-4,0,-11,11:5 - 11:8 - 9:11 - 11:7 - 0:0
17673660,2024-03-24 11:30:00,Nazaryan Mushegh - Asatryan Murad,3:0,6:11 - 7:11 - 6:11 - 0:0 - 0:0,0,3,Nazaryan Mushegh,Asatryan Murad,fiurst,Asatryan Murad - Nazaryan Mushegh,52,33,19,-14,14,17,18,17,0,0,-5,-4,-5,0,0,-14,11:6 - 11:7 - 11:6 - 0:0 - 0:0
17673659,2024-03-24 11:25:00,Diaryan Aleksandr - Nikoghosyan Narek,2:3,12:10 - 9:11 - 10:12 - 13:11 - 10:12,2,3,Diaryan Aleksandr,Nikoghosyan Narek,fiurst,Diaryan Aleksandr - Nikoghosyan Narek,110,54,56,2,-2,22,20,22,24,22,-2,2,2,-2,2,2,12:10 - 9:11 - 10:12 - 13:11 - 10:12
17673655,2024-03-24 11:00:00,Hovhannesyan Rafik - Nazaryan Mushegh,0:3,7:11 - 9:11 - 6:11 - 0:0 - 0:0,0,3,Hovhannesyan Rafik,Nazaryan Mushegh,fiurst,Hovhannesyan Rafik - Nazaryan Mushegh,55,22,33,11,-11,18,20,17,0,0,4,2,5,0,0,11,7:11 - 9:11 - 6:11 - 0:0 - 0:0
17673652,2024-03-24 10:45:00,Asatryan Murad - Nikoghosyan Narek,3:1,11:7 - 4:11 - 11:7 - 11:4 - 0:0,3,1,Asatryan Murad,Nikoghosyan Narek,fiurst,Asatryan Murad - Nikoghosyan Narek,66,37,29,-8,8,18,15,18,15,0,-4,7,-4,-7,0,-8,11:7 - 4:11 - 11:7 - 11:4 - 0:0
17673645,2024-03-24 10:30:00,Diaryan Aleksandr - Hovhannesyan Rafik,3:0,11:6 - 11:7 - 11:6 - 0:0 - 0:0,3,0,Diaryan Aleksandr,Hovhannesyan Rafik,fiurst,Diaryan Aleksandr - Hovhannesyan Rafik,52,33,19,-14,14,17,18,17,0,0,-5,-4,-5,0,0,-14,11:6 - 11:7 - 11:6 - 0:0 - 0:0
17673636,2024-03-24 10:15:00,Nikoghosyan Narek - Nazaryan Mushegh,3:1,7:11 - 5:11 - 11:8 - 7:11 - 0:0,1,3,Nikoghosyan Narek,Nazaryan Mushegh,fiurst,Nazaryan Mushegh - Nikoghosyan Narek,71,41,30,-11,11,18,16,19,18,0,-4,-6,3,-4,0,-11,11:7 - 11:5 - 8:11 - 11:7 - 0:0
17673632,2024-03-24 10:00:00,Asatryan Murad - Diaryan Aleksandr,3:0,11:9 - 12:10 - 11:6 - 0:0 - 0:0,3,0,Asatryan Murad,Diaryan Aleksandr,fiurst,Asatryan Murad - Diaryan Aleksandr,59,34,25,-9,9,20,22,17,0,0,-2,-2,-5,0,0,-9,11:9 - 12:10 - 11:6 - 0:0 - 0:0
17646506,2024-03-23 17:45:00,Mkrtchyan Andranik - Gevorgyan Gegham,0:3,11:6 - 11:4 - 11:5 - 0:0 - 0:0,3,0,Mkrtchyan Andranik,Gevorgyan Gegham,fiurst,Gevorgyan Gegham - Mkrtchyan Andranik,48,15,33,18,-18,17,15,16,0,0,5,7,6,0,0,18,6:11 - 4:11 - 5:11 - 0:0 - 0:0
17646505,2024-03-23 17:30:00,Arutyunov Ruben - Avakimyan Davit,3:0,11:7 - 11:7 - 11:5 - 0:0 - 0:0,3,0,Arutyunov Ruben,Avakimyan Davit,fiurst,Arutyunov Ruben - Avakimyan Davit,52,33,19,-14,14,18,18,16,0,0,-4,-4,-6,0,0,-14,11:7 - 11:7 - 11:5 - 0:0 - 0:0
17646493,2024-03-23 17:15:00,Petrosyan Davit - Mkrtchyan Andranik,3:1,7:11 - 11:7 - 7:11 - 5:11 - 0:0,1,3,Petrosyan Davit,Mkrtchyan Andranik,fiurst,Mkrtchyan Andranik - Petrosyan Davit,70,40,30,-10,10,18,18,18,16,0,-4,4,-4,-6,0,-10,11:7 - 7:11 - 11:7 - 11:5 - 0:0
17646492,2024-03-23 17:10:00,Arutyunov Ruben - Gevorgyan Gegham,3:1,9:11 - 11:3 - 11:5 - 11:4 - 0:0,3,1,Arutyunov Ruben,Gevorgyan Gegham,fiurst,Arutyunov Ruben - Gevorgyan Gegham,65,42,23,-19,19,20,14,16,15,0,2,-8,-6,-7,0,-19,9:11 - 11:3 - 11:5 - 11:4 - 0:0
17646488,2024-03-23 16:45:00,Avakimyan Davit - Petrosyan Davit,1:3,11:6 - 4:11 - 7:11 - 6:11 - 0:0,1,3,Avakimyan Davit,Petrosyan Davit,fiurst,Avakimyan Davit - Petrosyan Davit,67,28,39,11,-11,17,15,18,17,0,-5,7,4,5,0,11,11:6 - 4:11 - 7:11 - 6:11 - 0:0
17646485,2024-03-23 16:35:00,Mkrtchyan Andranik - Arutyunov Ruben,3:2,2:11 - 11:3 - 3:11 - 11:9 - 6:11,2,3,Mkrtchyan Andranik,Arutyunov Ruben,fiurst,Arutyunov Ruben - Mkrtchyan Andranik,78,45,33,-12,12,13,14,14,20,17,-9,8,-8,2,-5,-12,11:2 - 3:11 - 11:3 - 9:11 - 11:6
17646484,2024-03-23 16:15:00,Gevorgyan Gegham - Petrosyan Davit,0:3,9:11 - 7:11 - 11:13 - 0:0 - 0:0,0,3,Gevorgyan Gegham,Petrosyan Davit,fiurst,Gevorgyan Gegham - Petrosyan Davit,62,27,35,8,-8,20,18,24,0,0,2,4,2,0,0,8,9:11 - 7:11 - 11:13 - 0:0 - 0:0
17646481,2024-03-23 16:00:00,Avakimyan Davit - Mkrtchyan Andranik,2:3,11:5 - 9:11 - 11:6 - 5:11 - 9:11,2,3,Avakimyan Davit,Mkrtchyan Andranik,fiurst,Avakimyan Davit - Mkrtchyan Andranik,89,45,44,-1,1,16,20,17,16,20,-6,2,-5,6,2,-1,11:5 - 9:11 - 11:6 - 5:11 - 9:11
17646479,2024-03-23 15:45:00,Petrosyan Davit - Arutyunov Ruben,3:1,11:9 - 7:11 - 1:11 - 7:11 - 0:0,1,3,Petrosyan Davit,Arutyunov Ruben,fiurst,Arutyunov Ruben - Petrosyan Davit,68,42,26,-16,16,20,18,12,18,0,2,-4,-10,-4,0,-16,9:11 - 11:7 - 11:1 - 11:7 - 0:0
17646475,2024-03-23 15:30:00,Gevorgyan Gegham - Avakimyan Davit,3:1,5:11 - 8:11 - 11:5 - 6:11 - 0:0,1,3,Gevorgyan Gegham,Avakimyan Davit,fiurst,Avakimyan Davit - Gevorgyan Gegham,68,38,30,-8,8,16,19,16,17,0,-6,-3,6,-5,0,-8,11:5 - 11:8 - 5:11 - 11:6 - 0:0
17646470,2024-03-23 15:15:00,Asatryan Murad - Diaryan Aleksandr,3:0,12:10 - 11:5 - 11:9 - 0:0 - 0:0,3,0,Asatryan Murad,Diaryan Aleksandr,fiurst,Asatryan Murad - Diaryan Aleksandr,58,34,24,-10,10,22,16,20,0,0,-2,-6,-2,0,0,-10,12:10 - 11:5 - 11:9 - 0:0 - 0:0
17646465,2024-03-23 15:00:00,Papyan Karen - Hovhannesyan Rafik,0:3,11:9 - 11:7 - 11:5 - 0:0 - 0:0,3,0,Papyan Karen,Hovhannesyan Rafik,fiurst,Hovhannesyan Rafik - Papyan Karen,54,21,33,12,-12,20,18,16,0,0,2,4,6,0,0,12,9:11 - 7:11 - 5:11 - 0:0 - 0:0
17646460,2024-03-23 14:50:00,Nazaryan Mushegh - Asatryan Murad,3:0,7:11 - 5:11 - 7:11 - 0:0 - 0:0,0,3,Nazaryan Mushegh,Asatryan Murad,fiurst,Asatryan Murad - Nazaryan Mushegh,52,33,19,-14,14,18,16,18,0,0,-4,-6,-4,0,0,-14,11:7 - 11:5 - 11:7 - 0:0 - 0:0
17646448,2024-03-23 14:35:00,Diaryan Aleksandr - Papyan Karen,3:0,12:10 - 11:6 - 11:9 - 0:0 - 0:0,3,0,Diaryan Aleksandr,Papyan Karen,fiurst,Diaryan Aleksandr - Papyan Karen,59,34,25,-9,9,22,17,20,0,0,-2,-5,-2,0,0,-9,12:10 - 11:6 - 11:9 - 0:0 - 0:0
17646438,2024-03-23 14:15:00,Nazaryan Mushegh - Hovhannesyan Rafik,1:3,11:8 - 8:11 - 11:6 - 11:3 - 0:0,3,1,Nazaryan Mushegh,Hovhannesyan Rafik,fiurst,Hovhannesyan Rafik - Nazaryan Mushegh,69,28,41,13,-13,19,19,17,14,0,3,-3,5,8,0,13,8:11 - 11:8 - 6:11 - 3:11 - 0:0
17646435,2024-03-23 14:00:00,Asatryan Murad - Papyan Karen,3:1,13:11 - 7:11 - 11:9 - 11:4 - 0:0,3,1,Asatryan Murad,Papyan Karen,fiurst,Asatryan Murad - Papyan Karen,77,42,35,-7,7,24,18,20,15,0,-2,4,-2,-7,0,-7,13:11 - 7:11 - 11:9 - 11:4 - 0:0
17646430,2024-03-23 13:45:00,Diaryan Aleksandr - Nazaryan Mushegh,3:2,7:11 - 11:7 - 3:11 - 12:10 - 11:8,3,2,Diaryan Aleksandr,Nazaryan Mushegh,fiurst,Diaryan Aleksandr - Nazaryan Mushegh,91,44,47,3,-3,18,18,14,22,19,4,-4,8,-2,-3,3,7:11 - 11:7 - 3:11 - 12:10 - 11:8
17646427,2024-03-23 13:30:00,Hovhannesyan Rafik - Asatryan Murad,3:0,5:11 - 8:11 - 7:11 - 0:0 - 0:0,0,3,Hovhannesyan Rafik,Asatryan Murad,fiurst,Asatryan Murad - Hovhannesyan Rafik,53,33,20,-13,13,16,19,18,0,0,-6,-3,-4,0,0,-13,11:5 - 11:8 - 11:7 - 0:0 - 0:0
17646419,2024-03-23 13:15:00,Papyan Karen - Nazaryan Mushegh,1:3,11:5 - 9:11 - 13:11 - 12:10 - 0:0,3,1,Papyan Karen,Nazaryan Mushegh,fiurst,Nazaryan Mushegh - Papyan Karen,82,37,45,8,-8,16,20,24,22,0,6,-2,2,2,0,8,5:11 - 11:9 - 11:13 - 10:12 - 0:0
17646403,2024-03-23 13:00:00,Hovhannesyan Rafik - Diaryan Aleksandr,3:0,7:11 - 5:11 - 5:11 - 0:0 - 0:0,0,3,Hovhannesyan Rafik,Diaryan Aleksandr,fiurst,Diaryan Aleksandr - Hovhannesyan Rafik,50,33,17,-16,16,18,16,16,0,0,-4,-6,-6,0,0,-16,11:7 - 11:5 - 11:5 - 0:0 - 0:0
17646381,2024-03-23 12:15:00,Asatryan Murad - Nazaryan Mushegh,3:0,11:5 - 11:4 - 16:14 - 0:0 - 0:0,3,0,Asatryan Murad,Nazaryan Mushegh,fiurst,Asatryan Murad - Nazaryan Mushegh,61,38,23,-15,15,16,15,30,0,0,-6,-7,-2,0,0,-15,11:5 - 11:4 - 16:14 - 0:0 - 0:0
17646378,2024-03-23 12:00:00,Hovhannesyan Rafik - Papyan Karen,3:0,11:9 - 11:7 - 11:4 - 0:0 - 0:0,3,0,Hovhannesyan Rafik,Papyan Karen,fiurst,Hovhannesyan Rafik - Papyan Karen,53,33,20,-13,13,20,18,15,0,0,-2,-4,-7,0,0,-13,11:9 - 11:7 - 11:4 - 0:0 - 0:0
17646373,2024-03-23 11:50:00,Diaryan Aleksandr - Asatryan Murad,3:0,7:11 - 9:11 - 5:11 - 0:0 - 0:0,0,3,Diaryan Aleksandr,Asatryan Murad,fiurst,Asatryan Murad - Diaryan Aleksandr,54,33,21,-12,12,18,20,16,0,0,-4,-2,-6,0,0,-12,11:7 - 11:9 - 11:5 - 0:0 - 0:0
17646364,2024-03-23 11:30:00,Hovhannesyan Rafik - Nazaryan Mushegh,3:1,11:7 - 6:11 - 11:5 - 11:7 - 0:0,3,1,Hovhannesyan Rafik,Nazaryan Mushegh,fiurst,Hovhannesyan Rafik - Nazaryan Mushegh,69,39,30,-9,9,18,17,16,18,0,-4,5,-6,-4,0,-9,11:7 - 6:11 - 11:5 - 11:7 - 0:0
17646361,2024-03-23 11:15:00,Papyan Karen - Diaryan Aleksandr,3:2,12:10 - 11:9 - 5:11 - 12:14 - 7:11,2,3,Papyan Karen,Diaryan Aleksandr,fiurst,Diaryan Aleksandr - Papyan Karen,102,55,47,-8,8,22,20,16,26,18,2,2,-6,-2,-4,-8,10:12 - 9:11 - 11:5 - 14:12 - 11:7
17646359,2024-03-23 11:05:00,Asatryan Murad - Hovhannesyan Rafik,3:0,11:7 - 11:5 - 11:2 - 0:0 - 0:0,3,0,Asatryan Murad,Hovhannesyan Rafik,fiurst,Asatryan Murad - Hovhannesyan Rafik,47,33,14,-19,19,18,16,13,0,0,-4,-6,-9,0,0,-19,11:7 - 11:5 - 11:2 - 0:0 - 0:0
17646356,2024-03-23 10:45:00,Nazaryan Mushegh - Diaryan Aleksandr,3:1,6:11 - 4:11 - 11:7 - 5:11 - 0:0,1,3,Nazaryan Mushegh,Diaryan Aleksandr,fiurst,Diaryan Aleksandr - Nazaryan Mushegh,66,40,26,-14,14,17,15,18,16,0,-5,-7,4,-6,0,-14,11:6 - 11:4 - 7:11 - 11:5 - 0:0
17646355,2024-03-23 10:35:00,Papyan Karen - Asatryan Murad,3:0,7:11 - 7:11 - 5:11 - 0:0 - 0:0,0,3,Papyan Karen,Asatryan Murad,fiurst,Asatryan Murad - Papyan Karen,52,33,19,-14,14,18,18,16,0,0,-4,-4,-6,0,0,-14,11:7 - 11:7 - 11:5 - 0:0 - 0:0
17646352,2024-03-23 10:15:00,Diaryan Aleksandr - Hovhannesyan Rafik,3:0,11:8 - 11:8 - 12:10 - 0:0 - 0:0,3,0,Diaryan Aleksandr,Hovhannesyan Rafik,fiurst,Diaryan Aleksandr - Hovhannesyan Rafik,60,34,26,-8,8,19,19,22,0,0,-3,-3,-2,0,0,-8,11:8 - 11:8 - 12:10 - 0:0 - 0:0
17646347,2024-03-23 10:00:00,Nazaryan Mushegh - Papyan Karen,3:1,11:6 - 7:11 - 11:8 - 11:5 - 0:0,3,1,Nazaryan Mushegh,Papyan Karen,fiurst,Nazaryan Mushegh - Papyan Karen,70,40,30,-10,10,17,18,19,16,0,-5,4,-3,-6,0,-10,11:6 - 7:11 - 11:8 - 11:5 - 0:0
17627293,2024-03-22 17:45:00,Avakimyan Davit - Arutyunov Ruben,3:1,8:11 - 11:8 - 7:11 - 3:11 - 0:0,1,3,Avakimyan Davit,Arutyunov Ruben,fiurst,Arutyunov Ruben - Avakimyan Davit,70,41,29,-12,12,19,19,18,14,0,-3,3,-4,-8,0,-12,11:8 - 8:11 - 11:7 - 11:3 - 0:0
17627290,2024-03-22 17:30:00,Mkrtchyan Andranik - Soghomonyan Hrayr,3:2,8:11 - 8:11 - 11:8 - 11:5 - 11:2,3,2,Mkrtchyan Andranik,Soghomonyan Hrayr,fiurst,Mkrtchyan Andranik - Soghomonyan Hrayr,86,49,37,-12,12,19,19,19,16,13,3,3,-3,-6,-9,-12,8:11 - 8:11 - 11:8 - 11:5 - 11:2
17627287,2024-03-22 17:15:00,Gevorgyan Gegham - Avakimyan Davit,3:1,10:12 - 7:11 - 11:8 - 4:11 - 0:0,1,3,Gevorgyan Gegham,Avakimyan Davit,fiurst,Avakimyan Davit - Gevorgyan Gegham,74,42,32,-10,10,22,18,19,15,0,-2,-4,3,-7,0,-10,12:10 - 11:7 - 8:11 - 11:4 - 0:0
17627286,2024-03-22 17:00:00,Mkrtchyan Andranik - Arutyunov Ruben,0:3,12:10 - 11:7 - 11:3 - 0:0 - 0:0,3,0,Mkrtchyan Andranik,Arutyunov Ruben,fiurst,Arutyunov Ruben - Mkrtchyan Andranik,54,20,34,14,-14,22,18,14,0,0,2,4,8,0,0,14,10:12 - 7:11 - 3:11 - 0:0 - 0:0
17627275,2024-03-22 16:45:00,Soghomonyan Hrayr - Gevorgyan Gegham,1:3,11:6 - 11:8 - 6:11 - 11:6 - 0:0,3,1,Soghomonyan Hrayr,Gevorgyan Gegham,fiurst,Gevorgyan Gegham - Soghomonyan Hrayr,70,31,39,8,-8,17,19,17,17,0,5,3,-5,5,0,8,6:11 - 8:11 - 11:6 - 6:11 - 0:0
17627273,2024-03-22 16:30:00,Avakimyan Davit - Mkrtchyan Andranik,0:3,4:11 - 9:11 - 6:11 - 0:0 - 0:0,0,3,Avakimyan Davit,Mkrtchyan Andranik,fiurst,Avakimyan Davit - Mkrtchyan Andranik,52,19,33,14,-14,15,20,17,0,0,7,2,5,0,0,14,4:11 - 9:11 - 6:11 - 0:0 - 0:0
17627271,2024-03-22 16:15:00,Arutyunov Ruben - Gevorgyan Gegham,3:0,11:6 - 11:2 - 11:5 - 0:0 - 0:0,3,0,Arutyunov Ruben,Gevorgyan Gegham,fiurst,Arutyunov Ruben - Gevorgyan Gegham,46,33,13,-20,20,17,13,16,0,0,-5,-9,-6,0,0,-20,11:6 - 11:2 - 11:5 - 0:0 - 0:0
17627266,2024-03-22 16:00:00,Soghomonyan Hrayr - Avakimyan Davit,1:3,11:8 - 8:11 - 11:2 - 11:5 - 0:0,3,1,Soghomonyan Hrayr,Avakimyan Davit,fiurst,Avakimyan Davit - Soghomonyan Hrayr,67,26,41,15,-15,19,19,13,16,0,3,-3,9,6,0,15,8:11 - 11:8 - 2:11 - 5:11 - 0:0
17627257,2024-03-22 15:45:00,Gevorgyan Gegham - Mkrtchyan Andranik,1:3,10:12 - 9:11 - 11:8 - 5:11 - 0:0,1,3,Gevorgyan Gegham,Mkrtchyan Andranik,fiurst,Gevorgyan Gegham - Mkrtchyan Andranik,77,35,42,7,-7,22,20,19,16,0,2,2,-3,6,0,7,10:12 - 9:11 - 11:8 - 5:11 - 0:0
17627254,2024-03-22 15:30:00,Arutyunov Ruben - Soghomonyan Hrayr,3:0,11:6 - 11:8 - 11:8 - 0:0 - 0:0,3,0,Arutyunov Ruben,Soghomonyan Hrayr,fiurst,Arutyunov Ruben - Soghomonyan Hrayr,55,33,22,-11,11,17,19,19,0,0,-5,-3,-3,0,0,-11,11:6 - 11:8 - 11:8 - 0:0 - 0:0
17627253,2024-03-22 15:20:00,Hovhannesyan Rafik - Papyan Karen,2:3,11:7 - 9:11 - 8:11 - 11:9 - 4:11,2,3,Hovhannesyan Rafik,Papyan Karen,fiurst,Hovhannesyan Rafik - Papyan Karen,92,43,49,6,-6,18,20,19,20,15,-4,2,3,-2,7,6,11:7 - 9:11 - 8:11 - 11:9 - 4:11
17627241,2024-03-22 15:05:00,Rafayelyan Edgar - Nikoghosyan Narek,0:3,13:11 - 11:5 - 11:9 - 0:0 - 0:0,3,0,Rafayelyan Edgar,Nikoghosyan Narek,fiurst,Nikoghosyan Narek - Rafayelyan Edgar,60,25,35,10,-10,24,16,20,0,0,2,6,2,0,0,10,11:13 - 5:11 - 9:11 - 0:0 - 0:0
17627240,2024-03-22 14:55:00,Diaryan Aleksandr - Hovhannesyan Rafik,3:2,11:7 - 9:11 - 6:11 - 16:14 - 11:6,3,2,Diaryan Aleksandr,Hovhannesyan Rafik,fiurst,Diaryan Aleksandr - Hovhannesyan Rafik,102,53,49,-4,4,18,20,17,30,17,-4,2,5,-2,-5,-4,11:7 - 9:11 - 6:11 - 16:14 - 11:6
17627237,2024-03-22 14:30:00,Papyan Karen - Rafayelyan Edgar,0:3,4:11 - 7:11 - 6:11 - 0:0 - 0:0,0,3,Papyan Karen,Rafayelyan Edgar,fiurst,Papyan Karen - Rafayelyan Edgar,50,17,33,16,-16,15,18,17,0,0,7,4,5,0,0,16,4:11 - 7:11 - 6:11 - 0:0 - 0:0
17627235,2024-03-22 14:20:00,Diaryan Aleksandr - Nikoghosyan Narek,1:3,11:13 - 4:11 - 11:8 - 8:11 - 0:0,1,3,Diaryan Aleksandr,Nikoghosyan Narek,fiurst,Diaryan Aleksandr - Nikoghosyan Narek,77,34,43,9,-9,24,15,19,19,0,2,7,-3,3,0,9,11:13 - 4:11 - 11:8 - 8:11 - 0:0
17627229,2024-03-22 14:00:00,Papyan Karen - Diaryan Aleksandr,1:3,11:7 - 4:11 - 11:9 - 11:8 - 0:0,3,1,Papyan Karen,Diaryan Aleksandr,fiurst,Diaryan Aleksandr - Papyan Karen,72,35,37,2,-2,18,15,20,19,0,4,-7,2,3,0,2,7:11 - 11:4 - 9:11 - 8:11 - 0:0
17627232,2024-03-22 14:00:00,Hovhannesyan Rafik - Rafayelyan Edgar,0:3,7:11 - 11:13 - 7:11 - 0:0 - 0:0,0,3,Hovhannesyan Rafik,Rafayelyan Edgar,fiurst,Hovhannesyan Rafik - Rafayelyan Edgar,60,25,35,10,-10,18,24,18,0,0,4,2,4,0,0,10,7:11 - 11:13 - 7:11 - 0:0 - 0:0
17627227,2024-03-22 13:30:00,Nikoghosyan Narek - Hovhannesyan Rafik,0:3,11:8 - 11:6 - 11:8 - 0:0 - 0:0,3,0,Nikoghosyan Narek,Hovhannesyan Rafik,fiurst,Hovhannesyan Rafik - Nikoghosyan Narek,55,22,33,11,-11,19,17,19,0,0,3,5,3,0,0,11,8:11 - 6:11 - 8:11 - 0:0 - 0:0
17627225,2024-03-22 13:25:00,Rafayelyan Edgar - Diaryan Aleksandr,3:1,13:15 - 9:11 - 11:8 - 9:11 - 0:0,1,3,Rafayelyan Edgar,Diaryan Aleksandr,fiurst,Diaryan Aleksandr - Rafayelyan Edgar,87,45,42,-3,3,28,20,19,20,0,-2,-2,3,-2,0,-3,15:13 - 11:9 - 8:11 - 11:9 - 0:0
17627224,2024-03-22 13:10:00,Nikoghosyan Narek - Papyan Karen,3:0,11:7 - 11:5 - 11:4 - 0:0 - 0:0,3,0,Nikoghosyan Narek,Papyan Karen,fiurst,Nikoghosyan Narek - Papyan Karen,49,33,16,-17,17,18,16,15,0,0,-4,-6,-7,0,0,-17,11:7 - 11:5 - 11:4 - 0:0 - 0:0
17627207,2024-03-22 12:15:00,Nikoghosyan Narek - Rafayelyan Edgar,3:2,11:6 - 7:11 - 18:16 - 10:12 - 11:7,3,2,Nikoghosyan Narek,Rafayelyan Edgar,fiurst,Nikoghosyan Narek - Rafayelyan Edgar,109,57,52,-5,5,17,18,34,22,18,-5,4,-2,2,-4,-5,11:6 - 7:11 - 18:16 - 10:12 - 11:7
17627211,2024-03-22 12:15:00,Hovhannesyan Rafik - Diaryan Aleksandr,3:0,3:11 - 2:11 - 9:11 - 0:0 - 0:0,0,3,Hovhannesyan Rafik,Diaryan Aleksandr,fiurst,Diaryan Aleksandr - Hovhannesyan Rafik,47,33,14,-19,19,14,13,20,0,0,-8,-9,-2,0,0,-19,11:3 - 11:2 - 11:9 - 0:0 - 0:0
17627203,2024-03-22 11:45:00,Papyan Karen - Hovhannesyan Rafik,2:3,8:11 - 12:10 - 11:2 - 9:11 - 11:6,3,2,Papyan Karen,Hovhannesyan Rafik,fiurst,Hovhannesyan Rafik - Papyan Karen,91,40,51,11,-11,19,22,13,20,17,-3,2,9,-2,5,11,11:8 - 10:12 - 2:11 - 11:9 - 6:11
17627200,2024-03-22 11:35:00,Nikoghosyan Narek - Diaryan Aleksandr,3:1,13:11 - 12:14 - 8:11 - 11:13 - 0:0,1,3,Nikoghosyan Narek,Diaryan Aleksandr,fiurst,Diaryan Aleksandr - Nikoghosyan Narek,93,49,44,-5,5,24,26,19,24,0,2,-2,-3,-2,0,-5,11:13 - 14:12 - 11:8 - 13:11 - 0:0
17627197,2024-03-22 11:25:00,Rafayelyan Edgar - Papyan Karen,0:3,11:5 - 11:5 - 11:5 - 0:0 - 0:0,3,0,Rafayelyan Edgar,Papyan Karen,fiurst,Papyan Karen - Rafayelyan Edgar,48,15,33,18,-18,16,16,16,0,0,6,6,6,0,0,18,5:11 - 5:11 - 5:11 - 0:0 - 0:0
17627196,2024-03-22 11:10:00,Hovhannesyan Rafik - Nikoghosyan Narek,0:3,9:11 - 5:11 - 10:12 - 0:0 - 0:0,0,3,Hovhannesyan Rafik,Nikoghosyan Narek,fiurst,Hovhannesyan Rafik - Nikoghosyan Narek,58,24,34,10,-10,20,16,22,0,0,2,6,2,0,0,10,9:11 - 5:11 - 10:12 - 0:0 - 0:0
17627195,2024-03-22 10:45:00,Diaryan Aleksandr - Papyan Karen,1:3,11:13 - 9:11 - 13:11 - 10:12 - 0:0,1,3,Diaryan Aleksandr,Papyan Karen,fiurst,Diaryan Aleksandr - Papyan Karen,90,43,47,4,-4,24,20,24,22,0,2,2,-2,2,0,4,11:13 - 9:11 - 13:11 - 10:12 - 0:0
17627186,2024-03-22 10:30:00,Rafayelyan Edgar - Hovhannesyan Rafik,0:3,11:7 - 11:3 - 11:3 - 0:0 - 0:0,3,0,Rafayelyan Edgar,Hovhannesyan Rafik,fiurst,Hovhannesyan Rafik - Rafayelyan Edgar,46,13,33,20,-20,18,14,14,0,0,4,8,8,0,0,20,7:11 - 3:11 - 3:11 - 0:0 - 0:0
17627180,2024-03-22 10:15:00,Papyan Karen - Nikoghosyan Narek,3:0,5:11 - 7:11 - 6:11 - 0:0 - 0:0,0,3,Papyan Karen,Nikoghosyan Narek,fiurst,Nikoghosyan Narek - Papyan Karen,51,33,18,-15,15,16,18,17,0,0,-6,-4,-5,0,0,-15,11:5 - 11:7 - 11:6 - 0:0 - 0:0
17627178,2024-03-22 10:00:00,Diaryan Aleksandr - Rafayelyan Edgar,0:3,9:11 - 3:11 - 6:11 - 0:0 - 0:0,0,3,Diaryan Aleksandr,Rafayelyan Edgar,fiurst,Diaryan Aleksandr - Rafayelyan Edgar,51,18,33,15,-15,20,14,17,0,0,2,8,5,0,0,15,9:11 - 3:11 - 6:11 - 0:0 - 0:0
17608333,2024-03-21 17:45:00,Petrosyan Davit - Gevorgyan Gegham,3:2,9:11 - 11:8 - 6:11 - 12:10 - 9:11,2,3,Petrosyan Davit,Gevorgyan Gegham,fiurst,Gevorgyan Gegham - Petrosyan Davit,98,51,47,-4,4,20,19,17,22,20,-2,3,-5,2,-2,-4,11:9 - 8:11 - 11:6 - 10:12 - 11:9
17608335,2024-03-21 17:45:00,Soghomonyan Hrayr - Avakimyan Davit,1:3,9:11 - 11:7 - 11:8 - 11:3 - 0:0,3,1,Soghomonyan Hrayr,Avakimyan Davit,fiurst,Avakimyan Davit - Soghomonyan Hrayr,71,29,42,13,-13,20,18,19,14,0,-2,4,3,8,0,13,11:9 - 7:11 - 8:11 - 3:11 - 0:0
17608332,2024-03-21 17:15:00,Arutyunov Ruben - Soghomonyan Hrayr,2:0,11:5 - 13:11 - 0:0 - 0:0 - 0:0,2,0,Arutyunov Ruben,Soghomonyan Hrayr,fiurst,Arutyunov Ruben - Soghomonyan Hrayr,40,24,16,-8,8,16,24,0,0,0,-6,-2,0,0,0,-8,11:5 - 13:11 - 0:0 - 0:0 - 0:0
17608328,2024-03-21 17:00:00,Petrosyan Davit - Avakimyan Davit,3:2,11:4 - 6:11 - 10:12 - 12:10 - 8:11,2,3,Petrosyan Davit,Avakimyan Davit,fiurst,Avakimyan Davit - Petrosyan Davit,95,48,47,-1,1,15,17,22,22,19,7,-5,-2,2,-3,-1,4:11 - 11:6 - 12:10 - 10:12 - 11:8
17608327,2024-03-21 16:50:00,Gevorgyan Gegham - Arutyunov Ruben,3:0,2:11 - 5:11 - 7:11 - 0:0 - 0:0,0,3,Gevorgyan Gegham,Arutyunov Ruben,fiurst,Arutyunov Ruben - Gevorgyan Gegham,47,33,14,-19,19,13,16,18,0,0,-9,-6,-4,0,0,-19,11:2 - 11:5 - 11:7 - 0:0 - 0:0
17608319,2024-03-21 16:30:00,Soghomonyan Hrayr - Petrosyan Davit,1:3,9:11 - 11:5 - 11:2 - 11:5 - 0:0,3,1,Soghomonyan Hrayr,Petrosyan Davit,fiurst,Petrosyan Davit - Soghomonyan Hrayr,65,23,42,19,-19,20,16,13,16,0,-2,6,9,6,0,19,11:9 - 5:11 - 2:11 - 5:11 - 0:0
17608316,2024-03-21 16:20:00,Avakimyan Davit - Arutyunov Ruben,3:0,5:11 - 4:11 - 6:11 - 0:0 - 0:0,0,3,Avakimyan Davit,Arutyunov Ruben,fiurst,Arutyunov Ruben - Avakimyan Davit,48,33,15,-18,18,16,15,17,0,0,-6,-7,-5,0,0,-18,11:5 - 11:4 - 11:6 - 0:0 - 0:0
17608314,2024-03-21 16:05:00,Gevorgyan Gegham - Soghomonyan Hrayr,1:3,5:11 - 11:4 - 8:11 - 6:11 - 0:0,1,3,Gevorgyan Gegham,Soghomonyan Hrayr,fiurst,Gevorgyan Gegham - Soghomonyan Hrayr,67,30,37,7,-7,16,15,19,17,0,6,-7,3,5,0,7,5:11 - 11:4 - 8:11 - 6:11 - 0:0
17608309,2024-03-21 15:45:00,Arutyunov Ruben - Petrosyan Davit,3:1,13:11 - 11:4 - 8:11 - 11:6 - 0:0,3,1,Arutyunov Ruben,Petrosyan Davit,fiurst,Arutyunov Ruben - Petrosyan Davit,75,43,32,-11,11,24,15,19,17,0,-2,-7,3,-5,0,-11,13:11 - 11:4 - 8:11 - 11:6 - 0:0
17608300,2024-03-21 15:30:00,Avakimyan Davit - Gevorgyan Gegham,2:3,12:14 - 11:6 - 6:11 - 11:9 - 10:12,2,3,Avakimyan Davit,Gevorgyan Gegham,fiurst,Avakimyan Davit - Gevorgyan Gegham,102,50,52,2,-2,26,17,17,20,22,2,-5,5,-2,2,2,12:14 - 11:6 - 6:11 - 11:9 - 10:12
17608299,2024-03-21 15:20:00,Nikoghosyan Narek - Asatryan Murad,3:0,5:11 - 8:11 - 3:11 - 0:0 - 0:0,0,3,Nikoghosyan Narek,Asatryan Murad,fiurst,Asatryan Murad - Nikoghosyan Narek,49,33,16,-17,17,16,19,14,0,0,-6,-3,-8,0,0,-17,11:5 - 11:8 - 11:3 - 0:0 - 0:0
17608297,2024-03-21 15:00:00,Nazaryan Mushegh - Hovhannesyan Rafik,2:0,5:11 - 10:12 - 0:0 - 0:0 - 0:0,0,2,Nazaryan Mushegh,Hovhannesyan Rafik,fiurst,Hovhannesyan Rafik - Nazaryan Mushegh,38,23,15,-8,8,16,22,0,0,0,-6,-2,0,0,0,-8,11:5 - 12:10 - 0:0 - 0:0 - 0:0
17608294,2024-03-21 14:45:00,Rafayelyan Edgar - Nikoghosyan Narek,3:2,5:11 - 11:3 - 11:2 - 4:11 - 12:14,2,3,Rafayelyan Edgar,Nikoghosyan Narek,fiurst,Nikoghosyan Narek - Rafayelyan Edgar,84,41,43,2,-2,16,14,13,15,26,-6,8,9,-7,-2,2,11:5 - 3:11 - 2:11 - 11:4 - 14:12
17608293,2024-03-21 14:30:00,Asatryan Murad - Nazaryan Mushegh,3:0,11:3 - 11:6 - 11:3 - 0:0 - 0:0,3,0,Asatryan Murad,Nazaryan Mushegh,fiurst,Asatryan Murad - Nazaryan Mushegh,45,33,12,-21,21,14,17,14,0,0,-8,-5,-8,0,0,-21,11:3 - 11:6 - 11:3 - 0:0 - 0:0
17608290,2024-03-21 14:15:00,Rafayelyan Edgar - Hovhannesyan Rafik,0:3,11:6 - 11:4 - 11:8 - 0:0 - 0:0,3,0,Rafayelyan Edgar,Hovhannesyan Rafik,fiurst,Hovhannesyan Rafik - Rafayelyan Edgar,51,18,33,15,-15,17,15,19,0,0,5,7,3,0,0,15,6:11 - 4:11 - 8:11 - 0:0 - 0:0
17608288,2024-03-21 14:10:00,Nikoghosyan Narek - Nazaryan Mushegh,0:3,11:5 - 11:8 - 11:3 - 0:0 - 0:0,3,0,Nikoghosyan Narek,Nazaryan Mushegh,fiurst,Nazaryan Mushegh - Nikoghosyan Narek,49,16,33,17,-17,16,19,14,0,0,6,3,8,0,0,17,5:11 - 8:11 - 3:11 - 0:0 - 0:0
17608273,2024-03-21 13:45:00,Asatryan Murad - Rafayelyan Edgar,3:0,11:5 - 11:7 - 11:5 - 0:0 - 0:0,3,0,Asatryan Murad,Rafayelyan Edgar,fiurst,Asatryan Murad - Rafayelyan Edgar,50,33,17,-16,16,16,18,16,0,0,-6,-4,-6,0,0,-16,11:5 - 11:7 - 11:5 - 0:0 - 0:0
17608267,2024-03-21 13:30:00,Hovhannesyan Rafik - Nikoghosyan Narek,1:3,11:8 - 7:11 - 5:11 - 10:12 - 0:0,1,3,Hovhannesyan Rafik,Nikoghosyan Narek,fiurst,Hovhannesyan Rafik - Nikoghosyan Narek,75,33,42,9,-9,19,18,16,22,0,-3,4,6,2,0,9,11:8 - 7:11 - 5:11 - 10:12 - 0:0
17608263,2024-03-21 13:15:00,Nazaryan Mushegh - Rafayelyan Edgar,0:3,5:11 - 10:12 - 10:12 - 0:0 - 0:0,0,3,Nazaryan Mushegh,Rafayelyan Edgar,fiurst,Nazaryan Mushegh - Rafayelyan Edgar,60,25,35,10,-10,16,22,22,0,0,6,2,2,0,0,10,5:11 - 10:12 - 10:12 - 0:0 - 0:0
17608262,2024-03-21 13:00:00,Hovhannesyan Rafik - Asatryan Murad,3:0,3:11 - 4:11 - 4:11 - 0:0 - 0:0,0,3,Hovhannesyan Rafik,Asatryan Murad,fiurst,Asatryan Murad - Hovhannesyan Rafik,44,33,11,-22,22,14,15,15,0,0,-8,-7,-7,0,0,-22,11:3 - 11:4 - 11:4 - 0:0 - 0:0
17608257,2024-03-21 12:25:00,Nikoghosyan Narek - Rafayelyan Edgar,1:3,9:11 - 3:11 - 11:6 - 5:11 - 0:0,1,3,Nikoghosyan Narek,Rafayelyan Edgar,fiurst,Nikoghosyan Narek - Rafayelyan Edgar,67,28,39,11,-11,20,14,17,16,0,2,8,-5,6,0,11,9:11 - 3:11 - 11:6 - 5:11 - 0:0
17608253,2024-03-21 12:10:00,Hovhannesyan Rafik - Nazaryan Mushegh,3:1,11:7 - 8:11 - 11:8 - 11:3 - 0:0,3,1,Hovhannesyan Rafik,Nazaryan Mushegh,fiurst,Hovhannesyan Rafik - Nazaryan Mushegh,70,41,29,-12,12,18,19,19,14,0,-4,3,-3,-8,0,-12,11:7 - 8:11 - 11:8 - 11:3 - 0:0
17608244,2024-03-21 11:45:00,Asatryan Murad - Nikoghosyan Narek,3:1,15:13 - 12:10 - 9:11 - 11:8 - 0:0,3,1,Asatryan Murad,Nikoghosyan Narek,fiurst,Asatryan Murad - Nikoghosyan Narek,89,47,42,-5,5,28,22,20,19,0,-2,-2,2,-3,0,-5,15:13 - 12:10 - 9:11 - 11:8 - 0:0
17608235,2024-03-21 11:40:00,Hovhannesyan Rafik - Rafayelyan Edgar,2:3,11:13 - 9:11 - 12:10 - 11:5 - 9:11,2,3,Hovhannesyan Rafik,Rafayelyan Edgar,fiurst,Hovhannesyan Rafik - Rafayelyan Edgar,102,52,50,-2,2,24,20,22,16,20,2,2,-2,-6,2,-2,11:13 - 9:11 - 12:10 - 11:5 - 9:11
17608223,2024-03-21 11:20:00,Nazaryan Mushegh - Asatryan Murad,3:0,8:11 - 5:11 - 3:11 - 0:0 - 0:0,0,3,Nazaryan Mushegh,Asatryan Murad,fiurst,Asatryan Murad - Nazaryan Mushegh,49,33,16,-17,17,19,16,14,0,0,-3,-6,-8,0,0,-17,11:8 - 11:5 - 11:3 - 0:0 - 0:0
17608213,2024-03-21 11:05:00,Nikoghosyan Narek - Hovhannesyan Rafik,1:3,11:6 - 11:7 - 12:14 - 11:7 - 0:0,3,1,Nikoghosyan Narek,Hovhannesyan Rafik,fiurst,Hovhannesyan Rafik - Nikoghosyan Narek,79,34,45,11,-11,17,18,26,18,0,5,4,-2,4,0,11,6:11 - 7:11 - 14:12 - 7:11 - 0:0
17608191,2024-03-21 10:45:00,Rafayelyan Edgar - Asatryan Murad,3:1,9:11 - 11:6 - 5:11 - 0:11 - 0:0,1,3,Rafayelyan Edgar,Asatryan Murad,fiurst,Asatryan Murad - Rafayelyan Edgar,64,39,25,-14,14,20,17,16,11,0,-2,5,-6,-11,0,-14,11:9 - 6:11 - 11:5 - 11:0 - 0:0
17608186,2024-03-21 10:30:00,Nazaryan Mushegh - Nikoghosyan Narek,0:3,8:11 - 9:11 - 9:11 - 0:0 - 0:0,0,3,Nazaryan Mushegh,Nikoghosyan Narek,fiurst,Nazaryan Mushegh - Nikoghosyan Narek,59,26,33,7,-7,19,20,20,0,0,3,2,2,0,0,7,8:11 - 9:11 - 9:11 - 0:0 - 0:0
17608183,2024-03-21 10:15:00,Asatryan Murad - Hovhannesyan Rafik,3:0,11:6 - 11:2 - 11:4 - 0:0 - 0:0,3,0,Asatryan Murad,Hovhannesyan Rafik,fiurst,Asatryan Murad - Hovhannesyan Rafik,45,33,12,-21,21,17,13,15,0,0,-5,-9,-7,0,0,-21,11:6 - 11:2 - 11:4 - 0:0 - 0:0
17608179,2024-03-21 10:00:00,Rafayelyan Edgar - Nazaryan Mushegh,1:3,11:3 - 11:8 - 7:11 - 11:6 - 0:0,3,1,Rafayelyan Edgar,Nazaryan Mushegh,fiurst,Nazaryan Mushegh - Rafayelyan Edgar,68,28,40,12,-12,14,19,18,17,0,8,3,-4,5,0,12,3:11 - 8:11 - 11:7 - 6:11 - 0:0
17588992,2024-03-20 17:50:00,Gevorgyan Gegham - Petrosyan Davit,1:3,11:7 - 5:11 - 9:11 - 8:11 - 0:0,1,3,Gevorgyan Gegham,Petrosyan Davit,fiurst,Gevorgyan Gegham - Petrosyan Davit,73,33,40,7,-7,18,16,20,19,0,-4,6,2,3,0,7,11:7 - 5:11 - 9:11 - 8:11 - 0:0
17588963,2024-03-20 17:35:00,Avakimyan Davit - Mkrtchyan Andranik,3:0,11:9 - 11:8 - 11:9 - 0:0 - 0:0,3,0,Avakimyan Davit,Mkrtchyan Andranik,fiurst,Avakimyan Davit - Mkrtchyan Andranik,59,33,26,-7,7,20,19,20,0,0,-2,-3,-2,0,0,-7,11:9 - 11:8 - 11:9 - 0:0 - 0:0
17588962,2024-03-20 17:25:00,Soghomonyan Hrayr - Gevorgyan Gegham,1:3,9:11 - 11:7 - 11:6 - 11:7 - 0:0,3,1,Soghomonyan Hrayr,Gevorgyan Gegham,fiurst,Gevorgyan Gegham - Soghomonyan Hrayr,73,31,42,11,-11,20,18,17,18,0,-2,4,5,4,0,11,11:9 - 7:11 - 6:11 - 7:11 - 0:0
17588961,2024-03-20 17:00:00,Avakimyan Davit - Petrosyan Davit,3:0,11:9 - 11:2 - 11:9 - 0:0 - 0:0,3,0,Avakimyan Davit,Petrosyan Davit,fiurst,Avakimyan Davit - Petrosyan Davit,53,33,20,-13,13,20,13,20,0,0,-2,-9,-2,0,0,-13,11:9 - 11:2 - 11:9 - 0:0 - 0:0
17588958,2024-03-20 16:45:00,Mkrtchyan Andranik - Soghomonyan Hrayr,3:2,10:12 - 14:12 - 11:8 - 7:11 - 11:8,3,2,Mkrtchyan Andranik,Soghomonyan Hrayr,fiurst,Mkrtchyan Andranik - Soghomonyan Hrayr,104,53,51,-2,2,22,26,19,18,19,2,-2,-3,4,-3,-2,10:12 - 14:12 - 11:8 - 7:11 - 11:8
17588955,2024-03-20 16:35:00,Gevorgyan Gegham - Avakimyan Davit,3:1,6:11 - 11:7 - 7:11 - 4:11 - 0:0,1,3,Gevorgyan Gegham,Avakimyan Davit,fiurst,Avakimyan Davit - Gevorgyan Gegham,68,40,28,-12,12,17,18,18,15,0,-5,4,-4,-7,0,-12,11:6 - 7:11 - 11:7 - 11:4 - 0:0
17588951,2024-03-20 16:15:00,Petrosyan Davit - Soghomonyan Hrayr,0:3,9:11 - 5:11 - 8:11 - 0:0 - 0:0,0,3,Petrosyan Davit,Soghomonyan Hrayr,fiurst,Petrosyan Davit - Soghomonyan Hrayr,55,22,33,11,-11,20,16,19,0,0,2,6,3,0,0,11,9:11 - 5:11 - 8:11 - 0:0 - 0:0
17588950,2024-03-20 16:10:00,Mkrtchyan Andranik - Gevorgyan Gegham,1:3,11:7 - 7:11 - 11:9 - 11:8 - 0:0,3,1,Mkrtchyan Andranik,Gevorgyan Gegham,fiurst,Gevorgyan Gegham - Mkrtchyan Andranik,75,35,40,5,-5,18,18,20,19,0,4,-4,2,3,0,5,7:11 - 11:7 - 9:11 - 8:11 - 0:0
17588938,2024-03-20 15:45:00,Soghomonyan Hrayr - Avakimyan Davit,1:3,9:11 - 11:8 - 11:5 - 11:5 - 0:0,3,1,Soghomonyan Hrayr,Avakimyan Davit,fiurst,Avakimyan Davit - Soghomonyan Hrayr,71,29,42,13,-13,20,19,16,16,0,-2,3,6,6,0,13,11:9 - 8:11 - 5:11 - 5:11 - 0:0
17588936,2024-03-20 15:35:00,Petrosyan Davit - Mkrtchyan Andranik,3:2,12:10 - 8:11 - 13:11 - 5:11 - 8:11,2,3,Petrosyan Davit,Mkrtchyan Andranik,fiurst,Mkrtchyan Andranik - Petrosyan Davit,100,54,46,-8,8,22,19,24,16,19,2,-3,2,-6,-3,-8,10:12 - 11:8 - 11:13 - 11:5 - 11:8
17588935,2024-03-20 15:20:00,Diaryan Aleksandr - Rafayelyan Edgar,1:3,11:13 - 11:7 - 5:11 - 7:11 - 0:0,1,3,Diaryan Aleksandr,Rafayelyan Edgar,fiurst,Diaryan Aleksandr - Rafayelyan Edgar,76,34,42,8,-8,24,18,16,18,0,2,-4,6,4,0,8,11:13 - 11:7 - 5:11 - 7:11 - 0:0
17588933,2024-03-20 15:10:00,Asatryan Murad - Nikoghosyan Narek,3:1,11:6 - 5:11 - 11:7 - 11:5 - 0:0,3,1,Asatryan Murad,Nikoghosyan Narek,fiurst,Asatryan Murad - Nikoghosyan Narek,67,38,29,-9,9,17,16,18,16,0,-5,6,-4,-6,0,-9,11:6 - 5:11 - 11:7 - 11:5 - 0:0
17588929,2024-03-20 15:00:00,Hovhannesyan Rafik - Diaryan Aleksandr,3:0,9:11 - 9:11 - 10:12 - 0:0 - 0:0,0,3,Hovhannesyan Rafik,Diaryan Aleksandr,fiurst,Diaryan Aleksandr - Hovhannesyan Rafik,62,34,28,-6,6,20,20,22,0,0,-2,-2,-2,0,0,-6,11:9 - 11:9 - 12:10 - 0:0 - 0:0
17588925,2024-03-20 14:45:00,Rafayelyan Edgar - Asatryan Murad,1:3,9:11 - 13:11 - 11:7 - 12:10 - 0:0,3,1,Rafayelyan Edgar,Asatryan Murad,fiurst,Asatryan Murad - Rafayelyan Edgar,84,39,45,6,-6,20,24,18,22,0,-2,2,4,2,0,6,11:9 - 11:13 - 7:11 - 10:12 - 0:0
17588924,2024-03-20 14:25:00,Hovhannesyan Rafik - Nikoghosyan Narek,3:1,11:7 - 11:8 - 7:11 - 12:10 - 0:0,3,1,Hovhannesyan Rafik,Nikoghosyan Narek,fiurst,Hovhannesyan Rafik - Nikoghosyan Narek,77,41,36,-5,5,18,19,18,22,0,-4,-3,4,-2,0,-5,11:7 - 11:8 - 7:11 - 12:10 - 0:0
17588912,2024-03-20 14:15:00,Diaryan Aleksandr - Asatryan Murad,3:1,11:6 - 4:11 - 10:12 - 8:11 - 0:0,1,3,Diaryan Aleksandr,Asatryan Murad,fiurst,Asatryan Murad - Diaryan Aleksandr,73,40,33,-7,7,17,15,22,19,0,5,-7,-2,-3,0,-7,6:11 - 11:4 - 12:10 - 11:8 - 0:0
17588908,2024-03-20 13:45:00,Nikoghosyan Narek - Diaryan Aleksandr,2:3,5:11 - 11:6 - 6:11 - 11:9 - 11:7,3,2,Nikoghosyan Narek,Diaryan Aleksandr,fiurst,Diaryan Aleksandr - Nikoghosyan Narek,88,44,44,0,0,16,17,17,20,18,-6,5,-5,2,4,0,11:5 - 6:11 - 11:6 - 9:11 - 7:11
17588910,2024-03-20 13:45:00,Rafayelyan Edgar - Hovhannesyan Rafik,0:3,11:6 - 11:6 - 11:5 - 0:0 - 0:0,3,0,Rafayelyan Edgar,Hovhannesyan Rafik,fiurst,Hovhannesyan Rafik - Rafayelyan Edgar,50,17,33,16,-16,17,17,16,0,0,5,5,6,0,0,16,6:11 - 6:11 - 5:11 - 0:0 - 0:0
17588903,2024-03-20 13:15:00,Asatryan Murad - Hovhannesyan Rafik,3:0,11:9 - 11:2 - 11:6 - 0:0 - 0:0,3,0,Asatryan Murad,Hovhannesyan Rafik,fiurst,Asatryan Murad - Hovhannesyan Rafik,50,33,17,-16,16,20,13,17,0,0,-2,-9,-5,0,0,-16,11:9 - 11:2 - 11:6 - 0:0 - 0:0
17588902,2024-03-20 13:00:00,Nikoghosyan Narek - Rafayelyan Edgar,3:2,8:11 - 11:5 - 11:5 - 4:11 - 11:7,3,2,Nikoghosyan Narek,Rafayelyan Edgar,fiurst,Nikoghosyan Narek - Rafayelyan Edgar,84,45,39,-6,6,19,16,16,15,18,3,-6,-6,7,-4,-6,8:11 - 11:5 - 11:5 - 4:11 - 11:7
17588899,2024-03-20 12:25:00,Diaryan Aleksandr - Hovhannesyan Rafik,3:0,11:4 - 12:10 - 11:5 - 0:0 - 0:0,3,0,Diaryan Aleksandr,Hovhannesyan Rafik,fiurst,Diaryan Aleksandr - Hovhannesyan Rafik,53,34,19,-15,15,15,22,16,0,0,-7,-2,-6,0,0,-15,11:4 - 12:10 - 11:5 - 0:0 - 0:0
17588897,2024-03-20 12:10:00,Nikoghosyan Narek - Asatryan Murad,3:1,11:13 - 11:4 - 3:11 - 8:11 - 0:0,1,3,Nikoghosyan Narek,Asatryan Murad,fiurst,Asatryan Murad - Nikoghosyan Narek,72,39,33,-6,6,24,15,14,19,0,-2,7,-8,-3,0,-6,13:11 - 4:11 - 11:3 - 11:8 - 0:0
17588896,2024-03-20 12:00:00,Rafayelyan Edgar - Diaryan Aleksandr,2:3,8:11 - 11:5 - 11:8 - 8:11 - 11:5,3,2,Rafayelyan Edgar,Diaryan Aleksandr,fiurst,Diaryan Aleksandr - Rafayelyan Edgar,89,40,49,9,-9,19,16,19,19,16,-3,6,3,-3,6,9,11:8 - 5:11 - 8:11 - 11:8 - 5:11
17588895,2024-03-20 11:40:00,Nikoghosyan Narek - Hovhannesyan Rafik,1:3,11:7 - 8:11 - 11:6 - 11:4 - 0:0,3,1,Nikoghosyan Narek,Hovhannesyan Rafik,fiurst,Hovhannesyan Rafik - Nikoghosyan Narek,69,28,41,13,-13,18,19,17,15,0,4,-3,5,7,0,13,7:11 - 11:8 - 6:11 - 4:11 - 0:0
17588883,2024-03-20 11:20:00,Asatryan Murad - Rafayelyan Edgar,3:2,12:10 - 5:11 - 10:12 - 12:10 - 11:6,3,2,Asatryan Murad,Rafayelyan Edgar,fiurst,Asatryan Murad - Rafayelyan Edgar,99,50,49,-1,1,22,16,22,22,17,-2,6,2,-2,-5,-1,12:10 - 5:11 - 10:12 - 12:10 - 11:6
17588882,2024-03-20 11:05:00,Diaryan Aleksandr - Nikoghosyan Narek,1:3,13:15 - 5:11 - 11:8 - 10:12 - 0:0,1,3,Diaryan Aleksandr,Nikoghosyan Narek,fiurst,Diaryan Aleksandr - Nikoghosyan Narek,85,39,46,7,-7,28,16,19,22,0,2,6,-3,2,0,7,13:15 - 5:11 - 11:8 - 10:12 - 0:0
17588868,2024-03-20 10:45:00,Hovhannesyan Rafik - Rafayelyan Edgar,1:3,5:11 - 8:11 - 11:9 - 2:11 - 0:0,1,3,Hovhannesyan Rafik,Rafayelyan Edgar,fiurst,Hovhannesyan Rafik - Rafayelyan Edgar,68,26,42,16,-16,16,19,20,13,0,6,3,-2,9,0,16,5:11 - 8:11 - 11:9 - 2:11 - 0:0
17588853,2024-03-20 10:30:00,Asatryan Murad - Diaryan Aleksandr,3:2,8:11 - 11:5 - 6:11 - 13:11 - 11:9,3,2,Asatryan Murad,Diaryan Aleksandr,fiurst,Asatryan Murad - Diaryan Aleksandr,96,49,47,-2,2,19,16,17,24,20,3,-6,5,-2,-2,-2,8:11 - 11:5 - 6:11 - 13:11 - 11:9
17588850,2024-03-20 10:15:00,Rafayelyan Edgar - Nikoghosyan Narek,1:3,11:7 - 11:6 - 11:13 - 11:8 - 0:0,3,1,Rafayelyan Edgar,Nikoghosyan Narek,fiurst,Nikoghosyan Narek - Rafayelyan Edgar,78,34,44,10,-10,18,17,24,19,0,4,5,-2,3,0,10,7:11 - 6:11 - 13:11 - 8:11 - 0:0
17588848,2024-03-20 10:00:00,Hovhannesyan Rafik - Asatryan Murad,3:0,6:11 - 8:11 - 6:11 - 0:0 - 0:0,0,3,Hovhannesyan Rafik,Asatryan Murad,fiurst,Asatryan Murad - Hovhannesyan Rafik,53,33,20,-13,13,17,19,17,0,0,-5,-3,-5,0,0,-13,11:6 - 11:8 - 11:6 - 0:0 - 0:0
17568064,2024-03-19 17:50:00,Mkrtchyan Andranik - Soghomonyan Hrayr,3:2,12:14 - 11:6 - 8:11 - 11:7 - 13:11,3,2,Mkrtchyan Andranik,Soghomonyan Hrayr,fiurst,Mkrtchyan Andranik - Soghomonyan Hrayr,104,55,49,-6,6,26,17,19,18,24,2,-5,3,-4,-2,-6,12:14 - 11:6 - 8:11 - 11:7 - 13:11
17568061,2024-03-19 17:30:00,Gevorgyan Gegham - Arutyunov Ruben,3:0,2:11 - 7:11 - 5:11 - 0:0 - 0:0,0,3,Gevorgyan Gegham,Arutyunov Ruben,fiurst,Arutyunov Ruben - Gevorgyan Gegham,47,33,14,-19,19,13,18,16,0,0,-9,-4,-6,0,0,-19,11:2 - 11:7 - 11:5 - 0:0 - 0:0
17568060,2024-03-19 17:25:00,Petrosyan Davit - Mkrtchyan Andranik,0:3,11:9 - 11:9 - 12:10 - 0:0 - 0:0,3,0,Petrosyan Davit,Mkrtchyan Andranik,fiurst,Mkrtchyan Andranik - Petrosyan Davit,62,28,34,6,-6,20,20,22,0,0,2,2,2,0,0,6,9:11 - 9:11 - 10:12 - 0:0 - 0:0
17568056,2024-03-19 17:10:00,Gevorgyan Gegham - Soghomonyan Hrayr,0:3,3:11 - 10:12 - 8:11 - 0:0 - 0:0,0,3,Gevorgyan Gegham,Soghomonyan Hrayr,fiurst,Gevorgyan Gegham - Soghomonyan Hrayr,55,21,34,13,-13,14,22,19,0,0,8,2,3,0,0,13,3:11 - 10:12 - 8:11 - 0:0 - 0:0
17568055,2024-03-19 16:45:00,Arutyunov Ruben - Petrosyan Davit,3:2,9:11 - 11:5 - 6:11 - 12:10 - 11:7,3,2,Arutyunov Ruben,Petrosyan Davit,fiurst,Arutyunov Ruben - Petrosyan Davit,93,49,44,-5,5,20,16,17,22,18,2,-6,5,-2,-4,-5,9:11 - 11:5 - 6:11 - 12:10 - 11:7
17568042,2024-03-19 16:40:00,Mkrtchyan Andranik - Gevorgyan Gegham,1:3,7:11 - 11:7 - 11:5 - 11:9 - 0:0,3,1,Mkrtchyan Andranik,Gevorgyan Gegham,fiurst,Gevorgyan Gegham - Mkrtchyan Andranik,72,32,40,8,-8,18,18,16,20,0,-4,4,6,2,0,8,11:7 - 7:11 - 5:11 - 9:11 - 0:0
17568041,2024-03-19 16:25:00,Soghomonyan Hrayr - Petrosyan Davit,0:3,11:5 - 11:4 - 11:7 - 0:0 - 0:0,3,0,Soghomonyan Hrayr,Petrosyan Davit,fiurst,Petrosyan Davit - Soghomonyan Hrayr,49,16,33,17,-17,16,15,18,0,0,6,7,4,0,0,17,5:11 - 4:11 - 7:11 - 0:0 - 0:0
17568038,2024-03-19 16:05:00,Arutyunov Ruben - Mkrtchyan Andranik,3:1,11:3 - 11:8 - 6:11 - 13:11 - 0:0,3,1,Arutyunov Ruben,Mkrtchyan Andranik,fiurst,Arutyunov Ruben - Mkrtchyan Andranik,74,41,33,-8,8,14,19,17,24,0,-8,-3,5,-2,0,-8,11:3 - 11:8 - 6:11 - 13:11 - 0:0
17568034,2024-03-19 15:45:00,Petrosyan Davit - Gevorgyan Gegham,2:3,9:11 - 10:12 - 11:5 - 11:9 - 11:2,3,2,Petrosyan Davit,Gevorgyan Gegham,fiurst,Gevorgyan Gegham - Petrosyan Davit,91,39,52,13,-13,20,22,16,20,13,-2,-2,6,2,9,13,11:9 - 12:10 - 5:11 - 9:11 - 2:11
17568032,2024-03-19 15:30:00,Soghomonyan Hrayr - Arutyunov Ruben,1:3,11:8 - 11:5 - 5:11 - 11:9 - 0:0,3,1,Soghomonyan Hrayr,Arutyunov Ruben,fiurst,Arutyunov Ruben - Soghomonyan Hrayr,71,33,38,5,-5,19,16,16,20,0,3,6,-6,2,0,5,8:11 - 5:11 - 11:5 - 9:11 - 0:0
17568031,2024-03-19 15:25:00,Nikoghosyan Narek - Asatryan Murad,3:1,11:8 - 4:11 - 9:11 - 8:11 - 0:0,1,3,Nikoghosyan Narek,Asatryan Murad,fiurst,Asatryan Murad - Nikoghosyan Narek,73,41,32,-9,9,19,15,20,19,0,3,-7,-2,-3,0,-9,8:11 - 11:4 - 11:9 - 11:8 - 0:0
17568030,2024-03-19 15:00:00,Diaryan Aleksandr - Nazaryan Mushegh,3:2,11:5 - 11:5 - 9:11 - 8:11 - 11:5,3,2,Diaryan Aleksandr,Nazaryan Mushegh,fiurst,Diaryan Aleksandr - Nazaryan Mushegh,87,50,37,-13,13,16,16,20,19,16,-6,-6,2,3,-6,-13,11:5 - 11:5 - 9:11 - 8:11 - 11:5
17568027,2024-03-19 14:50:00,Papyan Karen - Nikoghosyan Narek,3:1,11:7 - 8:11 - 9:11 - 9:11 - 0:0,1,3,Papyan Karen,Nikoghosyan Narek,fiurst,Nikoghosyan Narek - Papyan Karen,77,40,37,-3,3,18,19,20,20,0,4,-3,-2,-2,0,-3,7:11 - 11:8 - 11:9 - 11:9 - 0:0
17568024,2024-03-19 14:30:00,Asatryan Murad - Diaryan Aleksandr,3:1,11:13 - 12:10 - 11:7 - 13:11 - 0:0,3,1,Asatryan Murad,Diaryan Aleksandr,fiurst,Asatryan Murad - Diaryan Aleksandr,88,47,41,-6,6,24,22,18,24,0,2,-2,-4,-2,0,-6,11:13 - 12:10 - 11:7 - 13:11 - 0:0
17568011,2024-03-19 14:20:00,Papyan Karen - Nazaryan Mushegh,3:1,11:9 - 7:11 - 7:11 - 9:11 - 0:0,1,3,Papyan Karen,Nazaryan Mushegh,fiurst,Nazaryan Mushegh - Papyan Karen,76,42,34,-8,8,20,18,18,20,0,2,-4,-4,-2,0,-8,9:11 - 11:7 - 11:7 - 11:9 - 0:0
17568010,2024-03-19 14:00:00,Nikoghosyan Narek - Diaryan Aleksandr,2:3,9:11 - 11:5 - 11:9 - 7:11 - 12:10,3,2,Nikoghosyan Narek,Diaryan Aleksandr,fiurst,Diaryan Aleksandr - Nikoghosyan Narek,96,46,50,4,-4,20,16,20,18,22,-2,6,2,-4,2,4,11:9 - 5:11 - 9:11 - 11:7 - 10:12
17568006,2024-03-19 13:50:00,Asatryan Murad - Papyan Karen,3:0,11:6 - 11:8 - 11:9 - 0:0 - 0:0,3,0,Asatryan Murad,Papyan Karen,fiurst,Asatryan Murad - Papyan Karen,56,33,23,-10,10,17,19,20,0,0,-5,-3,-2,0,0,-10,11:6 - 11:8 - 11:9 - 0:0 - 0:0
17568004,2024-03-19 13:30:00,Nazaryan Mushegh - Nikoghosyan Narek,3:2,7:11 - 11:2 - 11:5 - 7:11 - 11:4,3,2,Nazaryan Mushegh,Nikoghosyan Narek,fiurst,Nazaryan Mushegh - Nikoghosyan Narek,80,47,33,-14,14,18,13,16,18,15,4,-9,-6,4,-7,-14,7:11 - 11:2 - 11:5 - 7:11 - 11:4
17568001,2024-03-19 13:15:00,Diaryan Aleksandr - Papyan Karen,3:1,7:11 - 12:10 - 11:6 - 11:9 - 0:0,3,1,Diaryan Aleksandr,Papyan Karen,fiurst,Diaryan Aleksandr - Papyan Karen,77,41,36,-5,5,18,22,17,20,0,4,-2,-5,-2,0,-5,7:11 - 12:10 - 11:6 - 11:9 - 0:0
17567999,2024-03-19 13:00:00,Nazaryan Mushegh - Asatryan Murad,3:0,5:11 - 7:11 - 4:11 - 0:0 - 0:0,0,3,Nazaryan Mushegh,Asatryan Murad,fiurst,Asatryan Murad - Nazaryan Mushegh,49,33,16,-17,17,16,18,15,0,0,-6,-4,-7,0,0,-17,11:5 - 11:7 - 11:4 - 0:0 - 0:0
17567997,2024-03-19 12:15:00,Nikoghosyan Narek - Papyan Karen,3:1,11:8 - 11:9 - 8:11 - 11:8 - 0:0,3,1,Nikoghosyan Narek,Papyan Karen,fiurst,Nikoghosyan Narek - Papyan Karen,77,41,36,-5,5,19,20,19,19,0,-3,-2,3,-3,0,-5,11:8 - 11:9 - 8:11 - 11:8 - 0:0
17567995,2024-03-19 12:05:00,Nazaryan Mushegh - Diaryan Aleksandr,3:2,11:6 - 11:8 - 3:11 - 8:11 - 6:11,2,3,Nazaryan Mushegh,Diaryan Aleksandr,fiurst,Diaryan Aleksandr - Nazaryan Mushegh,86,47,39,-8,8,17,19,14,19,17,5,3,-8,-3,-5,-8,6:11 - 8:11 - 11:3 - 11:8 - 11:6
17567990,2024-03-19 11:45:00,Asatryan Murad - Nikoghosyan Narek,3:0,11:7 - 11:3 - 11:7 - 0:0 - 0:0,3,0,Asatryan Murad,Nikoghosyan Narek,fiurst,Asatryan Murad - Nikoghosyan Narek,50,33,17,-16,16,18,14,18,0,0,-4,-8,-4,0,0,-16,11:7 - 11:3 - 11:7 - 0:0 - 0:0
17567982,2024-03-19 11:40:00,Nazaryan Mushegh - Papyan Karen,0:3,7:11 - 10:12 - 8:11 - 0:0 - 0:0,0,3,Nazaryan Mushegh,Papyan Karen,fiurst,Nazaryan Mushegh - Papyan Karen,59,25,34,9,-9,18,22,19,0,0,4,2,3,0,0,9,7:11 - 10:12 - 8:11 - 0:0 - 0:0
17567980,2024-03-19 11:20:00,Diaryan Aleksandr - Asatryan Murad,3:0,4:11 - 6:11 - 7:11 - 0:0 - 0:0,0,3,Diaryan Aleksandr,Asatryan Murad,fiurst,Asatryan Murad - Diaryan Aleksandr,50,33,17,-16,16,15,17,18,0,0,-7,-5,-4,0,0,-16,11:4 - 11:6 - 11:7 - 0:0 - 0:0
17567975,2024-03-19 11:10:00,Nikoghosyan Narek - Nazaryan Mushegh,3:1,11:8 - 3:11 - 6:11 - 3:11 - 0:0,1,3,Nikoghosyan Narek,Nazaryan Mushegh,fiurst,Nazaryan Mushegh - Nikoghosyan Narek,64,41,23,-18,18,19,14,17,14,0,3,-8,-5,-8,0,-18,8:11 - 11:3 - 11:6 - 11:3 - 0:0
17567973,2024-03-19 10:50:00,Papyan Karen - Asatryan Murad,3:0,6:11 - 4:11 - 6:11 - 0:0 - 0:0,0,3,Papyan Karen,Asatryan Murad,fiurst,Asatryan Murad - Papyan Karen,49,33,16,-17,17,17,15,17,0,0,-5,-7,-5,0,0,-17,11:6 - 11:4 - 11:6 - 0:0 - 0:0
17567971,2024-03-19 10:35:00,Diaryan Aleksandr - Nikoghosyan Narek,2:3,8:11 - 7:11 - 11:9 - 11:5 - 7:11,2,3,Diaryan Aleksandr,Nikoghosyan Narek,fiurst,Diaryan Aleksandr - Nikoghosyan Narek,91,44,47,3,-3,19,18,20,16,18,3,4,-2,-6,4,3,8:11 - 7:11 - 11:9 - 11:5 - 7:11
17567968,2024-03-19 10:15:00,Asatryan Murad - Nazaryan Mushegh,3:0,11:4 - 11:5 - 11:4 - 0:0 - 0:0,3,0,Asatryan Murad,Nazaryan Mushegh,fiurst,Asatryan Murad - Nazaryan Mushegh,46,33,13,-20,20,15,16,15,0,0,-7,-6,-7,0,0,-20,11:4 - 11:5 - 11:4 - 0:0 - 0:0
17567964,2024-03-19 10:10:00,Papyan Karen - Diaryan Aleksandr,2:3,11:8 - 7:11 - 11:6 - 3:11 - 12:10,3,2,Papyan Karen,Diaryan Aleksandr,fiurst,Diaryan Aleksandr - Papyan Karen,90,46,44,-2,2,19,18,17,14,22,3,-4,5,-8,2,-2,8:11 - 11:7 - 6:11 - 11:3 - 10:12
17551992,2024-03-18 17:45:00,Arutyunov Ruben - Mkrtchyan Andranik,3:2,11:9 - 8:11 - 9:11 - 11:7 - 11:9,3,2,Arutyunov Ruben,Mkrtchyan Andranik,fiurst,Arutyunov Ruben - Mkrtchyan Andranik,97,50,47,-3,3,20,19,20,18,20,-2,3,2,-4,-2,-3,11:9 - 8:11 - 9:11 - 11:7 - 11:9
17551982,2024-03-18 17:30:00,Petrosyan Davit - Soghomonyan Hrayr,1:3,11:9 - 6:11 - 6:11 - 6:11 - 0:0,1,3,Petrosyan Davit,Soghomonyan Hrayr,fiurst,Petrosyan Davit - Soghomonyan Hrayr,71,29,42,13,-13,20,17,17,17,0,-2,5,5,5,0,13,11:9 - 6:11 - 6:11 - 6:11 - 0:0
17551978,2024-03-18 17:15:00,Gevorgyan Hayk - Arutyunov Ruben,3:1,4:11 - 11:13 - 11:5 - 10:12 - 0:0,1,3,Gevorgyan Hayk,Arutyunov Ruben,fiurst,Arutyunov Ruben - Gevorgyan Hayk,77,41,36,-5,5,15,24,16,22,0,-7,-2,6,-2,0,-5,11:4 - 13:11 - 5:11 - 12:10 - 0:0
17551961,2024-03-18 17:00:00,Petrosyan Davit - Mkrtchyan Andranik,3:0,9:11 - 9:11 - 6:11 - 0:0 - 0:0,0,3,Petrosyan Davit,Mkrtchyan Andranik,fiurst,Mkrtchyan Andranik - Petrosyan Davit,57,33,24,-9,9,20,20,17,0,0,-2,-2,-5,0,0,-9,11:9 - 11:9 - 11:6 - 0:0 - 0:0
17551956,2024-03-18 16:45:00,Soghomonyan Hrayr - Gevorgyan Hayk,1:3,11:8 - 8:11 - 11:3 - 11:5 - 0:0,3,1,Soghomonyan Hrayr,Gevorgyan Hayk,fiurst,Gevorgyan Hayk - Soghomonyan Hrayr,68,27,41,14,-14,19,19,14,16,0,3,-3,8,6,0,14,8:11 - 11:8 - 3:11 - 5:11 - 0:0
17551951,2024-03-18 16:35:00,Arutyunov Ruben - Petrosyan Davit,3:0,11:1 - 11:1 - 11:3 - 0:0 - 0:0,3,0,Arutyunov Ruben,Petrosyan Davit,fiurst,Arutyunov Ruben - Petrosyan Davit,38,33,5,-28,28,12,12,14,0,0,-10,-10,-8,0,0,-28,11:1 - 11:1 - 11:3 - 0:0 - 0:0
17551947,2024-03-18 16:15:00,Mkrtchyan Andranik - Gevorgyan Hayk,3:1,6:11 - 12:10 - 9:11 - 11:13 - 0:0,1,3,Mkrtchyan Andranik,Gevorgyan Hayk,fiurst,Gevorgyan Hayk - Mkrtchyan Andranik,83,45,38,-7,7,17,22,20,24,0,-5,2,-2,-2,0,-7,11:6 - 10:12 - 11:9 - 13:11 - 0:0
17550261,2024-03-18 16:00:00,Soghomonyan Hrayr - Arutyunov Ruben,3:1,11:9 - 4:11 - 5:11 - 8:11 - 0:0,1,3,Soghomonyan Hrayr,Arutyunov Ruben,fiurst,Arutyunov Ruben - Soghomonyan Hrayr,70,42,28,-14,14,20,15,16,19,0,2,-7,-6,-3,0,-14,9:11 - 11:4 - 11:5 - 11:8 - 0:0
17550256,2024-03-18 15:45:00,Gevorgyan Hayk - Petrosyan Davit,3:2,8:11 - 12:10 - 11:5 - 7:11 - 11:5,3,2,Gevorgyan Hayk,Petrosyan Davit,fiurst,Gevorgyan Hayk - Petrosyan Davit,91,49,42,-7,7,19,22,16,18,16,3,-2,-6,4,-6,-7,8:11 - 12:10 - 11:5 - 7:11 - 11:5
17550253,2024-03-18 15:30:00,Mkrtchyan Andranik - Soghomonyan Hrayr,3:0,11:6 - 11:8 - 11:9 - 0:0 - 0:0,3,0,Mkrtchyan Andranik,Soghomonyan Hrayr,fiurst,Mkrtchyan Andranik - Soghomonyan Hrayr,56,33,23,-10,10,17,19,20,0,0,-5,-3,-2,0,0,-10,11:6 - 11:8 - 11:9 - 0:0 - 0:0
17550251,2024-03-18 15:15:00,Diaryan Aleksandr - Rafayelyan Edgar,0:3,6:11 - 9:11 - 5:11 - 0:0 - 0:0,0,3,Diaryan Aleksandr,Rafayelyan Edgar,fiurst,Diaryan Aleksandr - Rafayelyan Edgar,53,20,33,13,-13,17,20,16,0,0,5,2,6,0,0,13,6:11 - 9:11 - 5:11 - 0:0 - 0:0
17550250,2024-03-18 15:00:00,Nazaryan Mushegh - Papyan Karen,3:2,11:5 - 10:12 - 11:9 - 13:15 - 11:8,3,2,Nazaryan Mushegh,Papyan Karen,fiurst,Nazaryan Mushegh - Papyan Karen,105,56,49,-7,7,16,22,20,28,19,-6,2,-2,2,-3,-7,11:5 - 10:12 - 11:9 - 13:15 - 11:8
17550237,2024-03-18 14:45:00,Nikoghosyan Narek - Diaryan Aleksandr,0:3,14:12 - 14:12 - 11:2 - 0:0 - 0:0,3,0,Nikoghosyan Narek,Diaryan Aleksandr,fiurst,Diaryan Aleksandr - Nikoghosyan Narek,65,26,39,13,-13,26,26,13,0,0,2,2,9,0,0,13,12:14 - 12:14 - 2:11 - 0:0 - 0:0
17550234,2024-03-18 14:30:00,Rafayelyan Edgar - Nazaryan Mushegh,0:3,11:4 - 11:8 - 11:5 - 0:0 - 0:0,3,0,Rafayelyan Edgar,Nazaryan Mushegh,fiurst,Nazaryan Mushegh - Rafayelyan Edgar,50,17,33,16,-16,15,19,16,0,0,7,3,6,0,0,16,4:11 - 8:11 - 5:11 - 0:0 - 0:0
17550233,2024-03-18 14:20:00,Nikoghosyan Narek - Papyan Karen,0:3,10:12 - 8:11 - 7:11 - 0:0 - 0:0,0,3,Nikoghosyan Narek,Papyan Karen,fiurst,Nikoghosyan Narek - Papyan Karen,59,25,34,9,-9,22,19,18,0,0,2,3,4,0,0,9,10:12 - 8:11 - 7:11 - 0:0 - 0:0
17550225,2024-03-18 14:00:00,Diaryan Aleksandr - Nazaryan Mushegh,3:1,9:11 - 11:8 - 11:8 - 11:3 - 0:0,3,1,Diaryan Aleksandr,Nazaryan Mushegh,fiurst,Diaryan Aleksandr - Nazaryan Mushegh,72,42,30,-12,12,20,19,19,14,0,2,-3,-3,-8,0,-12,9:11 - 11:8 - 11:8 - 11:3 - 0:0
17550224,2024-03-18 13:45:00,Rafayelyan Edgar - Nikoghosyan Narek,1:3,4:11 - 11:7 - 11:4 - 11:7 - 0:0,3,1,Rafayelyan Edgar,Nikoghosyan Narek,fiurst,Nikoghosyan Narek - Rafayelyan Edgar,66,29,37,8,-8,15,18,15,18,0,-7,4,7,4,0,8,11:4 - 7:11 - 4:11 - 7:11 - 0:0
17550222,2024-03-18 13:35:00,Papyan Karen - Diaryan Aleksandr,0:3,12:10 - 12:10 - 12:10 - 0:0 - 0:0,3,0,Papyan Karen,Diaryan Aleksandr,fiurst,Diaryan Aleksandr - Papyan Karen,66,30,36,6,-6,22,22,22,0,0,2,2,2,0,0,6,10:12 - 10:12 - 10:12 - 0:0 - 0:0
17550211,2024-03-18 13:15:00,Nazaryan Mushegh - Nikoghosyan Narek,0:3,8:11 - 5:11 - 8:11 - 0:0 - 0:0,0,3,Nazaryan Mushegh,Nikoghosyan Narek,fiurst,Nazaryan Mushegh - Nikoghosyan Narek,54,21,33,12,-12,19,16,19,0,0,3,6,3,0,0,12,8:11 - 5:11 - 8:11 - 0:0 - 0:0
17550204,2024-03-18 13:00:00,Papyan Karen - Rafayelyan Edgar,2:3,8:11 - 5:11 - 12:10 - 12:10 - 5:11,2,3,Papyan Karen,Rafayelyan Edgar,fiurst,Papyan Karen - Rafayelyan Edgar,95,42,53,11,-11,19,16,22,22,16,3,6,-2,-2,6,11,8:11 - 5:11 - 12:10 - 12:10 - 5:11
17550201,2024-03-18 12:15:00,Diaryan Aleksandr - Nikoghosyan Narek,3:0,11:6 - 11:9 - 11:8 - 0:0 - 0:0,3,0,Diaryan Aleksandr,Nikoghosyan Narek,fiurst,Diaryan Aleksandr - Nikoghosyan Narek,56,33,23,-10,10,17,20,19,0,0,-5,-2,-3,0,0,-10,11:6 - 11:9 - 11:8 - 0:0 - 0:0
17550197,2024-03-18 12:10:00,Papyan Karen - Nazaryan Mushegh,0:3,11:7 - 11:2 - 11:7 - 0:0 - 0:0,3,0,Papyan Karen,Nazaryan Mushegh,fiurst,Nazaryan Mushegh - Papyan Karen,49,16,33,17,-17,18,13,18,0,0,4,9,4,0,0,17,7:11 - 2:11 - 7:11 - 0:0 - 0:0
17550196,2024-03-18 11:45:00,Rafayelyan Edgar - Diaryan Aleksandr,1:3,11:6 - 11:7 - 10:12 - 11:6 - 0:0,3,1,Rafayelyan Edgar,Diaryan Aleksandr,fiurst,Diaryan Aleksandr - Rafayelyan Edgar,74,31,43,12,-12,17,18,22,17,0,5,4,-2,5,0,12,6:11 - 7:11 - 12:10 - 6:11 - 0:0
17550192,2024-03-18 11:35:00,Papyan Karen - Nikoghosyan Narek,3:0,7:11 - 15:17 - 8:11 - 0:0 - 0:0,0,3,Papyan Karen,Nikoghosyan Narek,fiurst,Nikoghosyan Narek - Papyan Karen,69,39,30,-9,9,18,32,19,0,0,-4,-2,-3,0,0,-9,11:7 - 17:15 - 11:8 - 0:0 - 0:0
17550189,2024-03-18 11:20:00,Nazaryan Mushegh - Rafayelyan Edgar,0:3,9:11 - 8:11 - 4:11 - 0:0 - 0:0,0,3,Nazaryan Mushegh,Rafayelyan Edgar,fiurst,Nazaryan Mushegh - Rafayelyan Edgar,54,21,33,12,-12,20,19,15,0,0,2,3,7,0,0,12,9:11 - 8:11 - 4:11 - 0:0 - 0:0
17550158,2024-03-18 11:00:00,Diaryan Aleksandr - Papyan Karen,1:3,11:3 - 10:12 - 9:11 - 11:13 - 0:0,1,3,Diaryan Aleksandr,Papyan Karen,fiurst,Diaryan Aleksandr - Papyan Karen,80,41,39,-2,2,14,22,20,24,0,-8,2,2,2,0,-2,11:3 - 10:12 - 9:11 - 11:13 - 0:0
17550141,2024-03-18 10:45:00,Nikoghosyan Narek - Rafayelyan Edgar,1:3,11:4 - 9:11 - 8:11 - 5:11 - 0:0,1,3,Nikoghosyan Narek,Rafayelyan Edgar,fiurst,Nikoghosyan Narek - Rafayelyan Edgar,70,33,37,4,-4,15,20,19,16,0,-7,2,3,6,0,4,11:4 - 9:11 - 8:11 - 5:11 - 0:0
17550137,2024-03-18 10:30:00,Nazaryan Mushegh - Diaryan Aleksandr,3:1,11:3 - 6:11 - 11:13 - 5:11 - 0:0,1,3,Nazaryan Mushegh,Diaryan Aleksandr,fiurst,Diaryan Aleksandr - Nazaryan Mushegh,71,38,33,-5,5,14,17,24,16,0,8,-5,-2,-6,0,-5,3:11 - 11:6 - 13:11 - 11:5 - 0:0
17550133,2024-03-18 10:15:00,Rafayelyan Edgar - Papyan Karen,3:1,9:11 - 11:3 - 6:11 - 9:11 - 0:0,1,3,Rafayelyan Edgar,Papyan Karen,fiurst,Papyan Karen - Rafayelyan Edgar,71,36,35,-1,1,20,14,17,20,0,-2,8,-5,-2,0,-1,11:9 - 3:11 - 11:6 - 11:9 - 0:0
17550132,2024-03-18 10:00:00,Nikoghosyan Narek - Nazaryan Mushegh,0:3,11:7 - 11:6 - 14:12 - 0:0 - 0:0,3,0,Nikoghosyan Narek,Nazaryan Mushegh,fiurst,Nazaryan Mushegh - Nikoghosyan Narek,61,25,36,11,-11,18,17,26,0,0,4,5,2,0,0,11,7:11 - 6:11 - 12:14 - 0:0 - 0:0
17530033,2024-03-17 17:45:00,Petrosyan Davit - Gevorgyan Gegham,0:3,11:2 - 11:2 - 11:5 - 0:0 - 0:0,3,0,Petrosyan Davit,Gevorgyan Gegham,fiurst,Gevorgyan Gegham - Petrosyan Davit,42,9,33,24,-24,13,13,16,0,0,9,9,6,0,0,24,2:11 - 2:11 - 5:11 - 0:0 - 0:0
17530031,2024-03-17 17:30:00,Mkrtchyan Andranik - Gevorgyan Hayk,1:3,11:6 - 11:5 - 8:11 - 13:11 - 0:0,3,1,Mkrtchyan Andranik,Gevorgyan Hayk,fiurst,Gevorgyan Hayk - Mkrtchyan Andranik,76,33,43,10,-10,17,16,19,24,0,5,6,-3,2,0,10,6:11 - 5:11 - 11:8 - 11:13 - 0:0
17530025,2024-03-17 17:15:00,Avakimyan Davit - Petrosyan Davit,3:0,12:10 - 11:2 - 11:7 - 0:0 - 0:0,3,0,Avakimyan Davit,Petrosyan Davit,fiurst,Avakimyan Davit - Petrosyan Davit,53,34,19,-15,15,22,13,18,0,0,-2,-9,-4,0,0,-15,12:10 - 11:2 - 11:7 - 0:0 - 0:0
17530022,2024-03-17 17:10:00,Mkrtchyan Andranik - Gevorgyan Gegham,2:3,7:11 - 11:3 - 5:11 - 11:7 - 11:8,3,2,Mkrtchyan Andranik,Gevorgyan Gegham,fiurst,Gevorgyan Gegham - Mkrtchyan Andranik,85,40,45,5,-5,18,14,16,18,19,-4,8,-6,4,3,5,11:7 - 3:11 - 11:5 - 7:11 - 8:11
17530016,2024-03-17 17:00:00,Gevorgyan Hayk - Avakimyan Davit,0:3,11:8 - 11:5 - 11:5 - 0:0 - 0:0,3,0,Gevorgyan Hayk,Avakimyan Davit,fiurst,Avakimyan Davit - Gevorgyan Hayk,51,18,33,15,-15,19,16,16,0,0,3,6,6,0,0,15,8:11 - 5:11 - 5:11 - 0:0 - 0:0
17530015,2024-03-17 16:50:00,Petrosyan Davit - Mkrtchyan Andranik,3:1,13:11 - 8:11 - 6:11 - 5:11 - 0:0,1,3,Petrosyan Davit,Mkrtchyan Andranik,fiurst,Mkrtchyan Andranik - Petrosyan Davit,76,44,32,-12,12,24,19,17,16,0,2,-3,-5,-6,0,-12,11:13 - 11:8 - 11:6 - 11:5 - 0:0
17530014,2024-03-17 16:15:00,Gevorgyan Gegham - Avakimyan Davit,1:3,11:7 - 9:11 - 11:8 - 11:7 - 0:0,3,1,Gevorgyan Gegham,Avakimyan Davit,fiurst,Avakimyan Davit - Gevorgyan Gegham,75,33,42,9,-9,18,20,19,18,0,4,-2,3,4,0,9,7:11 - 11:9 - 8:11 - 7:11 - 0:0
17530006,2024-03-17 16:10:00,Gevorgyan Hayk - Petrosyan Davit,2:3,13:15 - 14:12 - 11:8 - 10:12 - 10:12,2,3,Gevorgyan Hayk,Petrosyan Davit,fiurst,Gevorgyan Hayk - Petrosyan Davit,117,58,59,1,-1,28,26,19,22,22,2,-2,-3,2,2,1,13:15 - 14:12 - 11:8 - 10:12 - 10:12
17529991,2024-03-17 15:45:00,Avakimyan Davit - Mkrtchyan Andranik,0:3,7:11 - 9:11 - 8:11 - 0:0 - 0:0,0,3,Avakimyan Davit,Mkrtchyan Andranik,fiurst,Avakimyan Davit - Mkrtchyan Andranik,57,24,33,9,-9,18,20,19,0,0,4,2,3,0,0,9,7:11 - 9:11 - 8:11 - 0:0 - 0:0
17529986,2024-03-17 15:30:00,Gevorgyan Gegham - Gevorgyan Hayk,2:3,13:11 - 11:8 - 8:11 - 8:11 - 5:11,2,3,Gevorgyan Gegham,Gevorgyan Hayk,fiurst,Gevorgyan Gegham - Gevorgyan Hayk,97,45,52,7,-7,24,19,19,19,16,-2,-3,3,3,6,7,13:11 - 11:8 - 8:11 - 8:11 - 5:11
17529984,2024-03-17 15:15:00,Nazaryan Mushegh - Papyan Karen,3:0,11:7 - 11:4 - 11:5 - 0:0 - 0:0,3,0,Nazaryan Mushegh,Papyan Karen,fiurst,Nazaryan Mushegh - Papyan Karen,49,33,16,-17,17,18,15,16,0,0,-4,-7,-6,0,0,-17,11:7 - 11:4 - 11:5 - 0:0 - 0:0
17529981,2024-03-17 15:00:00,Rafayelyan Edgar - Soghomonyan Hrayr,3:0,11:6 - 11:8 - 11:8 - 0:0 - 0:0,3,0,Rafayelyan Edgar,Soghomonyan Hrayr,fiurst,Rafayelyan Edgar - Soghomonyan Hrayr,55,33,22,-11,11,17,19,19,0,0,-5,-3,-3,0,0,-11,11:6 - 11:8 - 11:8 - 0:0 - 0:0
17529972,2024-03-17 14:45:00,Asatryan Murad - Nazaryan Mushegh,3:0,11:5 - 12:10 - 11:7 - 0:0 - 0:0,3,0,Asatryan Murad,Nazaryan Mushegh,fiurst,Asatryan Murad - Nazaryan Mushegh,56,34,22,-12,12,16,22,18,0,0,-6,-2,-4,0,0,-12,11:5 - 12:10 - 11:7 - 0:0 - 0:0
17529970,2024-03-17 14:30:00,Papyan Karen - Rafayelyan Edgar,1:3,7:11 - 9:11 - 12:10 - 8:11 - 0:0,1,3,Papyan Karen,Rafayelyan Edgar,fiurst,Papyan Karen - Rafayelyan Edgar,79,36,43,7,-7,18,20,22,19,0,4,2,-2,3,0,7,7:11 - 9:11 - 12:10 - 8:11 - 0:0
17529964,2024-03-17 14:15:00,Asatryan Murad - Soghomonyan Hrayr,3:1,11:8 - 11:6 - 8:11 - 11:1 - 0:0,3,1,Asatryan Murad,Soghomonyan Hrayr,fiurst,Asatryan Murad - Soghomonyan Hrayr,67,41,26,-15,15,19,17,19,12,0,-3,-5,3,-10,0,-15,11:8 - 11:6 - 8:11 - 11:1 - 0:0
17529951,2024-03-17 14:00:00,Nazaryan Mushegh - Rafayelyan Edgar,1:3,7:11 - 8:11 - 14:12 - 4:11 - 0:0,1,3,Nazaryan Mushegh,Rafayelyan Edgar,fiurst,Nazaryan Mushegh - Rafayelyan Edgar,78,33,45,12,-12,18,19,26,15,0,4,3,-2,7,0,12,7:11 - 8:11 - 14:12 - 4:11 - 0:0
17529949,2024-03-17 13:45:00,Papyan Karen - Asatryan Murad,3:1,11:9 - 5:11 - 6:11 - 2:11 - 0:0,1,3,Papyan Karen,Asatryan Murad,fiurst,Asatryan Murad - Papyan Karen,66,42,24,-18,18,20,16,17,13,0,2,-6,-5,-9,0,-18,9:11 - 11:5 - 11:6 - 11:2 - 0:0
17529943,2024-03-17 13:30:00,Soghomonyan Hrayr - Nazaryan Mushegh,3:0,7:11 - 6:11 - 9:11 - 0:0 - 0:0,0,3,Soghomonyan Hrayr,Nazaryan Mushegh,fiurst,Nazaryan Mushegh - Soghomonyan Hrayr,55,33,22,-11,11,18,17,20,0,0,-4,-5,-2,0,0,-11,11:7 - 11:6 - 11:9 - 0:0 - 0:0
17529937,2024-03-17 13:15:00,Rafayelyan Edgar - Asatryan Murad,1:3,11:7 - 4:11 - 11:9 - 11:8 - 0:0,3,1,Rafayelyan Edgar,Asatryan Murad,fiurst,Asatryan Murad - Rafayelyan Edgar,72,35,37,2,-2,18,15,20,19,0,4,-7,2,3,0,2,7:11 - 11:4 - 9:11 - 8:11 - 0:0
17529923,2024-03-17 13:00:00,Soghomonyan Hrayr - Papyan Karen,3:0,8:11 - 8:11 - 8:11 - 0:0 - 0:0,0,3,Soghomonyan Hrayr,Papyan Karen,fiurst,Papyan Karen - Soghomonyan Hrayr,57,33,24,-9,9,19,19,19,0,0,-3,-3,-3,0,0,-9,11:8 - 11:8 - 11:8 - 0:0 - 0:0
17529913,2024-03-17 12:15:00,Nazaryan Mushegh - Asatryan Murad,3:0,5:11 - 2:11 - 5:11 - 0:0 - 0:0,0,3,Nazaryan Mushegh,Asatryan Murad,fiurst,Asatryan Murad - Nazaryan Mushegh,45,33,12,-21,21,16,13,16,0,0,-6,-9,-6,0,0,-21,11:5 - 11:2 - 11:5 - 0:0 - 0:0
17529895,2024-03-17 12:00:00,Soghomonyan Hrayr - Rafayelyan Edgar,3:0,3:11 - 7:11 - 7:11 - 0:0 - 0:0,0,3,Soghomonyan Hrayr,Rafayelyan Edgar,fiurst,Rafayelyan Edgar - Soghomonyan Hrayr,50,33,17,-16,16,14,18,18,0,0,-8,-4,-4,0,0,-16,11:3 - 11:7 - 11:7 - 0:0 - 0:0
17529893,2024-03-17 11:45:00,Papyan Karen - Nazaryan Mushegh,0:3,17:15 - 11:5 - 11:8 - 0:0 - 0:0,3,0,Papyan Karen,Nazaryan Mushegh,fiurst,Nazaryan Mushegh - Papyan Karen,67,28,39,11,-11,32,16,19,0,0,2,6,3,0,0,11,15:17 - 5:11 - 8:11 - 0:0 - 0:0
17529889,2024-03-17 11:30:00,Soghomonyan Hrayr - Asatryan Murad,3:0,10:12 - 5:11 - 2:11 - 0:0 - 0:0,0,3,Soghomonyan Hrayr,Asatryan Murad,fiurst,Asatryan Murad - Soghomonyan Hrayr,51,34,17,-17,17,22,16,13,0,0,-2,-6,-9,0,0,-17,12:10 - 11:5 - 11:2 - 0:0 - 0:0
17529884,2024-03-17 11:25:00,Rafayelyan Edgar - Papyan Karen,0:3,12:10 - 11:9 - 11:9 - 0:0 - 0:0,3,0,Rafayelyan Edgar,Papyan Karen,fiurst,Papyan Karen - Rafayelyan Edgar,62,28,34,6,-6,22,20,20,0,0,2,2,2,0,0,6,10:12 - 9:11 - 9:11 - 0:0 - 0:0
17529881,2024-03-17 11:05:00,Nazaryan Mushegh - Soghomonyan Hrayr,3:0,11:6 - 11:7 - 11:9 - 0:0 - 0:0,3,0,Nazaryan Mushegh,Soghomonyan Hrayr,fiurst,Nazaryan Mushegh - Soghomonyan Hrayr,55,33,22,-11,11,17,18,20,0,0,-5,-4,-2,0,0,-11,11:6 - 11:7 - 11:9 - 0:0 - 0:0
17529870,2024-03-17 10:45:00,Asatryan Murad - Papyan Karen,2:3,9:11 - 11:8 - 11:9 - 8:11 - 8:11,2,3,Asatryan Murad,Papyan Karen,fiurst,Asatryan Murad - Papyan Karen,97,47,50,3,-3,20,19,20,19,19,2,-3,-2,3,3,3,9:11 - 11:8 - 11:9 - 8:11 - 8:11
17529855,2024-03-17 10:30:00,Rafayelyan Edgar - Nazaryan Mushegh,3:2,9:11 - 11:7 - 15:13 - 4:11 - 12:14,2,3,Rafayelyan Edgar,Nazaryan Mushegh,fiurst,Nazaryan Mushegh - Rafayelyan Edgar,107,56,51,-5,5,20,18,28,15,26,-2,4,2,-7,-2,-5,11:9 - 7:11 - 13:15 - 11:4 - 14:12
17529847,2024-03-17 10:15:00,Papyan Karen - Soghomonyan Hrayr,3:0,11:6 - 12:10 - 11:5 - 0:0 - 0:0,3,0,Papyan Karen,Soghomonyan Hrayr,fiurst,Papyan Karen - Soghomonyan Hrayr,55,34,21,-13,13,17,22,16,0,0,-5,-2,-6,0,0,-13,11:6 - 12:10 - 11:5 - 0:0 - 0:0
17529846,2024-03-17 10:00:00,Asatryan Murad - Rafayelyan Edgar,0:3,9:11 - 4:11 - 6:11 - 0:0 - 0:0,0,3,Asatryan Murad,Rafayelyan Edgar,fiurst,Asatryan Murad - Rafayelyan Edgar,52,19,33,14,-14,20,15,17,0,0,2,7,5,0,0,14,9:11 - 4:11 - 6:11 - 0:0 - 0:0
17509430,2024-03-16 17:45:00,Mkrtchyan Andranik - Arutyunov Ruben,3:1,11:8 - 1:11 - 4:11 - 8:11 - 0:0,1,3,Mkrtchyan Andranik,Arutyunov Ruben,fiurst,Arutyunov Ruben - Mkrtchyan Andranik,65,41,24,-17,17,19,12,15,19,0,3,-10,-7,-3,0,-17,8:11 - 11:1 - 11:4 - 11:8 - 0:0
17509420,2024-03-16 17:30:00,Avakimyan Davit - Gevorgyan Gegham,3:0,11:7 - 12:10 - 11:4 - 0:0 - 0:0,3,0,Avakimyan Davit,Gevorgyan Gegham,fiurst,Avakimyan Davit - Gevorgyan Gegham,55,34,21,-13,13,18,22,15,0,0,-4,-2,-7,0,0,-13,11:7 - 12:10 - 11:4 - 0:0 - 0:0
17509414,2024-03-16 17:25:00,Gevorgyan Hayk - Mkrtchyan Andranik,0:3,9:11 - 8:11 - 5:11 - 0:0 - 0:0,0,3,Gevorgyan Hayk,Mkrtchyan Andranik,fiurst,Gevorgyan Hayk - Mkrtchyan Andranik,55,22,33,11,-11,20,19,16,0,0,2,3,6,0,0,11,9:11 - 8:11 - 5:11 - 0:0 - 0:0
17509406,2024-03-16 17:00:00,Avakimyan Davit - Arutyunov Ruben,3:0,7:11 - 5:11 - 8:11 - 0:0 - 0:0,0,3,Avakimyan Davit,Arutyunov Ruben,fiurst,Arutyunov Ruben - Avakimyan Davit,53,33,20,-13,13,18,16,19,0,0,-4,-6,-3,0,0,-13,11:7 - 11:5 - 11:8 - 0:0 - 0:0
17509401,2024-03-16 16:50:00,Gevorgyan Gegham - Gevorgyan Hayk,1:3,11:7 - 7:11 - 7:11 - 3:11 - 0:0,1,3,Gevorgyan Gegham,Gevorgyan Hayk,fiurst,Gevorgyan Gegham - Gevorgyan Hayk,68,28,40,12,-12,18,18,18,14,0,-4,4,4,8,0,12,11:7 - 7:11 - 7:11 - 3:11 - 0:0
17509399,2024-03-16 16:35:00,Mkrtchyan Andranik - Avakimyan Davit,0:3,11:9 - 11:7 - 11:9 - 0:0 - 0:0,3,0,Mkrtchyan Andranik,Avakimyan Davit,fiurst,Avakimyan Davit - Mkrtchyan Andranik,58,25,33,8,-8,20,18,20,0,0,2,4,2,0,0,8,9:11 - 7:11 - 9:11 - 0:0 - 0:0
17509385,2024-03-16 16:15:00,Arutyunov Ruben - Gevorgyan Hayk,3:1,8:11 - 12:10 - 11:4 - 11:7 - 0:0,3,1,Arutyunov Ruben,Gevorgyan Hayk,fiurst,Arutyunov Ruben - Gevorgyan Hayk,74,42,32,-10,10,19,22,15,18,0,3,-2,-7,-4,0,-10,8:11 - 12:10 - 11:4 - 11:7 - 0:0
17509340,2024-03-16 16:00:00,Gevorgyan Gegham - Mkrtchyan Andranik,2:3,11:3 - 4:11 - 9:11 - 11:8 - 8:11,2,3,Gevorgyan Gegham,Mkrtchyan Andranik,fiurst,Gevorgyan Gegham - Mkrtchyan Andranik,87,43,44,1,-1,14,15,20,19,19,-8,7,2,-3,3,1,11:3 - 4:11 - 9:11 - 11:8 - 8:11
17509338,2024-03-16 15:45:00,Gevorgyan Hayk - Avakimyan Davit,0:3,11:3 - 14:12 - 13:11 - 0:0 - 0:0,3,0,Gevorgyan Hayk,Avakimyan Davit,fiurst,Avakimyan Davit - Gevorgyan Hayk,64,26,38,12,-12,14,26,24,0,0,8,2,2,0,0,12,3:11 - 12:14 - 11:13 - 0:0 - 0:0
17509319,2024-03-16 15:30:00,Nikoghosyan Narek - Soghomonyan Hrayr,3:0,11:8 - 12:10 - 11:6 - 0:0 - 0:0,3,0,Nikoghosyan Narek,Soghomonyan Hrayr,fiurst,Nikoghosyan Narek - Soghomonyan Hrayr,58,34,24,-10,10,19,22,17,0,0,-3,-2,-5,0,0,-10,11:8 - 12:10 - 11:6 - 0:0 - 0:0
17509324,2024-03-16 15:30:00,Arutyunov Ruben - Gevorgyan Gegham,3:0,11:5 - 11:5 - 11:4 - 0:0 - 0:0,3,0,Arutyunov Ruben,Gevorgyan Gegham,fiurst,Arutyunov Ruben - Gevorgyan Gegham,47,33,14,-19,19,16,16,15,0,0,-6,-6,-7,0,0,-19,11:5 - 11:5 - 11:4 - 0:0 - 0:0
17509317,2024-03-16 15:00:00,Nazaryan Mushegh - Papyan Karen,3:0,11:9 - 11:8 - 11:6 - 0:0 - 0:0,3,0,Nazaryan Mushegh,Papyan Karen,fiurst,Nazaryan Mushegh - Papyan Karen,56,33,23,-10,10,20,19,17,0,0,-2,-3,-5,0,0,-10,11:9 - 11:8 - 11:6 - 0:0 - 0:0
17509312,2024-03-16 14:45:00,Rafayelyan Edgar - Nikoghosyan Narek,2:3,11:7 - 12:14 - 9:11 - 18:16 - 13:11,3,2,Rafayelyan Edgar,Nikoghosyan Narek,fiurst,Nikoghosyan Narek - Rafayelyan Edgar,122,59,63,4,-4,18,26,20,34,24,4,-2,-2,2,2,4,7:11 - 14:12 - 11:9 - 16:18 - 11:13
17509310,2024-03-16 14:35:00,Soghomonyan Hrayr - Nazaryan Mushegh,3:2,10:12 - 11:8 - 12:10 - 5:11 - 6:11,2,3,Soghomonyan Hrayr,Nazaryan Mushegh,fiurst,Nazaryan Mushegh - Soghomonyan Hrayr,96,52,44,-8,8,22,19,22,16,17,-2,3,2,-6,-5,-8,12:10 - 8:11 - 10:12 - 11:5 - 11:6
17509309,2024-03-16 14:15:00,Rafayelyan Edgar - Papyan Karen,1:3,11:4 - 12:10 - 10:12 - 11:7 - 0:0,3,1,Rafayelyan Edgar,Papyan Karen,fiurst,Papyan Karen - Rafayelyan Edgar,77,33,44,11,-11,15,22,22,18,0,7,2,-2,4,0,11,4:11 - 10:12 - 12:10 - 7:11 - 0:0
17509297,2024-03-16 14:05:00,Nikoghosyan Narek - Nazaryan Mushegh,3:1,11:6 - 3:11 - 6:11 - 7:11 - 0:0,1,3,Nikoghosyan Narek,Nazaryan Mushegh,fiurst,Nazaryan Mushegh - Nikoghosyan Narek,66,39,27,-12,12,17,14,17,18,0,5,-8,-5,-4,0,-12,6:11 - 11:3 - 11:6 - 11:7 - 0:0
17509291,2024-03-16 13:45:00,Soghomonyan Hrayr - Rafayelyan Edgar,3:0,5:11 - 8:11 - 9:11 - 0:0 - 0:0,0,3,Soghomonyan Hrayr,Rafayelyan Edgar,fiurst,Rafayelyan Edgar - Soghomonyan Hrayr,55,33,22,-11,11,16,19,20,0,0,-6,-3,-2,0,0,-11,11:5 - 11:8 - 11:9 - 0:0 - 0:0
17509288,2024-03-16 13:30:00,Papyan Karen - Nikoghosyan Narek,3:0,6:11 - 8:11 - 10:12 - 0:0 - 0:0,0,3,Papyan Karen,Nikoghosyan Narek,fiurst,Nikoghosyan Narek - Papyan Karen,58,34,24,-10,10,17,19,22,0,0,-5,-3,-2,0,0,-10,11:6 - 11:8 - 12:10 - 0:0 - 0:0
17509264,2024-03-16 13:15:00,Nazaryan Mushegh - Rafayelyan Edgar,2:3,11:9 - 6:11 - 11:9 - 4:11 - 5:11,2,3,Nazaryan Mushegh,Rafayelyan Edgar,fiurst,Nazaryan Mushegh - Rafayelyan Edgar,88,37,51,14,-14,20,17,20,15,16,-2,5,-2,7,6,14,11:9 - 6:11 - 11:9 - 4:11 - 5:11
17509255,2024-03-16 13:00:00,Papyan Karen - Soghomonyan Hrayr,3:2,11:9 - 2:11 - 13:11 - 10:12 - 12:10,3,2,Papyan Karen,Soghomonyan Hrayr,fiurst,Papyan Karen - Soghomonyan Hrayr,101,48,53,5,-5,20,13,24,22,22,-2,9,-2,2,-2,5,11:9 - 2:11 - 13:11 - 10:12 - 12:10
17509154,2024-03-16 12:15:00,Nikoghosyan Narek - Rafayelyan Edgar,0:3,9:11 - 4:11 - 10:12 - 0:0 - 0:0,0,3,Nikoghosyan Narek,Rafayelyan Edgar,fiurst,Nikoghosyan Narek - Rafayelyan Edgar,57,23,34,11,-11,20,15,22,0,0,2,7,2,0,0,11,9:11 - 4:11 - 10:12 - 0:0 - 0:0
17509152,2024-03-16 12:00:00,Papyan Karen - Nazaryan Mushegh,1:3,11:9 - 11:5 - 4:11 - 11:5 - 0:0,3,1,Papyan Karen,Nazaryan Mushegh,fiurst,Nazaryan Mushegh - Papyan Karen,67,30,37,7,-7,20,16,15,16,0,2,6,-7,6,0,7,9:11 - 5:11 - 11:4 - 5:11 - 0:0
17509151,2024-03-16 11:45:00,Soghomonyan Hrayr - Nikoghosyan Narek,3:0,9:11 - 7:11 - 5:11 - 0:0 - 0:0,0,3,Soghomonyan Hrayr,Nikoghosyan Narek,fiurst,Nikoghosyan Narek - Soghomonyan Hrayr,54,33,21,-12,12,20,18,16,0,0,-2,-4,-6,0,0,-12,11:9 - 11:7 - 11:5 - 0:0 - 0:0
17509117,2024-03-16 11:30:00,Papyan Karen - Rafayelyan Edgar,2:3,11:9 - 8:11 - 5:11 - 11:7 - 6:11,2,3,Papyan Karen,Rafayelyan Edgar,fiurst,Papyan Karen - Rafayelyan Edgar,90,41,49,8,-8,20,19,16,18,17,-2,3,6,-4,5,8,11:9 - 8:11 - 5:11 - 11:7 - 6:11
17509115,2024-03-16 11:15:00,Nazaryan Mushegh - Soghomonyan Hrayr,3:0,11:9 - 11:9 - 11:9 - 0:0 - 0:0,3,0,Nazaryan Mushegh,Soghomonyan Hrayr,fiurst,Nazaryan Mushegh - Soghomonyan Hrayr,60,33,27,-6,6,20,20,20,0,0,-2,-2,-2,0,0,-6,11:9 - 11:9 - 11:9 - 0:0 - 0:0
17509111,2024-03-16 11:05:00,Nikoghosyan Narek - Papyan Karen,3:0,11:8 - 11:5 - 11:7 - 0:0 - 0:0,3,0,Nikoghosyan Narek,Papyan Karen,fiurst,Nikoghosyan Narek - Papyan Karen,53,33,20,-13,13,19,16,18,0,0,-3,-6,-4,0,0,-13,11:8 - 11:5 - 11:7 - 0:0 - 0:0
17509069,2024-03-16 10:45:00,Rafayelyan Edgar - Soghomonyan Hrayr,3:1,11:6 - 11:2 - 7:11 - 11:8 - 0:0,3,1,Rafayelyan Edgar,Soghomonyan Hrayr,fiurst,Rafayelyan Edgar - Soghomonyan Hrayr,67,40,27,-13,13,17,13,18,19,0,-5,-9,4,-3,0,-13,11:6 - 11:2 - 7:11 - 11:8 - 0:0
17509065,2024-03-16 10:30:00,Nazaryan Mushegh - Nikoghosyan Narek,1:3,9:11 - 3:11 - 11:8 - 6:11 - 0:0,1,3,Nazaryan Mushegh,Nikoghosyan Narek,fiurst,Nazaryan Mushegh - Nikoghosyan Narek,70,29,41,12,-12,20,14,19,17,0,2,8,-3,5,0,12,9:11 - 3:11 - 11:8 - 6:11 - 0:0
17509030,2024-03-16 10:15:00,Soghomonyan Hrayr - Papyan Karen,1:3,8:11 - 11:6 - 11:7 - 11:9 - 0:0,3,1,Soghomonyan Hrayr,Papyan Karen,fiurst,Papyan Karen - Soghomonyan Hrayr,74,33,41,8,-8,19,17,18,20,0,-3,5,4,2,0,8,11:8 - 6:11 - 7:11 - 9:11 - 0:0
17509026,2024-03-16 10:00:00,Rafayelyan Edgar - Nazaryan Mushegh,0:3,11:5 - 11:5 - 15:13 - 0:0 - 0:0,3,0,Rafayelyan Edgar,Nazaryan Mushegh,fiurst,Nazaryan Mushegh - Rafayelyan Edgar,60,23,37,14,-14,16,16,28,0,0,6,6,2,0,0,14,5:11 - 5:11 - 13:15 - 0:0 - 0:0
17482679,2024-03-15 17:45:00,Petrosyan Davit - Avakimyan Davit,1:3,11:8 - 12:10 - 15:17 - 12:10 - 0:0,3,1,Petrosyan Davit,Avakimyan Davit,fiurst,Avakimyan Davit - Petrosyan Davit,95,45,50,5,-5,19,22,32,22,0,3,2,-2,2,0,5,8:11 - 10:12 - 17:15 - 10:12 - 0:0
17482678,2024-03-15 17:30:00,Arutyunov Ruben - Karakhanyan Mher,3:0,11:8 - 11:5 - 11:5 - 0:0 - 0:0,3,0,Arutyunov Ruben,Karakhanyan Mher,fiurst,Arutyunov Ruben - Karakhanyan Mher,51,33,18,-15,15,19,16,16,0,0,-3,-6,-6,0,0,-15,11:8 - 11:5 - 11:5 - 0:0 - 0:0
17482676,2024-03-15 17:15:00,Gevorgyan Gegham - Petrosyan Davit,3:0,11:7 - 11:7 - 11:6 - 0:0 - 0:0,3,0,Gevorgyan Gegham,Petrosyan Davit,fiurst,Gevorgyan Gegham - Petrosyan Davit,53,33,20,-13,13,18,18,17,0,0,-4,-4,-5,0,0,-13,11:7 - 11:7 - 11:6 - 0:0 - 0:0
17482671,2024-03-15 17:00:00,Arutyunov Ruben - Avakimyan Davit,3:0,11:1 - 11:4 - 11:2 - 0:0 - 0:0,3,0,Arutyunov Ruben,Avakimyan Davit,fiurst,Arutyunov Ruben - Avakimyan Davit,40,33,7,-26,26,12,15,13,0,0,-10,-7,-9,0,0,-26,11:1 - 11:4 - 11:2 - 0:0 - 0:0
17482667,2024-03-15 16:50:00,Karakhanyan Mher - Gevorgyan Gegham,3:0,7:11 - 9:11 - 6:11 - 0:0 - 0:0,0,3,Karakhanyan Mher,Gevorgyan Gegham,fiurst,Gevorgyan Gegham - Karakhanyan Mher,55,33,22,-11,11,18,20,17,0,0,-4,-2,-5,0,0,-11,11:7 - 11:9 - 11:6 - 0:0 - 0:0
17482665,2024-03-15 16:30:00,Petrosyan Davit - Arutyunov Ruben,3:0,9:11 - 2:11 - 4:11 - 0:0 - 0:0,0,3,Petrosyan Davit,Arutyunov Ruben,fiurst,Arutyunov Ruben - Petrosyan Davit,48,33,15,-18,18,20,13,15,0,0,-2,-9,-7,0,0,-18,11:9 - 11:2 - 11:4 - 0:0 - 0:0
17482650,2024-03-15 16:15:00,Avakimyan Davit - Gevorgyan Gegham,3:2,5:11 - 8:11 - 11:4 - 11:9 - 11:8,3,2,Avakimyan Davit,Gevorgyan Gegham,fiurst,Avakimyan Davit - Gevorgyan Gegham,89,46,43,-3,3,16,19,15,20,19,6,3,-7,-2,-3,-3,5:11 - 8:11 - 11:4 - 11:9 - 11:8
17482639,2024-03-15 16:00:00,Karakhanyan Mher - Petrosyan Davit,0:3,6:11 - 4:11 - 8:11 - 0:0 - 0:0,0,3,Karakhanyan Mher,Petrosyan Davit,fiurst,Karakhanyan Mher - Petrosyan Davit,51,18,33,15,-15,17,15,19,0,0,5,7,3,0,0,15,6:11 - 4:11 - 8:11 - 0:0 - 0:0
17482616,2024-03-15 15:45:00,Gevorgyan Gegham - Arutyunov Ruben,3:0,8:11 - 8:11 - 6:11 - 0:0 - 0:0,0,3,Gevorgyan Gegham,Arutyunov Ruben,fiurst,Arutyunov Ruben - Gevorgyan Gegham,55,33,22,-11,11,19,19,17,0,0,-3,-3,-5,0,0,-11,11:8 - 11:8 - 11:6 - 0:0 - 0:0
17482611,2024-03-15 15:30:00,Avakimyan Davit - Karakhanyan Mher,3:0,11:5 - 11:9 - 11:9 - 0:0 - 0:0,3,0,Avakimyan Davit,Karakhanyan Mher,fiurst,Avakimyan Davit - Karakhanyan Mher,56,33,23,-10,10,16,20,20,0,0,-6,-2,-2,0,0,-10,11:5 - 11:9 - 11:9 - 0:0 - 0:0
17482608,2024-03-15 15:15:00,Nazaryan Mushegh - Papyan Karen,1:3,11:7 - 10:12 - 10:12 - 9:11 - 0:0,1,3,Nazaryan Mushegh,Papyan Karen,fiurst,Nazaryan Mushegh - Papyan Karen,82,40,42,2,-2,18,22,22,20,0,-4,2,2,2,0,2,11:7 - 10:12 - 10:12 - 9:11 - 0:0
17482589,2024-03-15 15:00:00,Hovhannesyan Rafik - Nikoghosyan Narek,1:3,11:13 - 11:8 - 5:11 - 2:11 - 0:0,1,3,Hovhannesyan Rafik,Nikoghosyan Narek,fiurst,Hovhannesyan Rafik - Nikoghosyan Narek,72,29,43,14,-14,24,19,16,13,0,2,-3,6,9,0,14,11:13 - 11:8 - 5:11 - 2:11 - 0:0
17482577,2024-03-15 14:45:00,Rafayelyan Edgar - Nazaryan Mushegh,1:3,11:9 - 11:7 - 7:11 - 11:6 - 0:0,3,1,Rafayelyan Edgar,Nazaryan Mushegh,fiurst,Nazaryan Mushegh - Rafayelyan Edgar,73,33,40,7,-7,20,18,18,17,0,2,4,-4,5,0,7,9:11 - 7:11 - 11:7 - 6:11 - 0:0
17482574,2024-03-15 14:40:00,Papyan Karen - Hovhannesyan Rafik,3:0,9:11 - 7:11 - 5:11 - 0:0 - 0:0,0,3,Papyan Karen,Hovhannesyan Rafik,fiurst,Hovhannesyan Rafik - Papyan Karen,54,33,21,-12,12,20,18,16,0,0,-2,-4,-6,0,0,-12,11:9 - 11:7 - 11:5 - 0:0 - 0:0
17482573,2024-03-15 14:15:00,Rafayelyan Edgar - Nikoghosyan Narek,0:3,11:4 - 13:11 - 11:3 - 0:0 - 0:0,3,0,Rafayelyan Edgar,Nikoghosyan Narek,fiurst,Nikoghosyan Narek - Rafayelyan Edgar,53,18,35,17,-17,15,24,14,0,0,7,2,8,0,0,17,4:11 - 11:13 - 3:11 - 0:0 - 0:0
17482571,2024-03-15 14:10:00,Nazaryan Mushegh - Hovhannesyan Rafik,1:3,13:11 - 11:7 - 7:11 - 11:7 - 0:0,3,1,Nazaryan Mushegh,Hovhannesyan Rafik,fiurst,Hovhannesyan Rafik - Nazaryan Mushegh,78,36,42,6,-6,24,18,18,18,0,2,4,-4,4,0,6,11:13 - 7:11 - 11:7 - 7:11 - 0:0
17482568,2024-03-15 13:45:00,Papyan Karen - Rafayelyan Edgar,0:3,6:11 - 6:11 - 7:11 - 0:0 - 0:0,0,3,Papyan Karen,Rafayelyan Edgar,fiurst,Papyan Karen - Rafayelyan Edgar,52,19,33,14,-14,17,17,18,0,0,5,5,4,0,0,14,6:11 - 6:11 - 7:11 - 0:0 - 0:0
17482567,2024-03-15 13:30:00,Nikoghosyan Narek - Nazaryan Mushegh,2:3,9:11 - 12:10 - 11:3 - 3:11 - 11:4,3,2,Nikoghosyan Narek,Nazaryan Mushegh,fiurst,Nazaryan Mushegh - Nikoghosyan Narek,85,39,46,7,-7,20,22,14,14,15,-2,2,8,-8,7,7,11:9 - 10:12 - 3:11 - 11:3 - 4:11
17482565,2024-03-15 13:15:00,Hovhannesyan Rafik - Rafayelyan Edgar,0:3,5:11 - 12:14 - 8:11 - 0:0 - 0:0,0,3,Hovhannesyan Rafik,Rafayelyan Edgar,fiurst,Hovhannesyan Rafik - Rafayelyan Edgar,61,25,36,11,-11,16,26,19,0,0,6,2,3,0,0,11,5:11 - 12:14 - 8:11 - 0:0 - 0:0
17482554,2024-03-15 13:00:00,Nikoghosyan Narek - Papyan Karen,3:1,11:2 - 11:3 - 8:11 - 11:6 - 0:0,3,1,Nikoghosyan Narek,Papyan Karen,fiurst,Nikoghosyan Narek - Papyan Karen,63,41,22,-19,19,13,14,19,17,0,-9,-8,3,-5,0,-19,11:2 - 11:3 - 8:11 - 11:6 - 0:0
17482550,2024-03-15 12:15:00,Nazaryan Mushegh - Rafayelyan Edgar,0:3,7:11 - 4:11 - 7:11 - 0:0 - 0:0,0,3,Nazaryan Mushegh,Rafayelyan Edgar,fiurst,Nazaryan Mushegh - Rafayelyan Edgar,51,18,33,15,-15,18,15,18,0,0,4,7,4,0,0,15,7:11 - 4:11 - 7:11 - 0:0 - 0:0
17482548,2024-03-15 12:10:00,Nikoghosyan Narek - Hovhannesyan Rafik,0:3,11:5 - 13:11 - 11:6 - 0:0 - 0:0,3,0,Nikoghosyan Narek,Hovhannesyan Rafik,fiurst,Hovhannesyan Rafik - Nikoghosyan Narek,57,22,35,13,-13,16,24,17,0,0,6,2,5,0,0,13,5:11 - 11:13 - 6:11 - 0:0 - 0:0
17482538,2024-03-15 11:45:00,Papyan Karen - Nazaryan Mushegh,3:1,3:11 - 11:6 - 5:11 - 3:11 - 0:0,1,3,Papyan Karen,Nazaryan Mushegh,fiurst,Nazaryan Mushegh - Papyan Karen,61,39,22,-17,17,14,17,16,14,0,-8,5,-6,-8,0,-17,11:3 - 6:11 - 11:5 - 11:3 - 0:0
17482537,2024-03-15 11:35:00,Nikoghosyan Narek - Rafayelyan Edgar,3:2,11:6 - 6:11 - 11:2 - 5:11 - 11:4,3,2,Nikoghosyan Narek,Rafayelyan Edgar,fiurst,Nikoghosyan Narek - Rafayelyan Edgar,78,44,34,-10,10,17,17,13,16,15,-5,5,-9,6,-7,-10,11:6 - 6:11 - 11:2 - 5:11 - 11:4
17482535,2024-03-15 11:20:00,Hovhannesyan Rafik - Papyan Karen,1:3,6:11 - 6:11 - 11:9 - 8:11 - 0:0,1,3,Hovhannesyan Rafik,Papyan Karen,fiurst,Hovhannesyan Rafik - Papyan Karen,73,31,42,11,-11,17,17,20,19,0,5,5,-2,3,0,11,6:11 - 6:11 - 11:9 - 8:11 - 0:0
17482524,2024-03-15 11:00:00,Nazaryan Mushegh - Nikoghosyan Narek,1:3,9:11 - 7:11 - 12:10 - 6:11 - 0:0,1,3,Nazaryan Mushegh,Nikoghosyan Narek,fiurst,Nazaryan Mushegh - Nikoghosyan Narek,77,34,43,9,-9,20,18,22,17,0,2,4,-2,5,0,9,9:11 - 7:11 - 12:10 - 6:11 - 0:0
17482523,2024-03-15 10:50:00,Rafayelyan Edgar - Papyan Karen,0:3,11:7 - 11:7 - 11:7 - 0:0 - 0:0,3,0,Rafayelyan Edgar,Papyan Karen,fiurst,Papyan Karen - Rafayelyan Edgar,54,21,33,12,-12,18,18,18,0,0,4,4,4,0,0,12,7:11 - 7:11 - 7:11 - 0:0 - 0:0
17482522,2024-03-15 10:35:00,Hovhannesyan Rafik - Nazaryan Mushegh,3:1,11:6 - 11:7 - 5:11 - 11:6 - 0:0,3,1,Hovhannesyan Rafik,Nazaryan Mushegh,fiurst,Hovhannesyan Rafik - Nazaryan Mushegh,68,38,30,-8,8,17,18,16,17,0,-5,-4,6,-5,0,-8,11:6 - 11:7 - 5:11 - 11:6 - 0:0
17482521,2024-03-15 10:15:00,Papyan Karen - Nikoghosyan Narek,2:3,12:10 - 7:11 - 8:11 - 11:5 - 11:9,3,2,Papyan Karen,Nikoghosyan Narek,fiurst,Nikoghosyan Narek - Papyan Karen,95,46,49,3,-3,22,18,19,16,20,2,-4,-3,6,2,3,10:12 - 11:7 - 11:8 - 5:11 - 9:11
17482518,2024-03-15 10:00:00,Rafayelyan Edgar - Hovhannesyan Rafik,0:3,11:1 - 11:9 - 14:12 - 0:0 - 0:0,3,0,Rafayelyan Edgar,Hovhannesyan Rafik,fiurst,Hovhannesyan Rafik - Rafayelyan Edgar,58,22,36,14,-14,12,20,26,0,0,10,2,2,0,0,14,1:11 - 9:11 - 12:14 - 0:0 - 0:0
17463340,2024-03-14 17:45:00,Karakhanyan Mher - Gevorgyan Hayk,3:1,12:10 - 4:11 - 5:11 - 7:11 - 0:0,1,3,Karakhanyan Mher,Gevorgyan Hayk,fiurst,Gevorgyan Hayk - Karakhanyan Mher,71,43,28,-15,15,22,15,16,18,0,2,-7,-6,-4,0,-15,10:12 - 11:4 - 11:5 - 11:7 - 0:0
17463333,2024-03-14 17:30:00,Arutyunov Ruben - Petrosyan Davit,3:1,11:6 - 12:14 - 12:10 - 11:8 - 0:0,3,1,Arutyunov Ruben,Petrosyan Davit,fiurst,Arutyunov Ruben - Petrosyan Davit,84,46,38,-8,8,17,26,22,19,0,-5,2,-2,-3,0,-8,11:6 - 12:14 - 12:10 - 11:8 - 0:0
17463331,2024-03-14 17:15:00,Avakimyan Davit - Karakhanyan Mher,3:1,12:10 - 11:4 - 9:11 - 11:5 - 0:0,3,1,Avakimyan Davit,Karakhanyan Mher,fiurst,Avakimyan Davit - Karakhanyan Mher,73,43,30,-13,13,22,15,20,16,0,-2,-7,2,-6,0,-13,12:10 - 11:4 - 9:11 - 11:5 - 0:0
17463327,2024-03-14 17:00:00,Arutyunov Ruben - Gevorgyan Hayk,3:0,11:7 - 11:7 - 11:9 - 0:0 - 0:0,3,0,Arutyunov Ruben,Gevorgyan Hayk,fiurst,Arutyunov Ruben - Gevorgyan Hayk,56,33,23,-10,10,18,18,20,0,0,-4,-4,-2,0,0,-10,11:7 - 11:7 - 11:9 - 0:0 - 0:0
17463326,2024-03-14 16:45:00,Petrosyan Davit - Avakimyan Davit,3:0,10:12 - 6:11 - 9:11 - 0:0 - 0:0,0,3,Petrosyan Davit,Avakimyan Davit,fiurst,Avakimyan Davit - Petrosyan Davit,59,34,25,-9,9,22,17,20,0,0,-2,-5,-2,0,0,-9,12:10 - 11:6 - 11:9 - 0:0 - 0:0
17463320,2024-03-14 16:30:00,Karakhanyan Mher - Arutyunov Ruben,3:0,4:11 - 8:11 - 5:11 - 0:0 - 0:0,0,3,Karakhanyan Mher,Arutyunov Ruben,fiurst,Arutyunov Ruben - Karakhanyan Mher,50,33,17,-16,16,15,19,16,0,0,-7,-3,-6,0,0,-16,11:4 - 11:8 - 11:5 - 0:0 - 0:0
17463319,2024-03-14 16:15:00,Gevorgyan Hayk - Avakimyan Davit,2:3,13:11 - 8:11 - 12:14 - 13:11 - 11:2,3,2,Gevorgyan Hayk,Avakimyan Davit,fiurst,Avakimyan Davit - Gevorgyan Hayk,106,49,57,8,-8,24,19,26,24,13,2,-3,-2,2,9,8,11:13 - 11:8 - 14:12 - 11:13 - 2:11
17463317,2024-03-14 16:00:00,Petrosyan Davit - Karakhanyan Mher,0:3,11:7 - 11:4 - 11:8 - 0:0 - 0:0,3,0,Petrosyan Davit,Karakhanyan Mher,fiurst,Karakhanyan Mher - Petrosyan Davit,52,19,33,14,-14,18,15,19,0,0,4,7,3,0,0,14,7:11 - 4:11 - 8:11 - 0:0 - 0:0
17463315,2024-03-14 15:45:00,Avakimyan Davit - Arutyunov Ruben,3:0,5:11 - 3:11 - 5:11 - 0:0 - 0:0,0,3,Avakimyan Davit,Arutyunov Ruben,fiurst,Arutyunov Ruben - Avakimyan Davit,46,33,13,-20,20,16,14,16,0,0,-6,-8,-6,0,0,-20,11:5 - 11:3 - 11:5 - 0:0 - 0:0
17463314,2024-03-14 15:30:00,Gevorgyan Hayk - Petrosyan Davit,3:2,9:11 - 11:5 - 11:6 - 4:11 - 11:4,3,2,Gevorgyan Hayk,Petrosyan Davit,fiurst,Gevorgyan Hayk - Petrosyan Davit,83,46,37,-9,9,20,16,17,15,15,2,-6,-5,7,-7,-9,9:11 - 11:5 - 11:6 - 4:11 - 11:4
17463305,2024-03-14 15:15:00,Nikoghosyan Narek - Asatryan Murad,3:2,11:9 - 11:5 - 3:11 - 7:11 - 5:11,2,3,Nikoghosyan Narek,Asatryan Murad,fiurst,Asatryan Murad - Nikoghosyan Narek,84,47,37,-10,10,20,16,14,18,16,2,6,-8,-4,-6,-10,9:11 - 5:11 - 11:3 - 11:7 - 11:5
17463300,2024-03-14 15:05:00,Papyan Karen - Rafayelyan Edgar,1:3,11:7 - 8:11 - 4:11 - 10:12 - 0:0,1,3,Papyan Karen,Rafayelyan Edgar,fiurst,Papyan Karen - Rafayelyan Edgar,74,33,41,8,-8,18,19,15,22,0,-4,3,7,2,0,8,11:7 - 8:11 - 4:11 - 10:12 - 0:0
17463296,2024-03-14 14:45:00,Soghomonyan Hrayr - Nikoghosyan Narek,3:0,9:11 - 8:11 - 6:11 - 0:0 - 0:0,0,3,Soghomonyan Hrayr,Nikoghosyan Narek,fiurst,Nikoghosyan Narek - Soghomonyan Hrayr,56,33,23,-10,10,20,19,17,0,0,-2,-3,-5,0,0,-10,11:9 - 11:8 - 11:6 - 0:0 - 0:0
17463293,2024-03-14 14:30:00,Asatryan Murad - Papyan Karen,3:1,7:11 - 11:5 - 11:6 - 11:6 - 0:0,3,1,Asatryan Murad,Papyan Karen,fiurst,Asatryan Murad - Papyan Karen,68,40,28,-12,12,18,16,17,17,0,4,-6,-5,-5,0,-12,7:11 - 11:5 - 11:6 - 11:6 - 0:0
17463290,2024-03-14 14:15:00,Soghomonyan Hrayr - Rafayelyan Edgar,3:0,5:11 - 7:11 - 6:11 - 0:0 - 0:0,0,3,Soghomonyan Hrayr,Rafayelyan Edgar,fiurst,Rafayelyan Edgar - Soghomonyan Hrayr,51,33,18,-15,15,16,18,17,0,0,-6,-4,-5,0,0,-15,11:5 - 11:7 - 11:6 - 0:0 - 0:0
17463288,2024-03-14 14:05:00,Nikoghosyan Narek - Papyan Karen,3:1,11:7 - 11:3 - 10:12 - 12:10 - 0:0,3,1,Nikoghosyan Narek,Papyan Karen,fiurst,Nikoghosyan Narek - Papyan Karen,76,44,32,-12,12,18,14,22,22,0,-4,-8,2,-2,0,-12,11:7 - 11:3 - 10:12 - 12:10 - 0:0
17463287,2024-03-14 13:45:00,Asatryan Murad - Soghomonyan Hrayr,3:0,12:10 - 11:9 - 12:10 - 0:0 - 0:0,3,0,Asatryan Murad,Soghomonyan Hrayr,fiurst,Asatryan Murad - Soghomonyan Hrayr,64,35,29,-6,6,22,20,22,0,0,-2,-2,-2,0,0,-6,12:10 - 11:9 - 12:10 - 0:0 - 0:0
17463283,2024-03-14 13:40:00,Rafayelyan Edgar - Nikoghosyan Narek,1:3,12:10 - 11:9 - 7:11 - 11:7 - 0:0,3,1,Rafayelyan Edgar,Nikoghosyan Narek,fiurst,Nikoghosyan Narek - Rafayelyan Edgar,78,37,41,4,-4,22,20,18,18,0,2,2,-4,4,0,4,10:12 - 9:11 - 11:7 - 7:11 - 0:0
17463270,2024-03-14 13:15:00,Papyan Karen - Soghomonyan Hrayr,3:0,12:10 - 11:7 - 12:10 - 0:0 - 0:0,3,0,Papyan Karen,Soghomonyan Hrayr,fiurst,Papyan Karen - Soghomonyan Hrayr,62,35,27,-8,8,22,18,22,0,0,-2,-4,-2,0,0,-8,12:10 - 11:7 - 12:10 - 0:0 - 0:0
17463269,2024-03-14 13:00:00,Rafayelyan Edgar - Asatryan Murad,1:3,4:11 - 13:11 - 11:7 - 11:6 - 0:0,3,1,Rafayelyan Edgar,Asatryan Murad,fiurst,Asatryan Murad - Rafayelyan Edgar,74,35,39,4,-4,15,24,18,17,0,-7,2,4,5,0,4,11:4 - 11:13 - 7:11 - 6:11 - 0:0
17463268,2024-03-14 12:15:00,Nikoghosyan Narek - Soghomonyan Hrayr,3:1,11:2 - 11:6 - 9:11 - 11:4 - 0:0,3,1,Nikoghosyan Narek,Soghomonyan Hrayr,fiurst,Nikoghosyan Narek - Soghomonyan Hrayr,65,42,23,-19,19,13,17,20,15,0,-9,-5,2,-7,0,-19,11:2 - 11:6 - 9:11 - 11:4 - 0:0
17463266,2024-03-14 12:00:00,Rafayelyan Edgar - Papyan Karen,1:3,2:11 - 11:3 - 12:10 - 12:10 - 0:0,3,1,Rafayelyan Edgar,Papyan Karen,fiurst,Papyan Karen - Rafayelyan Edgar,71,34,37,3,-3,13,14,22,22,0,-9,8,2,2,0,3,11:2 - 3:11 - 10:12 - 10:12 - 0:0
17463263,2024-03-14 11:50:00,Asatryan Murad - Nikoghosyan Narek,3:1,11:6 - 11:8 - 1:11 - 11:8 - 0:0,3,1,Asatryan Murad,Nikoghosyan Narek,fiurst,Asatryan Murad - Nikoghosyan Narek,67,34,33,-1,1,17,19,12,19,0,-5,-3,10,-3,0,-1,11:6 - 11:8 - 1:11 - 11:8 - 0:0
17463261,2024-03-14 11:40:00,Rafayelyan Edgar - Soghomonyan Hrayr,3:0,11:7 - 11:7 - 11:4 - 0:0 - 0:0,3,0,Rafayelyan Edgar,Soghomonyan Hrayr,fiurst,Rafayelyan Edgar - Soghomonyan Hrayr,51,33,18,-15,15,18,18,15,0,0,-4,-4,-7,0,0,-15,11:7 - 11:7 - 11:4 - 0:0 - 0:0
17463257,2024-03-14 11:20:00,Papyan Karen - Asatryan Murad,3:0,4:11 - 12:14 - 7:11 - 0:0 - 0:0,0,3,Papyan Karen,Asatryan Murad,fiurst,Asatryan Murad - Papyan Karen,59,36,23,-13,13,15,26,18,0,0,-7,-2,-4,0,0,-13,11:4 - 14:12 - 11:7 - 0:0 - 0:0
17463255,2024-03-14 11:10:00,Nikoghosyan Narek - Rafayelyan Edgar,1:3,11:8 - 6:11 - 8:11 - 8:11 - 0:0,1,3,Nikoghosyan Narek,Rafayelyan Edgar,fiurst,Nikoghosyan Narek - Rafayelyan Edgar,74,33,41,8,-8,19,17,19,19,0,-3,5,3,3,0,8,11:8 - 6:11 - 8:11 - 8:11 - 0:0
17463243,2024-03-14 10:50:00,Soghomonyan Hrayr - Asatryan Murad,3:0,4:11 - 6:11 - 6:11 - 0:0 - 0:0,0,3,Soghomonyan Hrayr,Asatryan Murad,fiurst,Asatryan Murad - Soghomonyan Hrayr,49,33,16,-17,17,15,17,17,0,0,-7,-5,-5,0,0,-17,11:4 - 11:6 - 11:6 - 0:0 - 0:0
17463241,2024-03-14 10:35:00,Papyan Karen - Nikoghosyan Narek,1:3,9:11 - 11:9 - 13:11 - 11:8 - 0:0,3,1,Papyan Karen,Nikoghosyan Narek,fiurst,Nikoghosyan Narek - Papyan Karen,83,39,44,5,-5,20,20,24,19,0,-2,2,2,3,0,5,11:9 - 9:11 - 11:13 - 8:11 - 0:0
17463240,2024-03-14 10:15:00,Asatryan Murad - Rafayelyan Edgar,3:2,11:4 - 5:11 - 13:11 - 12:14 - 12:10,3,2,Asatryan Murad,Rafayelyan Edgar,fiurst,Asatryan Murad - Rafayelyan Edgar,103,53,50,-3,3,15,16,24,26,22,-7,6,-2,2,-2,-3,11:4 - 5:11 - 13:11 - 12:14 - 12:10
17463238,2024-03-14 10:00:00,Soghomonyan Hrayr - Papyan Karen,3:2,11:7 - 7:11 - 9:11 - 11:4 - 4:11,2,3,Soghomonyan Hrayr,Papyan Karen,fiurst,Papyan Karen - Soghomonyan Hrayr,86,44,42,-2,2,18,18,20,15,15,4,-4,-2,7,-7,-2,7:11 - 11:7 - 11:9 - 4:11 - 11:4
17442647,2024-03-13 17:45:00,Mkrtchyan Andranik - Petrosyan Davit,3:2,8:11 - 11:5 - 11:7 - 7:11 - 11:9,3,2,Mkrtchyan Andranik,Petrosyan Davit,fiurst,Mkrtchyan Andranik - Petrosyan Davit,91,48,43,-5,5,19,16,18,18,20,3,-6,-4,4,-2,-5,8:11 - 11:5 - 11:7 - 7:11 - 11:9
17442644,2024-03-13 17:40:00,Avakimyan Davit - Gevorgyan Gegham,3:1,11:7 - 7:11 - 11:8 - 12:10 - 0:0,3,1,Avakimyan Davit,Gevorgyan Gegham,fiurst,Avakimyan Davit - Gevorgyan Gegham,77,41,36,-5,5,18,18,19,22,0,-4,4,-3,-2,0,-5,11:7 - 7:11 - 11:8 - 12:10 - 0:0
17442642,2024-03-13 17:25:00,Gevorgyan Hayk - Mkrtchyan Andranik,1:3,9:11 - 11:9 - 6:11 - 5:11 - 0:0,1,3,Gevorgyan Hayk,Mkrtchyan Andranik,fiurst,Gevorgyan Hayk - Mkrtchyan Andranik,73,31,42,11,-11,20,20,17,16,0,2,-2,5,6,0,11,9:11 - 11:9 - 6:11 - 5:11 - 0:0
17442641,2024-03-13 17:10:00,Avakimyan Davit - Petrosyan Davit,3:2,10:12 - 11:9 - 9:11 - 11:6 - 11:6,3,2,Avakimyan Davit,Petrosyan Davit,fiurst,Avakimyan Davit - Petrosyan Davit,96,52,44,-8,8,22,20,20,17,17,2,-2,2,-5,-5,-8,10:12 - 11:9 - 9:11 - 11:6 - 11:6
17442639,2024-03-13 17:00:00,Gevorgyan Gegham - Gevorgyan Hayk,0:3,5:11 - 9:11 - 6:11 - 0:0 - 0:0,0,3,Gevorgyan Gegham,Gevorgyan Hayk,fiurst,Gevorgyan Gegham - Gevorgyan Hayk,53,20,33,13,-13,16,20,17,0,0,6,2,5,0,0,13,5:11 - 9:11 - 6:11 - 0:0 - 0:0
17442638,2024-03-13 16:35:00,Mkrtchyan Andranik - Avakimyan Davit,3:2,12:10 - 11:13 - 11:8 - 9:11 - 6:11,2,3,Mkrtchyan Andranik,Avakimyan Davit,fiurst,Avakimyan Davit - Mkrtchyan Andranik,102,53,49,-4,4,22,24,19,20,17,2,-2,3,-2,-5,-4,10:12 - 13:11 - 8:11 - 11:9 - 11:6
17442630,2024-03-13 16:20:00,Petrosyan Davit - Gevorgyan Hayk,2:3,11:3 - 4:11 - 13:15 - 13:11 - 11:7,3,2,Petrosyan Davit,Gevorgyan Hayk,fiurst,Gevorgyan Hayk - Petrosyan Davit,99,47,52,5,-5,14,15,28,24,18,8,-7,-2,2,4,5,3:11 - 11:4 - 15:13 - 11:13 - 7:11
17442629,2024-03-13 16:05:00,Gevorgyan Gegham - Mkrtchyan Andranik,1:3,10:12 - 9:11 - 13:11 - 3:11 - 0:0,1,3,Gevorgyan Gegham,Mkrtchyan Andranik,fiurst,Gevorgyan Gegham - Mkrtchyan Andranik,80,35,45,10,-10,22,20,24,14,0,2,2,-2,8,0,10,10:12 - 9:11 - 13:11 - 3:11 - 0:0
17442624,2024-03-13 15:45:00,Gevorgyan Hayk - Avakimyan Davit,3:1,9:11 - 8:11 - 11:9 - 5:11 - 0:0,1,3,Gevorgyan Hayk,Avakimyan Davit,fiurst,Avakimyan Davit - Gevorgyan Hayk,75,42,33,-9,9,20,19,20,16,0,-2,-3,2,-6,0,-9,11:9 - 11:8 - 9:11 - 11:5 - 0:0
17442623,2024-03-13 15:35:00,Petrosyan Davit - Gevorgyan Gegham,2:3,7:11 - 2:11 - 11:8 - 11:7 - 11:5,3,2,Petrosyan Davit,Gevorgyan Gegham,fiurst,Gevorgyan Gegham - Petrosyan Davit,84,42,42,0,0,18,13,19,18,16,-4,-9,3,4,6,0,11:7 - 11:2 - 8:11 - 7:11 - 5:11
17442622,2024-03-13 15:15:00,Soghomonyan Hrayr - Hovhannesyan Rafik,3:2,6:11 - 11:9 - 5:11 - 17:15 - 4:11,2,3,Soghomonyan Hrayr,Hovhannesyan Rafik,fiurst,Hovhannesyan Rafik - Soghomonyan Hrayr,100,57,43,-14,14,17,20,16,32,15,-5,2,-6,2,-7,-14,11:6 - 9:11 - 11:5 - 15:17 - 11:4
17442620,2024-03-13 15:00:00,Rafayelyan Edgar - Nikoghosyan Narek,2:3,11:9 - 7:11 - 15:13 - 7:11 - 12:10,3,2,Rafayelyan Edgar,Nikoghosyan Narek,fiurst,Nikoghosyan Narek - Rafayelyan Edgar,106,54,52,-2,2,20,18,28,18,22,2,-4,2,-4,2,-2,9:11 - 11:7 - 13:15 - 11:7 - 10:12
17442615,2024-03-13 14:45:00,Papyan Karen - Soghomonyan Hrayr,3:0,11:5 - 11:6 - 11:4 - 0:0 - 0:0,3,0,Papyan Karen,Soghomonyan Hrayr,fiurst,Papyan Karen - Soghomonyan Hrayr,48,33,15,-18,18,16,17,15,0,0,-6,-5,-7,0,0,-18,11:5 - 11:6 - 11:4 - 0:0 - 0:0
17442613,2024-03-13 14:30:00,Hovhannesyan Rafik - Rafayelyan Edgar,1:3,13:11 - 7:11 - 6:11 - 10:12 - 0:0,1,3,Hovhannesyan Rafik,Rafayelyan Edgar,fiurst,Hovhannesyan Rafik - Rafayelyan Edgar,81,36,45,9,-9,24,18,17,22,0,-2,4,5,2,0,9,13:11 - 7:11 - 6:11 - 10:12 - 0:0
17442612,2024-03-13 14:15:00,Papyan Karen - Nikoghosyan Narek,3:0,11:13 - 6:11 - 2:11 - 0:0 - 0:0,0,3,Papyan Karen,Nikoghosyan Narek,fiurst,Nikoghosyan Narek - Papyan Karen,54,35,19,-16,16,24,17,13,0,0,-2,-5,-9,0,0,-16,13:11 - 11:6 - 11:2 - 0:0 - 0:0
17442611,2024-03-13 14:00:00,Soghomonyan Hrayr - Rafayelyan Edgar,3:1,8:11 - 8:11 - 11:8 - 6:11 - 0:0,1,3,Soghomonyan Hrayr,Rafayelyan Edgar,fiurst,Rafayelyan Edgar - Soghomonyan Hrayr,74,41,33,-8,8,19,19,19,17,0,-3,-3,3,-5,0,-8,11:8 - 11:8 - 8:11 - 11:6 - 0:0
17442610,2024-03-13 13:45:00,Hovhannesyan Rafik - Papyan Karen,0:3,8:11 - 9:11 - 7:11 - 0:0 - 0:0,0,3,Hovhannesyan Rafik,Papyan Karen,fiurst,Hovhannesyan Rafik - Papyan Karen,57,24,33,9,-9,19,20,18,0,0,3,2,4,0,0,9,8:11 - 9:11 - 7:11 - 0:0 - 0:0
17442605,2024-03-13 13:35:00,Nikoghosyan Narek - Soghomonyan Hrayr,3:1,11:9 - 9:11 - 11:7 - 11:8 - 0:0,3,1,Nikoghosyan Narek,Soghomonyan Hrayr,fiurst,Nikoghosyan Narek - Soghomonyan Hrayr,77,42,35,-7,7,20,20,18,19,0,-2,2,-4,-3,0,-7,11:9 - 9:11 - 11:7 - 11:8 - 0:0
17442598,2024-03-13 13:15:00,Rafayelyan Edgar - Papyan Karen,3:0,5:11 - 8:11 - 6:11 - 0:0 - 0:0,0,3,Rafayelyan Edgar,Papyan Karen,fiurst,Papyan Karen - Rafayelyan Edgar,52,33,19,-14,14,16,19,17,0,0,-6,-3,-5,0,0,-14,11:5 - 11:8 - 11:6 - 0:0 - 0:0
17442595,2024-03-13 13:10:00,Nikoghosyan Narek - Hovhannesyan Rafik,0:3,11:5 - 11:4 - 13:11 - 0:0 - 0:0,3,0,Nikoghosyan Narek,Hovhannesyan Rafik,fiurst,Hovhannesyan Rafik - Nikoghosyan Narek,55,20,35,15,-15,16,15,24,0,0,6,7,2,0,0,15,5:11 - 4:11 - 11:13 - 0:0 - 0:0
17442594,2024-03-13 12:15:00,Soghomonyan Hrayr - Papyan Karen,3:1,7:11 - 11:7 - 4:11 - 9:11 - 0:0,1,3,Soghomonyan Hrayr,Papyan Karen,fiurst,Papyan Karen - Soghomonyan Hrayr,71,40,31,-9,9,18,18,15,20,0,-4,4,-7,-2,0,-9,11:7 - 7:11 - 11:4 - 11:9 - 0:0
17442592,2024-03-13 12:10:00,Nikoghosyan Narek - Rafayelyan Edgar,2:3,15:13 - 7:11 - 9:11 - 11:8 - 8:11,2,3,Nikoghosyan Narek,Rafayelyan Edgar,fiurst,Nikoghosyan Narek - Rafayelyan Edgar,104,50,54,4,-4,28,18,20,19,19,-2,4,2,-3,3,4,15:13 - 7:11 - 9:11 - 11:8 - 8:11
17442586,2024-03-13 11:50:00,Hovhannesyan Rafik - Soghomonyan Hrayr,1:3,11:7 - 9:11 - 5:11 - 7:11 - 0:0,1,3,Hovhannesyan Rafik,Soghomonyan Hrayr,fiurst,Hovhannesyan Rafik - Soghomonyan Hrayr,72,32,40,8,-8,18,20,16,18,0,-4,2,6,4,0,8,11:7 - 9:11 - 5:11 - 7:11 - 0:0
17442584,2024-03-13 11:30:00,Nikoghosyan Narek - Papyan Karen,1:3,9:11 - 11:5 - 9:11 - 10:12 - 0:0,1,3,Nikoghosyan Narek,Papyan Karen,fiurst,Nikoghosyan Narek - Papyan Karen,78,39,39,0,0,20,16,20,22,0,2,-6,2,2,0,0,9:11 - 11:5 - 9:11 - 10:12 - 0:0
17442581,2024-03-13 11:15:00,Rafayelyan Edgar - Hovhannesyan Rafik,0:3,11:8 - 11:8 - 11:7 - 0:0 - 0:0,3,0,Rafayelyan Edgar,Hovhannesyan Rafik,fiurst,Hovhannesyan Rafik - Rafayelyan Edgar,56,23,33,10,-10,19,19,18,0,0,3,3,4,0,0,10,8:11 - 8:11 - 7:11 - 0:0 - 0:0
17442580,2024-03-13 11:00:00,Soghomonyan Hrayr - Nikoghosyan Narek,3:0,10:12 - 8:11 - 4:11 - 0:0 - 0:0,0,3,Soghomonyan Hrayr,Nikoghosyan Narek,fiurst,Nikoghosyan Narek - Soghomonyan Hrayr,56,34,22,-12,12,22,19,15,0,0,-2,-3,-7,0,0,-12,12:10 - 11:8 - 11:4 - 0:0 - 0:0
17442579,2024-03-13 10:50:00,Papyan Karen - Hovhannesyan Rafik,0:3,11:9 - 11:3 - 11:5 - 0:0 - 0:0,3,0,Papyan Karen,Hovhannesyan Rafik,fiurst,Hovhannesyan Rafik - Papyan Karen,50,17,33,16,-16,20,14,16,0,0,2,8,6,0,0,16,9:11 - 3:11 - 5:11 - 0:0 - 0:0
17442574,2024-03-13 10:30:00,Rafayelyan Edgar - Soghomonyan Hrayr,3:0,11:6 - 11:6 - 11:8 - 0:0 - 0:0,3,0,Rafayelyan Edgar,Soghomonyan Hrayr,fiurst,Rafayelyan Edgar - Soghomonyan Hrayr,53,33,20,-13,13,17,17,19,0,0,-5,-5,-3,0,0,-13,11:6 - 11:6 - 11:8 - 0:0 - 0:0
17442571,2024-03-13 10:20:00,Hovhannesyan Rafik - Nikoghosyan Narek,0:3,6:11 - 10:12 - 5:11 - 0:0 - 0:0,0,3,Hovhannesyan Rafik,Nikoghosyan Narek,fiurst,Hovhannesyan Rafik - Nikoghosyan Narek,55,21,34,13,-13,17,22,16,0,0,5,2,6,0,0,13,6:11 - 10:12 - 5:11 - 0:0 - 0:0
17442570,2024-03-13 10:05:00,Papyan Karen - Rafayelyan Edgar,3:2,11:5 - 11:6 - 8:11 - 6:11 - 11:5,3,2,Papyan Karen,Rafayelyan Edgar,fiurst,Papyan Karen - Rafayelyan Edgar,85,47,38,-9,9,16,17,19,17,16,-6,-5,3,5,-6,-9,11:5 - 11:6 - 8:11 - 6:11 - 11:5
17424668,2024-03-12 17:50:00,Gevorgyan Gegham - Karakhanyan Mher,3:0,12:10 - 11:8 - 11:9 - 0:0 - 0:0,3,0,Gevorgyan Gegham,Karakhanyan Mher,fiurst,Gevorgyan Gegham - Karakhanyan Mher,61,34,27,-7,7,22,19,20,0,0,-2,-3,-2,0,0,-7,12:10 - 11:8 - 11:9 - 0:0 - 0:0
17424659,2024-03-12 17:30:00,Arutyunov Ruben - Gevorgyan Hayk,1:3,11:2 - 15:17 - 2:11 - 7:11 - 0:0,1,3,Arutyunov Ruben,Gevorgyan Hayk,fiurst,Arutyunov Ruben - Gevorgyan Hayk,76,35,41,6,-6,13,32,13,18,0,-9,2,9,4,0,6,11:2 - 15:17 - 2:11 - 7:11 - 0:0
17424653,2024-03-12 17:15:00,Mkrtchyan Andranik - Gevorgyan Gegham,2:3,9:11 - 11:8 - 11:9 - 4:11 - 11:8,3,2,Mkrtchyan Andranik,Gevorgyan Gegham,fiurst,Gevorgyan Gegham - Mkrtchyan Andranik,93,47,46,-1,1,20,19,20,15,19,-2,3,2,-7,3,-1,11:9 - 8:11 - 9:11 - 11:4 - 8:11
17424648,2024-03-12 17:00:00,Arutyunov Ruben - Karakhanyan Mher,3:2,4:11 - 11:3 - 11:4 - 8:11 - 11:4,3,2,Arutyunov Ruben,Karakhanyan Mher,fiurst,Arutyunov Ruben - Karakhanyan Mher,78,45,33,-12,12,15,14,15,19,15,7,-8,-7,3,-7,-12,4:11 - 11:3 - 11:4 - 8:11 - 11:4
17424641,2024-03-12 16:45:00,Gevorgyan Hayk - Mkrtchyan Andranik,0:3,9:11 - 8:11 - 8:11 - 0:0 - 0:0,0,3,Gevorgyan Hayk,Mkrtchyan Andranik,fiurst,Gevorgyan Hayk - Mkrtchyan Andranik,58,25,33,8,-8,20,19,19,0,0,2,3,3,0,0,8,9:11 - 8:11 - 8:11 - 0:0 - 0:0
17424639,2024-03-12 16:30:00,Gevorgyan Gegham - Arutyunov Ruben,3:0,9:11 - 3:11 - 6:11 - 0:0 - 0:0,0,3,Gevorgyan Gegham,Arutyunov Ruben,fiurst,Arutyunov Ruben - Gevorgyan Gegham,51,33,18,-15,15,20,14,17,0,0,-2,-8,-5,0,0,-15,11:9 - 11:3 - 11:6 - 0:0 - 0:0
17424638,2024-03-12 16:15:00,Karakhanyan Mher - Mkrtchyan Andranik,1:3,11:6 - 6:11 - 7:11 - 8:11 - 0:0,1,3,Karakhanyan Mher,Mkrtchyan Andranik,fiurst,Karakhanyan Mher - Mkrtchyan Andranik,71,32,39,7,-7,17,17,18,19,0,-5,5,4,3,0,7,11:6 - 6:11 - 7:11 - 8:11 - 0:0
17424637,2024-03-12 16:00:00,Gevorgyan Hayk - Gevorgyan Gegham,3:1,9:11 - 11:4 - 9:11 - 6:11 - 0:0,1,3,Gevorgyan Hayk,Gevorgyan Gegham,fiurst,Gevorgyan Gegham - Gevorgyan Hayk,72,37,35,-2,2,20,15,20,17,0,-2,7,-2,-5,0,-2,11:9 - 4:11 - 11:9 - 11:6 - 0:0
17424626,2024-03-12 15:45:00,Mkrtchyan Andranik - Arutyunov Ruben,3:0,9:11 - 8:11 - 9:11 - 0:0 - 0:0,0,3,Mkrtchyan Andranik,Arutyunov Ruben,fiurst,Arutyunov Ruben - Mkrtchyan Andranik,59,33,26,-7,7,20,19,20,0,0,-2,-3,-2,0,0,-7,11:9 - 11:8 - 11:9 - 0:0 - 0:0
17424623,2024-03-12 15:30:00,Karakhanyan Mher - Gevorgyan Hayk,3:0,5:11 - 3:11 - 6:11 - 0:0 - 0:0,0,3,Karakhanyan Mher,Gevorgyan Hayk,fiurst,Gevorgyan Hayk - Karakhanyan Mher,47,33,14,-19,19,16,14,17,0,0,-6,-8,-5,0,0,-19,11:5 - 11:3 - 11:6 - 0:0 - 0:0
17424618,2024-03-12 15:25:00,Rafayelyan Edgar - Soghomonyan Hrayr,3:0,11:9 - 11:8 - 13:11 - 0:0 - 0:0,3,0,Rafayelyan Edgar,Soghomonyan Hrayr,fiurst,Rafayelyan Edgar - Soghomonyan Hrayr,63,35,28,-7,7,20,19,24,0,0,-2,-3,-2,0,0,-7,11:9 - 11:8 - 13:11 - 0:0 - 0:0
17424617,2024-03-12 15:00:00,Asatryan Murad - Hovhannesyan Rafik,3:1,3:11 - 11:2 - 11:5 - 11:3 - 0:0,3,1,Asatryan Murad,Hovhannesyan Rafik,fiurst,Asatryan Murad - Hovhannesyan Rafik,57,36,21,-15,15,14,13,16,14,0,8,-9,-6,-8,0,-15,3:11 - 11:2 - 11:5 - 11:3 - 0:0
17424613,2024-03-12 14:50:00,Nazaryan Mushegh - Rafayelyan Edgar,2:3,11:3 - 5:11 - 11:4 - 7:11 - 8:11,2,3,Nazaryan Mushegh,Rafayelyan Edgar,fiurst,Nazaryan Mushegh - Rafayelyan Edgar,82,42,40,-2,2,14,16,15,18,19,-8,6,-7,4,3,-2,11:3 - 5:11 - 11:4 - 7:11 - 8:11
17424612,2024-03-12 14:30:00,Soghomonyan Hrayr - Asatryan Murad,3:1,11:9 - 5:11 - 9:11 - 8:11 - 0:0,1,3,Soghomonyan Hrayr,Asatryan Murad,fiurst,Asatryan Murad - Soghomonyan Hrayr,75,42,33,-9,9,20,16,20,19,0,2,-6,-2,-3,0,-9,9:11 - 11:5 - 11:9 - 11:8 - 0:0
17424611,2024-03-12 14:20:00,Nazaryan Mushegh - Hovhannesyan Rafik,1:3,11:7 - 8:11 - 11:8 - 11:8 - 0:0,3,1,Nazaryan Mushegh,Hovhannesyan Rafik,fiurst,Hovhannesyan Rafik - Nazaryan Mushegh,75,34,41,7,-7,18,19,19,19,0,4,-3,3,3,0,7,7:11 - 11:8 - 8:11 - 8:11 - 0:0
17424607,2024-03-12 14:00:00,Rafayelyan Edgar - Asatryan Murad,3:0,10:12 - 3:11 - 11:13 - 0:0 - 0:0,0,3,Rafayelyan Edgar,Asatryan Murad,fiurst,Asatryan Murad - Rafayelyan Edgar,60,36,24,-12,12,22,14,24,0,0,-2,-8,-2,0,0,-12,12:10 - 11:3 - 13:11 - 0:0 - 0:0
17424595,2024-03-12 13:50:00,Soghomonyan Hrayr - Nazaryan Mushegh,3:1,7:11 - 11:6 - 8:11 - 6:11 - 0:0,1,3,Soghomonyan Hrayr,Nazaryan Mushegh,fiurst,Nazaryan Mushegh - Soghomonyan Hrayr,71,39,32,-7,7,18,17,19,17,0,-4,5,-3,-5,0,-7,11:7 - 6:11 - 11:8 - 11:6 - 0:0
17424594,2024-03-12 13:30:00,Hovhannesyan Rafik - Rafayelyan Edgar,1:3,11:4 - 10:12 - 3:11 - 5:11 - 0:0,1,3,Hovhannesyan Rafik,Rafayelyan Edgar,fiurst,Hovhannesyan Rafik - Rafayelyan Edgar,67,29,38,9,-9,15,22,14,16,0,-7,2,8,6,0,9,11:4 - 10:12 - 3:11 - 5:11 - 0:0
17424592,2024-03-12 13:15:00,Asatryan Murad - Nazaryan Mushegh,3:1,11:13 - 11:5 - 11:9 - 11:4 - 0:0,3,1,Asatryan Murad,Nazaryan Mushegh,fiurst,Asatryan Murad - Nazaryan Mushegh,75,44,31,-13,13,24,16,20,15,0,2,-6,-2,-7,0,-13,11:13 - 11:5 - 11:9 - 11:4 - 0:0
17424590,2024-03-12 13:00:00,Hovhannesyan Rafik - Soghomonyan Hrayr,3:1,11:13 - 11:6 - 11:5 - 13:11 - 0:0,3,1,Hovhannesyan Rafik,Soghomonyan Hrayr,fiurst,Hovhannesyan Rafik - Soghomonyan Hrayr,81,46,35,-11,11,24,17,16,24,0,2,-5,-6,-2,0,-11,11:13 - 11:6 - 11:5 - 13:11 - 0:0
17424588,2024-03-12 12:15:00,Rafayelyan Edgar - Nazaryan Mushegh,0:3,11:8 - 11:8 - 11:8 - 0:0 - 0:0,3,0,Rafayelyan Edgar,Nazaryan Mushegh,fiurst,Nazaryan Mushegh - Rafayelyan Edgar,57,24,33,9,-9,19,19,19,0,0,3,3,3,0,0,9,8:11 - 8:11 - 8:11 - 0:0 - 0:0
17424585,2024-03-12 12:05:00,Hovhannesyan Rafik - Asatryan Murad,3:0,8:11 - 6:11 - 4:11 - 0:0 - 0:0,0,3,Hovhannesyan Rafik,Asatryan Murad,fiurst,Asatryan Murad - Hovhannesyan Rafik,51,33,18,-15,15,19,17,15,0,0,-3,-5,-7,0,0,-15,11:8 - 11:6 - 11:4 - 0:0 - 0:0
17424574,2024-03-12 11:45:00,Soghomonyan Hrayr - Rafayelyan Edgar,3:0,6:11 - 9:11 - 8:11 - 0:0 - 0:0,0,3,Soghomonyan Hrayr,Rafayelyan Edgar,fiurst,Rafayelyan Edgar - Soghomonyan Hrayr,56,33,23,-10,10,17,20,19,0,0,-5,-2,-3,0,0,-10,11:6 - 11:9 - 11:8 - 0:0 - 0:0
17424572,2024-03-12 11:30:00,Hovhannesyan Rafik - Nazaryan Mushegh,1:3,15:13 - 9:11 - 9:11 - 13:15 - 0:0,1,3,Hovhannesyan Rafik,Nazaryan Mushegh,fiurst,Hovhannesyan Rafik - Nazaryan Mushegh,96,46,50,4,-4,28,20,20,28,0,-2,2,2,2,0,4,15:13 - 9:11 - 9:11 - 13:15 - 0:0
17424567,2024-03-12 11:15:00,Asatryan Murad - Soghomonyan Hrayr,3:0,11:3 - 11:8 - 11:3 - 0:0 - 0:0,3,0,Asatryan Murad,Soghomonyan Hrayr,fiurst,Asatryan Murad - Soghomonyan Hrayr,47,33,14,-19,19,14,19,14,0,0,-8,-3,-8,0,0,-19,11:3 - 11:8 - 11:3 - 0:0 - 0:0
17424565,2024-03-12 11:00:00,Rafayelyan Edgar - Hovhannesyan Rafik,0:3,11:9 - 11:3 - 11:7 - 0:0 - 0:0,3,0,Rafayelyan Edgar,Hovhannesyan Rafik,fiurst,Hovhannesyan Rafik - Rafayelyan Edgar,52,19,33,14,-14,20,14,18,0,0,2,8,4,0,0,14,9:11 - 3:11 - 7:11 - 0:0 - 0:0
17424560,2024-03-12 10:45:00,Nazaryan Mushegh - Soghomonyan Hrayr,3:0,11:7 - 11:5 - 11:8 - 0:0 - 0:0,3,0,Nazaryan Mushegh,Soghomonyan Hrayr,fiurst,Nazaryan Mushegh - Soghomonyan Hrayr,53,33,20,-13,13,18,16,19,0,0,-4,-6,-3,0,0,-13,11:7 - 11:5 - 11:8 - 0:0 - 0:0
17443603,2024-03-12 10:30:00,Asatryan Murad - Rafayelyan Edgar,3:1,5:11 - 11:9 - 11:6 - 11:3 - 0:0,3,1,Asatryan Murad,Rafayelyan Edgar,fiurst,Asatryan Murad - Rafayelyan Edgar,67,38,29,-9,9,16,20,17,14,0,6,-2,-5,-8,0,-9,5:11 - 11:9 - 11:6 - 11:3 - 0:0
17424556,2024-03-12 10:15:00,Soghomonyan Hrayr - Hovhannesyan Rafik,1:3,13:11 - 12:10 - 11:13 - 11:4 - 0:0,3,1,Soghomonyan Hrayr,Hovhannesyan Rafik,fiurst,Hovhannesyan Rafik - Soghomonyan Hrayr,85,38,47,9,-9,24,22,24,15,0,2,2,-2,7,0,9,11:13 - 10:12 - 13:11 - 4:11 - 0:0
17424555,2024-03-12 10:00:00,Nazaryan Mushegh - Asatryan Murad,3:0,6:11 - 4:11 - 7:11 - 0:0 - 0:0,0,3,Nazaryan Mushegh,Asatryan Murad,fiurst,Asatryan Murad - Nazaryan Mushegh,50,33,17,-16,16,17,15,18,0,0,-5,-7,-4,0,0,-16,11:6 - 11:4 - 11:7 - 0:0 - 0:0
17399487,2024-03-11 17:45:00,Petrosyan Davit - Avakimyan Davit,3:0,9:11 - 7:11 - 8:11 - 0:0 - 0:0,0,3,Petrosyan Davit,Avakimyan Davit,fiurst,Avakimyan Davit - Petrosyan Davit,57,33,24,-9,9,20,18,19,0,0,-2,-4,-3,0,0,-9,11:9 - 11:7 - 11:8 - 0:0 - 0:0
17399482,2024-03-11 17:30:00,Karakhanyan Mher - Mkrtchyan Andranik,1:3,13:15 - 9:11 - 12:10 - 7:11 - 0:0,1,3,Karakhanyan Mher,Mkrtchyan Andranik,fiurst,Karakhanyan Mher - Mkrtchyan Andranik,88,41,47,6,-6,28,20,22,18,0,2,2,-2,4,0,6,13:15 - 9:11 - 12:10 - 7:11 - 0:0
17399478,2024-03-11 17:25:00,Arutyunov Ruben - Petrosyan Davit,3:0,11:8 - 11:2 - 11:4 - 0:0 - 0:0,3,0,Arutyunov Ruben,Petrosyan Davit,fiurst,Arutyunov Ruben - Petrosyan Davit,47,33,14,-19,19,19,13,15,0,0,-3,-9,-7,0,0,-19,11:8 - 11:2 - 11:4 - 0:0 - 0:0
17399475,2024-03-11 17:00:00,Karakhanyan Mher - Avakimyan Davit,3:1,11:5 - 9:11 - 10:12 - 6:11 - 0:0,1,3,Karakhanyan Mher,Avakimyan Davit,fiurst,Avakimyan Davit - Karakhanyan Mher,75,39,36,-3,3,16,20,22,17,0,6,-2,-2,-5,0,-3,5:11 - 11:9 - 12:10 - 11:6 - 0:0
17399467,2024-03-11 16:45:00,Mkrtchyan Andranik - Arutyunov Ruben,3:2,9:11 - 11:8 - 14:12 - 10:12 - 12:14,2,3,Mkrtchyan Andranik,Arutyunov Ruben,fiurst,Arutyunov Ruben - Mkrtchyan Andranik,113,57,56,-1,1,20,19,26,22,26,-2,3,2,-2,-2,-1,11:9 - 8:11 - 12:14 - 12:10 - 14:12
17399465,2024-03-11 16:30:00,Petrosyan Davit - Karakhanyan Mher,1:3,11:6 - 11:7 - 8:11 - 11:8 - 0:0,3,1,Petrosyan Davit,Karakhanyan Mher,fiurst,Karakhanyan Mher - Petrosyan Davit,73,32,41,9,-9,17,18,19,19,0,5,4,-3,3,0,9,6:11 - 7:11 - 11:8 - 8:11 - 0:0
17399463,2024-03-11 16:15:00,Avakimyan Davit - Arutyunov Ruben,3:0,3:11 - 5:11 - 8:11 - 0:0 - 0:0,0,3,Avakimyan Davit,Arutyunov Ruben,fiurst,Arutyunov Ruben - Avakimyan Davit,49,33,16,-17,17,14,16,19,0,0,-8,-6,-3,0,0,-17,11:3 - 11:5 - 11:8 - 0:0 - 0:0
17399462,2024-03-11 16:00:00,Mkrtchyan Andranik - Petrosyan Davit,1:3,6:11 - 7:11 - 11:9 - 7:11 - 0:0,1,3,Mkrtchyan Andranik,Petrosyan Davit,fiurst,Mkrtchyan Andranik - Petrosyan Davit,73,31,42,11,-11,17,18,20,18,0,5,4,-2,4,0,11,6:11 - 7:11 - 11:9 - 7:11 - 0:0
17399458,2024-03-11 15:45:00,Arutyunov Ruben - Karakhanyan Mher,3:0,11:4 - 11:6 - 11:5 - 0:0 - 0:0,3,0,Arutyunov Ruben,Karakhanyan Mher,fiurst,Arutyunov Ruben - Karakhanyan Mher,48,33,15,-18,18,15,17,16,0,0,-7,-5,-6,0,0,-18,11:4 - 11:6 - 11:5 - 0:0 - 0:0
17399447,2024-03-11 15:30:00,Avakimyan Davit - Mkrtchyan Andranik,3:1,11:4 - 3:11 - 12:10 - 11:8 - 0:0,3,1,Avakimyan Davit,Mkrtchyan Andranik,fiurst,Avakimyan Davit - Mkrtchyan Andranik,70,37,33,-4,4,15,14,22,19,0,-7,8,-2,-3,0,-4,11:4 - 3:11 - 12:10 - 11:8 - 0:0
17399445,2024-03-11 15:15:00,Nikoghosyan Narek - Papyan Karen,3:0,11:8 - 11:5 - 11:5 - 0:0 - 0:0,3,0,Nikoghosyan Narek,Papyan Karen,fiurst,Nikoghosyan Narek - Papyan Karen,51,33,18,-15,15,19,16,16,0,0,-3,-6,-6,0,0,-15,11:8 - 11:5 - 11:5 - 0:0 - 0:0
17399440,2024-03-11 15:00:00,Rafayelyan Edgar - Nazaryan Mushegh,2:3,5:11 - 8:11 - 11:9 - 11:3 - 11:2,3,2,Rafayelyan Edgar,Nazaryan Mushegh,fiurst,Nazaryan Mushegh - Rafayelyan Edgar,82,36,46,10,-10,16,19,20,14,13,-6,-3,2,8,9,10,11:5 - 11:8 - 9:11 - 3:11 - 2:11
17399439,2024-03-11 14:45:00,Asatryan Murad - Nikoghosyan Narek,3:1,11:9 - 9:11 - 11:6 - 11:7 - 0:0,3,1,Asatryan Murad,Nikoghosyan Narek,fiurst,Asatryan Murad - Nikoghosyan Narek,75,42,33,-9,9,20,20,17,18,0,-2,2,-5,-4,0,-9,11:9 - 9:11 - 11:6 - 11:7 - 0:0
17399438,2024-03-11 14:30:00,Papyan Karen - Rafayelyan Edgar,0:3,6:11 - 5:11 - 8:11 - 0:0 - 0:0,0,3,Papyan Karen,Rafayelyan Edgar,fiurst,Papyan Karen - Rafayelyan Edgar,52,19,33,14,-14,17,16,19,0,0,5,6,3,0,0,14,6:11 - 5:11 - 8:11 - 0:0 - 0:0
17399428,2024-03-11 14:15:00,Asatryan Murad - Nazaryan Mushegh,3:1,11:7 - 8:11 - 11:3 - 11:5 - 0:0,3,1,Asatryan Murad,Nazaryan Mushegh,fiurst,Asatryan Murad - Nazaryan Mushegh,67,41,26,-15,15,18,19,14,16,0,-4,3,-8,-6,0,-15,11:7 - 8:11 - 11:3 - 11:5 - 0:0
17399426,2024-03-11 14:05:00,Nikoghosyan Narek - Rafayelyan Edgar,0:3,10:12 - 5:11 - 8:11 - 0:0 - 0:0,0,3,Nikoghosyan Narek,Rafayelyan Edgar,fiurst,Nikoghosyan Narek - Rafayelyan Edgar,57,23,34,11,-11,22,16,19,0,0,2,6,3,0,0,11,10:12 - 5:11 - 8:11 - 0:0 - 0:0
17399423,2024-03-11 13:45:00,Papyan Karen - Asatryan Murad,3:0,12:14 - 6:11 - 6:11 - 0:0 - 0:0,0,3,Papyan Karen,Asatryan Murad,fiurst,Asatryan Murad - Papyan Karen,60,36,24,-12,12,26,17,17,0,0,-2,-5,-5,0,0,-12,14:12 - 11:6 - 11:6 - 0:0 - 0:0
17399412,2024-03-11 13:30:00,Nazaryan Mushegh - Nikoghosyan Narek,3:1,11:8 - 11:3 - 4:11 - 12:10 - 0:0,3,1,Nazaryan Mushegh,Nikoghosyan Narek,fiurst,Nazaryan Mushegh - Nikoghosyan Narek,70,38,32,-6,6,19,14,15,22,0,-3,-8,7,-2,0,-6,11:8 - 11:3 - 4:11 - 12:10 - 0:0
17399411,2024-03-11 13:15:00,Rafayelyan Edgar - Asatryan Murad,3:1,9:11 - 11:8 - 3:11 - 11:13 - 0:0,1,3,Rafayelyan Edgar,Asatryan Murad,fiurst,Asatryan Murad - Rafayelyan Edgar,77,43,34,-9,9,20,19,14,24,0,-2,3,-8,-2,0,-9,11:9 - 8:11 - 11:3 - 13:11 - 0:0
17399408,2024-03-11 13:00:00,Nazaryan Mushegh - Papyan Karen,3:1,11:9 - 7:11 - 11:8 - 11:6 - 0:0,3,1,Nazaryan Mushegh,Papyan Karen,fiurst,Nazaryan Mushegh - Papyan Karen,74,40,34,-6,6,20,18,19,17,0,-2,4,-3,-5,0,-6,11:9 - 7:11 - 11:8 - 11:6 - 0:0
17399407,2024-03-11 12:15:00,Nikoghosyan Narek - Asatryan Murad,3:0,8:11 - 10:12 - 7:11 - 0:0 - 0:0,0,3,Nikoghosyan Narek,Asatryan Murad,fiurst,Asatryan Murad - Nikoghosyan Narek,59,34,25,-9,9,19,22,18,0,0,-3,-2,-4,0,0,-9,11:8 - 12:10 - 11:7 - 0:0 - 0:0
17399404,2024-03-11 12:05:00,Nazaryan Mushegh - Rafayelyan Edgar,1:3,11:8 - 8:11 - 3:11 - 7:11 - 0:0,1,3,Nazaryan Mushegh,Rafayelyan Edgar,fiurst,Nazaryan Mushegh - Rafayelyan Edgar,70,29,41,12,-12,19,19,14,18,0,-3,3,8,4,0,12,11:8 - 8:11 - 3:11 - 7:11 - 0:0
17399403,2024-03-11 11:50:00,Papyan Karen - Nikoghosyan Narek,0:3,11:8 - 12:10 - 11:6 - 0:0 - 0:0,3,0,Papyan Karen,Nikoghosyan Narek,fiurst,Nikoghosyan Narek - Papyan Karen,58,24,34,10,-10,19,22,17,0,0,3,2,5,0,0,10,8:11 - 10:12 - 6:11 - 0:0 - 0:0
17399402,2024-03-11 11:30:00,Nazaryan Mushegh - Asatryan Murad,3:0,4:11 - 3:11 - 4:11 - 0:0 - 0:0,0,3,Nazaryan Mushegh,Asatryan Murad,fiurst,Asatryan Murad - Nazaryan Mushegh,44,33,11,-22,22,15,14,15,0,0,-7,-8,-7,0,0,-22,11:4 - 11:3 - 11:4 - 0:0 - 0:0
17399401,2024-03-11 11:15:00,Rafayelyan Edgar - Papyan Karen,3:0,9:11 - 10:12 - 9:11 - 0:0 - 0:0,0,3,Rafayelyan Edgar,Papyan Karen,fiurst,Papyan Karen - Rafayelyan Edgar,62,34,28,-6,6,20,22,20,0,0,-2,-2,-2,0,0,-6,11:9 - 12:10 - 11:9 - 0:0 - 0:0
17399399,2024-03-11 11:05:00,Nikoghosyan Narek - Nazaryan Mushegh,2:3,11:9 - 7:11 - 11:6 - 9:11 - 11:8,3,2,Nikoghosyan Narek,Nazaryan Mushegh,fiurst,Nazaryan Mushegh - Nikoghosyan Narek,94,45,49,4,-4,20,18,17,20,19,2,-4,5,-2,3,4,9:11 - 11:7 - 6:11 - 11:9 - 8:11
17399397,2024-03-11 10:45:00,Asatryan Murad - Papyan Karen,3:0,11:6 - 11:5 - 11:5 - 0:0 - 0:0,3,0,Asatryan Murad,Papyan Karen,fiurst,Asatryan Murad - Papyan Karen,49,33,16,-17,17,17,16,16,0,0,-5,-6,-6,0,0,-17,11:6 - 11:5 - 11:5 - 0:0 - 0:0
17399388,2024-03-11 10:30:00,Rafayelyan Edgar - Nikoghosyan Narek,3:1,7:11 - 11:7 - 5:11 - 11:13 - 0:0,1,3,Rafayelyan Edgar,Nikoghosyan Narek,fiurst,Nikoghosyan Narek - Rafayelyan Edgar,76,42,34,-8,8,18,18,16,24,0,-4,4,-6,-2,0,-8,11:7 - 7:11 - 11:5 - 13:11 - 0:0
17399383,2024-03-11 10:15:00,Papyan Karen - Nazaryan Mushegh,3:0,9:11 - 4:11 - 9:11 - 0:0 - 0:0,0,3,Papyan Karen,Nazaryan Mushegh,fiurst,Nazaryan Mushegh - Papyan Karen,55,33,22,-11,11,20,15,20,0,0,-2,-7,-2,0,0,-11,11:9 - 11:4 - 11:9 - 0:0 - 0:0
17399382,2024-03-11 10:00:00,Asatryan Murad - Rafayelyan Edgar,3:1,8:11 - 11:7 - 11:7 - 11:4 - 0:0,3,1,Asatryan Murad,Rafayelyan Edgar,fiurst,Asatryan Murad - Rafayelyan Edgar,70,41,29,-12,12,19,18,18,15,0,3,-4,-4,-7,0,-12,8:11 - 11:7 - 11:7 - 11:4 - 0:0
17378760,2024-03-10 17:45:00,Mkrtchyan Andranik - Gevorgyan Gegham,0:3,11:7 - 11:9 - 11:6 - 0:0 - 0:0,3,0,Mkrtchyan Andranik,Gevorgyan Gegham,fiurst,Gevorgyan Gegham - Mkrtchyan Andranik,55,22,33,11,-11,18,20,17,0,0,4,2,5,0,0,11,7:11 - 9:11 - 6:11 - 0:0 - 0:0
17378759,2024-03-10 17:30:00,Avakimyan Davit - Petrosyan Davit,3:1,7:11 - 11:9 - 11:7 - 11:7 - 0:0,3,1,Avakimyan Davit,Petrosyan Davit,fiurst,Avakimyan Davit - Petrosyan Davit,74,40,34,-6,6,18,20,18,18,0,4,-2,-4,-4,0,-6,7:11 - 11:9 - 11:7 - 11:7 - 0:0
17378757,2024-03-10 17:15:00,Karakhanyan Mher - Mkrtchyan Andranik,0:3,9:11 - 9:11 - 9:11 - 0:0 - 0:0,0,3,Karakhanyan Mher,Mkrtchyan Andranik,fiurst,Karakhanyan Mher - Mkrtchyan Andranik,60,27,33,6,-6,20,20,20,0,0,2,2,2,0,0,6,9:11 - 9:11 - 9:11 - 0:0 - 0:0
17378755,2024-03-10 17:00:00,Avakimyan Davit - Gevorgyan Gegham,3:0,15:13 - 11:8 - 11:3 - 0:0 - 0:0,3,0,Avakimyan Davit,Gevorgyan Gegham,fiurst,Avakimyan Davit - Gevorgyan Gegham,61,37,24,-13,13,28,19,14,0,0,-2,-3,-8,0,0,-13,15:13 - 11:8 - 11:3 - 0:0 - 0:0
17378752,2024-03-10 16:45:00,Petrosyan Davit - Karakhanyan Mher,0:3,11:8 - 11:8 - 11:8 - 0:0 - 0:0,3,0,Petrosyan Davit,Karakhanyan Mher,fiurst,Karakhanyan Mher - Petrosyan Davit,57,24,33,9,-9,19,19,19,0,0,3,3,3,0,0,9,8:11 - 8:11 - 8:11 - 0:0 - 0:0
17378750,2024-03-10 16:35:00,Mkrtchyan Andranik - Avakimyan Davit,1:3,11:8 - 8:11 - 11:9 - 11:5 - 0:0,3,1,Mkrtchyan Andranik,Avakimyan Davit,fiurst,Avakimyan Davit - Mkrtchyan Andranik,74,33,41,8,-8,19,19,20,16,0,3,-3,2,6,0,8,8:11 - 11:8 - 9:11 - 5:11 - 0:0
17378738,2024-03-10 16:15:00,Gevorgyan Gegham - Karakhanyan Mher,3:1,6:11 - 11:7 - 11:6 - 11:5 - 0:0,3,1,Gevorgyan Gegham,Karakhanyan Mher,fiurst,Gevorgyan Gegham - Karakhanyan Mher,68,39,29,-10,10,17,18,17,16,0,5,-4,-5,-6,0,-10,6:11 - 11:7 - 11:6 - 11:5 - 0:0
17378735,2024-03-10 16:00:00,Petrosyan Davit - Mkrtchyan Andranik,2:3,15:13 - 9:11 - 2:11 - 11:9 - 11:6,3,2,Petrosyan Davit,Mkrtchyan Andranik,fiurst,Mkrtchyan Andranik - Petrosyan Davit,98,50,48,-2,2,28,20,13,20,17,2,-2,-9,2,5,-2,13:15 - 11:9 - 11:2 - 9:11 - 6:11
17378732,2024-03-10 15:45:00,Karakhanyan Mher - Avakimyan Davit,3:2,11:7 - 4:11 - 7:11 - 11:9 - 6:11,2,3,Karakhanyan Mher,Avakimyan Davit,fiurst,Avakimyan Davit - Karakhanyan Mher,88,49,39,-10,10,18,15,18,20,17,4,-7,-4,2,-5,-10,7:11 - 11:4 - 11:7 - 9:11 - 11:6
17378716,2024-03-10 15:30:00,Gevorgyan Gegham - Petrosyan Davit,1:3,11:6 - 8:11 - 9:11 - 8:11 - 0:0,1,3,Gevorgyan Gegham,Petrosyan Davit,fiurst,Gevorgyan Gegham - Petrosyan Davit,75,36,39,3,-3,17,19,20,19,0,-5,3,2,3,0,3,11:6 - 8:11 - 9:11 - 8:11 - 0:0
17378714,2024-03-10 15:20:00,Nazaryan Mushegh - Hovhannesyan Rafik,3:0,7:11 - 5:11 - 4:11 - 0:0 - 0:0,0,3,Nazaryan Mushegh,Hovhannesyan Rafik,fiurst,Hovhannesyan Rafik - Nazaryan Mushegh,49,33,16,-17,17,18,16,15,0,0,-4,-6,-7,0,0,-17,11:7 - 11:5 - 11:4 - 0:0 - 0:0
17378713,2024-03-10 15:05:00,Papyan Karen - Soghomonyan Hrayr,3:2,11:7 - 7:11 - 11:6 - 10:12 - 11:5,3,2,Papyan Karen,Soghomonyan Hrayr,fiurst,Papyan Karen - Soghomonyan Hrayr,91,50,41,-9,9,18,18,17,22,16,-4,4,-5,2,-6,-9,11:7 - 7:11 - 11:6 - 10:12 - 11:5
17378711,2024-03-10 14:55:00,Nikoghosyan Narek - Nazaryan Mushegh,1:3,11:9 - 13:11 - 8:11 - 11:6 - 0:0,3,1,Nikoghosyan Narek,Nazaryan Mushegh,fiurst,Nazaryan Mushegh - Nikoghosyan Narek,80,37,43,6,-6,20,24,19,17,0,2,2,-3,5,0,6,9:11 - 11:13 - 11:8 - 6:11 - 0:0
17378709,2024-03-10 14:30:00,Hovhannesyan Rafik - Papyan Karen,3:2,11:9 - 11:9 - 5:11 - 11:13 - 12:10,3,2,Hovhannesyan Rafik,Papyan Karen,fiurst,Hovhannesyan Rafik - Papyan Karen,102,50,52,2,-2,20,20,16,24,22,-2,-2,6,2,-2,2,11:9 - 11:9 - 5:11 - 11:13 - 12:10
17378707,2024-03-10 14:25:00,Nikoghosyan Narek - Soghomonyan Hrayr,3:0,11:5 - 14:12 - 11:6 - 0:0 - 0:0,3,0,Nikoghosyan Narek,Soghomonyan Hrayr,fiurst,Nikoghosyan Narek - Soghomonyan Hrayr,59,36,23,-13,13,16,26,17,0,0,-6,-2,-5,0,0,-13,11:5 - 14:12 - 11:6 - 0:0 - 0:0
17378706,2024-03-10 14:05:00,Nazaryan Mushegh - Papyan Karen,0:3,6:11 - 9:11 - 9:11 - 0:0 - 0:0,0,3,Nazaryan Mushegh,Papyan Karen,fiurst,Nazaryan Mushegh - Papyan Karen,57,24,33,9,-9,17,20,20,0,0,5,2,2,0,0,9,6:11 - 9:11 - 9:11 - 0:0 - 0:0
17378705,2024-03-10 13:45:00,Hovhannesyan Rafik - Nikoghosyan Narek,2:3,4:11 - 6:11 - 11:7 - 11:8 - 10:12,2,3,Hovhannesyan Rafik,Nikoghosyan Narek,fiurst,Hovhannesyan Rafik - Nikoghosyan Narek,91,42,49,7,-7,15,17,18,19,22,7,5,-4,-3,2,7,4:11 - 6:11 - 11:7 - 11:8 - 10:12
17378704,2024-03-10 13:40:00,Soghomonyan Hrayr - Nazaryan Mushegh,3:0,10:12 - 5:11 - 7:11 - 0:0 - 0:0,0,3,Soghomonyan Hrayr,Nazaryan Mushegh,fiurst,Nazaryan Mushegh - Soghomonyan Hrayr,56,34,22,-12,12,22,16,18,0,0,-2,-6,-4,0,0,-12,12:10 - 11:5 - 11:7 - 0:0 - 0:0
17378701,2024-03-10 13:15:00,Papyan Karen - Nikoghosyan Narek,3:0,8:11 - 9:11 - 7:11 - 0:0 - 0:0,0,3,Papyan Karen,Nikoghosyan Narek,fiurst,Nikoghosyan Narek - Papyan Karen,57,33,24,-9,9,19,20,18,0,0,-3,-2,-4,0,0,-9,11:8 - 11:9 - 11:7 - 0:0 - 0:0
17378688,2024-03-10 13:00:00,Soghomonyan Hrayr - Hovhannesyan Rafik,2:3,9:11 - 11:9 - 9:11 - 13:11 - 11:9,3,2,Soghomonyan Hrayr,Hovhannesyan Rafik,fiurst,Hovhannesyan Rafik - Soghomonyan Hrayr,104,51,53,2,-2,20,20,20,24,20,-2,2,-2,2,2,2,11:9 - 9:11 - 11:9 - 11:13 - 9:11
17378683,2024-03-10 12:15:00,Nazaryan Mushegh - Nikoghosyan Narek,0:3,8:11 - 10:12 - 3:11 - 0:0 - 0:0,0,3,Nazaryan Mushegh,Nikoghosyan Narek,fiurst,Nazaryan Mushegh - Nikoghosyan Narek,55,21,34,13,-13,19,22,14,0,0,3,2,8,0,0,13,8:11 - 10:12 - 3:11 - 0:0 - 0:0
17378679,2024-03-10 12:00:00,Soghomonyan Hrayr - Papyan Karen,3:1,8:11 - 1:11 - 11:4 - 9:11 - 0:0,1,3,Soghomonyan Hrayr,Papyan Karen,fiurst,Papyan Karen - Soghomonyan Hrayr,66,37,29,-8,8,19,12,15,20,0,-3,-10,7,-2,0,-8,11:8 - 11:1 - 4:11 - 11:9 - 0:0
17378675,2024-03-10 11:45:00,Hovhannesyan Rafik - Nazaryan Mushegh,0:3,9:11 - 9:11 - 7:11 - 0:0 - 0:0,0,3,Hovhannesyan Rafik,Nazaryan Mushegh,fiurst,Hovhannesyan Rafik - Nazaryan Mushegh,58,25,33,8,-8,20,20,18,0,0,2,2,4,0,0,8,9:11 - 9:11 - 7:11 - 0:0 - 0:0
17378672,2024-03-10 11:30:00,Soghomonyan Hrayr - Nikoghosyan Narek,3:1,13:15 - 8:11 - 11:6 - 10:12 - 0:0,1,3,Soghomonyan Hrayr,Nikoghosyan Narek,fiurst,Nikoghosyan Narek - Soghomonyan Hrayr,86,44,42,-2,2,28,19,17,22,0,-2,-3,5,-2,0,-2,15:13 - 11:8 - 6:11 - 12:10 - 0:0
17378670,2024-03-10 11:15:00,Papyan Karen - Hovhannesyan Rafik,0:3,11:9 - 11:9 - 13:11 - 0:0 - 0:0,3,0,Papyan Karen,Hovhannesyan Rafik,fiurst,Hovhannesyan Rafik - Papyan Karen,64,29,35,6,-6,20,20,24,0,0,2,2,2,0,0,6,9:11 - 9:11 - 11:13 - 0:0 - 0:0
17378655,2024-03-10 11:00:00,Nazaryan Mushegh - Soghomonyan Hrayr,0:3,7:11 - 7:11 - 11:13 - 0:0 - 0:0,0,3,Nazaryan Mushegh,Soghomonyan Hrayr,fiurst,Nazaryan Mushegh - Soghomonyan Hrayr,60,25,35,10,-10,18,18,24,0,0,4,4,2,0,0,10,7:11 - 7:11 - 11:13 - 0:0 - 0:0
17378654,2024-03-10 10:45:00,Nikoghosyan Narek - Hovhannesyan Rafik,0:3,12:10 - 11:3 - 11:6 - 0:0 - 0:0,3,0,Nikoghosyan Narek,Hovhannesyan Rafik,fiurst,Hovhannesyan Rafik - Nikoghosyan Narek,53,19,34,15,-15,22,14,17,0,0,2,8,5,0,0,15,10:12 - 3:11 - 6:11 - 0:0 - 0:0
17378653,2024-03-10 10:30:00,Papyan Karen - Nazaryan Mushegh,0:3,11:3 - 11:2 - 11:2 - 0:0 - 0:0,3,0,Papyan Karen,Nazaryan Mushegh,fiurst,Nazaryan Mushegh - Papyan Karen,40,7,33,26,-26,14,13,13,0,0,8,9,9,0,0,26,3:11 - 2:11 - 2:11 - 0:0 - 0:0
17378651,2024-03-10 10:15:00,Hovhannesyan Rafik - Soghomonyan Hrayr,3:1,11:5 - 11:6 - 10:12 - 11:7 - 0:0,3,1,Hovhannesyan Rafik,Soghomonyan Hrayr,fiurst,Hovhannesyan Rafik - Soghomonyan Hrayr,73,43,30,-13,13,16,17,22,18,0,-6,-5,2,-4,0,-13,11:5 - 11:6 - 10:12 - 11:7 - 0:0
17378647,2024-03-10 10:00:00,Nikoghosyan Narek - Papyan Karen,0:3,9:11 - 8:11 - 10:12 - 0:0 - 0:0,0,3,Nikoghosyan Narek,Papyan Karen,fiurst,Nikoghosyan Narek - Papyan Karen,61,27,34,7,-7,20,19,22,0,0,2,3,2,0,0,7,9:11 - 8:11 - 10:12 - 0:0 - 0:0
17359390,2024-03-09 17:45:00,Avakimyan Davit - Arutyunov Ruben,3:2,6:11 - 11:9 - 7:11 - 11:4 - 7:11,2,3,Avakimyan Davit,Arutyunov Ruben,fiurst,Arutyunov Ruben - Avakimyan Davit,88,46,42,-4,4,17,20,18,15,18,-5,2,-4,7,-4,-4,11:6 - 9:11 - 11:7 - 4:11 - 11:7
17359389,2024-03-09 17:30:00,Gevorgyan Hayk - Gevorgyan Gegham,3:1,11:9 - 6:11 - 6:11 - 9:11 - 0:0,1,3,Gevorgyan Hayk,Gevorgyan Gegham,fiurst,Gevorgyan Gegham - Gevorgyan Hayk,74,42,32,-10,10,20,17,17,20,0,2,-5,-5,-2,0,-10,9:11 - 11:6 - 11:6 - 11:9 - 0:0
17359388,2024-03-09 17:25:00,Mkrtchyan Andranik - Avakimyan Davit,1:3,6:11 - 11:4 - 11:6 - 11:4 - 0:0,3,1,Mkrtchyan Andranik,Avakimyan Davit,fiurst,Avakimyan Davit - Mkrtchyan Andranik,64,25,39,14,-14,17,15,17,15,0,-5,7,5,7,0,14,11:6 - 4:11 - 6:11 - 4:11 - 0:0
17359387,2024-03-09 17:00:00,Gevorgyan Hayk - Arutyunov Ruben,3:0,6:11 - 6:11 - 8:11 - 0:0 - 0:0,0,3,Gevorgyan Hayk,Arutyunov Ruben,fiurst,Arutyunov Ruben - Gevorgyan Hayk,53,33,20,-13,13,17,17,19,0,0,-5,-5,-3,0,0,-13,11:6 - 11:6 - 11:8 - 0:0 - 0:0
17359381,2024-03-09 16:55:00,Gevorgyan Gegham - Mkrtchyan Andranik,0:3,7:11 - 8:11 - 14:16 - 0:0 - 0:0,0,3,Gevorgyan Gegham,Mkrtchyan Andranik,fiurst,Gevorgyan Gegham - Mkrtchyan Andranik,67,29,38,9,-9,18,19,30,0,0,4,3,2,0,0,9,7:11 - 8:11 - 14:16 - 0:0 - 0:0
17359374,2024-03-09 16:30:00,Avakimyan Davit - Gevorgyan Hayk,1:3,11:7 - 8:11 - 2:11 - 4:11 - 0:0,1,3,Avakimyan Davit,Gevorgyan Hayk,fiurst,Avakimyan Davit - Gevorgyan Hayk,65,25,40,15,-15,18,19,13,15,0,-4,3,9,7,0,15,11:7 - 8:11 - 2:11 - 4:11 - 0:0
17359373,2024-03-09 16:20:00,Arutyunov Ruben - Mkrtchyan Andranik,1:3,7:11 - 7:11 - 11:8 - 9:11 - 0:0,1,3,Arutyunov Ruben,Mkrtchyan Andranik,fiurst,Arutyunov Ruben - Mkrtchyan Andranik,75,34,41,7,-7,18,18,19,20,0,4,4,-3,2,0,7,7:11 - 7:11 - 11:8 - 9:11 - 0:0
17359371,2024-03-09 16:00:00,Gevorgyan Gegham - Avakimyan Davit,1:3,5:11 - 12:10 - 11:2 - 11:4 - 0:0,3,1,Gevorgyan Gegham,Avakimyan Davit,fiurst,Avakimyan Davit - Gevorgyan Gegham,66,27,39,12,-12,16,22,13,15,0,-6,2,9,7,0,12,11:5 - 10:12 - 2:11 - 4:11 - 0:0
17359369,2024-03-09 15:45:00,Mkrtchyan Andranik - Gevorgyan Hayk,2:3,8:11 - 9:11 - 11:8 - 11:4 - 12:10,3,2,Mkrtchyan Andranik,Gevorgyan Hayk,fiurst,Gevorgyan Hayk - Mkrtchyan Andranik,95,44,51,7,-7,19,20,19,15,22,-3,-2,3,7,2,7,11:8 - 11:9 - 8:11 - 4:11 - 10:12
17359366,2024-03-09 15:30:00,Arutyunov Ruben - Gevorgyan Gegham,3:1,10:12 - 11:8 - 11:1 - 11:4 - 0:0,3,1,Arutyunov Ruben,Gevorgyan Gegham,fiurst,Arutyunov Ruben - Gevorgyan Gegham,68,43,25,-18,18,22,19,12,15,0,2,-3,-10,-7,0,-18,10:12 - 11:8 - 11:1 - 11:4 - 0:0
17359365,2024-03-09 15:15:00,Nikoghosyan Narek - Diaryan Aleksandr,1:3,8:11 - 11:6 - 12:10 - 16:14 - 0:0,3,1,Nikoghosyan Narek,Diaryan Aleksandr,fiurst,Diaryan Aleksandr - Nikoghosyan Narek,88,41,47,6,-6,19,17,22,30,0,-3,5,2,2,0,6,11:8 - 6:11 - 10:12 - 14:16 - 0:0
17359354,2024-03-09 15:00:00,Hovhannesyan Rafik - Asatryan Murad,3:0,10:12 - 6:11 - 5:11 - 0:0 - 0:0,0,3,Hovhannesyan Rafik,Asatryan Murad,fiurst,Asatryan Murad - Hovhannesyan Rafik,55,34,21,-13,13,22,17,16,0,0,-2,-5,-6,0,0,-13,12:10 - 11:6 - 11:5 - 0:0 - 0:0
17359352,2024-03-09 14:50:00,Soghomonyan Hrayr - Nikoghosyan Narek,3:1,6:11 - 8:11 - 11:7 - 7:11 - 0:0,1,3,Soghomonyan Hrayr,Nikoghosyan Narek,fiurst,Nikoghosyan Narek - Soghomonyan Hrayr,72,40,32,-8,8,17,19,18,18,0,-5,-3,4,-4,0,-8,11:6 - 11:8 - 7:11 - 11:7 - 0:0
17359351,2024-03-09 14:30:00,Diaryan Aleksandr - Hovhannesyan Rafik,3:2,11:8 - 7:11 - 5:11 - 11:7 - 14:12,3,2,Diaryan Aleksandr,Hovhannesyan Rafik,fiurst,Diaryan Aleksandr - Hovhannesyan Rafik,97,48,49,1,-1,19,18,16,18,26,-3,4,6,-4,-2,1,11:8 - 7:11 - 5:11 - 11:7 - 14:12
17359348,2024-03-09 14:15:00,Soghomonyan Hrayr - Asatryan Murad,3:0,7:11 - 5:11 - 7:11 - 0:0 - 0:0,0,3,Soghomonyan Hrayr,Asatryan Murad,fiurst,Asatryan Murad - Soghomonyan Hrayr,52,33,19,-14,14,18,16,18,0,0,-4,-6,-4,0,0,-14,11:7 - 11:5 - 11:7 - 0:0 - 0:0
17359344,2024-03-09 14:00:00,Nikoghosyan Narek - Hovhannesyan Rafik,0:3,11:7 - 11:3 - 15:13 - 0:0 - 0:0,3,0,Nikoghosyan Narek,Hovhannesyan Rafik,fiurst,Hovhannesyan Rafik - Nikoghosyan Narek,60,23,37,14,-14,18,14,28,0,0,4,8,2,0,0,14,7:11 - 3:11 - 13:15 - 0:0 - 0:0
17359339,2024-03-09 13:45:00,Diaryan Aleksandr - Soghomonyan Hrayr,3:0,11:7 - 11:7 - 11:6 - 0:0 - 0:0,3,0,Diaryan Aleksandr,Soghomonyan Hrayr,fiurst,Diaryan Aleksandr - Soghomonyan Hrayr,53,33,20,-13,13,18,18,17,0,0,-4,-4,-5,0,0,-13,11:7 - 11:7 - 11:6 - 0:0 - 0:0
17359338,2024-03-09 13:30:00,Asatryan Murad - Nikoghosyan Narek,3:1,11:6 - 11:7 - 9:11 - 11:5 - 0:0,3,1,Asatryan Murad,Nikoghosyan Narek,fiurst,Asatryan Murad - Nikoghosyan Narek,71,42,29,-13,13,17,18,20,16,0,-5,-4,2,-6,0,-13,11:6 - 11:7 - 9:11 - 11:5 - 0:0
17359327,2024-03-09 13:15:00,Hovhannesyan Rafik - Soghomonyan Hrayr,1:3,9:11 - 11:7 - 11:13 - 3:11 - 0:0,1,3,Hovhannesyan Rafik,Soghomonyan Hrayr,fiurst,Hovhannesyan Rafik - Soghomonyan Hrayr,76,34,42,8,-8,20,18,24,14,0,2,-4,2,8,0,8,9:11 - 11:7 - 11:13 - 3:11 - 0:0
17359323,2024-03-09 13:00:00,Asatryan Murad - Diaryan Aleksandr,2:3,9:11 - 9:11 - 11:9 - 11:9 - 6:11,2,3,Asatryan Murad,Diaryan Aleksandr,fiurst,Asatryan Murad - Diaryan Aleksandr,97,46,51,5,-5,20,20,20,20,17,2,2,-2,-2,5,5,9:11 - 9:11 - 11:9 - 11:9 - 6:11
17359321,2024-03-09 12:15:00,Nikoghosyan Narek - Soghomonyan Hrayr,2:3,9:11 - 11:6 - 5:11 - 11:4 - 9:11,2,3,Nikoghosyan Narek,Soghomonyan Hrayr,fiurst,Nikoghosyan Narek - Soghomonyan Hrayr,88,45,43,-2,2,20,17,16,15,20,2,-5,6,-7,2,-2,9:11 - 11:6 - 5:11 - 11:4 - 9:11
17359319,2024-03-09 12:00:00,Asatryan Murad - Hovhannesyan Rafik,3:0,11:2 - 11:3 - 11:4 - 0:0 - 0:0,3,0,Asatryan Murad,Hovhannesyan Rafik,fiurst,Asatryan Murad - Hovhannesyan Rafik,42,33,9,-24,24,13,14,15,0,0,-9,-8,-7,0,0,-24,11:2 - 11:3 - 11:4 - 0:0 - 0:0
17359315,2024-03-09 11:45:00,Diaryan Aleksandr - Nikoghosyan Narek,3:1,11:8 - 11:3 - 9:11 - 11:6 - 0:0,3,1,Diaryan Aleksandr,Nikoghosyan Narek,fiurst,Diaryan Aleksandr - Nikoghosyan Narek,70,42,28,-14,14,19,14,20,17,0,-3,-8,2,-5,0,-14,11:8 - 11:3 - 9:11 - 11:6 - 0:0
17359312,2024-03-09 11:30:00,Asatryan Murad - Soghomonyan Hrayr,3:0,11:7 - 11:9 - 11:6 - 0:0 - 0:0,3,0,Asatryan Murad,Soghomonyan Hrayr,fiurst,Asatryan Murad - Soghomonyan Hrayr,55,33,22,-11,11,18,20,17,0,0,-4,-2,-5,0,0,-11,11:7 - 11:9 - 11:6 - 0:0 - 0:0
17359310,2024-03-09 11:15:00,Hovhannesyan Rafik - Diaryan Aleksandr,3:0,9:11 - 5:11 - 7:11 - 0:0 - 0:0,0,3,Hovhannesyan Rafik,Diaryan Aleksandr,fiurst,Diaryan Aleksandr - Hovhannesyan Rafik,54,33,21,-12,12,20,16,18,0,0,-2,-6,-4,0,0,-12,11:9 - 11:5 - 11:7 - 0:0 - 0:0
17359306,2024-03-09 11:00:00,Nikoghosyan Narek - Asatryan Murad,3:0,9:11 - 4:11 - 9:11 - 0:0 - 0:0,0,3,Nikoghosyan Narek,Asatryan Murad,fiurst,Asatryan Murad - Nikoghosyan Narek,55,33,22,-11,11,20,15,20,0,0,-2,-7,-2,0,0,-11,11:9 - 11:4 - 11:9 - 0:0 - 0:0
17359304,2024-03-09 10:45:00,Soghomonyan Hrayr - Diaryan Aleksandr,3:0,9:11 - 9:11 - 10:12 - 0:0 - 0:0,0,3,Soghomonyan Hrayr,Diaryan Aleksandr,fiurst,Diaryan Aleksandr - Soghomonyan Hrayr,62,34,28,-6,6,20,20,22,0,0,-2,-2,-2,0,0,-6,11:9 - 11:9 - 12:10 - 0:0 - 0:0
17359291,2024-03-09 10:30:00,Hovhannesyan Rafik - Nikoghosyan Narek,1:3,11:9 - 7:11 - 2:11 - 8:11 - 0:0,1,3,Hovhannesyan Rafik,Nikoghosyan Narek,fiurst,Hovhannesyan Rafik - Nikoghosyan Narek,70,28,42,14,-14,20,18,13,19,0,-2,4,9,3,0,14,11:9 - 7:11 - 2:11 - 8:11 - 0:0
17359288,2024-03-09 10:15:00,Diaryan Aleksandr - Asatryan Murad,3:2,12:10 - 11:8 - 7:11 - 10:12 - 9:11,2,3,Diaryan Aleksandr,Asatryan Murad,fiurst,Asatryan Murad - Diaryan Aleksandr,101,52,49,-3,3,22,19,18,22,20,2,3,-4,-2,-2,-3,10:12 - 8:11 - 11:7 - 12:10 - 11:9
17359284,2024-03-09 10:00:00,Soghomonyan Hrayr - Hovhannesyan Rafik,3:2,12:10 - 5:11 - 9:11 - 13:11 - 8:11,2,3,Soghomonyan Hrayr,Hovhannesyan Rafik,fiurst,Hovhannesyan Rafik - Soghomonyan Hrayr,101,54,47,-7,7,22,16,20,24,19,2,-6,-2,2,-3,-7,10:12 - 11:5 - 11:9 - 11:13 - 11:8
17344840,2024-03-08 17:45:00,Petrosyan Davit - Gevorgyan Hayk,3:0,3:11 - 3:11 - 8:11 - 0:0 - 0:0,0,3,Petrosyan Davit,Gevorgyan Hayk,fiurst,Gevorgyan Hayk - Petrosyan Davit,47,33,14,-19,19,14,14,19,0,0,-8,-8,-3,0,0,-19,11:3 - 11:3 - 11:8 - 0:0 - 0:0
17344836,2024-03-08 17:30:00,Arutyunov Ruben - Karakhanyan Mher,3:0,11:4 - 11:4 - 11:7 - 0:0 - 0:0,3,0,Arutyunov Ruben,Karakhanyan Mher,fiurst,Arutyunov Ruben - Karakhanyan Mher,48,33,15,-18,18,15,15,18,0,0,-7,-7,-4,0,0,-18,11:4 - 11:4 - 11:7 - 0:0 - 0:0
17344834,2024-03-08 17:15:00,Gevorgyan Gegham - Petrosyan Davit,3:1,11:9 - 4:11 - 12:10 - 11:9 - 0:0,3,1,Gevorgyan Gegham,Petrosyan Davit,fiurst,Gevorgyan Gegham - Petrosyan Davit,77,38,39,1,-1,20,15,22,20,0,-2,7,-2,-2,0,1,11:9 - 4:11 - 12:10 - 11:9 - 0:0
17344831,2024-03-08 17:00:00,Arutyunov Ruben - Gevorgyan Hayk,3:1,11:8 - 6:11 - 11:9 - 11:5 - 0:0,3,1,Arutyunov Ruben,Gevorgyan Hayk,fiurst,Arutyunov Ruben - Gevorgyan Hayk,72,39,33,-6,6,19,17,20,16,0,-3,5,-2,-6,0,-6,11:8 - 6:11 - 11:9 - 11:5 - 0:0
17344819,2024-03-08 16:45:00,Karakhanyan Mher - Gevorgyan Gegham,3:2,9:11 - 11:9 - 11:9 - 7:11 - 2:11,2,3,Karakhanyan Mher,Gevorgyan Gegham,fiurst,Gevorgyan Gegham - Karakhanyan Mher,91,51,40,-11,11,20,20,20,18,13,-2,2,2,-4,-9,-11,11:9 - 9:11 - 9:11 - 11:7 - 11:2
17344818,2024-03-08 16:30:00,Petrosyan Davit - Arutyunov Ruben,3:1,6:11 - 6:11 - 11:5 - 9:11 - 0:0,1,3,Petrosyan Davit,Arutyunov Ruben,fiurst,Arutyunov Ruben - Petrosyan Davit,70,38,32,-6,6,17,17,16,20,0,-5,-5,6,-2,0,-6,11:6 - 11:6 - 5:11 - 11:9 - 0:0
17344817,2024-03-08 16:15:00,Gevorgyan Hayk - Gevorgyan Gegham,0:3,11:3 - 11:7 - 11:9 - 0:0 - 0:0,3,0,Gevorgyan Hayk,Gevorgyan Gegham,fiurst,Gevorgyan Gegham - Gevorgyan Hayk,52,19,33,14,-14,14,18,20,0,0,8,4,2,0,0,14,3:11 - 7:11 - 9:11 - 0:0 - 0:0
17344815,2024-03-08 16:00:00,Karakhanyan Mher - Petrosyan Davit,1:3,9:11 - 12:10 - 7:11 - 8:11 - 0:0,1,3,Karakhanyan Mher,Petrosyan Davit,fiurst,Karakhanyan Mher - Petrosyan Davit,79,36,43,7,-7,20,22,18,19,0,2,-2,4,3,0,7,9:11 - 12:10 - 7:11 - 8:11 - 0:0
17344813,2024-03-08 15:45:00,Gevorgyan Gegham - Arutyunov Ruben,3:0,5:11 - 3:11 - 5:11 - 0:0 - 0:0,0,3,Gevorgyan Gegham,Arutyunov Ruben,fiurst,Arutyunov Ruben - Gevorgyan Gegham,46,33,13,-20,20,16,14,16,0,0,-6,-8,-6,0,0,-20,11:5 - 11:3 - 11:5 - 0:0 - 0:0
17344812,2024-03-08 15:30:00,Gevorgyan Hayk - Karakhanyan Mher,3:0,12:10 - 11:9 - 11:9 - 0:0 - 0:0,3,0,Gevorgyan Hayk,Karakhanyan Mher,fiurst,Gevorgyan Hayk - Karakhanyan Mher,62,34,28,-6,6,22,20,20,0,0,-2,-2,-2,0,0,-6,12:10 - 11:9 - 11:9 - 0:0 - 0:0
17344809,2024-03-08 15:15:00,Asatryan Murad - Papyan Karen,3:0,11:8 - 11:6 - 11:9 - 0:0 - 0:0,3,0,Asatryan Murad,Papyan Karen,fiurst,Asatryan Murad - Papyan Karen,56,33,23,-10,10,19,17,20,0,0,-3,-5,-2,0,0,-10,11:8 - 11:6 - 11:9 - 0:0 - 0:0
17344808,2024-03-08 15:00:00,Nazaryan Mushegh - Diaryan Aleksandr,3:0,8:11 - 4:11 - 3:11 - 0:0 - 0:0,0,3,Nazaryan Mushegh,Diaryan Aleksandr,fiurst,Diaryan Aleksandr - Nazaryan Mushegh,48,33,15,-18,18,19,15,14,0,0,-3,-7,-8,0,0,-18,11:8 - 11:4 - 11:3 - 0:0 - 0:0
17344792,2024-03-08 14:45:00,Rafayelyan Edgar - Asatryan Murad,0:3,11:9 - 11:5 - 11:5 - 0:0 - 0:0,3,0,Rafayelyan Edgar,Asatryan Murad,fiurst,Asatryan Murad - Rafayelyan Edgar,52,19,33,14,-14,20,16,16,0,0,2,6,6,0,0,14,9:11 - 5:11 - 5:11 - 0:0 - 0:0
17344791,2024-03-08 14:30:00,Papyan Karen - Nazaryan Mushegh,2:3,9:11 - 11:5 - 7:11 - 11:9 - 11:9,3,2,Papyan Karen,Nazaryan Mushegh,fiurst,Nazaryan Mushegh - Papyan Karen,94,45,49,4,-4,20,16,18,20,20,-2,6,-4,2,2,4,11:9 - 5:11 - 11:7 - 9:11 - 9:11
17344790,2024-03-08 14:20:00,Rafayelyan Edgar - Diaryan Aleksandr,2:3,11:7 - 11:9 - 6:11 - 10:12 - 11:2,3,2,Rafayelyan Edgar,Diaryan Aleksandr,fiurst,Diaryan Aleksandr - Rafayelyan Edgar,90,41,49,8,-8,18,20,17,22,13,4,2,-5,-2,9,8,7:11 - 9:11 - 11:6 - 12:10 - 2:11
17344789,2024-03-08 14:00:00,Asatryan Murad - Nazaryan Mushegh,3:0,11:5 - 11:6 - 11:5 - 0:0 - 0:0,3,0,Asatryan Murad,Nazaryan Mushegh,fiurst,Asatryan Murad - Nazaryan Mushegh,49,33,16,-17,17,16,17,16,0,0,-6,-5,-6,0,0,-17,11:5 - 11:6 - 11:5 - 0:0 - 0:0
17344786,2024-03-08 13:45:00,Papyan Karen - Rafayelyan Edgar,1:3,8:11 - 8:11 - 15:13 - 4:11 - 0:0,1,3,Papyan Karen,Rafayelyan Edgar,fiurst,Papyan Karen - Rafayelyan Edgar,81,35,46,11,-11,19,19,28,15,0,3,3,-2,7,0,11,8:11 - 8:11 - 15:13 - 4:11 - 0:0
17344785,2024-03-08 13:30:00,Diaryan Aleksandr - Asatryan Murad,3:2,15:13 - 9:11 - 14:12 - 7:11 - 2:11,2,3,Diaryan Aleksandr,Asatryan Murad,fiurst,Asatryan Murad - Diaryan Aleksandr,105,58,47,-11,11,28,20,26,18,13,2,-2,2,-4,-9,-11,13:15 - 11:9 - 12:14 - 11:7 - 11:2
17344784,2024-03-08 13:15:00,Nazaryan Mushegh - Rafayelyan Edgar,0:3,11:13 - 9:11 - 7:11 - 0:0 - 0:0,0,3,Nazaryan Mushegh,Rafayelyan Edgar,fiurst,Nazaryan Mushegh - Rafayelyan Edgar,62,27,35,8,-8,24,20,18,0,0,2,2,4,0,0,8,11:13 - 9:11 - 7:11 - 0:0 - 0:0
17344778,2024-03-08 13:00:00,Diaryan Aleksandr - Papyan Karen,1:3,11:9 - 13:15 - 12:14 - 5:11 - 0:0,1,3,Diaryan Aleksandr,Papyan Karen,fiurst,Diaryan Aleksandr - Papyan Karen,90,41,49,8,-8,20,28,26,16,0,-2,2,2,6,0,8,11:9 - 13:15 - 12:14 - 5:11 - 0:0
17344771,2024-03-08 12:15:00,Asatryan Murad - Rafayelyan Edgar,3:2,11:9 - 8:11 - 9:11 - 11:5 - 11:8,3,2,Asatryan Murad,Rafayelyan Edgar,fiurst,Asatryan Murad - Rafayelyan Edgar,94,50,44,-6,6,20,19,20,16,19,-2,3,2,-6,-3,-6,11:9 - 8:11 - 9:11 - 11:5 - 11:8
17344770,2024-03-08 12:05:00,Diaryan Aleksandr - Nazaryan Mushegh,3:1,9:11 - 13:11 - 11:4 - 11:5 - 0:0,3,1,Diaryan Aleksandr,Nazaryan Mushegh,fiurst,Diaryan Aleksandr - Nazaryan Mushegh,75,44,31,-13,13,20,24,15,16,0,2,-2,-7,-6,0,-13,9:11 - 13:11 - 11:4 - 11:5 - 0:0
17344768,2024-03-08 11:45:00,Papyan Karen - Asatryan Murad,3:2,3:11 - 11:7 - 12:10 - 11:13 - 6:11,2,3,Papyan Karen,Asatryan Murad,fiurst,Asatryan Murad - Papyan Karen,95,52,43,-9,9,14,18,22,24,17,-8,4,2,-2,-5,-9,11:3 - 7:11 - 10:12 - 13:11 - 11:6
17344767,2024-03-08 11:35:00,Diaryan Aleksandr - Rafayelyan Edgar,2:3,13:11 - 8:11 - 11:5 - 8:11 - 5:11,2,3,Diaryan Aleksandr,Rafayelyan Edgar,fiurst,Diaryan Aleksandr - Rafayelyan Edgar,94,45,49,4,-4,24,19,16,19,16,-2,3,-6,3,6,4,13:11 - 8:11 - 11:5 - 8:11 - 5:11
17344764,2024-03-08 11:20:00,Nazaryan Mushegh - Papyan Karen,3:2,11:9 - 9:11 - 6:11 - 11:9 - 11:9,3,2,Nazaryan Mushegh,Papyan Karen,fiurst,Nazaryan Mushegh - Papyan Karen,97,48,49,1,-1,20,20,17,20,20,-2,2,5,-2,-2,1,11:9 - 9:11 - 6:11 - 11:9 - 11:9
17344763,2024-03-08 11:00:00,Asatryan Murad - Diaryan Aleksandr,3:0,11:9 - 15:13 - 11:9 - 0:0 - 0:0,3,0,Asatryan Murad,Diaryan Aleksandr,fiurst,Asatryan Murad - Diaryan Aleksandr,68,37,31,-6,6,20,28,20,0,0,-2,-2,-2,0,0,-6,11:9 - 15:13 - 11:9 - 0:0 - 0:0
17344750,2024-03-08 10:50:00,Rafayelyan Edgar - Papyan Karen,1:3,9:11 - 11:3 - 11:8 - 11:8 - 0:0,3,1,Rafayelyan Edgar,Papyan Karen,fiurst,Papyan Karen - Rafayelyan Edgar,72,30,42,12,-12,20,14,19,19,0,-2,8,3,3,0,12,11:9 - 3:11 - 8:11 - 8:11 - 0:0
17344724,2024-03-08 10:30:00,Nazaryan Mushegh - Asatryan Murad,1:3,11:13 - 11:7 - 11:9 - 11:4 - 0:0,3,1,Nazaryan Mushegh,Asatryan Murad,fiurst,Asatryan Murad - Nazaryan Mushegh,77,33,44,11,-11,24,18,20,15,0,-2,4,2,7,0,11,13:11 - 7:11 - 9:11 - 4:11 - 0:0
17344712,2024-03-08 10:15:00,Papyan Karen - Diaryan Aleksandr,2:3,11:7 - 11:8 - 9:11 - 10:12 - 11:2,3,2,Papyan Karen,Diaryan Aleksandr,fiurst,Diaryan Aleksandr - Papyan Karen,92,40,52,12,-12,18,19,20,22,13,4,3,-2,-2,9,12,7:11 - 8:11 - 11:9 - 12:10 - 2:11
17344711,2024-03-08 10:00:00,Rafayelyan Edgar - Nazaryan Mushegh,0:3,11:9 - 11:6 - 11:6 - 0:0 - 0:0,3,0,Rafayelyan Edgar,Nazaryan Mushegh,fiurst,Nazaryan Mushegh - Rafayelyan Edgar,54,21,33,12,-12,20,17,17,0,0,2,5,5,0,0,12,9:11 - 6:11 - 6:11 - 0:0 - 0:0
17319887,2024-03-07 17:40:00,Karakhanyan Mher - Mkrtchyan Andranik,0:3,9:11 - 7:11 - 9:11 - 0:0 - 0:0,0,3,Karakhanyan Mher,Mkrtchyan Andranik,fiurst,Karakhanyan Mher - Mkrtchyan Andranik,58,25,33,8,-8,20,18,20,0,0,2,4,2,0,0,8,9:11 - 7:11 - 9:11 - 0:0 - 0:0
17319885,2024-03-07 17:30:00,Petrosyan Davit - Avakimyan Davit,3:0,9:11 - 6:11 - 3:11 - 0:0 - 0:0,0,3,Petrosyan Davit,Avakimyan Davit,fiurst,Avakimyan Davit - Petrosyan Davit,51,33,18,-15,15,20,17,14,0,0,-2,-5,-8,0,0,-15,11:9 - 11:6 - 11:3 - 0:0 - 0:0
17319875,2024-03-07 17:15:00,Gevorgyan Hayk - Karakhanyan Mher,3:0,11:3 - 11:7 - 11:5 - 0:0 - 0:0,3,0,Gevorgyan Hayk,Karakhanyan Mher,fiurst,Gevorgyan Hayk - Karakhanyan Mher,48,33,15,-18,18,14,18,16,0,0,-8,-4,-6,0,0,-18,11:3 - 11:7 - 11:5 - 0:0 - 0:0
17319871,2024-03-07 17:00:00,Petrosyan Davit - Mkrtchyan Andranik,0:3,11:6 - 12:10 - 11:8 - 0:0 - 0:0,3,0,Petrosyan Davit,Mkrtchyan Andranik,fiurst,Mkrtchyan Andranik - Petrosyan Davit,58,24,34,10,-10,17,22,19,0,0,5,2,3,0,0,10,6:11 - 10:12 - 8:11 - 0:0 - 0:0
17319870,2024-03-07 16:55:00,Avakimyan Davit - Gevorgyan Hayk,0:3,5:11 - 4:11 - 5:11 - 0:0 - 0:0,0,3,Avakimyan Davit,Gevorgyan Hayk,fiurst,Avakimyan Davit - Gevorgyan Hayk,47,14,33,19,-19,16,15,16,0,0,6,7,6,0,0,19,5:11 - 4:11 - 5:11 - 0:0 - 0:0
17319868,2024-03-07 16:30:00,Karakhanyan Mher - Petrosyan Davit,0:3,7:11 - 6:11 - 5:11 - 0:0 - 0:0,0,3,Karakhanyan Mher,Petrosyan Davit,fiurst,Karakhanyan Mher - Petrosyan Davit,51,18,33,15,-15,18,17,16,0,0,4,5,6,0,0,15,7:11 - 6:11 - 5:11 - 0:0 - 0:0
17319865,2024-03-07 16:25:00,Mkrtchyan Andranik - Gevorgyan Hayk,3:2,13:11 - 8:11 - 6:11 - 11:5 - 9:11,2,3,Mkrtchyan Andranik,Gevorgyan Hayk,fiurst,Gevorgyan Hayk - Mkrtchyan Andranik,96,49,47,-2,2,24,19,17,16,20,2,-3,-5,6,-2,-2,11:13 - 11:8 - 11:6 - 5:11 - 11:9
17319863,2024-03-07 16:00:00,Avakimyan Davit - Karakhanyan Mher,3:0,15:13 - 11:7 - 11:7 - 0:0 - 0:0,3,0,Avakimyan Davit,Karakhanyan Mher,fiurst,Avakimyan Davit - Karakhanyan Mher,64,37,27,-10,10,28,18,18,0,0,-2,-4,-4,0,0,-10,15:13 - 11:7 - 11:7 - 0:0 - 0:0
17319862,2024-03-07 15:50:00,Gevorgyan Hayk - Petrosyan Davit,2:3,11:8 - 8:11 - 4:11 - 11:6 - 10:12,2,3,Gevorgyan Hayk,Petrosyan Davit,fiurst,Gevorgyan Hayk - Petrosyan Davit,92,44,48,4,-4,19,19,15,17,22,-3,3,7,-5,2,4,11:8 - 8:11 - 4:11 - 11:6 - 10:12
17319860,2024-03-07 15:30:00,Mkrtchyan Andranik - Avakimyan Davit,2:3,6:11 - 11:7 - 11:6 - 8:11 - 12:10,3,2,Mkrtchyan Andranik,Avakimyan Davit,fiurst,Avakimyan Davit - Mkrtchyan Andranik,93,45,48,3,-3,17,18,17,19,22,-5,4,5,-3,2,3,11:6 - 7:11 - 6:11 - 11:8 - 10:12
17319846,2024-03-07 15:15:00,Soghomonyan Hrayr - Rafayelyan Edgar,3:1,7:11 - 11:8 - 4:11 - 3:11 - 0:0,1,3,Soghomonyan Hrayr,Rafayelyan Edgar,fiurst,Rafayelyan Edgar - Soghomonyan Hrayr,66,41,25,-16,16,18,19,15,14,0,-4,3,-7,-8,0,-16,11:7 - 8:11 - 11:4 - 11:3 - 0:0
17319844,2024-03-07 15:00:00,Papyan Karen - Nikoghosyan Narek,3:2,11:9 - 4:11 - 6:11 - 16:14 - 9:11,2,3,Papyan Karen,Nikoghosyan Narek,fiurst,Nikoghosyan Narek - Papyan Karen,102,56,46,-10,10,20,15,17,30,20,2,-7,-5,2,-2,-10,9:11 - 11:4 - 11:6 - 14:16 - 11:9
17319843,2024-03-07 14:45:00,Hovhannesyan Rafik - Soghomonyan Hrayr,2:3,11:4 - 6:11 - 11:5 - 12:14 - 9:11,2,3,Hovhannesyan Rafik,Soghomonyan Hrayr,fiurst,Hovhannesyan Rafik - Soghomonyan Hrayr,94,49,45,-4,4,15,17,16,26,20,-7,5,-6,2,2,-4,11:4 - 6:11 - 11:5 - 12:14 - 9:11
17319842,2024-03-07 14:30:00,Rafayelyan Edgar - Papyan Karen,1:3,9:11 - 11:6 - 14:12 - 11:4 - 0:0,3,1,Rafayelyan Edgar,Papyan Karen,fiurst,Papyan Karen - Rafayelyan Edgar,78,33,45,12,-12,20,17,26,15,0,-2,5,2,7,0,12,11:9 - 6:11 - 12:14 - 4:11 - 0:0
17319841,2024-03-07 14:20:00,Hovhannesyan Rafik - Nikoghosyan Narek,1:3,9:11 - 5:11 - 11:5 - 10:12 - 0:0,1,3,Hovhannesyan Rafik,Nikoghosyan Narek,fiurst,Hovhannesyan Rafik - Nikoghosyan Narek,74,35,39,4,-4,20,16,16,22,0,2,6,-6,2,0,4,9:11 - 5:11 - 11:5 - 10:12 - 0:0
17319831,2024-03-07 14:00:00,Soghomonyan Hrayr - Papyan Karen,3:0,13:15 - 11:13 - 7:11 - 0:0 - 0:0,0,3,Soghomonyan Hrayr,Papyan Karen,fiurst,Papyan Karen - Soghomonyan Hrayr,70,39,31,-8,8,28,24,18,0,0,-2,-2,-4,0,0,-8,15:13 - 13:11 - 11:7 - 0:0 - 0:0
17319830,2024-03-07 13:55:00,Rafayelyan Edgar - Hovhannesyan Rafik,0:3,11:8 - 11:8 - 11:7 - 0:0 - 0:0,3,0,Rafayelyan Edgar,Hovhannesyan Rafik,fiurst,Hovhannesyan Rafik - Rafayelyan Edgar,56,23,33,10,-10,19,19,18,0,0,3,3,4,0,0,10,8:11 - 8:11 - 7:11 - 0:0 - 0:0
17319826,2024-03-07 13:45:00,Nikoghosyan Narek - Soghomonyan Hrayr,3:0,11:6 - 11:7 - 11:6 - 0:0 - 0:0,3,0,Nikoghosyan Narek,Soghomonyan Hrayr,fiurst,Nikoghosyan Narek - Soghomonyan Hrayr,52,33,19,-14,14,17,18,17,0,0,-5,-4,-5,0,0,-14,11:6 - 11:7 - 11:6 - 0:0 - 0:0
17319825,2024-03-07 13:15:00,Papyan Karen - Hovhannesyan Rafik,2:3,7:11 - 12:10 - 9:11 - 11:4 - 12:10,3,2,Papyan Karen,Hovhannesyan Rafik,fiurst,Hovhannesyan Rafik - Papyan Karen,97,46,51,5,-5,18,22,20,15,22,-4,2,-2,7,2,5,11:7 - 10:12 - 11:9 - 4:11 - 10:12
17319824,2024-03-07 13:00:00,Nikoghosyan Narek - Rafayelyan Edgar,2:3,9:11 - 10:12 - 11:7 - 11:4 - 11:13,2,3,Nikoghosyan Narek,Rafayelyan Edgar,fiurst,Nikoghosyan Narek - Rafayelyan Edgar,99,52,47,-5,5,20,22,18,15,24,2,2,-4,-7,2,-5,9:11 - 10:12 - 11:7 - 11:4 - 11:13
17319822,2024-03-07 12:20:00,Soghomonyan Hrayr - Hovhannesyan Rafik,3:1,9:11 - 11:9 - 7:11 - 8:11 - 0:0,1,3,Soghomonyan Hrayr,Hovhannesyan Rafik,fiurst,Hovhannesyan Rafik - Soghomonyan Hrayr,77,42,35,-7,7,20,20,18,19,0,-2,2,-4,-3,0,-7,11:9 - 9:11 - 11:7 - 11:8 - 0:0
17319817,2024-03-07 12:00:00,Nikoghosyan Narek - Papyan Karen,3:2,11:6 - 11:7 - 9:11 - 9:11 - 11:8,3,2,Nikoghosyan Narek,Papyan Karen,fiurst,Nikoghosyan Narek - Papyan Karen,94,51,43,-8,8,17,18,20,20,19,-5,-4,2,2,-3,-8,11:6 - 11:7 - 9:11 - 9:11 - 11:8
17319808,2024-03-07 11:55:00,Rafayelyan Edgar - Soghomonyan Hrayr,3:1,6:11 - 11:5 - 11:9 - 11:4 - 0:0,3,1,Rafayelyan Edgar,Soghomonyan Hrayr,fiurst,Rafayelyan Edgar - Soghomonyan Hrayr,68,39,29,-10,10,17,16,20,15,0,5,-6,-2,-7,0,-10,6:11 - 11:5 - 11:9 - 11:4 - 0:0
17319805,2024-03-07 11:30:00,Nikoghosyan Narek - Hovhannesyan Rafik,0:3,12:10 - 12:10 - 11:5 - 0:0 - 0:0,3,0,Nikoghosyan Narek,Hovhannesyan Rafik,fiurst,Hovhannesyan Rafik - Nikoghosyan Narek,60,25,35,10,-10,22,22,16,0,0,2,2,6,0,0,10,10:12 - 10:12 - 5:11 - 0:0 - 0:0
17319803,2024-03-07 11:15:00,Papyan Karen - Rafayelyan Edgar,3:0,11:9 - 11:8 - 11:9 - 0:0 - 0:0,3,0,Papyan Karen,Rafayelyan Edgar,fiurst,Papyan Karen - Rafayelyan Edgar,59,33,26,-7,7,20,19,20,0,0,-2,-3,-2,0,0,-7,11:9 - 11:8 - 11:9 - 0:0 - 0:0
17319801,2024-03-07 11:00:00,Soghomonyan Hrayr - Nikoghosyan Narek,1:3,11:7 - 11:4 - 6:11 - 11:8 - 0:0,3,1,Soghomonyan Hrayr,Nikoghosyan Narek,fiurst,Nikoghosyan Narek - Soghomonyan Hrayr,69,30,39,9,-9,18,15,17,19,0,4,7,-5,3,0,9,7:11 - 4:11 - 11:6 - 8:11 - 0:0
17279226,2024-03-07 10:50:00,Hovhannesyan Rafik - Rafayelyan Edgar,1:3,11:9 - 3:11 - 6:11 - 7:11 - 0:0,1,3,Hovhannesyan Rafik,Rafayelyan Edgar,fiurst,Hovhannesyan Rafik - Rafayelyan Edgar,69,27,42,15,-15,20,14,17,18,0,-2,8,5,4,0,15,11:9 - 3:11 - 6:11 - 7:11 - 0:0
17279219,2024-03-07 10:30:00,Papyan Karen - Soghomonyan Hrayr,3:1,11:5 - 11:9 - 7:11 - 11:8 - 0:0,3,1,Papyan Karen,Soghomonyan Hrayr,fiurst,Papyan Karen - Soghomonyan Hrayr,73,40,33,-7,7,16,20,18,19,0,-6,-2,4,-3,0,-7,11:5 - 11:9 - 7:11 - 11:8 - 0:0
17279210,2024-03-07 10:15:00,Rafayelyan Edgar - Nikoghosyan Narek,3:1,8:11 - 11:9 - 6:11 - 10:12 - 0:0,1,3,Rafayelyan Edgar,Nikoghosyan Narek,fiurst,Nikoghosyan Narek - Rafayelyan Edgar,78,43,35,-8,8,19,20,17,22,0,-3,2,-5,-2,0,-8,11:8 - 9:11 - 11:6 - 12:10 - 0:0
17279208,2024-03-07 10:00:00,Hovhannesyan Rafik - Papyan Karen,0:3,6:11 - 6:11 - 3:11 - 0:0 - 0:0,0,3,Hovhannesyan Rafik,Papyan Karen,fiurst,Hovhannesyan Rafik - Papyan Karen,48,15,33,18,-18,17,17,14,0,0,5,5,8,0,0,18,6:11 - 6:11 - 3:11 - 0:0 - 0:0
17300579,2024-03-06 17:45:00,Mkrtchyan Andranik - Karakhanyan Mher,0:3,11:4 - 11:9 - 11:3 - 0:0 - 0:0,3,0,Mkrtchyan Andranik,Karakhanyan Mher,fiurst,Karakhanyan Mher - Mkrtchyan Andranik,49,16,33,17,-17,15,20,14,0,0,7,2,8,0,0,17,4:11 - 9:11 - 3:11 - 0:0 - 0:0
17300577,2024-03-06 17:30:00,Gevorgyan Gegham - Arutyunov Ruben,3:0,2:11 - 2:11 - 2:11 - 0:0 - 0:0,0,3,Gevorgyan Gegham,Arutyunov Ruben,fiurst,Arutyunov Ruben - Gevorgyan Gegham,39,33,6,-27,27,13,13,13,0,0,-9,-9,-9,0,0,-27,11:2 - 11:2 - 11:2 - 0:0 - 0:0
17300575,2024-03-06 17:15:00,Avakimyan Davit - Mkrtchyan Andranik,3:2,8:11 - 10:12 - 11:9 - 14:12 - 11:7,3,2,Avakimyan Davit,Mkrtchyan Andranik,fiurst,Avakimyan Davit - Mkrtchyan Andranik,105,54,51,-3,3,19,22,20,26,18,3,2,-2,-2,-4,-3,8:11 - 10:12 - 11:9 - 14:12 - 11:7
17300565,2024-03-06 17:00:00,Gevorgyan Gegham - Karakhanyan Mher,3:0,11:7 - 11:3 - 12:10 - 0:0 - 0:0,3,0,Gevorgyan Gegham,Karakhanyan Mher,fiurst,Gevorgyan Gegham - Karakhanyan Mher,54,34,20,-14,14,18,14,22,0,0,-4,-8,-2,0,0,-14,11:7 - 11:3 - 12:10 - 0:0 - 0:0
17300554,2024-03-06 16:45:00,Arutyunov Ruben - Avakimyan Davit,3:0,11:4 - 11:3 - 11:8 - 0:0 - 0:0,3,0,Arutyunov Ruben,Avakimyan Davit,fiurst,Arutyunov Ruben - Avakimyan Davit,48,33,15,-18,18,15,14,19,0,0,-7,-8,-3,0,0,-18,11:4 - 11:3 - 11:8 - 0:0 - 0:0
17300550,2024-03-06 16:30:00,Mkrtchyan Andranik - Gevorgyan Gegham,1:3,12:14 - 13:11 - 11:5 - 11:8 - 0:0,3,1,Mkrtchyan Andranik,Gevorgyan Gegham,fiurst,Gevorgyan Gegham - Mkrtchyan Andranik,85,38,47,9,-9,26,24,16,19,0,-2,2,6,3,0,9,14:12 - 11:13 - 5:11 - 8:11 - 0:0
17300549,2024-03-06 16:20:00,Karakhanyan Mher - Avakimyan Davit,3:0,14:16 - 5:11 - 7:11 - 0:0 - 0:0,0,3,Karakhanyan Mher,Avakimyan Davit,fiurst,Avakimyan Davit - Karakhanyan Mher,64,38,26,-12,12,30,16,18,0,0,-2,-6,-4,0,0,-12,16:14 - 11:5 - 11:7 - 0:0 - 0:0
17300547,2024-03-06 16:00:00,Arutyunov Ruben - Mkrtchyan Andranik,3:1,11:13 - 11:4 - 11:9 - 11:1 - 0:0,3,1,Arutyunov Ruben,Mkrtchyan Andranik,fiurst,Arutyunov Ruben - Mkrtchyan Andranik,71,44,27,-17,17,24,15,20,12,0,2,-7,-2,-10,0,-17,11:13 - 11:4 - 11:9 - 11:1 - 0:0
17300544,2024-03-06 15:50:00,Avakimyan Davit - Gevorgyan Gegham,3:2,11:5 - 7:11 - 12:10 - 5:11 - 11:9,3,2,Avakimyan Davit,Gevorgyan Gegham,fiurst,Avakimyan Davit - Gevorgyan Gegham,92,46,46,0,0,16,18,22,16,20,-6,4,-2,6,-2,0,11:5 - 7:11 - 12:10 - 5:11 - 11:9
17300537,2024-03-06 15:30:00,Karakhanyan Mher - Arutyunov Ruben,3:1,12:10 - 7:11 - 6:11 - 7:11 - 0:0,1,3,Karakhanyan Mher,Arutyunov Ruben,fiurst,Arutyunov Ruben - Karakhanyan Mher,75,43,32,-11,11,22,18,17,18,0,2,-4,-5,-4,0,-11,10:12 - 11:7 - 11:6 - 11:7 - 0:0
17300536,2024-03-06 15:25:00,Hovhannesyan Rafik - Nikoghosyan Narek,2:3,11:5 - 14:12 - 3:11 - 1:11 - 11:13,2,3,Hovhannesyan Rafik,Nikoghosyan Narek,fiurst,Hovhannesyan Rafik - Nikoghosyan Narek,92,40,52,12,-12,16,26,14,12,24,-6,-2,8,10,2,12,11:5 - 14:12 - 3:11 - 1:11 - 11:13
17300524,2024-03-06 15:10:00,Soghomonyan Hrayr - Nazaryan Mushegh,3:1,11:9 - 8:11 - 6:11 - 3:11 - 0:0,1,3,Soghomonyan Hrayr,Nazaryan Mushegh,fiurst,Nazaryan Mushegh - Soghomonyan Hrayr,70,42,28,-14,14,20,19,17,14,0,2,-3,-5,-8,0,-14,9:11 - 11:8 - 11:6 - 11:3 - 0:0
17300520,2024-03-06 15:05:00,Diaryan Aleksandr - Hovhannesyan Rafik,3:0,11:4 - 14:12 - 11:5 - 0:0 - 0:0,3,0,Diaryan Aleksandr,Hovhannesyan Rafik,fiurst,Diaryan Aleksandr - Hovhannesyan Rafik,57,36,21,-15,15,15,26,16,0,0,-7,-2,-6,0,0,-15,11:4 - 14:12 - 11:5 - 0:0 - 0:0
17300512,2024-03-06 14:35:00,Diaryan Aleksandr - Nazaryan Mushegh,2:3,11:7 - 7:11 - 8:11 - 11:8 - 6:11,2,3,Diaryan Aleksandr,Nazaryan Mushegh,fiurst,Diaryan Aleksandr - Nazaryan Mushegh,91,43,48,5,-5,18,18,19,19,17,-4,4,3,-3,5,5,11:7 - 7:11 - 8:11 - 11:8 - 6:11
17300517,2024-03-06 14:35:00,Nikoghosyan Narek - Soghomonyan Hrayr,3:2,5:11 - 11:9 - 8:11 - 11:3 - 11:4,3,2,Nikoghosyan Narek,Soghomonyan Hrayr,fiurst,Nikoghosyan Narek - Soghomonyan Hrayr,84,46,38,-8,8,16,20,19,14,15,6,-2,3,-8,-7,-8,5:11 - 11:9 - 8:11 - 11:3 - 11:4
17300510,2024-03-06 14:00:00,Hovhannesyan Rafik - Soghomonyan Hrayr,2:3,9:11 - 5:11 - 11:7 - 14:12 - 10:12,2,3,Hovhannesyan Rafik,Soghomonyan Hrayr,fiurst,Hovhannesyan Rafik - Soghomonyan Hrayr,102,49,53,4,-4,20,16,18,26,22,2,6,-4,-2,2,4,9:11 - 5:11 - 11:7 - 14:12 - 10:12
17300499,2024-03-06 13:45:00,Nikoghosyan Narek - Diaryan Aleksandr,2:3,8:11 - 12:10 - 11:13 - 11:4 - 11:9,3,2,Nikoghosyan Narek,Diaryan Aleksandr,fiurst,Diaryan Aleksandr - Nikoghosyan Narek,100,47,53,6,-6,19,22,24,15,20,-3,2,-2,7,2,6,11:8 - 10:12 - 13:11 - 4:11 - 9:11
17300494,2024-03-06 13:40:00,Nazaryan Mushegh - Hovhannesyan Rafik,0:3,11:6 - 11:8 - 11:5 - 0:0 - 0:0,3,0,Nazaryan Mushegh,Hovhannesyan Rafik,fiurst,Hovhannesyan Rafik - Nazaryan Mushegh,52,19,33,14,-14,17,19,16,0,0,5,3,6,0,0,14,6:11 - 8:11 - 5:11 - 0:0 - 0:0
17300492,2024-03-06 13:15:00,Soghomonyan Hrayr - Diaryan Aleksandr,3:1,7:11 - 7:11 - 11:8 - 7:11 - 0:0,1,3,Soghomonyan Hrayr,Diaryan Aleksandr,fiurst,Diaryan Aleksandr - Soghomonyan Hrayr,73,41,32,-9,9,18,18,19,18,0,-4,-4,3,-4,0,-9,11:7 - 11:7 - 8:11 - 11:7 - 0:0
17300486,2024-03-06 13:00:00,Nazaryan Mushegh - Nikoghosyan Narek,2:3,11:5 - 7:11 - 11:9 - 11:13 - 7:11,2,3,Nazaryan Mushegh,Nikoghosyan Narek,fiurst,Nazaryan Mushegh - Nikoghosyan Narek,96,47,49,2,-2,16,18,20,24,18,-6,4,-2,2,4,2,11:5 - 7:11 - 11:9 - 11:13 - 7:11
17300482,2024-03-06 12:40:00,Hovhannesyan Rafik - Diaryan Aleksandr,3:1,11:8 - 8:11 - 10:12 - 5:11 - 0:0,1,3,Hovhannesyan Rafik,Diaryan Aleksandr,fiurst,Diaryan Aleksandr - Hovhannesyan Rafik,76,42,34,-8,8,19,19,22,16,0,3,-3,-2,-6,0,-8,8:11 - 11:8 - 12:10 - 11:5 - 0:0
17300479,2024-03-06 12:00:00,Nazaryan Mushegh - Soghomonyan Hrayr,1:3,11:7 - 10:12 - 9:11 - 6:11 - 0:0,1,3,Nazaryan Mushegh,Soghomonyan Hrayr,fiurst,Nazaryan Mushegh - Soghomonyan Hrayr,77,36,41,5,-5,18,22,20,17,0,-4,2,2,5,0,5,11:7 - 10:12 - 9:11 - 6:11 - 0:0
17300477,2024-03-06 11:55:00,Nikoghosyan Narek - Hovhannesyan Rafik,3:2,13:11 - 4:11 - 11:8 - 6:11 - 9:11,2,3,Nikoghosyan Narek,Hovhannesyan Rafik,fiurst,Hovhannesyan Rafik - Nikoghosyan Narek,95,52,43,-9,9,24,15,19,17,20,2,-7,3,-5,-2,-9,11:13 - 11:4 - 8:11 - 11:6 - 11:9
17300460,2024-03-06 11:30:00,Nazaryan Mushegh - Diaryan Aleksandr,3:0,6:11 - 2:11 - 4:11 - 0:0 - 0:0,0,3,Nazaryan Mushegh,Diaryan Aleksandr,fiurst,Diaryan Aleksandr - Nazaryan Mushegh,45,33,12,-21,21,17,13,15,0,0,-5,-9,-7,0,0,-21,11:6 - 11:2 - 11:4 - 0:0 - 0:0
17300458,2024-03-06 11:25:00,Soghomonyan Hrayr - Nikoghosyan Narek,3:2,4:11 - 12:10 - 11:6 - 2:11 - 5:11,2,3,Soghomonyan Hrayr,Nikoghosyan Narek,fiurst,Nikoghosyan Narek - Soghomonyan Hrayr,83,49,34,-15,15,15,22,17,13,16,-7,2,5,-9,-6,-15,11:4 - 10:12 - 6:11 - 11:2 - 11:5
17300457,2024-03-06 11:00:00,Hovhannesyan Rafik - Nazaryan Mushegh,0:3,8:11 - 9:11 - 9:11 - 0:0 - 0:0,0,3,Hovhannesyan Rafik,Nazaryan Mushegh,fiurst,Hovhannesyan Rafik - Nazaryan Mushegh,59,26,33,7,-7,19,20,20,0,0,3,2,2,0,0,7,8:11 - 9:11 - 9:11 - 0:0 - 0:0
17300454,2024-03-06 10:45:00,Diaryan Aleksandr - Nikoghosyan Narek,1:3,11:6 - 2:11 - 8:11 - 7:11 - 0:0,1,3,Diaryan Aleksandr,Nikoghosyan Narek,fiurst,Diaryan Aleksandr - Nikoghosyan Narek,67,28,39,11,-11,17,13,19,18,0,-5,9,3,4,0,11,11:6 - 2:11 - 8:11 - 7:11 - 0:0
17300451,2024-03-06 10:30:00,Soghomonyan Hrayr - Hovhannesyan Rafik,3:2,8:11 - 11:5 - 8:11 - 12:10 - 5:11,2,3,Soghomonyan Hrayr,Hovhannesyan Rafik,fiurst,Hovhannesyan Rafik - Soghomonyan Hrayr,92,48,44,-4,4,19,16,19,22,16,-3,6,-3,2,-6,-4,11:8 - 5:11 - 11:8 - 10:12 - 11:5
17300450,2024-03-06 10:15:00,Nikoghosyan Narek - Nazaryan Mushegh,2:3,6:11 - 6:11 - 11:6 - 11:7 - 18:16,3,2,Nikoghosyan Narek,Nazaryan Mushegh,fiurst,Nazaryan Mushegh - Nikoghosyan Narek,103,51,52,1,-1,17,17,17,18,34,-5,-5,5,4,2,1,11:6 - 11:6 - 6:11 - 7:11 - 16:18
17300438,2024-03-06 10:00:00,Diaryan Aleksandr - Soghomonyan Hrayr,3:0,11:6 - 11:6 - 12:10 - 0:0 - 0:0,3,0,Diaryan Aleksandr,Soghomonyan Hrayr,fiurst,Diaryan Aleksandr - Soghomonyan Hrayr,56,34,22,-12,12,17,17,22,0,0,-5,-5,-2,0,0,-12,11:6 - 11:6 - 12:10 - 0:0 - 0:0
17279206,2024-03-05 16:35:00,Gevorgyan Hayk - Arutyunov Ruben,3:1,9:11 - 5:11 - 14:12 - 5:11 - 0:0,1,3,Gevorgyan Hayk,Arutyunov Ruben,fiurst,Arutyunov Ruben - Gevorgyan Hayk,78,45,33,-12,12,20,16,26,16,0,-2,-6,2,-6,0,-12,11:9 - 11:5 - 12:14 - 11:5 - 0:0
17279202,2024-03-05 16:30:00,Gevorgyan Gegham - Petrosyan Davit,0:3,10:12 - 11:13 - 4:11 - 0:0 - 0:0,0,3,Gevorgyan Gegham,Petrosyan Davit,fiurst,Gevorgyan Gegham - Petrosyan Davit,61,25,36,11,-11,22,24,15,0,0,2,2,7,0,0,11,10:12 - 11:13 - 4:11 - 0:0 - 0:0
17279198,2024-03-05 16:15:00,Avakimyan Davit - Arutyunov Ruben,3:0,9:11 - 0:11 - 12:14 - 0:0 - 0:0,0,3,Avakimyan Davit,Arutyunov Ruben,fiurst,Arutyunov Ruben - Avakimyan Davit,57,36,21,-15,15,20,11,26,0,0,-2,-11,-2,0,0,-15,11:9 - 11:0 - 14:12 - 0:0 - 0:0
17279196,2024-03-05 16:00:00,Gevorgyan Hayk - Gevorgyan Gegham,0:3,13:11 - 12:10 - 11:6 - 0:0 - 0:0,3,0,Gevorgyan Hayk,Gevorgyan Gegham,fiurst,Gevorgyan Gegham - Gevorgyan Hayk,63,27,36,9,-9,24,22,17,0,0,2,2,5,0,0,9,11:13 - 10:12 - 6:11 - 0:0 - 0:0
17279191,2024-03-05 15:45:00,Arutyunov Ruben - Petrosyan Davit,3:0,11:6 - 11:8 - 11:6 - 0:0 - 0:0,3,0,Arutyunov Ruben,Petrosyan Davit,fiurst,Arutyunov Ruben - Petrosyan Davit,53,33,20,-13,13,17,19,17,0,0,-5,-3,-5,0,0,-13,11:6 - 11:8 - 11:6 - 0:0 - 0:0
17279188,2024-03-05 15:30:00,Avakimyan Davit - Gevorgyan Hayk,0:3,6:11 - 6:11 - 3:11 - 0:0 - 0:0,0,3,Avakimyan Davit,Gevorgyan Hayk,fiurst,Avakimyan Davit - Gevorgyan Hayk,48,15,33,18,-18,17,17,14,0,0,5,5,8,0,0,18,6:11 - 6:11 - 3:11 - 0:0 - 0:0
17279178,2024-03-05 15:15:00,Rafayelyan Edgar - Papyan Karen,2:3,8:11 - 9:11 - 11:7 - 12:10 - 11:8,3,2,Rafayelyan Edgar,Papyan Karen,fiurst,Papyan Karen - Rafayelyan Edgar,98,47,51,4,-4,19,20,18,22,19,-3,-2,4,2,3,4,11:8 - 11:9 - 7:11 - 10:12 - 8:11
17279166,2024-03-05 15:00:00,Diaryan Aleksandr - Hovhannesyan Rafik,3:0,11:5 - 13:11 - 11:7 - 0:0 - 0:0,3,0,Diaryan Aleksandr,Hovhannesyan Rafik,fiurst,Diaryan Aleksandr - Hovhannesyan Rafik,58,35,23,-12,12,16,24,18,0,0,-6,-2,-4,0,0,-12,11:5 - 13:11 - 11:7 - 0:0 - 0:0
17279159,2024-03-05 14:55:00,Nazaryan Mushegh - Rafayelyan Edgar,0:3,9:11 - 5:11 - 5:11 - 0:0 - 0:0,0,3,Nazaryan Mushegh,Rafayelyan Edgar,fiurst,Nazaryan Mushegh - Rafayelyan Edgar,52,19,33,14,-14,20,16,16,0,0,2,6,6,0,0,14,9:11 - 5:11 - 5:11 - 0:0 - 0:0
17279157,2024-03-05 14:30:00,Papyan Karen - Diaryan Aleksandr,1:3,11:6 - 12:10 - 9:11 - 11:9 - 0:0,3,1,Papyan Karen,Diaryan Aleksandr,fiurst,Diaryan Aleksandr - Papyan Karen,79,36,43,7,-7,17,22,20,20,0,5,2,-2,2,0,7,6:11 - 10:12 - 11:9 - 9:11 - 0:0
17279156,2024-03-05 14:20:00,Nazaryan Mushegh - Hovhannesyan Rafik,3:2,7:11 - 11:9 - 12:14 - 11:5 - 7:11,2,3,Nazaryan Mushegh,Hovhannesyan Rafik,fiurst,Hovhannesyan Rafik - Nazaryan Mushegh,98,50,48,-2,2,18,20,26,16,18,-4,2,-2,6,-4,-2,11:7 - 9:11 - 14:12 - 5:11 - 11:7
17279145,2024-03-05 14:00:00,Rafayelyan Edgar - Diaryan Aleksandr,3:0,9:11 - 4:11 - 5:11 - 0:0 - 0:0,0,3,Rafayelyan Edgar,Diaryan Aleksandr,fiurst,Diaryan Aleksandr - Rafayelyan Edgar,51,33,18,-15,15,20,15,16,0,0,-2,-7,-6,0,0,-15,11:9 - 11:4 - 11:5 - 0:0 - 0:0
17279142,2024-03-05 13:45:00,Papyan Karen - Nazaryan Mushegh,1:3,6:11 - 11:5 - 11:8 - 11:9 - 0:0,3,1,Papyan Karen,Nazaryan Mushegh,fiurst,Nazaryan Mushegh - Papyan Karen,72,33,39,6,-6,17,16,19,20,0,-5,6,3,2,0,6,11:6 - 5:11 - 8:11 - 9:11 - 0:0
17279141,2024-03-05 13:30:00,Hovhannesyan Rafik - Rafayelyan Edgar,1:3,5:11 - 11:9 - 11:13 - 11:13 - 0:0,1,3,Hovhannesyan Rafik,Rafayelyan Edgar,fiurst,Hovhannesyan Rafik - Rafayelyan Edgar,84,38,46,8,-8,16,20,24,24,0,6,-2,2,2,0,8,5:11 - 11:9 - 11:13 - 11:13 - 0:0
17279137,2024-03-05 13:15:00,Diaryan Aleksandr - Nazaryan Mushegh,3:0,11:9 - 11:6 - 11:3 - 0:0 - 0:0,3,0,Diaryan Aleksandr,Nazaryan Mushegh,fiurst,Diaryan Aleksandr - Nazaryan Mushegh,51,33,18,-15,15,20,17,14,0,0,-2,-5,-8,0,0,-15,11:9 - 11:6 - 11:3 - 0:0 - 0:0
17279133,2024-03-05 13:05:00,Hovhannesyan Rafik - Papyan Karen,0:3,10:12 - 5:11 - 9:11 - 0:0 - 0:0,0,3,Hovhannesyan Rafik,Papyan Karen,fiurst,Hovhannesyan Rafik - Papyan Karen,58,24,34,10,-10,22,16,20,0,0,2,6,2,0,0,10,10:12 - 5:11 - 9:11 - 0:0 - 0:0
17279130,2024-03-05 12:15:00,Rafayelyan Edgar - Nazaryan Mushegh,0:3,11:5 - 11:7 - 11:8 - 0:0 - 0:0,3,0,Rafayelyan Edgar,Nazaryan Mushegh,fiurst,Nazaryan Mushegh - Rafayelyan Edgar,53,20,33,13,-13,16,18,19,0,0,6,4,3,0,0,13,5:11 - 7:11 - 8:11 - 0:0 - 0:0
17279127,2024-03-05 12:00:00,Hovhannesyan Rafik - Diaryan Aleksandr,3:0,6:11 - 8:11 - 6:11 - 0:0 - 0:0,0,3,Hovhannesyan Rafik,Diaryan Aleksandr,fiurst,Diaryan Aleksandr - Hovhannesyan Rafik,53,33,20,-13,13,17,19,17,0,0,-5,-3,-5,0,0,-13,11:6 - 11:8 - 11:6 - 0:0 - 0:0
17279125,2024-03-05 11:50:00,Papyan Karen - Rafayelyan Edgar,3:1,12:10 - 7:11 - 11:7 - 11:7 - 0:0,3,1,Papyan Karen,Rafayelyan Edgar,fiurst,Papyan Karen - Rafayelyan Edgar,76,41,35,-6,6,22,18,18,18,0,-2,4,-4,-4,0,-6,12:10 - 7:11 - 11:7 - 11:7 - 0:0
17279124,2024-03-05 11:30:00,Hovhannesyan Rafik - Nazaryan Mushegh,1:3,11:7 - 9:11 - 8:11 - 10:12 - 0:0,1,3,Hovhannesyan Rafik,Nazaryan Mushegh,fiurst,Hovhannesyan Rafik - Nazaryan Mushegh,79,38,41,3,-3,18,20,19,22,0,-4,2,3,2,0,3,11:7 - 9:11 - 8:11 - 10:12 - 0:0
17279117,2024-03-05 11:15:00,Diaryan Aleksandr - Papyan Karen,3:1,11:5 - 11:4 - 9:11 - 13:11 - 0:0,3,1,Diaryan Aleksandr,Papyan Karen,fiurst,Diaryan Aleksandr - Papyan Karen,75,44,31,-13,13,16,15,20,24,0,-6,-7,2,-2,0,-13,11:5 - 11:4 - 9:11 - 13:11 - 0:0
17279111,2024-03-05 11:00:00,Rafayelyan Edgar - Hovhannesyan Rafik,1:3,11:5 - 11:6 - 5:11 - 11:9 - 0:0,3,1,Rafayelyan Edgar,Hovhannesyan Rafik,fiurst,Hovhannesyan Rafik - Rafayelyan Edgar,69,31,38,7,-7,16,17,16,20,0,6,5,-6,2,0,7,5:11 - 6:11 - 11:5 - 9:11 - 0:0
17279109,2024-03-05 10:50:00,Nazaryan Mushegh - Papyan Karen,1:3,11:5 - 10:12 - 5:11 - 9:11 - 0:0,1,3,Nazaryan Mushegh,Papyan Karen,fiurst,Nazaryan Mushegh - Papyan Karen,74,35,39,4,-4,16,22,16,20,0,-6,2,6,2,0,4,11:5 - 10:12 - 5:11 - 9:11 - 0:0
17279108,2024-03-05 10:30:00,Diaryan Aleksandr - Rafayelyan Edgar,3:2,12:10 - 8:11 - 12:10 - 4:11 - 11:6,3,2,Diaryan Aleksandr,Rafayelyan Edgar,fiurst,Diaryan Aleksandr - Rafayelyan Edgar,95,47,48,1,-1,22,19,22,15,17,-2,3,-2,7,-5,1,12:10 - 8:11 - 12:10 - 4:11 - 11:6
17279100,2024-03-05 10:15:00,Papyan Karen - Hovhannesyan Rafik,1:3,11:13 - 11:6 - 11:7 - 11:6 - 0:0,3,1,Papyan Karen,Hovhannesyan Rafik,fiurst,Hovhannesyan Rafik - Papyan Karen,76,32,44,12,-12,24,17,18,17,0,-2,5,4,5,0,12,13:11 - 6:11 - 7:11 - 6:11 - 0:0
17279096,2024-03-05 10:00:00,Nazaryan Mushegh - Diaryan Aleksandr,3:2,11:8 - 8:11 - 6:11 - 12:10 - 12:14,2,3,Nazaryan Mushegh,Diaryan Aleksandr,fiurst,Diaryan Aleksandr - Nazaryan Mushegh,103,54,49,-5,5,19,19,17,22,26,3,-3,-5,2,-2,-5,8:11 - 11:8 - 11:6 - 10:12 - 14:12
17266007,2024-03-04 17:45:00,Gevorgyan Hayk - Petrosyan Davit,3:1,11:9 - 11:3 - 4:11 - 19:17 - 0:0,3,1,Gevorgyan Hayk,Petrosyan Davit,fiurst,Gevorgyan Hayk - Petrosyan Davit,85,45,40,-5,5,20,14,15,36,0,-2,-8,7,-2,0,-5,11:9 - 11:3 - 4:11 - 19:17 - 0:0
17266003,2024-03-04 17:30:00,Mkrtchyan Andranik - Arutyunov Ruben,3:1,7:11 - 7:11 - 13:11 - 2:11 - 0:0,1,3,Mkrtchyan Andranik,Arutyunov Ruben,fiurst,Arutyunov Ruben - Mkrtchyan Andranik,73,44,29,-15,15,18,18,24,13,0,-4,-4,2,-9,0,-15,11:7 - 11:7 - 11:13 - 11:2 - 0:0
17266002,2024-03-04 17:15:00,Karakhanyan Mher - Gevorgyan Hayk,3:0,6:11 - 7:11 - 3:11 - 0:0 - 0:0,0,3,Karakhanyan Mher,Gevorgyan Hayk,fiurst,Gevorgyan Hayk - Karakhanyan Mher,49,33,16,-17,17,17,18,14,0,0,-5,-4,-8,0,0,-17,11:6 - 11:7 - 11:3 - 0:0 - 0:0
17266000,2024-03-04 17:00:00,Mkrtchyan Andranik - Petrosyan Davit,3:0,11:9 - 11:6 - 16:14 - 0:0 - 0:0,3,0,Mkrtchyan Andranik,Petrosyan Davit,fiurst,Mkrtchyan Andranik - Petrosyan Davit,67,38,29,-9,9,20,17,30,0,0,-2,-5,-2,0,0,-9,11:9 - 11:6 - 16:14 - 0:0 - 0:0
17265998,2024-03-04 16:45:00,Arutyunov Ruben - Karakhanyan Mher,3:0,11:6 - 14:12 - 11:5 - 0:0 - 0:0,3,0,Arutyunov Ruben,Karakhanyan Mher,fiurst,Arutyunov Ruben - Karakhanyan Mher,59,36,23,-13,13,17,26,16,0,0,-5,-2,-6,0,0,-13,11:6 - 14:12 - 11:5 - 0:0 - 0:0
17264529,2024-03-04 16:40:00,Gevorgyan Hayk - Mkrtchyan Andranik,1:3,11:9 - 4:11 - 11:13 - 4:11 - 0:0,1,3,Gevorgyan Hayk,Mkrtchyan Andranik,fiurst,Gevorgyan Hayk - Mkrtchyan Andranik,74,30,44,14,-14,20,15,24,15,0,-2,7,2,7,0,14,11:9 - 4:11 - 11:13 - 4:11 - 0:0
17264524,2024-03-04 16:15:00,Petrosyan Davit - Karakhanyan Mher,0:3,11:8 - 11:4 - 11:5 - 0:0 - 0:0,3,0,Petrosyan Davit,Karakhanyan Mher,fiurst,Karakhanyan Mher - Petrosyan Davit,50,17,33,16,-16,19,15,16,0,0,3,7,6,0,0,16,8:11 - 4:11 - 5:11 - 0:0 - 0:0
17264519,2024-03-04 16:00:00,Arutyunov Ruben - Gevorgyan Hayk,2:3,11:5 - 10:12 - 8:11 - 11:8 - 8:11,2,3,Arutyunov Ruben,Gevorgyan Hayk,fiurst,Arutyunov Ruben - Gevorgyan Hayk,95,48,47,-1,1,16,22,19,19,19,-6,2,3,-3,3,-1,11:5 - 10:12 - 8:11 - 11:8 - 8:11
17264514,2024-03-04 15:45:00,Karakhanyan Mher - Mkrtchyan Andranik,0:0,0:0 - 0:0 - 0:0 - 0:0 - 0:0,0,0,Karakhanyan Mher,Mkrtchyan Andranik,fiurst,Karakhanyan Mher - Mkrtchyan Andranik,0,0,0,0,0,0,0,0,0,0,0,0,0,0,0,0,0:0 - 0:0 - 0:0 - 0:0 - 0:0
17264504,2024-03-04 15:30:00,Diaryan Aleksandr - Soghomonyan Hrayr,3:0,11:4 - 11:2 - 11:4 - 0:0 - 0:0,3,0,Diaryan Aleksandr,Soghomonyan Hrayr,fiurst,Diaryan Aleksandr - Soghomonyan Hrayr,43,33,10,-23,23,15,13,15,0,0,-7,-9,-7,0,0,-23,11:4 - 11:2 - 11:4 - 0:0 - 0:0
17264512,2024-03-04 15:30:00,Petrosyan Davit - Arutyunov Ruben,3:0,4:11 - 7:11 - 6:11 - 0:0 - 0:0,0,3,Petrosyan Davit,Arutyunov Ruben,fiurst,Arutyunov Ruben - Petrosyan Davit,50,33,17,-16,16,15,18,17,0,0,-7,-4,-5,0,0,-16,11:4 - 11:7 - 11:6 - 0:0 - 0:0
17264495,2024-03-04 15:00:00,Nikoghosyan Narek - Rafayelyan Edgar,3:1,11:9 - 8:11 - 11:9 - 11:5 - 0:0,3,1,Nikoghosyan Narek,Rafayelyan Edgar,fiurst,Nikoghosyan Narek - Rafayelyan Edgar,75,41,34,-7,7,20,19,20,16,0,-2,3,-2,-6,0,-7,11:9 - 8:11 - 11:9 - 11:5 - 0:0
17264489,2024-03-04 14:55:00,Papyan Karen - Diaryan Aleksandr,3:2,11:9 - 11:9 - 7:11 - 4:11 - 12:14,2,3,Papyan Karen,Diaryan Aleksandr,fiurst,Diaryan Aleksandr - Papyan Karen,99,54,45,-9,9,20,20,18,15,26,2,2,-4,-7,-2,-9,9:11 - 9:11 - 11:7 - 11:4 - 14:12
17264487,2024-03-04 14:35:00,Soghomonyan Hrayr - Nikoghosyan Narek,3:0,5:11 - 9:11 - 11:13 - 0:0 - 0:0,0,3,Soghomonyan Hrayr,Nikoghosyan Narek,fiurst,Nikoghosyan Narek - Soghomonyan Hrayr,60,35,25,-10,10,16,20,24,0,0,-6,-2,-2,0,0,-10,11:5 - 11:9 - 13:11 - 0:0 - 0:0
17264484,2024-03-04 14:30:00,Papyan Karen - Rafayelyan Edgar,0:3,4:11 - 3:11 - 6:11 - 0:0 - 0:0,0,3,Papyan Karen,Rafayelyan Edgar,fiurst,Papyan Karen - Rafayelyan Edgar,46,13,33,20,-20,15,14,17,0,0,7,8,5,0,0,20,4:11 - 3:11 - 6:11 - 0:0 - 0:0
17260173,2024-03-04 14:00:00,Soghomonyan Hrayr - Papyan Karen,3:1,11:13 - 11:8 - 5:11 - 9:11 - 0:0,1,3,Soghomonyan Hrayr,Papyan Karen,fiurst,Papyan Karen - Soghomonyan Hrayr,79,43,36,-7,7,24,19,16,20,0,-2,3,-6,-2,0,-7,13:11 - 8:11 - 11:5 - 11:9 - 0:0
17260178,2024-03-04 14:00:00,Diaryan Aleksandr - Nikoghosyan Narek,3:1,6:11 - 11:9 - 11:6 - 11:5 - 0:0,3,1,Diaryan Aleksandr,Nikoghosyan Narek,fiurst,Diaryan Aleksandr - Nikoghosyan Narek,70,39,31,-8,8,17,20,17,16,0,5,-2,-5,-6,0,-8,6:11 - 11:9 - 11:6 - 11:5 - 0:0
17260164,2024-03-04 13:30:00,Rafayelyan Edgar - Diaryan Aleksandr,0:3,12:10 - 11:4 - 11:5 - 0:0 - 0:0,3,0,Rafayelyan Edgar,Diaryan Aleksandr,fiurst,Diaryan Aleksandr - Rafayelyan Edgar,53,19,34,15,-15,22,15,16,0,0,2,7,6,0,0,15,10:12 - 4:11 - 5:11 - 0:0 - 0:0
17260162,2024-03-04 13:15:00,Nikoghosyan Narek - Papyan Karen,2:3,5:11 - 11:6 - 9:11 - 14:12 - 10:12,2,3,Nikoghosyan Narek,Papyan Karen,fiurst,Nikoghosyan Narek - Papyan Karen,101,49,52,3,-3,16,17,20,26,22,6,-5,2,-2,2,3,5:11 - 11:6 - 9:11 - 14:12 - 10:12
17260161,2024-03-04 13:00:00,Rafayelyan Edgar - Soghomonyan Hrayr,3:1,11:7 - 11:6 - 9:11 - 11:6 - 0:0,3,1,Rafayelyan Edgar,Soghomonyan Hrayr,fiurst,Rafayelyan Edgar - Soghomonyan Hrayr,72,42,30,-12,12,18,17,20,17,0,-4,-5,2,-5,0,-12,11:7 - 11:6 - 9:11 - 11:6 - 0:0
17260139,2024-03-04 12:15:00,Diaryan Aleksandr - Papyan Karen,3:1,11:5 - 6:11 - 12:10 - 11:2 - 0:0,3,1,Diaryan Aleksandr,Papyan Karen,fiurst,Diaryan Aleksandr - Papyan Karen,68,40,28,-12,12,16,17,22,13,0,-6,5,-2,-9,0,-12,11:5 - 6:11 - 12:10 - 11:2 - 0:0
17260123,2024-03-04 12:00:00,Rafayelyan Edgar - Nikoghosyan Narek,3:1,1:11 - 6:11 - 11:9 - 9:11 - 0:0,1,3,Rafayelyan Edgar,Nikoghosyan Narek,fiurst,Nikoghosyan Narek - Rafayelyan Edgar,69,42,27,-15,15,12,17,20,20,0,-10,-5,2,-2,0,-15,11:1 - 11:6 - 9:11 - 11:9 - 0:0
17260122,2024-03-04 11:50:00,Soghomonyan Hrayr - Diaryan Aleksandr,3:0,8:11 - 6:11 - 9:11 - 0:0 - 0:0,0,3,Soghomonyan Hrayr,Diaryan Aleksandr,fiurst,Diaryan Aleksandr - Soghomonyan Hrayr,56,33,23,-10,10,19,17,20,0,0,-3,-5,-2,0,0,-10,11:8 - 11:6 - 11:9 - 0:0 - 0:0
17260118,2024-03-04 11:35:00,Rafayelyan Edgar - Papyan Karen,3:0,5:11 - 8:11 - 5:11 - 0:0 - 0:0,0,3,Rafayelyan Edgar,Papyan Karen,fiurst,Papyan Karen - Rafayelyan Edgar,51,33,18,-15,15,16,19,16,0,0,-6,-3,-6,0,0,-15,11:5 - 11:8 - 11:5 - 0:0 - 0:0
17260107,2024-03-04 11:15:00,Nikoghosyan Narek - Soghomonyan Hrayr,3:1,11:7 - 12:10 - 11:13 - 12:10 - 0:0,3,1,Nikoghosyan Narek,Soghomonyan Hrayr,fiurst,Nikoghosyan Narek - Soghomonyan Hrayr,86,46,40,-6,6,18,22,24,22,0,-4,-2,2,-2,0,-6,11:7 - 12:10 - 11:13 - 12:10 - 0:0
17260106,2024-03-04 11:05:00,Diaryan Aleksandr - Rafayelyan Edgar,3:0,12:10 - 11:7 - 11:7 - 0:0 - 0:0,3,0,Diaryan Aleksandr,Rafayelyan Edgar,fiurst,Diaryan Aleksandr - Rafayelyan Edgar,58,34,24,-10,10,22,18,18,0,0,-2,-4,-4,0,0,-10,12:10 - 11:7 - 11:7 - 0:0 - 0:0
17260105,2024-03-04 10:45:00,Papyan Karen - Soghomonyan Hrayr,3:0,11:5 - 11:5 - 11:4 - 0:0 - 0:0,3,0,Papyan Karen,Soghomonyan Hrayr,fiurst,Papyan Karen - Soghomonyan Hrayr,47,33,14,-19,19,16,16,15,0,0,-6,-6,-7,0,0,-19,11:5 - 11:5 - 11:4 - 0:0 - 0:0
17260101,2024-03-04 10:35:00,Nikoghosyan Narek - Diaryan Aleksandr,3:0,9:11 - 8:11 - 9:11 - 0:0 - 0:0,0,3,Nikoghosyan Narek,Diaryan Aleksandr,fiurst,Diaryan Aleksandr - Nikoghosyan Narek,59,33,26,-7,7,20,19,20,0,0,-2,-3,-2,0,0,-7,11:9 - 11:8 - 11:9 - 0:0 - 0:0
17260098,2024-03-04 10:15:00,Soghomonyan Hrayr - Rafayelyan Edgar,3:0,14:16 - 10:12 - 5:11 - 0:0 - 0:0,0,3,Soghomonyan Hrayr,Rafayelyan Edgar,fiurst,Rafayelyan Edgar - Soghomonyan Hrayr,68,39,29,-10,10,30,22,16,0,0,-2,-2,-6,0,0,-10,16:14 - 12:10 - 11:5 - 0:0 - 0:0
17260096,2024-03-04 10:00:00,Papyan Karen - Nikoghosyan Narek,1:3,11:8 - 11:5 - 9:11 - 11:8 - 0:0,3,1,Papyan Karen,Nikoghosyan Narek,fiurst,Nikoghosyan Narek - Papyan Karen,74,32,42,10,-10,19,16,20,19,0,3,6,-2,3,0,10,8:11 - 5:11 - 11:9 - 8:11 - 0:0
17244571,2024-03-03 17:45:00,Petrosyan Davit - Gevorgyan Gegham,0:3,11:8 - 11:8 - 12:10 - 0:0 - 0:0,3,0,Petrosyan Davit,Gevorgyan Gegham,fiurst,Gevorgyan Gegham - Petrosyan Davit,60,26,34,8,-8,19,19,22,0,0,3,3,2,0,0,8,8:11 - 8:11 - 10:12 - 0:0 - 0:0
17244569,2024-03-03 17:30:00,Avakimyan Davit - Karakhanyan Mher,3:0,13:11 - 11:7 - 11:7 - 0:0 - 0:0,3,0,Avakimyan Davit,Karakhanyan Mher,fiurst,Avakimyan Davit - Karakhanyan Mher,60,35,25,-10,10,24,18,18,0,0,-2,-4,-4,0,0,-10,13:11 - 11:7 - 11:7 - 0:0 - 0:0
17244568,2024-03-03 17:15:00,Mkrtchyan Andranik - Petrosyan Davit,3:0,12:10 - 11:7 - 11:5 - 0:0 - 0:0,3,0,Mkrtchyan Andranik,Petrosyan Davit,fiurst,Mkrtchyan Andranik - Petrosyan Davit,56,34,22,-12,12,22,18,16,0,0,-2,-4,-6,0,0,-12,12:10 - 11:7 - 11:5 - 0:0 - 0:0
17244554,2024-03-03 17:00:00,Avakimyan Davit - Gevorgyan Gegham,3:2,11:7 - 9:11 - 6:11 - 12:10 - 11:8,3,2,Avakimyan Davit,Gevorgyan Gegham,fiurst,Avakimyan Davit - Gevorgyan Gegham,96,49,47,-2,2,18,20,17,22,19,-4,2,5,-2,-3,-2,11:7 - 9:11 - 6:11 - 12:10 - 11:8
17244550,2024-03-03 16:45:00,Karakhanyan Mher - Mkrtchyan Andranik,1:3,11:13 - 6:11 - 11:9 - 7:11 - 0:0,1,3,Karakhanyan Mher,Mkrtchyan Andranik,fiurst,Karakhanyan Mher - Mkrtchyan Andranik,79,35,44,9,-9,24,17,20,18,0,2,5,-2,4,0,9,11:13 - 6:11 - 11:9 - 7:11 - 0:0
17244548,2024-03-03 16:30:00,Petrosyan Davit - Avakimyan Davit,3:1,8:11 - 11:6 - 7:11 - 7:11 - 0:0,1,3,Petrosyan Davit,Avakimyan Davit,fiurst,Avakimyan Davit - Petrosyan Davit,72,39,33,-6,6,19,17,18,18,0,-3,5,-4,-4,0,-6,11:8 - 6:11 - 11:7 - 11:7 - 0:0
17244537,2024-03-03 16:20:00,Gevorgyan Gegham - Mkrtchyan Andranik,3:1,11:5 - 5:11 - 12:10 - 11:6 - 0:0,3,1,Gevorgyan Gegham,Mkrtchyan Andranik,fiurst,Gevorgyan Gegham - Mkrtchyan Andranik,71,39,32,-7,7,16,16,22,17,0,-6,6,-2,-5,0,-7,11:5 - 5:11 - 12:10 - 11:6 - 0:0
17244535,2024-03-03 16:00:00,Karakhanyan Mher - Petrosyan Davit,0:3,9:11 - 7:11 - 8:11 - 0:0 - 0:0,0,3,Karakhanyan Mher,Petrosyan Davit,fiurst,Karakhanyan Mher - Petrosyan Davit,57,24,33,9,-9,20,18,19,0,0,2,4,3,0,0,9,9:11 - 7:11 - 8:11 - 0:0 - 0:0
17244524,2024-03-03 15:45:00,Mkrtchyan Andranik - Avakimyan Davit,1:3,11:8 - 14:12 - 11:13 - 12:10 - 0:0,3,1,Mkrtchyan Andranik,Avakimyan Davit,fiurst,Avakimyan Davit - Mkrtchyan Andranik,91,43,48,5,-5,19,26,24,22,0,3,2,-2,2,0,5,8:11 - 12:14 - 13:11 - 10:12 - 0:0
17244522,2024-03-03 15:35:00,Gevorgyan Gegham - Karakhanyan Mher,3:0,11:6 - 11:7 - 11:4 - 0:0 - 0:0,3,0,Gevorgyan Gegham,Karakhanyan Mher,fiurst,Gevorgyan Gegham - Karakhanyan Mher,50,33,17,-16,16,17,18,15,0,0,-5,-4,-7,0,0,-16,11:6 - 11:7 - 11:4 - 0:0 - 0:0
17244521,2024-03-03 15:25:00,Papyan Karen - Hovhannesyan Rafik,2:3,11:9 - 6:11 - 11:5 - 9:11 - 11:9,3,2,Papyan Karen,Hovhannesyan Rafik,fiurst,Hovhannesyan Rafik - Papyan Karen,93,45,48,3,-3,20,17,16,20,20,2,-5,6,-2,2,3,9:11 - 11:6 - 5:11 - 11:9 - 9:11
17244473,2024-03-03 15:20:00,Nikoghosyan Narek - Nazaryan Mushegh,0:3,11:6 - 11:9 - 11:5 - 0:0 - 0:0,3,0,Nikoghosyan Narek,Nazaryan Mushegh,fiurst,Nazaryan Mushegh - Nikoghosyan Narek,53,20,33,13,-13,17,20,16,0,0,5,2,6,0,0,13,6:11 - 9:11 - 5:11 - 0:0 - 0:0
17244471,2024-03-03 14:55:00,Soghomonyan Hrayr - Papyan Karen,1:3,11:7 - 8:11 - 11:9 - 11:5 - 0:0,3,1,Soghomonyan Hrayr,Papyan Karen,fiurst,Papyan Karen - Soghomonyan Hrayr,73,32,41,9,-9,18,19,20,16,0,4,-3,2,6,0,9,7:11 - 11:8 - 9:11 - 5:11 - 0:0
17244470,2024-03-03 14:40:00,Hovhannesyan Rafik - Nikoghosyan Narek,2:3,7:11 - 9:11 - 11:5 - 11:5 - 14:16,2,3,Hovhannesyan Rafik,Nikoghosyan Narek,fiurst,Hovhannesyan Rafik - Nikoghosyan Narek,100,52,48,-4,4,18,20,16,16,30,4,2,-6,-6,2,-4,7:11 - 9:11 - 11:5 - 11:5 - 14:16
17244453,2024-03-03 14:25:00,Soghomonyan Hrayr - Nazaryan Mushegh,1:3,11:8 - 8:11 - 11:8 - 11:9 - 0:0,3,1,Soghomonyan Hrayr,Nazaryan Mushegh,fiurst,Nazaryan Mushegh - Soghomonyan Hrayr,77,36,41,5,-5,19,19,19,20,0,3,-3,3,2,0,5,8:11 - 11:8 - 8:11 - 9:11 - 0:0
17244449,2024-03-03 14:05:00,Papyan Karen - Nikoghosyan Narek,2:3,11:9 - 4:11 - 8:11 - 11:7 - 11:8,3,2,Papyan Karen,Nikoghosyan Narek,fiurst,Nikoghosyan Narek - Papyan Karen,91,46,45,-1,1,20,15,19,18,19,2,-7,-3,4,3,-1,9:11 - 11:4 - 11:8 - 7:11 - 8:11
17244432,2024-03-03 13:50:00,Hovhannesyan Rafik - Soghomonyan Hrayr,3:2,5:11 - 11:4 - 13:11 - 12:14 - 11:7,3,2,Hovhannesyan Rafik,Soghomonyan Hrayr,fiurst,Hovhannesyan Rafik - Soghomonyan Hrayr,99,52,47,-5,5,16,15,24,26,18,6,-7,-2,2,-4,-5,5:11 - 11:4 - 13:11 - 12:14 - 11:7
17244418,2024-03-03 13:30:00,Nazaryan Mushegh - Papyan Karen,3:1,11:7 - 11:8 - 8:11 - 11:8 - 0:0,3,1,Nazaryan Mushegh,Papyan Karen,fiurst,Nazaryan Mushegh - Papyan Karen,75,41,34,-7,7,18,19,19,19,0,-4,-3,3,-3,0,-7,11:7 - 11:8 - 8:11 - 11:8 - 0:0
17244414,2024-03-03 13:15:00,Nikoghosyan Narek - Soghomonyan Hrayr,3:1,11:5 - 11:5 - 9:11 - 11:9 - 0:0,3,1,Nikoghosyan Narek,Soghomonyan Hrayr,fiurst,Nikoghosyan Narek - Soghomonyan Hrayr,72,42,30,-12,12,16,16,20,20,0,-6,-6,2,-2,0,-12,11:5 - 11:5 - 9:11 - 11:9 - 0:0
17244411,2024-03-03 13:00:00,Nazaryan Mushegh - Hovhannesyan Rafik,3:1,10:12 - 7:11 - 12:10 - 7:11 - 0:0,1,3,Nazaryan Mushegh,Hovhannesyan Rafik,fiurst,Hovhannesyan Rafik - Nazaryan Mushegh,80,44,36,-8,8,22,18,22,18,0,-2,-4,2,-4,0,-8,12:10 - 11:7 - 10:12 - 11:7 - 0:0
17244402,2024-03-03 12:15:00,Papyan Karen - Soghomonyan Hrayr,3:2,11:6 - 11:13 - 11:7 - 11:13 - 11:8,3,2,Papyan Karen,Soghomonyan Hrayr,fiurst,Papyan Karen - Soghomonyan Hrayr,102,55,47,-8,8,17,24,18,24,19,-5,2,-4,2,-3,-8,11:6 - 11:13 - 11:7 - 11:13 - 11:8
17244365,2024-03-03 12:05:00,Nazaryan Mushegh - Nikoghosyan Narek,0:3,8:11 - 7:11 - 10:12 - 0:0 - 0:0,0,3,Nazaryan Mushegh,Nikoghosyan Narek,fiurst,Nazaryan Mushegh - Nikoghosyan Narek,59,25,34,9,-9,19,18,22,0,0,3,4,2,0,0,9,8:11 - 7:11 - 10:12 - 0:0 - 0:0
17244364,2024-03-03 11:45:00,Hovhannesyan Rafik - Papyan Karen,1:3,9:11 - 11:8 - 11:13 - 11:13 - 0:0,1,3,Hovhannesyan Rafik,Papyan Karen,fiurst,Hovhannesyan Rafik - Papyan Karen,87,42,45,3,-3,20,19,24,24,0,2,-3,2,2,0,3,9:11 - 11:8 - 11:13 - 11:13 - 0:0
17244351,2024-03-03 11:30:00,Nazaryan Mushegh - Soghomonyan Hrayr,3:2,11:8 - 7:11 - 11:8 - 8:11 - 11:7,3,2,Nazaryan Mushegh,Soghomonyan Hrayr,fiurst,Nazaryan Mushegh - Soghomonyan Hrayr,93,48,45,-3,3,19,18,19,19,18,-3,4,-3,3,-4,-3,11:8 - 7:11 - 11:8 - 8:11 - 11:7
17244348,2024-03-03 11:15:00,Nikoghosyan Narek - Hovhannesyan Rafik,0:3,11:7 - 13:11 - 11:7 - 0:0 - 0:0,3,0,Nikoghosyan Narek,Hovhannesyan Rafik,fiurst,Hovhannesyan Rafik - Nikoghosyan Narek,60,25,35,10,-10,18,24,18,0,0,4,2,4,0,0,10,7:11 - 11:13 - 7:11 - 0:0 - 0:0
17244347,2024-03-03 11:05:00,Papyan Karen - Nazaryan Mushegh,0:3,11:8 - 12:10 - 11:7 - 0:0 - 0:0,3,0,Papyan Karen,Nazaryan Mushegh,fiurst,Nazaryan Mushegh - Papyan Karen,59,25,34,9,-9,19,22,18,0,0,3,2,4,0,0,9,8:11 - 10:12 - 7:11 - 0:0 - 0:0
17244315,2024-03-03 10:50:00,Soghomonyan Hrayr - Hovhannesyan Rafik,2:3,11:5 - 12:10 - 9:11 - 8:11 - 11:7,3,2,Soghomonyan Hrayr,Hovhannesyan Rafik,fiurst,Hovhannesyan Rafik - Soghomonyan Hrayr,95,44,51,7,-7,16,22,20,19,18,6,2,-2,-3,4,7,5:11 - 10:12 - 11:9 - 11:8 - 7:11
17244313,2024-03-03 10:40:00,Nikoghosyan Narek - Papyan Karen,1:3,8:11 - 12:10 - 9:11 - 4:11 - 0:0,1,3,Nikoghosyan Narek,Papyan Karen,fiurst,Nikoghosyan Narek - Papyan Karen,76,33,43,10,-10,19,22,20,15,0,3,-2,2,7,0,10,8:11 - 12:10 - 9:11 - 4:11 - 0:0
17244312,2024-03-03 10:15:00,Hovhannesyan Rafik - Nazaryan Mushegh,1:3,8:11 - 11:9 - 7:11 - 8:11 - 0:0,1,3,Hovhannesyan Rafik,Nazaryan Mushegh,fiurst,Hovhannesyan Rafik - Nazaryan Mushegh,76,34,42,8,-8,19,20,18,19,0,3,-2,4,3,0,8,8:11 - 11:9 - 7:11 - 8:11 - 0:0
17244311,2024-03-03 10:00:00,Soghomonyan Hrayr - Nikoghosyan Narek,1:3,11:9 - 13:11 - 9:11 - 12:10 - 0:0,3,1,Soghomonyan Hrayr,Nikoghosyan Narek,fiurst,Nikoghosyan Narek - Soghomonyan Hrayr,86,41,45,4,-4,20,24,20,22,0,2,2,-2,2,0,4,9:11 - 11:13 - 11:9 - 10:12 - 0:0
17222343,2024-03-02 17:45:00,Avakimyan Davit - Mkrtchyan Andranik,2:3,12:10 - 10:12 - 11:8 - 6:11 - 9:11,2,3,Avakimyan Davit,Mkrtchyan Andranik,fiurst,Avakimyan Davit - Mkrtchyan Andranik,100,48,52,4,-4,22,22,19,17,20,-2,2,-3,5,2,4,12:10 - 10:12 - 11:8 - 6:11 - 9:11
17222338,2024-03-02 17:35:00,Gevorgyan Gegham - Gevorgyan Hayk,1:3,13:11 - 7:11 - 11:13 - 9:11 - 0:0,1,3,Gevorgyan Gegham,Gevorgyan Hayk,fiurst,Gevorgyan Gegham - Gevorgyan Hayk,86,40,46,6,-6,24,18,24,20,0,-2,4,2,2,0,6,13:11 - 7:11 - 11:13 - 9:11 - 0:0
17222336,2024-03-02 17:15:00,Arutyunov Ruben - Avakimyan Davit,3:0,11:4 - 11:6 - 11:8 - 0:0 - 0:0,3,0,Arutyunov Ruben,Avakimyan Davit,fiurst,Arutyunov Ruben - Avakimyan Davit,51,33,18,-15,15,15,17,19,0,0,-7,-5,-3,0,0,-15,11:4 - 11:6 - 11:8 - 0:0 - 0:0
17222333,2024-03-02 17:00:00,Gevorgyan Gegham - Mkrtchyan Andranik,1:3,11:5 - 11:13 - 8:11 - 9:11 - 0:0,1,3,Gevorgyan Gegham,Mkrtchyan Andranik,fiurst,Gevorgyan Gegham - Mkrtchyan Andranik,79,39,40,1,-1,16,24,19,20,0,-6,2,3,2,0,1,11:5 - 11:13 - 8:11 - 9:11 - 0:0
17222331,2024-03-02 16:45:00,Gevorgyan Hayk - Arutyunov Ruben,3:1,11:7 - 10:12 - 6:11 - 2:11 - 0:0,1,3,Gevorgyan Hayk,Arutyunov Ruben,fiurst,Arutyunov Ruben - Gevorgyan Hayk,70,41,29,-12,12,18,22,17,13,0,4,-2,-5,-9,0,-12,7:11 - 12:10 - 11:6 - 11:2 - 0:0
17222312,2024-03-02 16:30:00,Avakimyan Davit - Gevorgyan Gegham,3:1,11:6 - 7:11 - 11:7 - 11:8 - 0:0,3,1,Avakimyan Davit,Gevorgyan Gegham,fiurst,Avakimyan Davit - Gevorgyan Gegham,72,40,32,-8,8,17,18,18,19,0,-5,4,-4,-3,0,-8,11:6 - 7:11 - 11:7 - 11:8 - 0:0
17222309,2024-03-02 16:15:00,Mkrtchyan Andranik - Arutyunov Ruben,3:0,2:11 - 8:11 - 7:11 - 0:0 - 0:0,0,3,Mkrtchyan Andranik,Arutyunov Ruben,fiurst,Arutyunov Ruben - Mkrtchyan Andranik,50,33,17,-16,16,13,19,18,0,0,-9,-3,-4,0,0,-16,11:2 - 11:8 - 11:7 - 0:0 - 0:0
17222307,2024-03-02 16:00:00,Gevorgyan Hayk - Avakimyan Davit,1:3,12:10 - 12:14 - 11:5 - 12:10 - 0:0,3,1,Gevorgyan Hayk,Avakimyan Davit,fiurst,Avakimyan Davit - Gevorgyan Hayk,86,39,47,8,-8,22,26,16,22,0,2,-2,6,2,0,8,10:12 - 14:12 - 5:11 - 10:12 - 0:0
17222285,2024-03-02 15:45:00,Arutyunov Ruben - Gevorgyan Gegham,3:0,11:4 - 11:3 - 11:7 - 0:0 - 0:0,3,0,Arutyunov Ruben,Gevorgyan Gegham,fiurst,Arutyunov Ruben - Gevorgyan Gegham,47,33,14,-19,19,15,14,18,0,0,-7,-8,-4,0,0,-19,11:4 - 11:3 - 11:7 - 0:0 - 0:0
17222284,2024-03-02 15:30:00,Mkrtchyan Andranik - Gevorgyan Hayk,1:3,5:11 - 11:3 - 11:8 - 11:9 - 0:0,3,1,Mkrtchyan Andranik,Gevorgyan Hayk,fiurst,Gevorgyan Hayk - Mkrtchyan Andranik,69,31,38,7,-7,16,14,19,20,0,-6,8,3,2,0,7,11:5 - 3:11 - 8:11 - 9:11 - 0:0
17222272,2024-03-02 15:15:00,Diaryan Aleksandr - Rafayelyan Edgar,0:3,6:11 - 7:11 - 7:11 - 0:0 - 0:0,0,3,Diaryan Aleksandr,Rafayelyan Edgar,fiurst,Diaryan Aleksandr - Rafayelyan Edgar,53,20,33,13,-13,17,18,18,0,0,5,4,4,0,0,13,6:11 - 7:11 - 7:11 - 0:0 - 0:0
17222270,2024-03-02 15:00:00,Hovhannesyan Rafik - Nazaryan Mushegh,3:0,11:7 - 11:5 - 11:8 - 0:0 - 0:0,3,0,Hovhannesyan Rafik,Nazaryan Mushegh,fiurst,Hovhannesyan Rafik - Nazaryan Mushegh,53,33,20,-13,13,18,16,19,0,0,-4,-6,-3,0,0,-13,11:7 - 11:5 - 11:8 - 0:0 - 0:0
17222266,2024-03-02 14:40:00,Rafayelyan Edgar - Hovhannesyan Rafik,0:3,11:8 - 11:7 - 11:7 - 0:0 - 0:0,3,0,Rafayelyan Edgar,Hovhannesyan Rafik,fiurst,Hovhannesyan Rafik - Rafayelyan Edgar,55,22,33,11,-11,19,18,18,0,0,3,4,4,0,0,11,8:11 - 7:11 - 7:11 - 0:0 - 0:0
17222264,2024-03-02 14:15:00,Nikoghosyan Narek - Nazaryan Mushegh,0:0,0:0 - 0:0 - 0:0 - 0:0 - 0:0,0,0,Nikoghosyan Narek,Nazaryan Mushegh,fiurst,Nazaryan Mushegh - Nikoghosyan Narek,0,0,0,0,0,0,0,0,0,0,0,0,0,0,0,0,0:0 - 0:0 - 0:0 - 0:0 - 0:0
17221973,2024-03-02 14:00:00,Diaryan Aleksandr - Hovhannesyan Rafik,3:2,8:11 - 11:3 - 11:5 - 11:13 - 11:8,3,2,Diaryan Aleksandr,Hovhannesyan Rafik,fiurst,Diaryan Aleksandr - Hovhannesyan Rafik,92,52,40,-12,12,19,14,16,24,19,3,-8,-6,2,-3,-12,8:11 - 11:3 - 11:5 - 11:13 - 11:8
17221972,2024-03-02 13:50:00,Rafayelyan Edgar - Nikoghosyan Narek,0:3,13:11 - 11:7 - 11:3 - 0:0 - 0:0,3,0,Rafayelyan Edgar,Nikoghosyan Narek,fiurst,Nikoghosyan Narek - Rafayelyan Edgar,56,21,35,14,-14,24,18,14,0,0,2,4,8,0,0,14,11:13 - 7:11 - 3:11 - 0:0 - 0:0
17221965,2024-03-02 13:30:00,Nazaryan Mushegh - Diaryan Aleksandr,3:0,4:11 - 6:11 - 4:11 - 0:0 - 0:0,0,3,Nazaryan Mushegh,Diaryan Aleksandr,fiurst,Diaryan Aleksandr - Nazaryan Mushegh,47,33,14,-19,19,15,17,15,0,0,-7,-5,-7,0,0,-19,11:4 - 11:6 - 11:4 - 0:0 - 0:0
17221953,2024-03-02 13:20:00,Hovhannesyan Rafik - Nikoghosyan Narek,1:3,5:11 - 6:11 - 15:13 - 6:11 - 0:0,1,3,Hovhannesyan Rafik,Nikoghosyan Narek,fiurst,Hovhannesyan Rafik - Nikoghosyan Narek,78,32,46,14,-14,16,17,28,17,0,6,5,-2,5,0,14,5:11 - 6:11 - 15:13 - 6:11 - 0:0
17221951,2024-03-02 13:00:00,Nazaryan Mushegh - Rafayelyan Edgar,1:3,11:9 - 4:11 - 6:11 - 4:11 - 0:0,1,3,Nazaryan Mushegh,Rafayelyan Edgar,fiurst,Nazaryan Mushegh - Rafayelyan Edgar,67,25,42,17,-17,20,15,17,15,0,-2,7,5,7,0,17,11:9 - 4:11 - 6:11 - 4:11 - 0:0
17221946,2024-03-02 12:15:00,Diaryan Aleksandr - Nikoghosyan Narek,3:2,10:12 - 11:9 - 11:7 - 5:11 - 11:6,3,2,Diaryan Aleksandr,Nikoghosyan Narek,fiurst,Diaryan Aleksandr - Nikoghosyan Narek,93,48,45,-3,3,22,20,18,16,17,2,-2,-4,6,-5,-3,10:12 - 11:9 - 11:7 - 5:11 - 11:6
17221933,2024-03-02 12:00:00,Nazaryan Mushegh - Hovhannesyan Rafik,0:3,11:4 - 11:4 - 11:9 - 0:0 - 0:0,3,0,Nazaryan Mushegh,Hovhannesyan Rafik,fiurst,Hovhannesyan Rafik - Nazaryan Mushegh,50,17,33,16,-16,15,15,20,0,0,7,7,2,0,0,16,4:11 - 4:11 - 9:11 - 0:0 - 0:0
17221932,2024-03-02 11:45:00,Rafayelyan Edgar - Diaryan Aleksandr,0:3,11:5 - 12:10 - 11:7 - 0:0 - 0:0,3,0,Rafayelyan Edgar,Diaryan Aleksandr,fiurst,Diaryan Aleksandr - Rafayelyan Edgar,56,22,34,12,-12,16,22,18,0,0,6,2,4,0,0,12,5:11 - 10:12 - 7:11 - 0:0 - 0:0
17221930,2024-03-02 11:30:00,Nazaryan Mushegh - Nikoghosyan Narek,0:3,6:11 - 5:11 - 7:11 - 0:0 - 0:0,0,3,Nazaryan Mushegh,Nikoghosyan Narek,fiurst,Nazaryan Mushegh - Nikoghosyan Narek,51,18,33,15,-15,17,16,18,0,0,5,6,4,0,0,15,6:11 - 5:11 - 7:11 - 0:0 - 0:0
17221926,2024-03-02 11:15:00,Hovhannesyan Rafik - Rafayelyan Edgar,0:3,4:11 - 9:11 - 3:11 - 0:0 - 0:0,0,3,Hovhannesyan Rafik,Rafayelyan Edgar,fiurst,Hovhannesyan Rafik - Rafayelyan Edgar,49,16,33,17,-17,15,20,14,0,0,7,2,8,0,0,17,4:11 - 9:11 - 3:11 - 0:0 - 0:0
17221911,2024-03-02 11:00:00,Diaryan Aleksandr - Nazaryan Mushegh,3:0,11:8 - 11:3 - 11:3 - 0:0 - 0:0,3,0,Diaryan Aleksandr,Nazaryan Mushegh,fiurst,Diaryan Aleksandr - Nazaryan Mushegh,47,33,14,-19,19,19,14,14,0,0,-3,-8,-8,0,0,-19,11:8 - 11:3 - 11:3 - 0:0 - 0:0
17221909,2024-03-02 10:45:00,Nikoghosyan Narek - Rafayelyan Edgar,0:3,5:11 - 5:11 - 6:11 - 0:0 - 0:0,0,3,Nikoghosyan Narek,Rafayelyan Edgar,fiurst,Nikoghosyan Narek - Rafayelyan Edgar,49,16,33,17,-17,16,16,17,0,0,6,6,5,0,0,17,5:11 - 5:11 - 6:11 - 0:0 - 0:0
17221908,2024-03-02 10:30:00,Hovhannesyan Rafik - Diaryan Aleksandr,3:1,10:12 - 11:5 - 8:11 - 8:11 - 0:0,1,3,Hovhannesyan Rafik,Diaryan Aleksandr,fiurst,Diaryan Aleksandr - Hovhannesyan Rafik,76,39,37,-2,2,22,16,19,19,0,-2,6,-3,-3,0,-2,12:10 - 5:11 - 11:8 - 11:8 - 0:0
17221905,2024-03-02 10:15:00,Rafayelyan Edgar - Nazaryan Mushegh,0:3,11:6 - 11:8 - 11:2 - 0:0 - 0:0,3,0,Rafayelyan Edgar,Nazaryan Mushegh,fiurst,Nazaryan Mushegh - Rafayelyan Edgar,49,16,33,17,-17,17,19,13,0,0,5,3,9,0,0,17,6:11 - 8:11 - 2:11 - 0:0 - 0:0
17221904,2024-03-02 10:00:00,Nikoghosyan Narek - Hovhannesyan Rafik,2:3,11:5 - 8:11 - 7:11 - 11:4 - 11:4,3,2,Nikoghosyan Narek,Hovhannesyan Rafik,fiurst,Hovhannesyan Rafik - Nikoghosyan Narek,83,35,48,13,-13,16,19,18,15,15,6,-3,-4,7,7,13,5:11 - 11:8 - 11:7 - 4:11 - 4:11
17203951,2024-03-01 17:45:00,Gevorgyan Hayk - Arutyunov Ruben,3:1,8:11 - 11:9 - 6:11 - 8:11 - 0:0,1,3,Gevorgyan Hayk,Arutyunov Ruben,fiurst,Arutyunov Ruben - Gevorgyan Hayk,75,42,33,-9,9,19,20,17,19,0,-3,2,-5,-3,0,-9,11:8 - 9:11 - 11:6 - 11:8 - 0:0
17203949,2024-03-01 17:30:00,Petrosyan Davit - Avakimyan Davit,3:0,4:11 - 7:11 - 5:11 - 0:0 - 0:0,0,3,Petrosyan Davit,Avakimyan Davit,fiurst,Avakimyan Davit - Petrosyan Davit,49,33,16,-17,17,15,18,16,0,0,-7,-4,-6,0,0,-17,11:4 - 11:7 - 11:5 - 0:0 - 0:0
17203903,2024-03-01 17:15:00,Karakhanyan Mher - Gevorgyan Hayk,3:1,11:5 - 5:11 - 9:11 - 6:11 - 0:0,1,3,Karakhanyan Mher,Gevorgyan Hayk,fiurst,Gevorgyan Hayk - Karakhanyan Mher,69,38,31,-7,7,16,16,20,17,0,6,-6,-2,-5,0,-7,5:11 - 11:5 - 11:9 - 11:6 - 0:0
17203873,2024-03-01 17:10:00,Petrosyan Davit - Arutyunov Ruben,3:0,8:11 - 8:11 - 10:12 - 0:0 - 0:0,0,3,Petrosyan Davit,Arutyunov Ruben,fiurst,Arutyunov Ruben - Petrosyan Davit,60,34,26,-8,8,19,19,22,0,0,-3,-3,-2,0,0,-8,11:8 - 11:8 - 12:10 - 0:0 - 0:0
17203865,2024-03-01 16:45:00,Avakimyan Davit - Karakhanyan Mher,3:0,11:7 - 13:11 - 11:7 - 0:0 - 0:0,3,0,Avakimyan Davit,Karakhanyan Mher,fiurst,Avakimyan Davit - Karakhanyan Mher,60,35,25,-10,10,18,24,18,0,0,-4,-2,-4,0,0,-10,11:7 - 13:11 - 11:7 - 0:0 - 0:0
17203859,2024-03-01 16:30:00,Gevorgyan Hayk - Petrosyan Davit,2:3,11:6 - 9:11 - 7:11 - 11:8 - 8:11,2,3,Gevorgyan Hayk,Petrosyan Davit,fiurst,Gevorgyan Hayk - Petrosyan Davit,93,46,47,1,-1,17,20,18,19,19,-5,2,4,-3,3,1,11:6 - 9:11 - 7:11 - 11:8 - 8:11
17203857,2024-03-01 16:15:00,Arutyunov Ruben - Karakhanyan Mher,3:1,11:13 - 11:4 - 11:5 - 11:7 - 0:0,3,1,Arutyunov Ruben,Karakhanyan Mher,fiurst,Arutyunov Ruben - Karakhanyan Mher,73,44,29,-15,15,24,15,16,18,0,2,-7,-6,-4,0,-15,11:13 - 11:4 - 11:5 - 11:7 - 0:0
17203856,2024-03-01 16:00:00,Avakimyan Davit - Gevorgyan Hayk,0:3,4:11 - 14:16 - 7:11 - 0:0 - 0:0,0,3,Avakimyan Davit,Gevorgyan Hayk,fiurst,Avakimyan Davit - Gevorgyan Hayk,63,25,38,13,-13,15,30,18,0,0,7,2,4,0,0,13,4:11 - 14:16 - 7:11 - 0:0 - 0:0
17203855,2024-03-01 15:45:00,Karakhanyan Mher - Petrosyan Davit,0:3,9:11 - 8:11 - 5:11 - 0:0 - 0:0,0,3,Karakhanyan Mher,Petrosyan Davit,fiurst,Karakhanyan Mher - Petrosyan Davit,55,22,33,11,-11,20,19,16,0,0,2,3,6,0,0,11,9:11 - 8:11 - 5:11 - 0:0 - 0:0
17203854,2024-03-01 15:30:00,Arutyunov Ruben - Avakimyan Davit,3:0,11:8 - 11:6 - 11:5 - 0:0 - 0:0,3,0,Arutyunov Ruben,Avakimyan Davit,fiurst,Arutyunov Ruben - Avakimyan Davit,52,33,19,-14,14,19,17,16,0,0,-3,-5,-6,0,0,-14,11:8 - 11:6 - 11:5 - 0:0 - 0:0
17203853,2024-03-01 15:15:00,Soghomonyan Hrayr - Nikoghosyan Narek,3:0,8:11 - 17:19 - 1:11 - 0:0 - 0:0,0,3,Soghomonyan Hrayr,Nikoghosyan Narek,fiurst,Nikoghosyan Narek - Soghomonyan Hrayr,67,41,26,-15,15,19,36,12,0,0,-3,-2,-10,0,0,-15,11:8 - 19:17 - 11:1 - 0:0 - 0:0
17203844,2024-03-01 15:00:00,Papyan Karen - Diaryan Aleksandr,3:0,8:11 - 4:11 - 2:11 - 0:0 - 0:0,0,3,Papyan Karen,Diaryan Aleksandr,fiurst,Diaryan Aleksandr - Papyan Karen,47,33,14,-19,19,19,15,13,0,0,-3,-7,-9,0,0,-19,11:8 - 11:4 - 11:2 - 0:0 - 0:0
17203839,2024-03-01 14:45:00,Rafayelyan Edgar - Soghomonyan Hrayr,3:1,11:6 - 8:11 - 11:3 - 11:3 - 0:0,3,1,Rafayelyan Edgar,Soghomonyan Hrayr,fiurst,Rafayelyan Edgar - Soghomonyan Hrayr,64,41,23,-18,18,17,19,14,14,0,-5,3,-8,-8,0,-18,11:6 - 8:11 - 11:3 - 11:3 - 0:0
17203838,2024-03-01 14:30:00,Nikoghosyan Narek - Papyan Karen,3:2,12:10 - 8:11 - 10:12 - 11:4 - 11:3,3,2,Nikoghosyan Narek,Papyan Karen,fiurst,Nikoghosyan Narek - Papyan Karen,92,52,40,-12,12,22,19,22,15,14,-2,3,2,-7,-8,-12,12:10 - 8:11 - 10:12 - 11:4 - 11:3
17203835,2024-03-01 14:15:00,Rafayelyan Edgar - Diaryan Aleksandr,3:1,11:8 - 5:11 - 6:11 - 4:11 - 0:0,1,3,Rafayelyan Edgar,Diaryan Aleksandr,fiurst,Diaryan Aleksandr - Rafayelyan Edgar,67,41,26,-15,15,19,16,17,15,0,3,-6,-5,-7,0,-15,8:11 - 11:5 - 11:6 - 11:4 - 0:0
17203833,2024-03-01 14:00:00,Soghomonyan Hrayr - Papyan Karen,3:1,12:10 - 6:11 - 8:11 - 6:11 - 0:0,1,3,Soghomonyan Hrayr,Papyan Karen,fiurst,Papyan Karen - Soghomonyan Hrayr,75,43,32,-11,11,22,17,19,17,0,2,-5,-3,-5,0,-11,10:12 - 11:6 - 11:8 - 11:6 - 0:0
17203826,2024-03-01 13:45:00,Diaryan Aleksandr - Soghomonyan Hrayr,3:0,11:5 - 11:3 - 11:2 - 0:0 - 0:0,3,0,Diaryan Aleksandr,Soghomonyan Hrayr,fiurst,Diaryan Aleksandr - Soghomonyan Hrayr,43,33,10,-23,23,16,14,13,0,0,-6,-8,-9,0,0,-23,11:5 - 11:3 - 11:2 - 0:0 - 0:0
17203832,2024-03-01 13:45:00,Nikoghosyan Narek - Rafayelyan Edgar,0:3,8:11 - 10:12 - 6:11 - 0:0 - 0:0,0,3,Nikoghosyan Narek,Rafayelyan Edgar,fiurst,Nikoghosyan Narek - Rafayelyan Edgar,58,24,34,10,-10,19,22,17,0,0,3,2,5,0,0,10,8:11 - 10:12 - 6:11 - 0:0 - 0:0
17203817,2024-03-01 13:15:00,Papyan Karen - Rafayelyan Edgar,1:3,6:11 - 11:6 - 4:11 - 11:13 - 0:0,1,3,Papyan Karen,Rafayelyan Edgar,fiurst,Papyan Karen - Rafayelyan Edgar,73,32,41,9,-9,17,17,15,24,0,5,-5,7,2,0,9,6:11 - 11:6 - 4:11 - 11:13 - 0:0
17203813,2024-03-01 13:00:00,Diaryan Aleksandr - Nikoghosyan Narek,2:3,8:11 - 11:9 - 0:11 - 11:7 - 4:11,2,3,Diaryan Aleksandr,Nikoghosyan Narek,fiurst,Diaryan Aleksandr - Nikoghosyan Narek,83,34,49,15,-15,19,20,11,18,15,3,-2,11,-4,7,15,8:11 - 11:9 - 0:11 - 11:7 - 4:11
17203812,2024-03-01 12:15:00,Soghomonyan Hrayr - Rafayelyan Edgar,3:0,6:11 - 7:11 - 12:14 - 0:0 - 0:0,0,3,Soghomonyan Hrayr,Rafayelyan Edgar,fiurst,Rafayelyan Edgar - Soghomonyan Hrayr,61,36,25,-11,11,17,18,26,0,0,-5,-4,-2,0,0,-11,11:6 - 11:7 - 14:12 - 0:0 - 0:0
17203810,2024-03-01 12:10:00,Diaryan Aleksandr - Papyan Karen,1:3,11:6 - 8:11 - 7:11 - 7:11 - 0:0,1,3,Diaryan Aleksandr,Papyan Karen,fiurst,Diaryan Aleksandr - Papyan Karen,72,33,39,6,-6,17,19,18,18,0,-5,3,4,4,0,6,11:6 - 8:11 - 7:11 - 7:11 - 0:0
17203807,2024-03-01 11:50:00,Nikoghosyan Narek - Soghomonyan Hrayr,3:0,12:10 - 11:6 - 11:7 - 0:0 - 0:0,3,0,Nikoghosyan Narek,Soghomonyan Hrayr,fiurst,Nikoghosyan Narek - Soghomonyan Hrayr,57,34,23,-11,11,22,17,18,0,0,-2,-5,-4,0,0,-11,12:10 - 11:6 - 11:7 - 0:0 - 0:0
17203805,2024-03-01 11:40:00,Diaryan Aleksandr - Rafayelyan Edgar,3:2,11:6 - 5:11 - 11:4 - 10:12 - 11:2,3,2,Diaryan Aleksandr,Rafayelyan Edgar,fiurst,Diaryan Aleksandr - Rafayelyan Edgar,83,48,35,-13,13,17,16,15,22,13,-5,6,-7,2,-9,-13,11:6 - 5:11 - 11:4 - 10:12 - 11:2
17203803,2024-03-01 11:20:00,Papyan Karen - Nikoghosyan Narek,3:0,9:11 - 7:11 - 6:11 - 0:0 - 0:0,0,3,Papyan Karen,Nikoghosyan Narek,fiurst,Nikoghosyan Narek - Papyan Karen,55,33,22,-11,11,20,18,17,0,0,-2,-4,-5,0,0,-11,11:9 - 11:7 - 11:6 - 0:0 - 0:0
17203802,2024-03-01 11:00:00,Soghomonyan Hrayr - Diaryan Aleksandr,3:2,11:8 - 11:13 - 11:7 - 6:11 - 8:11,2,3,Soghomonyan Hrayr,Diaryan Aleksandr,fiurst,Diaryan Aleksandr - Soghomonyan Hrayr,97,50,47,-3,3,19,24,18,17,19,3,-2,4,-5,-3,-3,8:11 - 13:11 - 7:11 - 11:6 - 11:8
17203798,2024-03-01 10:50:00,Rafayelyan Edgar - Nikoghosyan Narek,1:3,11:6 - 5:11 - 11:8 - 11:5 - 0:0,3,1,Rafayelyan Edgar,Nikoghosyan Narek,fiurst,Nikoghosyan Narek - Rafayelyan Edgar,68,30,38,8,-8,17,16,19,16,0,5,-6,3,6,0,8,6:11 - 11:5 - 8:11 - 5:11 - 0:0
17203797,2024-03-01 10:45:00,Papyan Karen - Soghomonyan Hrayr,3:0,11:8 - 11:7 - 11:8 - 0:0 - 0:0,3,0,Papyan Karen,Soghomonyan Hrayr,fiurst,Papyan Karen - Soghomonyan Hrayr,56,33,23,-10,10,19,18,19,0,0,-3,-4,-3,0,0,-10,11:8 - 11:7 - 11:8 - 0:0 - 0:0
17203792,2024-03-01 10:15:00,Nikoghosyan Narek - Diaryan Aleksandr,3:1,11:9 - 6:11 - 9:11 - 1:11 - 0:0,1,3,Nikoghosyan Narek,Diaryan Aleksandr,fiurst,Diaryan Aleksandr - Nikoghosyan Narek,69,42,27,-15,15,20,17,20,12,0,2,-5,-2,-10,0,-15,9:11 - 11:6 - 11:9 - 11:1 - 0:0
17203782,2024-03-01 10:00:00,Rafayelyan Edgar - Papyan Karen,3:2,11:7 - 15:17 - 11:2 - 8:11 - 11:13,2,3,Rafayelyan Edgar,Papyan Karen,fiurst,Papyan Karen - Rafayelyan Edgar,106,50,56,6,-6,18,32,13,19,24,4,-2,9,-3,-2,6,7:11 - 17:15 - 2:11 - 11:8 - 13:11
17182480,2024-02-29 17:55:00,Petrosyan Davit - Gevorgyan Hayk,1:3,9:11 - 11:8 - 12:10 - 11:9 - 0:0,3,1,Petrosyan Davit,Gevorgyan Hayk,fiurst,Gevorgyan Hayk - Petrosyan Davit,81,38,43,5,-5,20,19,22,20,0,-2,3,2,2,0,5,11:9 - 8:11 - 10:12 - 9:11 - 0:0
17182476,2024-02-29 17:30:00,Mkrtchyan Andranik - Karakhanyan Mher,0:3,11:8 - 13:11 - 20:18 - 0:0 - 0:0,3,0,Mkrtchyan Andranik,Karakhanyan Mher,fiurst,Karakhanyan Mher - Mkrtchyan Andranik,81,37,44,7,-7,19,24,38,0,0,3,2,2,0,0,7,8:11 - 11:13 - 18:20 - 0:0 - 0:0
17182467,2024-02-29 17:25:00,Gevorgyan Gegham - Petrosyan Davit,1:3,3:11 - 6:11 - 11:8 - 5:11 - 0:0,1,3,Gevorgyan Gegham,Petrosyan Davit,fiurst,Gevorgyan Gegham - Petrosyan Davit,66,25,41,16,-16,14,17,19,16,0,8,5,-3,6,0,16,3:11 - 6:11 - 11:8 - 5:11 - 0:0
17182451,2024-02-29 17:00:00,Mkrtchyan Andranik - Gevorgyan Hayk,1:3,11:5 - 12:14 - 11:3 - 11:5 - 0:0,3,1,Mkrtchyan Andranik,Gevorgyan Hayk,fiurst,Gevorgyan Hayk - Mkrtchyan Andranik,72,27,45,18,-18,16,26,14,16,0,6,-2,8,6,0,18,5:11 - 14:12 - 3:11 - 5:11 - 0:0
17182447,2024-02-29 16:55:00,Karakhanyan Mher - Gevorgyan Gegham,3:1,7:11 - 11:9 - 8:11 - 4:11 - 0:0,1,3,Karakhanyan Mher,Gevorgyan Gegham,fiurst,Gevorgyan Gegham - Karakhanyan Mher,72,42,30,-12,12,18,20,19,15,0,-4,2,-3,-7,0,-12,11:7 - 9:11 - 11:8 - 11:4 - 0:0
17182444,2024-02-29 16:30:00,Petrosyan Davit - Mkrtchyan Andranik,3:1,11:5 - 8:11 - 12:14 - 7:11 - 0:0,1,3,Petrosyan Davit,Mkrtchyan Andranik,fiurst,Mkrtchyan Andranik - Petrosyan Davit,79,41,38,-3,3,16,19,26,18,0,6,-3,-2,-4,0,-3,5:11 - 11:8 - 14:12 - 11:7 - 0:0
17182434,2024-02-29 16:20:00,Gevorgyan Hayk - Gevorgyan Gegham,3:1,7:11 - 9:11 - 11:9 - 7:11 - 0:0,1,3,Gevorgyan Hayk,Gevorgyan Gegham,fiurst,Gevorgyan Gegham - Gevorgyan Hayk,76,42,34,-8,8,18,20,20,18,0,-4,-2,2,-4,0,-8,11:7 - 11:9 - 9:11 - 11:7 - 0:0
17182414,2024-02-29 16:00:00,Karakhanyan Mher - Petrosyan Davit,0:3,2:11 - 11:13 - 6:11 - 0:0 - 0:0,0,3,Karakhanyan Mher,Petrosyan Davit,fiurst,Karakhanyan Mher - Petrosyan Davit,54,19,35,16,-16,13,24,17,0,0,9,2,5,0,0,16,2:11 - 11:13 - 6:11 - 0:0 - 0:0
17182412,2024-02-29 15:45:00,Gevorgyan Gegham - Mkrtchyan Andranik,3:1,12:10 - 12:10 - 8:11 - 11:8 - 0:0,3,1,Gevorgyan Gegham,Mkrtchyan Andranik,fiurst,Gevorgyan Gegham - Mkrtchyan Andranik,82,43,39,-4,4,22,22,19,19,0,-2,-2,3,-3,0,-4,12:10 - 12:10 - 8:11 - 11:8 - 0:0
17182401,2024-02-29 15:30:00,Gevorgyan Hayk - Karakhanyan Mher,3:1,7:11 - 11:8 - 11:7 - 11:6 - 0:0,3,1,Gevorgyan Hayk,Karakhanyan Mher,fiurst,Gevorgyan Hayk - Karakhanyan Mher,72,40,32,-8,8,18,19,18,17,0,4,-3,-4,-5,0,-8,7:11 - 11:8 - 11:7 - 11:6 - 0:0
17182400,2024-02-29 15:15:00,Nazaryan Mushegh - Papyan Karen,2:3,11:5 - 8:11 - 11:8 - 8:11 - 7:11,2,3,Nazaryan Mushegh,Papyan Karen,fiurst,Nazaryan Mushegh - Papyan Karen,91,45,46,1,-1,16,19,19,19,18,-6,3,-3,3,4,1,11:5 - 8:11 - 11:8 - 8:11 - 7:11
17182388,2024-02-29 15:00:00,Rafayelyan Edgar - Soghomonyan Hrayr,3:1,9:11 - 11:3 - 11:5 - 11:7 - 0:0,3,1,Rafayelyan Edgar,Soghomonyan Hrayr,fiurst,Rafayelyan Edgar - Soghomonyan Hrayr,68,42,26,-16,16,20,14,16,18,0,2,-8,-6,-4,0,-16,9:11 - 11:3 - 11:5 - 11:7 - 0:0
17182384,2024-02-29 14:45:00,Hovhannesyan Rafik - Nazaryan Mushegh,3:1,8:11 - 11:8 - 12:10 - 11:5 - 0:0,3,1,Hovhannesyan Rafik,Nazaryan Mushegh,fiurst,Hovhannesyan Rafik - Nazaryan Mushegh,76,42,34,-8,8,19,19,22,16,0,3,-3,-2,-6,0,-8,8:11 - 11:8 - 12:10 - 11:5 - 0:0
17182381,2024-02-29 14:30:00,Papyan Karen - Rafayelyan Edgar,3:2,4:11 - 11:7 - 9:11 - 11:9 - 11:5,3,2,Papyan Karen,Rafayelyan Edgar,fiurst,Papyan Karen - Rafayelyan Edgar,89,46,43,-3,3,15,18,20,20,16,7,-4,2,-2,-6,-3,4:11 - 11:7 - 9:11 - 11:9 - 11:5
17182379,2024-02-29 14:15:00,Hovhannesyan Rafik - Soghomonyan Hrayr,3:1,11:5 - 11:8 - 7:11 - 13:11 - 0:0,3,1,Hovhannesyan Rafik,Soghomonyan Hrayr,fiurst,Hovhannesyan Rafik - Soghomonyan Hrayr,77,42,35,-7,7,16,19,18,24,0,-6,-3,4,-2,0,-7,11:5 - 11:8 - 7:11 - 13:11 - 0:0
17182375,2024-02-29 14:00:00,Nazaryan Mushegh - Rafayelyan Edgar,0:3,6:11 - 7:11 - 7:11 - 0:0 - 0:0,0,3,Nazaryan Mushegh,Rafayelyan Edgar,fiurst,Nazaryan Mushegh - Rafayelyan Edgar,53,20,33,13,-13,17,18,18,0,0,5,4,4,0,0,13,6:11 - 7:11 - 7:11 - 0:0 - 0:0
17182374,2024-02-29 13:45:00,Papyan Karen - Hovhannesyan Rafik,0:3,11:9 - 11:4 - 11:5 - 0:0 - 0:0,3,0,Papyan Karen,Hovhannesyan Rafik,fiurst,Hovhannesyan Rafik - Papyan Karen,51,18,33,15,-15,20,15,16,0,0,2,7,6,0,0,15,9:11 - 4:11 - 5:11 - 0:0 - 0:0
17182372,2024-02-29 13:30:00,Soghomonyan Hrayr - Nazaryan Mushegh,0:3,11:8 - 11:8 - 12:10 - 0:0 - 0:0,3,0,Soghomonyan Hrayr,Nazaryan Mushegh,fiurst,Nazaryan Mushegh - Soghomonyan Hrayr,60,26,34,8,-8,19,19,22,0,0,3,3,2,0,0,8,8:11 - 8:11 - 10:12 - 0:0 - 0:0
17182370,2024-02-29 13:15:00,Rafayelyan Edgar - Hovhannesyan Rafik,1:3,9:11 - 11:4 - 11:4 - 11:8 - 0:0,3,1,Rafayelyan Edgar,Hovhannesyan Rafik,fiurst,Hovhannesyan Rafik - Rafayelyan Edgar,69,27,42,15,-15,20,15,15,19,0,-2,7,7,3,0,15,11:9 - 4:11 - 4:11 - 8:11 - 0:0
17182369,2024-02-29 13:00:00,Soghomonyan Hrayr - Papyan Karen,1:3,11:9 - 9:11 - 11:5 - 11:6 - 0:0,3,1,Soghomonyan Hrayr,Papyan Karen,fiurst,Papyan Karen - Soghomonyan Hrayr,73,31,42,11,-11,20,20,16,17,0,2,-2,6,5,0,11,9:11 - 11:9 - 5:11 - 6:11 - 0:0
17182367,2024-02-29 12:15:00,Nazaryan Mushegh - Hovhannesyan Rafik,3:1,9:11 - 9:11 - 11:7 - 6:11 - 0:0,1,3,Nazaryan Mushegh,Hovhannesyan Rafik,fiurst,Hovhannesyan Rafik - Nazaryan Mushegh,75,40,35,-5,5,20,20,18,17,0,-2,-2,4,-5,0,-5,11:9 - 11:9 - 7:11 - 11:6 - 0:0
17182352,2024-02-29 12:00:00,Soghomonyan Hrayr - Rafayelyan Edgar,3:1,2:11 - 11:9 - 7:11 - 4:11 - 0:0,1,3,Soghomonyan Hrayr,Rafayelyan Edgar,fiurst,Rafayelyan Edgar - Soghomonyan Hrayr,66,42,24,-18,18,13,20,18,15,0,-9,2,-4,-7,0,-18,11:2 - 9:11 - 11:7 - 11:4 - 0:0
17182351,2024-02-29 11:45:00,Papyan Karen - Nazaryan Mushegh,0:3,12:10 - 11:8 - 11:6 - 0:0 - 0:0,3,0,Papyan Karen,Nazaryan Mushegh,fiurst,Nazaryan Mushegh - Papyan Karen,58,24,34,10,-10,22,19,17,0,0,2,3,5,0,0,10,10:12 - 8:11 - 6:11 - 0:0 - 0:0
17182347,2024-02-29 11:30:00,Soghomonyan Hrayr - Hovhannesyan Rafik,1:3,10:12 - 11:6 - 11:9 - 15:13 - 0:0,3,1,Soghomonyan Hrayr,Hovhannesyan Rafik,fiurst,Hovhannesyan Rafik - Soghomonyan Hrayr,87,40,47,7,-7,22,17,20,28,0,-2,5,2,2,0,7,12:10 - 6:11 - 9:11 - 13:15 - 0:0
17182346,2024-02-29 11:15:00,Rafayelyan Edgar - Papyan Karen,2:3,7:11 - 11:6 - 9:11 - 11:8 - 11:4,3,2,Rafayelyan Edgar,Papyan Karen,fiurst,Papyan Karen - Rafayelyan Edgar,89,40,49,9,-9,18,17,20,19,15,-4,5,-2,3,7,9,11:7 - 6:11 - 11:9 - 8:11 - 4:11
17182343,2024-02-29 11:00:00,Nazaryan Mushegh - Soghomonyan Hrayr,3:2,9:11 - 8:11 - 11:4 - 11:6 - 12:10,3,2,Nazaryan Mushegh,Soghomonyan Hrayr,fiurst,Nazaryan Mushegh - Soghomonyan Hrayr,93,51,42,-9,9,20,19,15,17,22,2,3,-7,-5,-2,-9,9:11 - 8:11 - 11:4 - 11:6 - 12:10
17182313,2024-02-29 10:45:00,Hovhannesyan Rafik - Papyan Karen,1:3,4:11 - 11:9 - 8:11 - 8:11 - 0:0,1,3,Hovhannesyan Rafik,Papyan Karen,fiurst,Hovhannesyan Rafik - Papyan Karen,73,31,42,11,-11,15,20,19,19,0,7,-2,3,3,0,11,4:11 - 11:9 - 8:11 - 8:11 - 0:0
17182305,2024-02-29 10:30:00,Rafayelyan Edgar - Nazaryan Mushegh,0:3,12:10 - 11:6 - 11:8 - 0:0 - 0:0,3,0,Rafayelyan Edgar,Nazaryan Mushegh,fiurst,Nazaryan Mushegh - Rafayelyan Edgar,58,24,34,10,-10,22,17,19,0,0,2,5,3,0,0,10,10:12 - 6:11 - 8:11 - 0:0 - 0:0
17182300,2024-02-29 10:15:00,Papyan Karen - Soghomonyan Hrayr,3:1,11:9 - 11:9 - 10:12 - 11:6 - 0:0,3,1,Papyan Karen,Soghomonyan Hrayr,fiurst,Papyan Karen - Soghomonyan Hrayr,79,43,36,-7,7,20,20,22,17,0,-2,-2,2,-5,0,-7,11:9 - 11:9 - 10:12 - 11:6 - 0:0
17182284,2024-02-29 10:00:00,Hovhannesyan Rafik - Rafayelyan Edgar,1:3,5:11 - 6:11 - 11:6 - 15:17 - 0:0,1,3,Hovhannesyan Rafik,Rafayelyan Edgar,fiurst,Hovhannesyan Rafik - Rafayelyan Edgar,82,37,45,8,-8,16,17,17,32,0,6,5,-5,2,0,8,5:11 - 6:11 - 11:6 - 15:17 - 0:0
17173183,2024-02-28 17:45:00,Arutyunov Ruben - Avakimyan Davit,3:0,11:8 - 11:7 - 11:2 - 0:0 - 0:0,3,0,Arutyunov Ruben,Avakimyan Davit,fiurst,Arutyunov Ruben - Avakimyan Davit,50,33,17,-16,16,19,18,13,0,0,-3,-4,-9,0,0,-16,11:8 - 11:7 - 11:2 - 0:0 - 0:0
17173171,2024-02-28 17:30:00,Karakhanyan Mher - Gevorgyan Gegham,3:1,12:10 - 9:11 - 6:11 - 6:11 - 0:0,1,3,Karakhanyan Mher,Gevorgyan Gegham,fiurst,Gevorgyan Gegham - Karakhanyan Mher,76,43,33,-10,10,22,20,17,17,0,2,-2,-5,-5,0,-10,10:12 - 11:9 - 11:6 - 11:6 - 0:0
17173164,2024-02-28 17:15:00,Mkrtchyan Andranik - Arutyunov Ruben,3:0,9:11 - 6:11 - 9:11 - 0:0 - 0:0,0,3,Mkrtchyan Andranik,Arutyunov Ruben,fiurst,Arutyunov Ruben - Mkrtchyan Andranik,57,33,24,-9,9,20,17,20,0,0,-2,-5,-2,0,0,-9,11:9 - 11:6 - 11:9 - 0:0 - 0:0
17173163,2024-02-28 17:00:00,Karakhanyan Mher - Avakimyan Davit,3:1,9:11 - 8:11 - 13:11 - 9:11 - 0:0,1,3,Karakhanyan Mher,Avakimyan Davit,fiurst,Avakimyan Davit - Karakhanyan Mher,83,44,39,-5,5,20,19,24,20,0,-2,-3,2,-2,0,-5,11:9 - 11:8 - 11:13 - 11:9 - 0:0
17173143,2024-02-28 16:45:00,Gevorgyan Gegham - Mkrtchyan Andranik,1:3,11:5 - 7:11 - 6:11 - 7:11 - 0:0,1,3,Gevorgyan Gegham,Mkrtchyan Andranik,fiurst,Gevorgyan Gegham - Mkrtchyan Andranik,69,31,38,7,-7,16,18,17,18,0,-6,4,5,4,0,7,11:5 - 7:11 - 6:11 - 7:11 - 0:0
17173142,2024-02-28 16:30:00,Arutyunov Ruben - Karakhanyan Mher,3:0,11:4 - 11:3 - 11:6 - 0:0 - 0:0,3,0,Arutyunov Ruben,Karakhanyan Mher,fiurst,Arutyunov Ruben - Karakhanyan Mher,46,33,13,-20,20,15,14,17,0,0,-7,-8,-5,0,0,-20,11:4 - 11:3 - 11:6 - 0:0 - 0:0
17173112,2024-02-28 16:15:00,Avakimyan Davit - Mkrtchyan Andranik,2:3,9:11 - 11:5 - 11:9 - 5:11 - 8:11,2,3,Avakimyan Davit,Mkrtchyan Andranik,fiurst,Avakimyan Davit - Mkrtchyan Andranik,91,44,47,3,-3,20,16,20,16,19,2,-6,-2,6,3,3,9:11 - 11:5 - 11:9 - 5:11 - 8:11
17173110,2024-02-28 16:05:00,Gevorgyan Gegham - Arutyunov Ruben,3:0,7:11 - 6:11 - 5:11 - 0:0 - 0:0,0,3,Gevorgyan Gegham,Arutyunov Ruben,fiurst,Arutyunov Ruben - Gevorgyan Gegham,51,33,18,-15,15,18,17,16,0,0,-4,-5,-6,0,0,-15,11:7 - 11:6 - 11:5 - 0:0 - 0:0
17173099,2024-02-28 15:45:00,Mkrtchyan Andranik - Karakhanyan Mher,2:3,11:4 - 11:8 - 9:11 - 9:11 - 11:7,3,2,Mkrtchyan Andranik,Karakhanyan Mher,fiurst,Karakhanyan Mher - Mkrtchyan Andranik,92,41,51,10,-10,15,19,20,20,18,7,3,-2,-2,4,10,4:11 - 8:11 - 11:9 - 11:9 - 7:11
17173096,2024-02-28 15:30:00,Avakimyan Davit - Gevorgyan Gegham,3:2,13:11 - 8:11 - 11:6 - 9:11 - 11:8,3,2,Avakimyan Davit,Gevorgyan Gegham,fiurst,Avakimyan Davit - Gevorgyan Gegham,99,52,47,-5,5,24,19,17,20,19,-2,3,-5,2,-3,-5,13:11 - 8:11 - 11:6 - 9:11 - 11:8
17173857,2024-02-28 15:15:00,Hovhannesyan Rafik - Soghomonyan Hrayr,1:3,4:11 - 9:11 - 11:5 - 8:11 - 0:0,1,3,Hovhannesyan Rafik,Soghomonyan Hrayr,fiurst,Hovhannesyan Rafik - Soghomonyan Hrayr,70,32,38,6,-6,15,20,16,19,0,7,2,-6,3,0,6,4:11 - 9:11 - 11:5 - 8:11 - 0:0
17173075,2024-02-28 15:10:00,Nikoghosyan Narek - Nazaryan Mushegh,1:3,11:7 - 11:7 - 9:11 - 11:5 - 0:0,3,1,Nikoghosyan Narek,Nazaryan Mushegh,fiurst,Nazaryan Mushegh - Nikoghosyan Narek,72,30,42,12,-12,18,18,20,16,0,4,4,-2,6,0,12,7:11 - 7:11 - 11:9 - 5:11 - 0:0
17173856,2024-02-28 14:45:00,Diaryan Aleksandr - Hovhannesyan Rafik,3:0,11:5 - 14:12 - 14:12 - 0:0 - 0:0,3,0,Diaryan Aleksandr,Hovhannesyan Rafik,fiurst,Diaryan Aleksandr - Hovhannesyan Rafik,68,39,29,-10,10,16,26,26,0,0,-6,-2,-2,0,0,-10,11:5 - 14:12 - 14:12 - 0:0 - 0:0
17173055,2024-02-28 14:40:00,Soghomonyan Hrayr - Nikoghosyan Narek,3:1,11:6 - 11:13 - 8:11 - 5:11 - 0:0,1,3,Soghomonyan Hrayr,Nikoghosyan Narek,fiurst,Nikoghosyan Narek - Soghomonyan Hrayr,76,41,35,-6,6,17,24,19,16,0,5,-2,-3,-6,0,-6,6:11 - 13:11 - 11:8 - 11:5 - 0:0
17173043,2024-02-28 14:15:00,Diaryan Aleksandr - Nazaryan Mushegh,0:3,5:11 - 5:11 - 9:11 - 0:0 - 0:0,0,3,Diaryan Aleksandr,Nazaryan Mushegh,fiurst,Diaryan Aleksandr - Nazaryan Mushegh,52,19,33,14,-14,16,16,20,0,0,6,6,2,0,0,14,5:11 - 5:11 - 9:11 - 0:0 - 0:0
17173852,2024-02-28 14:00:00,Hovhannesyan Rafik - Nikoghosyan Narek,2:3,10:12 - 12:10 - 8:11 - 11:7 - 2:11,2,3,Hovhannesyan Rafik,Nikoghosyan Narek,fiurst,Hovhannesyan Rafik - Nikoghosyan Narek,94,43,51,8,-8,22,22,19,18,13,2,-2,3,-4,9,8,10:12 - 12:10 - 8:11 - 11:7 - 2:11
17173027,2024-02-28 13:55:00,Soghomonyan Hrayr - Diaryan Aleksandr,0:3,14:12 - 11:7 - 11:5 - 0:0 - 0:0,3,0,Soghomonyan Hrayr,Diaryan Aleksandr,fiurst,Diaryan Aleksandr - Soghomonyan Hrayr,60,24,36,12,-12,26,18,16,0,0,2,4,6,0,0,12,12:14 - 7:11 - 5:11 - 0:0 - 0:0
17173846,2024-02-28 13:30:00,Nazaryan Mushegh - Hovhannesyan Rafik,3:1,11:3 - 7:11 - 8:11 - 7:11 - 0:0,1,3,Nazaryan Mushegh,Hovhannesyan Rafik,fiurst,Hovhannesyan Rafik - Nazaryan Mushegh,69,36,33,-3,3,14,18,19,18,0,8,-4,-3,-4,0,-3,3:11 - 11:7 - 11:8 - 11:7 - 0:0
17173025,2024-02-28 13:15:00,Nikoghosyan Narek - Diaryan Aleksandr,3:0,5:11 - 7:11 - 15:17 - 0:0 - 0:0,0,3,Nikoghosyan Narek,Diaryan Aleksandr,fiurst,Diaryan Aleksandr - Nikoghosyan Narek,66,39,27,-12,12,16,18,32,0,0,-6,-4,-2,0,0,-12,11:5 - 11:7 - 17:15 - 0:0 - 0:0
17173024,2024-02-28 13:00:00,Nazaryan Mushegh - Soghomonyan Hrayr,2:3,10:12 - 12:10 - 11:7 - 6:11 - 7:11,2,3,Nazaryan Mushegh,Soghomonyan Hrayr,fiurst,Nazaryan Mushegh - Soghomonyan Hrayr,97,46,51,5,-5,22,22,18,17,18,2,-2,-4,5,4,5,10:12 - 12:10 - 11:7 - 6:11 - 7:11
17173831,2024-02-28 12:15:00,Hovhannesyan Rafik - Diaryan Aleksandr,3:0,5:11 - 9:11 - 7:11 - 0:0 - 0:0,0,3,Hovhannesyan Rafik,Diaryan Aleksandr,fiurst,Diaryan Aleksandr - Hovhannesyan Rafik,54,33,21,-12,12,16,20,18,0,0,-6,-2,-4,0,0,-12,11:5 - 11:9 - 11:7 - 0:0 - 0:0
17173020,2024-02-28 12:10:00,Nazaryan Mushegh - Nikoghosyan Narek,0:3,8:11 - 6:11 - 13:15 - 0:0 - 0:0,0,3,Nazaryan Mushegh,Nikoghosyan Narek,fiurst,Nazaryan Mushegh - Nikoghosyan Narek,64,27,37,10,-10,19,17,28,0,0,3,5,2,0,0,10,8:11 - 6:11 - 13:15 - 0:0 - 0:0
17173829,2024-02-28 11:45:00,Soghomonyan Hrayr - Hovhannesyan Rafik,0:3,13:11 - 11:7 - 13:11 - 0:0 - 0:0,3,0,Soghomonyan Hrayr,Hovhannesyan Rafik,fiurst,Hovhannesyan Rafik - Soghomonyan Hrayr,66,29,37,8,-8,24,18,24,0,0,2,4,2,0,0,8,11:13 - 7:11 - 11:13 - 0:0 - 0:0
17173004,2024-02-28 11:35:00,Nazaryan Mushegh - Diaryan Aleksandr,3:2,6:11 - 9:11 - 12:10 - 11:9 - 3:11,2,3,Nazaryan Mushegh,Diaryan Aleksandr,fiurst,Diaryan Aleksandr - Nazaryan Mushegh,93,52,41,-11,11,17,20,22,20,14,-5,-2,2,2,-8,-11,11:6 - 11:9 - 10:12 - 9:11 - 11:3
17172985,2024-02-28 11:15:00,Nikoghosyan Narek - Soghomonyan Hrayr,2:3,11:13 - 6:11 - 11:7 - 11:8 - 11:13,2,3,Nikoghosyan Narek,Soghomonyan Hrayr,fiurst,Nikoghosyan Narek - Soghomonyan Hrayr,102,50,52,2,-2,24,17,18,19,24,2,5,-4,-3,2,2,11:13 - 6:11 - 11:7 - 11:8 - 11:13
17173825,2024-02-28 11:00:00,Hovhannesyan Rafik - Nazaryan Mushegh,2:3,11:3 - 8:11 - 9:11 - 11:7 - 8:11,2,3,Hovhannesyan Rafik,Nazaryan Mushegh,fiurst,Hovhannesyan Rafik - Nazaryan Mushegh,90,47,43,-4,4,14,19,20,18,19,-8,3,2,-4,3,-4,11:3 - 8:11 - 9:11 - 11:7 - 8:11
17171845,2024-02-28 10:45:00,Diaryan Aleksandr - Soghomonyan Hrayr,0:3,8:11 - 4:11 - 8:11 - 0:0 - 0:0,0,3,Diaryan Aleksandr,Soghomonyan Hrayr,fiurst,Diaryan Aleksandr - Soghomonyan Hrayr,53,20,33,13,-13,19,15,19,0,0,3,7,3,0,0,13,8:11 - 4:11 - 8:11 - 0:0 - 0:0
17173823,2024-02-28 10:30:00,Nikoghosyan Narek - Hovhannesyan Rafik,1:3,5:11 - 11:8 - 14:12 - 11:5 - 0:0,3,1,Nikoghosyan Narek,Hovhannesyan Rafik,fiurst,Hovhannesyan Rafik - Nikoghosyan Narek,77,36,41,5,-5,16,19,26,16,0,-6,3,2,6,0,5,11:5 - 8:11 - 12:14 - 5:11 - 0:0
17171822,2024-02-28 10:15:00,Soghomonyan Hrayr - Nazaryan Mushegh,1:3,11:8 - 11:7 - 5:11 - 11:7 - 0:0,3,1,Soghomonyan Hrayr,Nazaryan Mushegh,fiurst,Nazaryan Mushegh - Soghomonyan Hrayr,71,33,38,5,-5,19,18,16,18,0,3,4,-6,4,0,5,8:11 - 7:11 - 11:5 - 7:11 - 0:0
17171821,2024-02-28 10:00:00,Diaryan Aleksandr - Nikoghosyan Narek,1:3,11:6 - 10:12 - 6:11 - 4:11 - 0:0,1,3,Diaryan Aleksandr,Nikoghosyan Narek,fiurst,Diaryan Aleksandr - Nikoghosyan Narek,71,31,40,9,-9,17,22,17,15,0,-5,2,5,7,0,9,11:6 - 10:12 - 6:11 - 4:11 - 0:0
17146287,2024-02-27 17:45:00,Gevorgyan Hayk - Karakhanyan Mher,3:0,11:7 - 11:6 - 11:2 - 0:0 - 0:0,3,0,Gevorgyan Hayk,Karakhanyan Mher,fiurst,Gevorgyan Hayk - Karakhanyan Mher,48,33,15,-18,18,18,17,13,0,0,-4,-5,-9,0,0,-18,11:7 - 11:6 - 11:2 - 0:0 - 0:0
17146285,2024-02-27 17:30:00,Arutyunov Ruben - Avakimyan Davit,3:0,11:2 - 11:3 - 11:8 - 0:0 - 0:0,3,0,Arutyunov Ruben,Avakimyan Davit,fiurst,Arutyunov Ruben - Avakimyan Davit,46,33,13,-20,20,13,14,19,0,0,-9,-8,-3,0,0,-20,11:2 - 11:3 - 11:8 - 0:0 - 0:0
17146283,2024-02-27 17:15:00,Petrosyan Davit - Gevorgyan Hayk,0:3,11:7 - 12:10 - 11:9 - 0:0 - 0:0,3,0,Petrosyan Davit,Gevorgyan Hayk,fiurst,Gevorgyan Hayk - Petrosyan Davit,60,26,34,8,-8,18,22,20,0,0,4,2,2,0,0,8,7:11 - 10:12 - 9:11 - 0:0 - 0:0
17146270,2024-02-27 17:00:00,Arutyunov Ruben - Karakhanyan Mher,3:0,11:4 - 11:3 - 11:8 - 0:0 - 0:0,3,0,Arutyunov Ruben,Karakhanyan Mher,fiurst,Arutyunov Ruben - Karakhanyan Mher,48,33,15,-18,18,15,14,19,0,0,-7,-8,-3,0,0,-18,11:4 - 11:3 - 11:8 - 0:0 - 0:0
17146269,2024-02-27 16:45:00,Avakimyan Davit - Petrosyan Davit,1:3,11:6 - 4:11 - 10:12 - 3:11 - 0:0,1,3,Avakimyan Davit,Petrosyan Davit,fiurst,Avakimyan Davit - Petrosyan Davit,68,28,40,12,-12,17,15,22,14,0,-5,7,2,8,0,12,11:6 - 4:11 - 10:12 - 3:11 - 0:0
17146266,2024-02-27 16:30:00,Gevorgyan Hayk - Arutyunov Ruben,3:1,3:11 - 4:11 - 11:8 - 6:11 - 0:0,1,3,Gevorgyan Hayk,Arutyunov Ruben,fiurst,Arutyunov Ruben - Gevorgyan Hayk,65,41,24,-17,17,14,15,19,17,0,-8,-7,3,-5,0,-17,11:3 - 11:4 - 8:11 - 11:6 - 0:0
17146257,2024-02-27 16:15:00,Karakhanyan Mher - Petrosyan Davit,0:3,8:11 - 9:11 - 4:11 - 0:0 - 0:0,0,3,Karakhanyan Mher,Petrosyan Davit,fiurst,Karakhanyan Mher - Petrosyan Davit,54,21,33,12,-12,19,20,15,0,0,3,2,7,0,0,12,8:11 - 9:11 - 4:11 - 0:0 - 0:0
17146255,2024-02-27 16:00:00,Avakimyan Davit - Gevorgyan Hayk,1:3,11:9 - 4:11 - 8:11 - 1:11 - 0:0,1,3,Avakimyan Davit,Gevorgyan Hayk,fiurst,Avakimyan Davit - Gevorgyan Hayk,66,24,42,18,-18,20,15,19,12,0,-2,7,3,10,0,18,11:9 - 4:11 - 8:11 - 1:11 - 0:0
17146253,2024-02-27 15:45:00,Petrosyan Davit - Arutyunov Ruben,3:2,12:10 - 11:9 - 4:11 - 7:11 - 8:11,2,3,Petrosyan Davit,Arutyunov Ruben,fiurst,Arutyunov Ruben - Petrosyan Davit,94,52,42,-10,10,22,20,15,18,19,2,2,-7,-4,-3,-10,10:12 - 9:11 - 11:4 - 11:7 - 11:8
17146242,2024-02-27 15:30:00,Karakhanyan Mher - Avakimyan Davit,3:1,11:6 - 2:11 - 4:11 - 4:11 - 0:0,1,3,Karakhanyan Mher,Avakimyan Davit,fiurst,Avakimyan Davit - Karakhanyan Mher,60,39,21,-18,18,17,13,15,15,0,5,-9,-7,-7,0,-18,6:11 - 11:2 - 11:4 - 11:4 - 0:0
17146232,2024-02-27 15:20:00,Nikoghosyan Narek - Rafayelyan Edgar,3:0,11:8 - 11:5 - 11:7 - 0:0 - 0:0,3,0,Nikoghosyan Narek,Rafayelyan Edgar,fiurst,Nikoghosyan Narek - Rafayelyan Edgar,53,33,20,-13,13,19,16,18,0,0,-3,-6,-4,0,0,-13,11:8 - 11:5 - 11:7 - 0:0 - 0:0
17146229,2024-02-27 15:00:00,Diaryan Aleksandr - Mkrtchyan Andranik,3:0,11:9 - 11:5 - 11:5 - 0:0 - 0:0,3,0,Diaryan Aleksandr,Mkrtchyan Andranik,fiurst,Diaryan Aleksandr - Mkrtchyan Andranik,52,33,19,-14,14,20,16,16,0,0,-2,-6,-6,0,0,-14,11:9 - 11:5 - 11:5 - 0:0 - 0:0
17146208,2024-02-27 14:45:00,Papyan Karen - Nikoghosyan Narek,3:2,9:11 - 11:6 - 11:7 - 4:11 - 7:11,2,3,Papyan Karen,Nikoghosyan Narek,fiurst,Nikoghosyan Narek - Papyan Karen,88,46,42,-4,4,20,17,18,15,18,-2,5,4,-7,-4,-4,11:9 - 6:11 - 7:11 - 11:4 - 11:7
17146205,2024-02-27 14:30:00,Rafayelyan Edgar - Diaryan Aleksandr,2:3,11:6 - 5:11 - 6:11 - 11:6 - 11:3,3,2,Rafayelyan Edgar,Diaryan Aleksandr,fiurst,Diaryan Aleksandr - Rafayelyan Edgar,81,37,44,7,-7,17,16,17,17,14,5,-6,-5,5,8,7,6:11 - 11:5 - 11:6 - 6:11 - 3:11
17146203,2024-02-27 14:15:00,Papyan Karen - Mkrtchyan Andranik,1:3,11:9 - 11:9 - 9:11 - 11:8 - 0:0,3,1,Papyan Karen,Mkrtchyan Andranik,fiurst,Mkrtchyan Andranik - Papyan Karen,79,37,42,5,-5,20,20,20,19,0,2,2,-2,3,0,5,9:11 - 9:11 - 11:9 - 8:11 - 0:0
17146197,2024-02-27 14:00:00,Nikoghosyan Narek - Diaryan Aleksandr,3:0,10:12 - 5:11 - 8:11 - 0:0 - 0:0,0,3,Nikoghosyan Narek,Diaryan Aleksandr,fiurst,Diaryan Aleksandr - Nikoghosyan Narek,57,34,23,-11,11,22,16,19,0,0,-2,-6,-3,0,0,-11,12:10 - 11:5 - 11:8 - 0:0 - 0:0
17146192,2024-02-27 13:55:00,Rafayelyan Edgar - Papyan Karen,0:3,11:7 - 11:8 - 11:8 - 0:0 - 0:0,3,0,Rafayelyan Edgar,Papyan Karen,fiurst,Papyan Karen - Rafayelyan Edgar,56,23,33,10,-10,18,19,19,0,0,4,3,3,0,0,10,7:11 - 8:11 - 8:11 - 0:0 - 0:0
17146181,2024-02-27 13:30:00,Mkrtchyan Andranik - Nikoghosyan Narek,0:3,6:11 - 5:11 - 3:11 - 0:0 - 0:0,0,3,Mkrtchyan Andranik,Nikoghosyan Narek,fiurst,Mkrtchyan Andranik - Nikoghosyan Narek,47,14,33,19,-19,17,16,14,0,0,5,6,8,0,0,19,6:11 - 5:11 - 3:11 - 0:0 - 0:0
17146174,2024-02-27 13:15:00,Diaryan Aleksandr - Papyan Karen,3:2,11:5 - 9:11 - 11:8 - 9:11 - 11:4,3,2,Diaryan Aleksandr,Papyan Karen,fiurst,Diaryan Aleksandr - Papyan Karen,90,51,39,-12,12,16,20,19,20,15,-6,2,-3,2,-7,-12,11:5 - 9:11 - 11:8 - 9:11 - 11:4
17146163,2024-02-27 13:00:00,Mkrtchyan Andranik - Rafayelyan Edgar,0:3,9:11 - 6:11 - 8:11 - 0:0 - 0:0,0,3,Mkrtchyan Andranik,Rafayelyan Edgar,fiurst,Mkrtchyan Andranik - Rafayelyan Edgar,56,23,33,10,-10,20,17,19,0,0,2,5,3,0,0,10,9:11 - 6:11 - 8:11 - 0:0 - 0:0
17146162,2024-02-27 12:20:00,Nikoghosyan Narek - Papyan Karen,3:2,6:11 - 11:8 - 11:8 - 5:11 - 11:5,3,2,Nikoghosyan Narek,Papyan Karen,fiurst,Nikoghosyan Narek - Papyan Karen,87,44,43,-1,1,17,19,19,16,16,5,-3,-3,6,-6,-1,6:11 - 11:8 - 11:8 - 5:11 - 11:5
17146160,2024-02-27 12:00:00,Mkrtchyan Andranik - Diaryan Aleksandr,3:0,4:11 - 3:11 - 8:11 - 0:0 - 0:0,0,3,Mkrtchyan Andranik,Diaryan Aleksandr,fiurst,Diaryan Aleksandr - Mkrtchyan Andranik,48,33,15,-18,18,15,14,19,0,0,-7,-8,-3,0,0,-18,11:4 - 11:3 - 11:8 - 0:0 - 0:0
17146158,2024-02-27 11:45:00,Rafayelyan Edgar - Nikoghosyan Narek,1:3,11:7 - 11:5 - 6:11 - 11:9 - 0:0,3,1,Rafayelyan Edgar,Nikoghosyan Narek,fiurst,Nikoghosyan Narek - Rafayelyan Edgar,71,32,39,7,-7,18,16,17,20,0,4,6,-5,2,0,7,7:11 - 5:11 - 11:6 - 9:11 - 0:0
17146157,2024-02-27 11:30:00,Mkrtchyan Andranik - Papyan Karen,1:3,8:11 - 14:12 - 5:11 - 9:11 - 0:0,1,3,Mkrtchyan Andranik,Papyan Karen,fiurst,Mkrtchyan Andranik - Papyan Karen,81,36,45,9,-9,19,26,16,20,0,3,-2,6,2,0,9,8:11 - 14:12 - 5:11 - 9:11 - 0:0
17146135,2024-02-27 11:15:00,Diaryan Aleksandr - Rafayelyan Edgar,3:0,11:5 - 11:6 - 11:8 - 0:0 - 0:0,3,0,Diaryan Aleksandr,Rafayelyan Edgar,fiurst,Diaryan Aleksandr - Rafayelyan Edgar,52,33,19,-14,14,16,17,19,0,0,-6,-5,-3,0,0,-14,11:5 - 11:6 - 11:8 - 0:0 - 0:0
17146133,2024-02-27 11:10:00,Nikoghosyan Narek - Mkrtchyan Andranik,1:3,11:9 - 4:11 - 13:11 - 11:9 - 0:0,3,1,Nikoghosyan Narek,Mkrtchyan Andranik,fiurst,Mkrtchyan Andranik - Nikoghosyan Narek,79,40,39,-1,1,20,15,24,20,0,2,-7,2,2,0,-1,9:11 - 11:4 - 11:13 - 9:11 - 0:0
17146130,2024-02-27 10:45:00,Papyan Karen - Rafayelyan Edgar,3:2,11:9 - 11:7 - 10:12 - 11:13 - 11:9,3,2,Papyan Karen,Rafayelyan Edgar,fiurst,Papyan Karen - Rafayelyan Edgar,104,54,50,-4,4,20,18,22,24,20,-2,-4,2,2,-2,-4,11:9 - 11:7 - 10:12 - 11:13 - 11:9
17160459,2024-02-27 10:30:00,Diaryan Aleksandr - Nikoghosyan Narek,3:2,6:11 - 11:8 - 4:11 - 11:5 - 11:7,3,2,Diaryan Aleksandr,Nikoghosyan Narek,fiurst,Diaryan Aleksandr - Nikoghosyan Narek,85,43,42,-1,1,17,19,15,16,18,5,-3,7,-6,-4,-1,6:11 - 11:8 - 4:11 - 11:5 - 11:7
17146128,2024-02-27 10:30:00,Mkrtchyan Andranik - Nikoghosyan Narek,0:0,0:0 - 0:0 - 0:0 - 0:0 - 0:0,0,0,Mkrtchyan Andranik,Nikoghosyan Narek,fiurst,Mkrtchyan Andranik - Nikoghosyan Narek,0,0,0,0,0,0,0,0,0,0,0,0,0,0,0,0,0:0 - 0:0 - 0:0 - 0:0 - 0:0
17146110,2024-02-27 10:15:00,Rafayelyan Edgar - Mkrtchyan Andranik,0:3,12:10 - 12:10 - 11:4 - 0:0 - 0:0,3,0,Rafayelyan Edgar,Mkrtchyan Andranik,fiurst,Mkrtchyan Andranik - Rafayelyan Edgar,59,24,35,11,-11,22,22,15,0,0,2,2,7,0,0,11,10:12 - 10:12 - 4:11 - 0:0 - 0:0
17146070,2024-02-27 10:00:00,Papyan Karen - Diaryan Aleksandr,3:0,12:14 - 5:11 - 9:11 - 0:0 - 0:0,0,3,Papyan Karen,Diaryan Aleksandr,fiurst,Diaryan Aleksandr - Papyan Karen,62,36,26,-10,10,26,16,20,0,0,-2,-6,-2,0,0,-10,14:12 - 11:5 - 11:9 - 0:0 - 0:0
17121082,2024-02-26 17:45:00,Avakimyan Davit - Petrosyan Davit,3:2,14:16 - 14:12 - 11:6 - 6:11 - 11:5,3,2,Avakimyan Davit,Petrosyan Davit,fiurst,Avakimyan Davit - Petrosyan Davit,106,56,50,-6,6,30,26,17,17,16,2,-2,-5,5,-6,-6,14:16 - 14:12 - 11:6 - 6:11 - 11:5
17121078,2024-02-26 17:40:00,Gevorgyan Gegham - Gevorgyan Hayk,3:0,12:10 - 11:8 - 11:3 - 0:0 - 0:0,3,0,Gevorgyan Gegham,Gevorgyan Hayk,fiurst,Gevorgyan Gegham - Gevorgyan Hayk,55,34,21,-13,13,22,19,14,0,0,-2,-3,-8,0,0,-13,12:10 - 11:8 - 11:3 - 0:0 - 0:0
17121075,2024-02-26 17:15:00,Arutyunov Ruben - Avakimyan Davit,3:0,11:8 - 11:9 - 11:4 - 0:0 - 0:0,3,0,Arutyunov Ruben,Avakimyan Davit,fiurst,Arutyunov Ruben - Avakimyan Davit,54,33,21,-12,12,19,20,15,0,0,-3,-2,-7,0,0,-12,11:8 - 11:9 - 11:4 - 0:0 - 0:0
17121071,2024-02-26 17:00:00,Gevorgyan Gegham - Petrosyan Davit,0:3,9:11 - 4:11 - 7:11 - 0:0 - 0:0,0,3,Gevorgyan Gegham,Petrosyan Davit,fiurst,Gevorgyan Gegham - Petrosyan Davit,53,20,33,13,-13,20,15,18,0,0,2,7,4,0,0,13,9:11 - 4:11 - 7:11 - 0:0 - 0:0
17121064,2024-02-26 16:45:00,Grigoryan Erik - Arutyunov Ruben,3:0,1:11 - 4:11 - 7:11 - 0:0 - 0:0,0,3,Grigoryan Erik,Arutyunov Ruben,fiurst,Arutyunov Ruben - Grigoryan Erik,45,33,12,-21,21,12,15,18,0,0,-10,-7,-4,0,0,-21,11:1 - 11:4 - 11:7 - 0:0 - 0:0
17121057,2024-02-26 16:30:00,Avakimyan Davit - Gevorgyan Gegham,3:0,13:11 - 11:6 - 11:9 - 0:0 - 0:0,3,0,Avakimyan Davit,Gevorgyan Gegham,fiurst,Avakimyan Davit - Gevorgyan Gegham,61,35,26,-9,9,24,17,20,0,0,-2,-5,-2,0,0,-9,13:11 - 11:6 - 11:9 - 0:0 - 0:0
17121056,2024-02-26 16:15:00,Petrosyan Davit - Arutyunov Ruben,3:0,10:12 - 3:11 - 8:11 - 0:0 - 0:0,0,3,Petrosyan Davit,Arutyunov Ruben,fiurst,Arutyunov Ruben - Petrosyan Davit,55,34,21,-13,13,22,14,19,0,0,-2,-8,-3,0,0,-13,12:10 - 11:3 - 11:8 - 0:0 - 0:0
17121049,2024-02-26 16:00:00,Grigoryan Erik - Avakimyan Davit,3:0,6:11 - 7:11 - 6:11 - 0:0 - 0:0,0,3,Grigoryan Erik,Avakimyan Davit,fiurst,Avakimyan Davit - Grigoryan Erik,52,33,19,-14,14,17,18,17,0,0,-5,-4,-5,0,0,-14,11:6 - 11:7 - 11:6 - 0:0 - 0:0
17121038,2024-02-26 15:45:00,Arutyunov Ruben - Gevorgyan Gegham,3:0,11:6 - 11:6 - 11:6 - 0:0 - 0:0,3,0,Arutyunov Ruben,Gevorgyan Gegham,fiurst,Arutyunov Ruben - Gevorgyan Gegham,51,33,18,-15,15,17,17,17,0,0,-5,-5,-5,0,0,-15,11:6 - 11:6 - 11:6 - 0:0 - 0:0
17121031,2024-02-26 15:40:00,Petrosyan Davit - Grigoryan Erik,0:3,12:10 - 11:7 - 11:4 - 0:0 - 0:0,3,0,Petrosyan Davit,Grigoryan Erik,fiurst,Grigoryan Erik - Petrosyan Davit,55,21,34,13,-13,22,18,15,0,0,2,4,7,0,0,13,10:12 - 7:11 - 4:11 - 0:0 - 0:0
17121022,2024-02-26 15:15:00,Diaryan Aleksandr - Papyan Karen,3:2,5:11 - 11:4 - 8:11 - 11:9 - 11:8,3,2,Diaryan Aleksandr,Papyan Karen,fiurst,Diaryan Aleksandr - Papyan Karen,89,46,43,-3,3,16,15,19,20,19,6,-7,3,-2,-3,-3,5:11 - 11:4 - 8:11 - 11:9 - 11:8
17121017,2024-02-26 15:00:00,Rafayelyan Edgar - Soghomonyan Hrayr,3:1,11:8 - 6:11 - 11:6 - 11:7 - 0:0,3,1,Rafayelyan Edgar,Soghomonyan Hrayr,fiurst,Rafayelyan Edgar - Soghomonyan Hrayr,71,39,32,-7,7,19,17,17,18,0,-3,5,-5,-4,0,-7,11:8 - 6:11 - 11:6 - 11:7 - 0:0
17121012,2024-02-26 14:45:00,Nazaryan Mushegh - Diaryan Aleksandr,3:2,12:10 - 8:11 - 11:4 - 5:11 - 6:11,2,3,Nazaryan Mushegh,Diaryan Aleksandr,fiurst,Diaryan Aleksandr - Nazaryan Mushegh,89,47,42,-5,5,22,19,15,16,17,2,-3,7,-6,-5,-5,10:12 - 11:8 - 4:11 - 11:5 - 11:6
17121010,2024-02-26 14:35:00,Papyan Karen - Rafayelyan Edgar,3:0,11:8 - 11:9 - 11:7 - 0:0 - 0:0,3,0,Papyan Karen,Rafayelyan Edgar,fiurst,Papyan Karen - Rafayelyan Edgar,57,33,24,-9,9,19,20,18,0,0,-3,-2,-4,0,0,-9,11:8 - 11:9 - 11:7 - 0:0 - 0:0
17121007,2024-02-26 14:15:00,Nazaryan Mushegh - Soghomonyan Hrayr,3:1,11:9 - 10:12 - 11:6 - 11:6 - 0:0,3,1,Nazaryan Mushegh,Soghomonyan Hrayr,fiurst,Nazaryan Mushegh - Soghomonyan Hrayr,76,43,33,-10,10,20,22,17,17,0,-2,2,-5,-5,0,-10,11:9 - 10:12 - 11:6 - 11:6 - 0:0
17121000,2024-02-26 14:00:00,Diaryan Aleksandr - Rafayelyan Edgar,3:1,9:11 - 11:7 - 11:8 - 12:10 - 0:0,3,1,Diaryan Aleksandr,Rafayelyan Edgar,fiurst,Diaryan Aleksandr - Rafayelyan Edgar,79,43,36,-7,7,20,18,19,22,0,2,-4,-3,-2,0,-7,9:11 - 11:7 - 11:8 - 12:10 - 0:0
17120996,2024-02-26 13:50:00,Papyan Karen - Nazaryan Mushegh,3:1,6:11 - 12:10 - 5:11 - 7:11 - 0:0,1,3,Papyan Karen,Nazaryan Mushegh,fiurst,Nazaryan Mushegh - Papyan Karen,73,43,30,-13,13,17,22,16,18,0,-5,2,-6,-4,0,-13,11:6 - 10:12 - 11:5 - 11:7 - 0:0
17120995,2024-02-26 13:30:00,Soghomonyan Hrayr - Diaryan Aleksandr,3:0,7:11 - 4:11 - 5:11 - 0:0 - 0:0,0,3,Soghomonyan Hrayr,Diaryan Aleksandr,fiurst,Diaryan Aleksandr - Soghomonyan Hrayr,49,33,16,-17,17,18,15,16,0,0,-4,-7,-6,0,0,-17,11:7 - 11:4 - 11:5 - 0:0 - 0:0
17120981,2024-02-26 13:15:00,Rafayelyan Edgar - Nazaryan Mushegh,1:3,5:11 - 11:8 - 11:5 - 11:4 - 0:0,3,1,Rafayelyan Edgar,Nazaryan Mushegh,fiurst,Nazaryan Mushegh - Rafayelyan Edgar,66,28,38,10,-10,16,19,16,15,0,-6,3,6,7,0,10,11:5 - 8:11 - 5:11 - 4:11 - 0:0
17120976,2024-02-26 13:00:00,Soghomonyan Hrayr - Papyan Karen,3:1,11:9 - 9:11 - 10:12 - 4:11 - 0:0,1,3,Soghomonyan Hrayr,Papyan Karen,fiurst,Papyan Karen - Soghomonyan Hrayr,77,43,34,-9,9,20,20,22,15,0,2,-2,-2,-7,0,-9,9:11 - 11:9 - 12:10 - 11:4 - 0:0
17120973,2024-02-26 12:15:00,Diaryan Aleksandr - Nazaryan Mushegh,3:1,11:13 - 11:4 - 11:4 - 11:5 - 0:0,3,1,Diaryan Aleksandr,Nazaryan Mushegh,fiurst,Diaryan Aleksandr - Nazaryan Mushegh,70,44,26,-18,18,24,15,15,16,0,2,-7,-7,-6,0,-18,11:13 - 11:4 - 11:4 - 11:5 - 0:0
17120963,2024-02-26 12:00:00,Soghomonyan Hrayr - Rafayelyan Edgar,3:0,9:11 - 8:11 - 11:13 - 0:0 - 0:0,0,3,Soghomonyan Hrayr,Rafayelyan Edgar,fiurst,Rafayelyan Edgar - Soghomonyan Hrayr,63,35,28,-7,7,20,19,24,0,0,-2,-3,-2,0,0,-7,11:9 - 11:8 - 13:11 - 0:0 - 0:0
17120954,2024-02-26 11:50:00,Papyan Karen - Diaryan Aleksandr,0:3,11:5 - 11:8 - 11:7 - 0:0 - 0:0,3,0,Papyan Karen,Diaryan Aleksandr,fiurst,Diaryan Aleksandr - Papyan Karen,53,20,33,13,-13,16,19,18,0,0,6,3,4,0,0,13,5:11 - 8:11 - 7:11 - 0:0 - 0:0
17120949,2024-02-26 11:30:00,Soghomonyan Hrayr - Nazaryan Mushegh,3:1,11:13 - 11:9 - 9:11 - 7:11 - 0:0,1,3,Soghomonyan Hrayr,Nazaryan Mushegh,fiurst,Nazaryan Mushegh - Soghomonyan Hrayr,82,44,38,-6,6,24,20,20,18,0,-2,2,-2,-4,0,-6,13:11 - 9:11 - 11:9 - 11:7 - 0:0
17120946,2024-02-26 11:15:00,Rafayelyan Edgar - Papyan Karen,1:3,11:8 - 11:9 - 8:11 - 12:10 - 0:0,3,1,Rafayelyan Edgar,Papyan Karen,fiurst,Papyan Karen - Rafayelyan Edgar,80,38,42,4,-4,19,20,19,22,0,3,2,-3,2,0,4,8:11 - 9:11 - 11:8 - 10:12 - 0:0
17120944,2024-02-26 11:00:00,Diaryan Aleksandr - Soghomonyan Hrayr,3:1,9:11 - 11:4 - 11:7 - 11:6 - 0:0,3,1,Diaryan Aleksandr,Soghomonyan Hrayr,fiurst,Diaryan Aleksandr - Soghomonyan Hrayr,70,42,28,-14,14,20,15,18,17,0,2,-7,-4,-5,0,-14,9:11 - 11:4 - 11:7 - 11:6 - 0:0
17120920,2024-02-26 10:45:00,Nazaryan Mushegh - Papyan Karen,0:3,6:11 - 7:11 - 4:11 - 0:0 - 0:0,0,3,Nazaryan Mushegh,Papyan Karen,fiurst,Nazaryan Mushegh - Papyan Karen,50,17,33,16,-16,17,18,15,0,0,5,4,7,0,0,16,6:11 - 7:11 - 4:11 - 0:0 - 0:0
17120917,2024-02-26 10:30:00,Rafayelyan Edgar - Diaryan Aleksandr,1:3,11:6 - 11:6 - 10:12 - 12:10 - 0:0,3,1,Rafayelyan Edgar,Diaryan Aleksandr,fiurst,Diaryan Aleksandr - Rafayelyan Edgar,78,34,44,10,-10,17,17,22,22,0,5,5,-2,2,0,10,6:11 - 6:11 - 12:10 - 10:12 - 0:0
17120912,2024-02-26 10:15:00,Papyan Karen - Soghomonyan Hrayr,3:0,11:8 - 11:8 - 11:3 - 0:0 - 0:0,3,0,Papyan Karen,Soghomonyan Hrayr,fiurst,Papyan Karen - Soghomonyan Hrayr,52,33,19,-14,14,19,19,14,0,0,-3,-3,-8,0,0,-14,11:8 - 11:8 - 11:3 - 0:0 - 0:0
17120909,2024-02-26 10:00:00,Nazaryan Mushegh - Rafayelyan Edgar,1:3,5:11 - 8:11 - 11:8 - 7:11 - 0:0,1,3,Nazaryan Mushegh,Rafayelyan Edgar,fiurst,Nazaryan Mushegh - Rafayelyan Edgar,72,31,41,10,-10,16,19,19,18,0,6,3,-3,4,0,10,5:11 - 8:11 - 11:8 - 7:11 - 0:0
17106460,2024-02-25 17:50:00,Gevorgyan Hayk - Gevorgyan Gegham,3:2,11:4 - 7:11 - 11:8 - 8:11 - 10:12,2,3,Gevorgyan Hayk,Gevorgyan Gegham,fiurst,Gevorgyan Gegham - Gevorgyan Hayk,93,46,47,1,-1,15,18,19,19,22,7,-4,3,-3,-2,1,4:11 - 11:7 - 8:11 - 11:8 - 12:10
17106459,2024-02-25 17:40:00,Grigoryan Erik - Karakhanyan Mher,3:0,12:10 - 11:3 - 11:4 - 0:0 - 0:0,3,0,Grigoryan Erik,Karakhanyan Mher,fiurst,Grigoryan Erik - Karakhanyan Mher,51,34,17,-17,17,22,14,15,0,0,-2,-8,-7,0,0,-17,12:10 - 11:3 - 11:4 - 0:0 - 0:0
17106456,2024-02-25 17:15:00,Petrosyan Davit - Gevorgyan Hayk,1:3,2:11 - 11:9 - 11:8 - 15:13 - 0:0,3,1,Petrosyan Davit,Gevorgyan Hayk,fiurst,Gevorgyan Hayk - Petrosyan Davit,80,41,39,-2,2,13,20,19,28,0,-9,2,3,2,0,-2,11:2 - 9:11 - 8:11 - 13:15 - 0:0
17106433,2024-02-25 17:10:00,Grigoryan Erik - Gevorgyan Gegham,3:2,11:7 - 11:13 - 11:4 - 8:11 - 6:11,2,3,Grigoryan Erik,Gevorgyan Gegham,fiurst,Gevorgyan Gegham - Grigoryan Erik,93,46,47,1,-1,18,24,15,19,17,4,-2,7,-3,-5,1,7:11 - 13:11 - 4:11 - 11:8 - 11:6
17106411,2024-02-25 16:45:00,Karakhanyan Mher - Petrosyan Davit,0:3,2:11 - 4:11 - 9:11 - 0:0 - 0:0,0,3,Karakhanyan Mher,Petrosyan Davit,fiurst,Karakhanyan Mher - Petrosyan Davit,48,15,33,18,-18,13,15,20,0,0,9,7,2,0,0,18,2:11 - 4:11 - 9:11 - 0:0 - 0:0
17106409,2024-02-25 16:35:00,Gevorgyan Hayk - Grigoryan Erik,2:3,11:8 - 9:11 - 11:9 - 5:11 - 9:11,2,3,Gevorgyan Hayk,Grigoryan Erik,fiurst,Gevorgyan Hayk - Grigoryan Erik,95,45,50,5,-5,19,20,20,16,20,-3,2,-2,6,2,5,11:8 - 9:11 - 11:9 - 5:11 - 9:11
17106402,2024-02-25 16:20:00,Gevorgyan Gegham - Petrosyan Davit,3:1,11:7 - 9:11 - 11:9 - 11:2 - 0:0,3,1,Gevorgyan Gegham,Petrosyan Davit,fiurst,Gevorgyan Gegham - Petrosyan Davit,71,42,29,-13,13,18,20,20,13,0,-4,2,-2,-9,0,-13,11:7 - 9:11 - 11:9 - 11:2 - 0:0
17106396,2024-02-25 16:00:00,Karakhanyan Mher - Gevorgyan Hayk,3:2,11:7 - 11:8 - 8:11 - 5:11 - 5:11,2,3,Karakhanyan Mher,Gevorgyan Hayk,fiurst,Gevorgyan Hayk - Karakhanyan Mher,88,48,40,-8,8,18,19,19,16,16,4,3,-3,-6,-6,-8,7:11 - 8:11 - 11:8 - 11:5 - 11:5
17106392,2024-02-25 15:45:00,Petrosyan Davit - Grigoryan Erik,3:0,13:15 - 9:11 - 7:11 - 0:0 - 0:0,0,3,Petrosyan Davit,Grigoryan Erik,fiurst,Grigoryan Erik - Petrosyan Davit,66,37,29,-8,8,28,20,18,0,0,-2,-2,-4,0,0,-8,15:13 - 11:9 - 11:7 - 0:0 - 0:0
17106384,2024-02-25 15:40:00,Gevorgyan Gegham - Karakhanyan Mher,3:2,13:11 - 8:11 - 6:11 - 11:7 - 11:7,3,2,Gevorgyan Gegham,Karakhanyan Mher,fiurst,Gevorgyan Gegham - Karakhanyan Mher,96,49,47,-2,2,24,19,17,18,18,-2,3,5,-4,-4,-2,13:11 - 8:11 - 6:11 - 11:7 - 11:7
17106366,2024-02-25 15:15:00,Nazaryan Mushegh - Rafayelyan Edgar,1:3,7:11 - 7:11 - 16:14 - 5:11 - 0:0,1,3,Nazaryan Mushegh,Rafayelyan Edgar,fiurst,Nazaryan Mushegh - Rafayelyan Edgar,82,35,47,12,-12,18,18,30,16,0,4,4,-2,6,0,12,7:11 - 7:11 - 16:14 - 5:11 - 0:0
17106362,2024-02-25 15:10:00,Nikoghosyan Narek - Diaryan Aleksandr,2:3,2:11 - 5:11 - 11:6 - 11:5 - 11:9,3,2,Nikoghosyan Narek,Diaryan Aleksandr,fiurst,Diaryan Aleksandr - Nikoghosyan Narek,82,42,40,-2,2,13,16,17,16,20,-9,-6,5,6,2,-2,11:2 - 11:5 - 6:11 - 5:11 - 9:11
17106360,2024-02-25 14:45:00,Soghomonyan Hrayr - Nazaryan Mushegh,0:3,11:8 - 11:8 - 11:7 - 0:0 - 0:0,3,0,Soghomonyan Hrayr,Nazaryan Mushegh,fiurst,Nazaryan Mushegh - Soghomonyan Hrayr,56,23,33,10,-10,19,19,18,0,0,3,3,4,0,0,10,8:11 - 8:11 - 7:11 - 0:0 - 0:0
17106357,2024-02-25 14:30:00,Rafayelyan Edgar - Nikoghosyan Narek,3:2,8:11 - 11:13 - 11:7 - 11:7 - 8:11,2,3,Rafayelyan Edgar,Nikoghosyan Narek,fiurst,Nikoghosyan Narek - Rafayelyan Edgar,98,49,49,0,0,19,24,18,18,19,-3,-2,4,4,-3,0,11:8 - 13:11 - 7:11 - 7:11 - 11:8
17106351,2024-02-25 14:15:00,Soghomonyan Hrayr - Diaryan Aleksandr,3:1,7:11 - 5:11 - 11:8 - 9:11 - 0:0,1,3,Soghomonyan Hrayr,Diaryan Aleksandr,fiurst,Diaryan Aleksandr - Soghomonyan Hrayr,73,41,32,-9,9,18,16,19,20,0,-4,-6,3,-2,0,-9,11:7 - 11:5 - 8:11 - 11:9 - 0:0
17106332,2024-02-25 14:00:00,Nazaryan Mushegh - Nikoghosyan Narek,0:3,7:11 - 7:11 - 7:11 - 0:0 - 0:0,0,3,Nazaryan Mushegh,Nikoghosyan Narek,fiurst,Nazaryan Mushegh - Nikoghosyan Narek,54,21,33,12,-12,18,18,18,0,0,4,4,4,0,0,12,7:11 - 7:11 - 7:11 - 0:0 - 0:0
17106327,2024-02-25 13:45:00,Rafayelyan Edgar - Soghomonyan Hrayr,3:2,13:15 - 12:10 - 9:11 - 11:7 - 11:4,3,2,Rafayelyan Edgar,Soghomonyan Hrayr,fiurst,Rafayelyan Edgar - Soghomonyan Hrayr,103,56,47,-9,9,28,22,20,18,15,2,-2,2,-4,-7,-9,13:15 - 12:10 - 9:11 - 11:7 - 11:4
17106318,2024-02-25 13:30:00,Diaryan Aleksandr - Nazaryan Mushegh,3:0,11:7 - 11:8 - 11:6 - 0:0 - 0:0,3,0,Diaryan Aleksandr,Nazaryan Mushegh,fiurst,Diaryan Aleksandr - Nazaryan Mushegh,54,33,21,-12,12,18,19,17,0,0,-4,-3,-5,0,0,-12,11:7 - 11:8 - 11:6 - 0:0 - 0:0
17106309,2024-02-25 13:15:00,Nikoghosyan Narek - Soghomonyan Hrayr,3:2,11:6 - 9:11 - 4:11 - 11:8 - 11:1,3,2,Nikoghosyan Narek,Soghomonyan Hrayr,fiurst,Nikoghosyan Narek - Soghomonyan Hrayr,83,46,37,-9,9,17,20,15,19,12,-5,2,7,-3,-10,-9,11:6 - 9:11 - 4:11 - 11:8 - 11:1
17106307,2024-02-25 13:00:00,Diaryan Aleksandr - Rafayelyan Edgar,3:1,11:7 - 6:11 - 11:7 - 11:4 - 0:0,3,1,Diaryan Aleksandr,Rafayelyan Edgar,fiurst,Diaryan Aleksandr - Rafayelyan Edgar,68,39,29,-10,10,18,17,18,15,0,-4,5,-4,-7,0,-10,11:7 - 6:11 - 11:7 - 11:4 - 0:0
17106295,2024-02-25 12:20:00,Nazaryan Mushegh - Soghomonyan Hrayr,1:3,9:11 - 11:7 - 8:11 - 8:11 - 0:0,1,3,Nazaryan Mushegh,Soghomonyan Hrayr,fiurst,Nazaryan Mushegh - Soghomonyan Hrayr,76,36,40,4,-4,20,18,19,19,0,2,-4,3,3,0,4,9:11 - 11:7 - 8:11 - 8:11 - 0:0
17106293,2024-02-25 12:10:00,Diaryan Aleksandr - Nikoghosyan Narek,1:3,11:7 - 8:11 - 10:12 - 6:11 - 0:0,1,3,Diaryan Aleksandr,Nikoghosyan Narek,fiurst,Diaryan Aleksandr - Nikoghosyan Narek,76,35,41,6,-6,18,19,22,17,0,-4,3,2,5,0,6,11:7 - 8:11 - 10:12 - 6:11 - 0:0
17106290,2024-02-25 11:55:00,Rafayelyan Edgar - Nazaryan Mushegh,0:3,11:8 - 11:6 - 11:4 - 0:0 - 0:0,3,0,Rafayelyan Edgar,Nazaryan Mushegh,fiurst,Nazaryan Mushegh - Rafayelyan Edgar,51,18,33,15,-15,19,17,15,0,0,3,5,7,0,0,15,8:11 - 6:11 - 4:11 - 0:0 - 0:0
17106289,2024-02-25 11:35:00,Diaryan Aleksandr - Soghomonyan Hrayr,3:1,9:11 - 11:8 - 12:10 - 11:7 - 0:0,3,1,Diaryan Aleksandr,Soghomonyan Hrayr,fiurst,Diaryan Aleksandr - Soghomonyan Hrayr,79,43,36,-7,7,20,19,22,18,0,2,-3,-2,-4,0,-7,9:11 - 11:8 - 12:10 - 11:7 - 0:0
17106284,2024-02-25 11:15:00,Nikoghosyan Narek - Rafayelyan Edgar,2:3,11:7 - 11:9 - 9:11 - 6:11 - 6:11,2,3,Nikoghosyan Narek,Rafayelyan Edgar,fiurst,Nikoghosyan Narek - Rafayelyan Edgar,92,43,49,6,-6,18,20,20,17,17,-4,-2,2,5,5,6,11:7 - 11:9 - 9:11 - 6:11 - 6:11
17106283,2024-02-25 11:00:00,Nazaryan Mushegh - Diaryan Aleksandr,3:2,11:7 - 5:11 - 12:10 - 9:11 - 9:11,2,3,Nazaryan Mushegh,Diaryan Aleksandr,fiurst,Diaryan Aleksandr - Nazaryan Mushegh,96,50,46,-4,4,18,16,22,20,20,4,-6,2,-2,-2,-4,7:11 - 11:5 - 10:12 - 11:9 - 11:9
17106265,2024-02-25 10:45:00,Soghomonyan Hrayr - Rafayelyan Edgar,3:1,5:11 - 9:11 - 11:7 - 9:11 - 0:0,1,3,Soghomonyan Hrayr,Rafayelyan Edgar,fiurst,Rafayelyan Edgar - Soghomonyan Hrayr,74,40,34,-6,6,16,20,18,20,0,-6,-2,4,-2,0,-6,11:5 - 11:9 - 7:11 - 11:9 - 0:0
17106253,2024-02-25 10:30:00,Nikoghosyan Narek - Nazaryan Mushegh,0:3,11:9 - 11:4 - 11:8 - 0:0 - 0:0,3,0,Nikoghosyan Narek,Nazaryan Mushegh,fiurst,Nazaryan Mushegh - Nikoghosyan Narek,54,21,33,12,-12,20,15,19,0,0,2,7,3,0,0,12,9:11 - 4:11 - 8:11 - 0:0 - 0:0
17106249,2024-02-25 10:15:00,Rafayelyan Edgar - Diaryan Aleksandr,3:1,6:11 - 11:9 - 10:12 - 7:11 - 0:0,1,3,Rafayelyan Edgar,Diaryan Aleksandr,fiurst,Diaryan Aleksandr - Rafayelyan Edgar,77,43,34,-9,9,17,20,22,18,0,-5,2,-2,-4,0,-9,11:6 - 9:11 - 12:10 - 11:7 - 0:0
17106229,2024-02-25 10:00:00,Soghomonyan Hrayr - Nikoghosyan Narek,0:3,11:9 - 12:10 - 11:5 - 0:0 - 0:0,3,0,Soghomonyan Hrayr,Nikoghosyan Narek,fiurst,Nikoghosyan Narek - Soghomonyan Hrayr,58,24,34,10,-10,20,22,16,0,0,2,2,6,0,0,10,9:11 - 10:12 - 5:11 - 0:0 - 0:0
17083382,2024-02-24 17:45:00,Grigoryan Erik - Arutyunov Ruben,3:2,11:5 - 13:15 - 13:11 - 3:11 - 9:11,2,3,Grigoryan Erik,Arutyunov Ruben,fiurst,Arutyunov Ruben - Grigoryan Erik,102,53,49,-4,4,16,28,24,14,20,6,-2,2,-8,-2,-4,5:11 - 15:13 - 11:13 - 11:3 - 11:9
17083381,2024-02-24 17:30:00,Gevorgyan Hayk - Karakhanyan Mher,3:1,6:11 - 11:7 - 11:7 - 11:5 - 0:0,3,1,Gevorgyan Hayk,Karakhanyan Mher,fiurst,Gevorgyan Hayk - Karakhanyan Mher,69,39,30,-9,9,17,18,18,16,0,5,-4,-4,-6,0,-9,6:11 - 11:7 - 11:7 - 11:5 - 0:0
17083380,2024-02-24 17:15:00,Gevorgyan Gegham - Grigoryan Erik,1:3,11:5 - 13:15 - 9:11 - 4:11 - 0:0,1,3,Gevorgyan Gegham,Grigoryan Erik,fiurst,Gevorgyan Gegham - Grigoryan Erik,79,37,42,5,-5,16,28,20,15,0,-6,2,2,7,0,5,11:5 - 13:15 - 9:11 - 4:11 - 0:0
17083379,2024-02-24 17:00:00,Gevorgyan Hayk - Arutyunov Ruben,3:0,7:11 - 5:11 - 10:12 - 0:0 - 0:0,0,3,Gevorgyan Hayk,Arutyunov Ruben,fiurst,Arutyunov Ruben - Gevorgyan Hayk,56,34,22,-12,12,18,16,22,0,0,-4,-6,-2,0,0,-12,11:7 - 11:5 - 12:10 - 0:0 - 0:0
17083377,2024-02-24 16:45:00,Karakhanyan Mher - Gevorgyan Gegham,3:0,8:11 - 6:11 - 10:12 - 0:0 - 0:0,0,3,Karakhanyan Mher,Gevorgyan Gegham,fiurst,Gevorgyan Gegham - Karakhanyan Mher,58,34,24,-10,10,19,17,22,0,0,-3,-5,-2,0,0,-10,11:8 - 11:6 - 12:10 - 0:0 - 0:0
17083374,2024-02-24 16:30:00,Grigoryan Erik - Gevorgyan Hayk,1:3,11:6 - 11:7 - 4:11 - 14:12 - 0:0,3,1,Grigoryan Erik,Gevorgyan Hayk,fiurst,Gevorgyan Hayk - Grigoryan Erik,76,36,40,4,-4,17,18,15,26,0,5,4,-7,2,0,4,6:11 - 7:11 - 11:4 - 12:14 - 0:0
17083373,2024-02-24 16:15:00,Arutyunov Ruben - Gevorgyan Gegham,3:0,11:5 - 11:6 - 11:6 - 0:0 - 0:0,3,0,Arutyunov Ruben,Gevorgyan Gegham,fiurst,Arutyunov Ruben - Gevorgyan Gegham,50,33,17,-16,16,16,17,17,0,0,-6,-5,-5,0,0,-16,11:5 - 11:6 - 11:6 - 0:0 - 0:0
17083354,2024-02-24 16:00:00,Karakhanyan Mher - Grigoryan Erik,3:1,11:5 - 7:11 - 4:11 - 12:14 - 0:0,1,3,Karakhanyan Mher,Grigoryan Erik,fiurst,Grigoryan Erik - Karakhanyan Mher,75,41,34,-7,7,16,18,15,26,0,6,-4,-7,-2,0,-7,5:11 - 11:7 - 11:4 - 14:12 - 0:0
17083353,2024-02-24 15:50:00,Gevorgyan Gegham - Gevorgyan Hayk,0:3,7:11 - 6:11 - 5:11 - 0:0 - 0:0,0,3,Gevorgyan Gegham,Gevorgyan Hayk,fiurst,Gevorgyan Gegham - Gevorgyan Hayk,51,18,33,15,-15,18,17,16,0,0,4,5,6,0,0,15,7:11 - 6:11 - 5:11 - 0:0 - 0:0
17083352,2024-02-24 15:30:00,Arutyunov Ruben - Karakhanyan Mher,3:0,11:3 - 11:1 - 11:1 - 0:0 - 0:0,3,0,Arutyunov Ruben,Karakhanyan Mher,fiurst,Arutyunov Ruben - Karakhanyan Mher,38,33,5,-28,28,14,12,12,0,0,-8,-10,-10,0,0,-28,11:3 - 11:1 - 11:1 - 0:0 - 0:0
17083351,2024-02-24 15:20:00,Nikoghosyan Narek - Soghomonyan Hrayr,2:3,2:11 - 13:11 - 11:13 - 11:5 - 9:11,2,3,Nikoghosyan Narek,Soghomonyan Hrayr,fiurst,Nikoghosyan Narek - Soghomonyan Hrayr,97,46,51,5,-5,13,24,24,16,20,9,-2,2,-6,2,5,2:11 - 13:11 - 11:13 - 11:5 - 9:11
17083336,2024-02-24 15:05:00,Papyan Karen - Nazaryan Mushegh,0:3,11:5 - 11:3 - 11:6 - 0:0 - 0:0,3,0,Papyan Karen,Nazaryan Mushegh,fiurst,Nazaryan Mushegh - Papyan Karen,47,14,33,19,-19,16,14,17,0,0,6,8,5,0,0,19,5:11 - 3:11 - 6:11 - 0:0 - 0:0
17083331,2024-02-24 14:45:00,Mkrtchyan Andranik - Nikoghosyan Narek,2:3,14:12 - 10:12 - 11:9 - 7:11 - 8:11,2,3,Mkrtchyan Andranik,Nikoghosyan Narek,fiurst,Mkrtchyan Andranik - Nikoghosyan Narek,105,50,55,5,-5,26,22,20,18,19,-2,2,-2,4,3,5,14:12 - 10:12 - 11:9 - 7:11 - 8:11
17083330,2024-02-24 14:30:00,Soghomonyan Hrayr - Papyan Karen,3:1,8:11 - 16:14 - 8:11 - 8:11 - 0:0,1,3,Soghomonyan Hrayr,Papyan Karen,fiurst,Papyan Karen - Soghomonyan Hrayr,87,47,40,-7,7,19,30,19,19,0,-3,2,-3,-3,0,-7,11:8 - 14:16 - 11:8 - 11:8 - 0:0
17083329,2024-02-24 14:15:00,Mkrtchyan Andranik - Nazaryan Mushegh,0:3,6:11 - 8:11 - 5:11 - 0:0 - 0:0,0,3,Mkrtchyan Andranik,Nazaryan Mushegh,fiurst,Mkrtchyan Andranik - Nazaryan Mushegh,52,19,33,14,-14,17,19,16,0,0,5,3,6,0,0,14,6:11 - 8:11 - 5:11 - 0:0 - 0:0
17083327,2024-02-24 14:00:00,Nikoghosyan Narek - Papyan Karen,3:0,11:6 - 11:7 - 11:4 - 0:0 - 0:0,3,0,Nikoghosyan Narek,Papyan Karen,fiurst,Nikoghosyan Narek - Papyan Karen,50,33,17,-16,16,17,18,15,0,0,-5,-4,-7,0,0,-16,11:6 - 11:7 - 11:4 - 0:0 - 0:0
17083325,2024-02-24 13:45:00,Soghomonyan Hrayr - Mkrtchyan Andranik,0:3,11:9 - 11:5 - 11:7 - 0:0 - 0:0,3,0,Soghomonyan Hrayr,Mkrtchyan Andranik,fiurst,Mkrtchyan Andranik - Soghomonyan Hrayr,54,21,33,12,-12,20,16,18,0,0,2,6,4,0,0,12,9:11 - 5:11 - 7:11 - 0:0 - 0:0
17083323,2024-02-24 13:30:00,Nazaryan Mushegh - Nikoghosyan Narek,3:0,11:5 - 11:6 - 11:9 - 0:0 - 0:0,3,0,Nazaryan Mushegh,Nikoghosyan Narek,fiurst,Nazaryan Mushegh - Nikoghosyan Narek,53,33,20,-13,13,16,17,20,0,0,-6,-5,-2,0,0,-13,11:5 - 11:6 - 11:9 - 0:0 - 0:0
17083321,2024-02-24 13:15:00,Papyan Karen - Mkrtchyan Andranik,1:3,11:4 - 6:11 - 13:11 - 11:9 - 0:0,3,1,Papyan Karen,Mkrtchyan Andranik,fiurst,Mkrtchyan Andranik - Papyan Karen,76,35,41,6,-6,15,17,24,20,0,7,-5,2,2,0,6,4:11 - 11:6 - 11:13 - 9:11 - 0:0
17083310,2024-02-24 13:00:00,Nazaryan Mushegh - Soghomonyan Hrayr,1:3,18:20 - 11:7 - 4:11 - 6:11 - 0:0,1,3,Nazaryan Mushegh,Soghomonyan Hrayr,fiurst,Nazaryan Mushegh - Soghomonyan Hrayr,88,39,49,10,-10,38,18,15,17,0,2,-4,7,5,0,10,18:20 - 11:7 - 4:11 - 6:11 - 0:0
17083308,2024-02-24 12:15:00,Nikoghosyan Narek - Mkrtchyan Andranik,0:3,11:4 - 11:4 - 11:7 - 0:0 - 0:0,3,0,Nikoghosyan Narek,Mkrtchyan Andranik,fiurst,Mkrtchyan Andranik - Nikoghosyan Narek,48,15,33,18,-18,15,15,18,0,0,7,7,4,0,0,18,4:11 - 4:11 - 7:11 - 0:0 - 0:0
17083306,2024-02-24 12:00:00,Nazaryan Mushegh - Papyan Karen,3:0,14:12 - 14:12 - 11:4 - 0:0 - 0:0,3,0,Nazaryan Mushegh,Papyan Karen,fiurst,Nazaryan Mushegh - Papyan Karen,67,39,28,-11,11,26,26,15,0,0,-2,-2,-7,0,0,-11,14:12 - 14:12 - 11:4 - 0:0 - 0:0
17083305,2024-02-24 11:45:00,Soghomonyan Hrayr - Nikoghosyan Narek,3:0,9:11 - 9:11 - 9:11 - 0:0 - 0:0,0,3,Soghomonyan Hrayr,Nikoghosyan Narek,fiurst,Nikoghosyan Narek - Soghomonyan Hrayr,60,33,27,-6,6,20,20,20,0,0,-2,-2,-2,0,0,-6,11:9 - 11:9 - 11:9 - 0:0 - 0:0
17083303,2024-02-24 11:35:00,Nazaryan Mushegh - Mkrtchyan Andranik,0:3,11:6 - 12:10 - 11:8 - 0:0 - 0:0,3,0,Nazaryan Mushegh,Mkrtchyan Andranik,fiurst,Mkrtchyan Andranik - Nazaryan Mushegh,58,24,34,10,-10,17,22,19,0,0,5,2,3,0,0,10,6:11 - 10:12 - 8:11 - 0:0 - 0:0
17083301,2024-02-24 11:15:00,Papyan Karen - Soghomonyan Hrayr,1:3,11:8 - 5:11 - 2:11 - 10:12 - 0:0,1,3,Papyan Karen,Soghomonyan Hrayr,fiurst,Papyan Karen - Soghomonyan Hrayr,70,28,42,14,-14,19,16,13,22,0,-3,6,9,2,0,14,11:8 - 5:11 - 2:11 - 10:12 - 0:0
17083300,2024-02-24 11:00:00,Nikoghosyan Narek - Nazaryan Mushegh,1:3,11:13 - 11:9 - 11:7 - 11:5 - 0:0,3,1,Nikoghosyan Narek,Nazaryan Mushegh,fiurst,Nazaryan Mushegh - Nikoghosyan Narek,78,34,44,10,-10,24,20,18,16,0,-2,2,4,6,0,10,13:11 - 9:11 - 7:11 - 5:11 - 0:0
17083297,2024-02-24 10:45:00,Mkrtchyan Andranik - Soghomonyan Hrayr,1:3,7:11 - 9:11 - 12:10 - 6:11 - 0:0,1,3,Mkrtchyan Andranik,Soghomonyan Hrayr,fiurst,Mkrtchyan Andranik - Soghomonyan Hrayr,77,34,43,9,-9,18,20,22,17,0,4,2,-2,5,0,9,7:11 - 9:11 - 12:10 - 6:11 - 0:0
17083296,2024-02-24 10:30:00,Papyan Karen - Nikoghosyan Narek,2:3,8:11 - 4:11 - 12:10 - 11:6 - 11:9,3,2,Papyan Karen,Nikoghosyan Narek,fiurst,Nikoghosyan Narek - Papyan Karen,93,47,46,-1,1,19,15,22,17,20,-3,-7,2,5,2,-1,11:8 - 11:4 - 10:12 - 6:11 - 9:11
17083295,2024-02-24 10:15:00,Soghomonyan Hrayr - Nazaryan Mushegh,3:1,11:7 - 9:11 - 7:11 - 8:11 - 0:0,1,3,Soghomonyan Hrayr,Nazaryan Mushegh,fiurst,Nazaryan Mushegh - Soghomonyan Hrayr,75,40,35,-5,5,18,20,18,19,0,4,-2,-4,-3,0,-5,7:11 - 11:9 - 11:7 - 11:8 - 0:0
17083282,2024-02-24 10:00:00,Mkrtchyan Andranik - Papyan Karen,0:3,10:12 - 10:12 - 3:11 - 0:0 - 0:0,0,3,Mkrtchyan Andranik,Papyan Karen,fiurst,Mkrtchyan Andranik - Papyan Karen,58,23,35,12,-12,22,22,14,0,0,2,2,8,0,0,12,10:12 - 10:12 - 3:11 - 0:0 - 0:0
17059799,2024-02-23 17:50:00,Karakhanyan Mher - Gevorgyan Hayk,3:1,5:11 - 11:7 - 4:11 - 9:11 - 0:0,1,3,Karakhanyan Mher,Gevorgyan Hayk,fiurst,Gevorgyan Hayk - Karakhanyan Mher,69,40,29,-11,11,16,18,15,20,0,-6,4,-7,-2,0,-11,11:5 - 7:11 - 11:4 - 11:9 - 0:0
17059797,2024-02-23 17:30:00,Gevorgyan Gegham - Arutyunov Ruben,3:0,1:11 - 7:11 - 7:11 - 0:0 - 0:0,0,3,Gevorgyan Gegham,Arutyunov Ruben,fiurst,Arutyunov Ruben - Gevorgyan Gegham,48,33,15,-18,18,12,18,18,0,0,-10,-4,-4,0,0,-18,11:1 - 11:7 - 11:7 - 0:0 - 0:0
17059793,2024-02-23 17:15:00,Petrosyan Davit - Karakhanyan Mher,0:3,11:9 - 11:5 - 11:4 - 0:0 - 0:0,3,0,Petrosyan Davit,Karakhanyan Mher,fiurst,Karakhanyan Mher - Petrosyan Davit,51,18,33,15,-15,20,16,15,0,0,2,6,7,0,0,15,9:11 - 5:11 - 4:11 - 0:0 - 0:0
17059790,2024-02-23 17:00:00,Gevorgyan Gegham - Gevorgyan Hayk,1:3,11:5 - 6:11 - 10:12 - 3:11 - 0:0,1,3,Gevorgyan Gegham,Gevorgyan Hayk,fiurst,Gevorgyan Gegham - Gevorgyan Hayk,69,30,39,9,-9,16,17,22,14,0,-6,5,2,8,0,9,11:5 - 6:11 - 10:12 - 3:11 - 0:0
17059776,2024-02-23 16:45:00,Arutyunov Ruben - Petrosyan Davit,3:1,9:11 - 11:6 - 11:4 - 11:9 - 0:0,3,1,Arutyunov Ruben,Petrosyan Davit,fiurst,Arutyunov Ruben - Petrosyan Davit,72,42,30,-12,12,20,17,15,20,0,2,-5,-7,-2,0,-12,9:11 - 11:6 - 11:4 - 11:9 - 0:0
17059774,2024-02-23 16:30:00,Karakhanyan Mher - Gevorgyan Gegham,3:0,11:13 - 5:11 - 9:11 - 0:0 - 0:0,0,3,Karakhanyan Mher,Gevorgyan Gegham,fiurst,Gevorgyan Gegham - Karakhanyan Mher,60,35,25,-10,10,24,16,20,0,0,-2,-6,-2,0,0,-10,13:11 - 11:5 - 11:9 - 0:0 - 0:0
17059770,2024-02-23 16:15:00,Gevorgyan Hayk - Petrosyan Davit,3:0,11:4 - 11:8 - 11:2 - 0:0 - 0:0,3,0,Gevorgyan Hayk,Petrosyan Davit,fiurst,Gevorgyan Hayk - Petrosyan Davit,47,33,14,-19,19,15,19,13,0,0,-7,-3,-9,0,0,-19,11:4 - 11:8 - 11:2 - 0:0 - 0:0
17059767,2024-02-23 16:00:00,Arutyunov Ruben - Karakhanyan Mher,3:0,11:5 - 11:6 - 11:4 - 0:0 - 0:0,3,0,Arutyunov Ruben,Karakhanyan Mher,fiurst,Arutyunov Ruben - Karakhanyan Mher,48,33,15,-18,18,16,17,15,0,0,-6,-5,-7,0,0,-18,11:5 - 11:6 - 11:4 - 0:0 - 0:0
17059765,2024-02-23 15:45:00,Petrosyan Davit - Gevorgyan Gegham,3:0,3:11 - 9:11 - 12:14 - 0:0 - 0:0,0,3,Petrosyan Davit,Gevorgyan Gegham,fiurst,Gevorgyan Gegham - Petrosyan Davit,60,36,24,-12,12,14,20,26,0,0,-8,-2,-2,0,0,-12,11:3 - 11:9 - 14:12 - 0:0 - 0:0
17059755,2024-02-23 15:30:00,Gevorgyan Hayk - Arutyunov Ruben,3:0,11:13 - 7:11 - 7:11 - 0:0 - 0:0,0,3,Gevorgyan Hayk,Arutyunov Ruben,fiurst,Arutyunov Ruben - Gevorgyan Hayk,60,35,25,-10,10,24,18,18,0,0,-2,-4,-4,0,0,-10,13:11 - 11:7 - 11:7 - 0:0 - 0:0
17059749,2024-02-23 15:15:00,Papyan Karen - Nazaryan Mushegh,1:3,13:15 - 11:9 - 11:9 - 11:9 - 0:0,3,1,Papyan Karen,Nazaryan Mushegh,fiurst,Nazaryan Mushegh - Papyan Karen,88,42,46,4,-4,28,20,20,20,0,-2,2,2,2,0,4,15:13 - 9:11 - 9:11 - 9:11 - 0:0
17059747,2024-02-23 15:05:00,Mkrtchyan Andranik - Rafayelyan Edgar,0:3,2:11 - 8:11 - 9:11 - 0:0 - 0:0,0,3,Mkrtchyan Andranik,Rafayelyan Edgar,fiurst,Mkrtchyan Andranik - Rafayelyan Edgar,52,19,33,14,-14,13,19,20,0,0,9,3,2,0,0,14,2:11 - 8:11 - 9:11 - 0:0 - 0:0
17059735,2024-02-23 14:45:00,Diaryan Aleksandr - Papyan Karen,3:1,14:12 - 15:13 - 7:11 - 13:11 - 0:0,3,1,Diaryan Aleksandr,Papyan Karen,fiurst,Diaryan Aleksandr - Papyan Karen,96,49,47,-2,2,26,28,18,24,0,-2,-2,4,-2,0,-2,14:12 - 15:13 - 7:11 - 13:11 - 0:0
17059732,2024-02-23 14:35:00,Nazaryan Mushegh - Mkrtchyan Andranik,3:1,14:16 - 7:11 - 11:8 - 9:11 - 0:0,1,3,Nazaryan Mushegh,Mkrtchyan Andranik,fiurst,Mkrtchyan Andranik - Nazaryan Mushegh,87,46,41,-5,5,30,18,19,20,0,-2,-4,3,-2,0,-5,16:14 - 11:7 - 8:11 - 11:9 - 0:0
17059728,2024-02-23 14:25:00,Diaryan Aleksandr - Rafayelyan Edgar,0:3,4:11 - 9:11 - 9:11 - 0:0 - 0:0,0,3,Diaryan Aleksandr,Rafayelyan Edgar,fiurst,Diaryan Aleksandr - Rafayelyan Edgar,55,22,33,11,-11,15,20,20,0,0,7,2,2,0,0,11,4:11 - 9:11 - 9:11 - 0:0 - 0:0
17059725,2024-02-23 14:00:00,Papyan Karen - Mkrtchyan Andranik,2:3,5:11 - 11:7 - 11:9 - 9:11 - 11:8,3,2,Papyan Karen,Mkrtchyan Andranik,fiurst,Mkrtchyan Andranik - Papyan Karen,93,46,47,1,-1,16,18,20,20,19,-6,4,2,-2,3,1,11:5 - 7:11 - 9:11 - 11:9 - 8:11
17059720,2024-02-23 13:45:00,Nazaryan Mushegh - Diaryan Aleksandr,3:1,13:11 - 9:11 - 14:16 - 6:11 - 0:0,1,3,Nazaryan Mushegh,Diaryan Aleksandr,fiurst,Diaryan Aleksandr - Nazaryan Mushegh,91,49,42,-7,7,24,20,30,17,0,2,-2,-2,-5,0,-7,11:13 - 11:9 - 16:14 - 11:6 - 0:0
17059692,2024-02-23 13:30:00,Rafayelyan Edgar - Papyan Karen,0:3,11:3 - 11:6 - 11:4 - 0:0 - 0:0,3,0,Rafayelyan Edgar,Papyan Karen,fiurst,Papyan Karen - Rafayelyan Edgar,46,13,33,20,-20,14,17,15,0,0,8,5,7,0,0,20,3:11 - 6:11 - 4:11 - 0:0 - 0:0
17059712,2024-02-23 13:15:00,Mkrtchyan Andranik - Diaryan Aleksandr,3:1,13:11 - 5:11 - 6:11 - 2:11 - 0:0,1,3,Mkrtchyan Andranik,Diaryan Aleksandr,fiurst,Diaryan Aleksandr - Mkrtchyan Andranik,70,44,26,-18,18,24,16,17,13,0,2,-6,-5,-9,0,-18,11:13 - 11:5 - 11:6 - 11:2 - 0:0
17059690,2024-02-23 13:00:00,Rafayelyan Edgar - Nazaryan Mushegh,1:3,8:11 - 11:7 - 11:7 - 11:4 - 0:0,3,1,Rafayelyan Edgar,Nazaryan Mushegh,fiurst,Nazaryan Mushegh - Rafayelyan Edgar,70,29,41,12,-12,19,18,18,15,0,-3,4,4,7,0,12,11:8 - 7:11 - 7:11 - 4:11 - 0:0
17059684,2024-02-23 12:15:00,Papyan Karen - Diaryan Aleksandr,3:2,9:11 - 7:11 - 11:9 - 11:6 - 12:14,2,3,Papyan Karen,Diaryan Aleksandr,fiurst,Diaryan Aleksandr - Papyan Karen,101,51,50,-1,1,20,18,20,17,26,-2,-4,2,5,-2,-1,11:9 - 11:7 - 9:11 - 6:11 - 14:12
17059682,2024-02-23 12:00:00,Rafayelyan Edgar - Mkrtchyan Andranik,1:3,9:11 - 20:18 - 12:10 - 11:7 - 0:0,3,1,Rafayelyan Edgar,Mkrtchyan Andranik,fiurst,Mkrtchyan Andranik - Rafayelyan Edgar,98,46,52,6,-6,20,38,22,18,0,-2,2,2,4,0,6,11:9 - 18:20 - 10:12 - 7:11 - 0:0
17059680,2024-02-23 11:45:00,Nazaryan Mushegh - Papyan Karen,3:1,11:4 - 11:9 - 11:13 - 11:9 - 0:0,3,1,Nazaryan Mushegh,Papyan Karen,fiurst,Nazaryan Mushegh - Papyan Karen,79,44,35,-9,9,15,20,24,20,0,-7,-2,2,-2,0,-9,11:4 - 11:9 - 11:13 - 11:9 - 0:0
17059677,2024-02-23 11:30:00,Rafayelyan Edgar - Diaryan Aleksandr,0:3,11:4 - 11:2 - 11:6 - 0:0 - 0:0,3,0,Rafayelyan Edgar,Diaryan Aleksandr,fiurst,Diaryan Aleksandr - Rafayelyan Edgar,45,12,33,21,-21,15,13,17,0,0,7,9,5,0,0,21,4:11 - 2:11 - 6:11 - 0:0 - 0:0
17059675,2024-02-23 11:20:00,Mkrtchyan Andranik - Nazaryan Mushegh,0:3,4:11 - 10:12 - 5:11 - 0:0 - 0:0,0,3,Mkrtchyan Andranik,Nazaryan Mushegh,fiurst,Mkrtchyan Andranik - Nazaryan Mushegh,53,19,34,15,-15,15,22,16,0,0,7,2,6,0,0,15,4:11 - 10:12 - 5:11 - 0:0 - 0:0
17059672,2024-02-23 11:00:00,Papyan Karen - Rafayelyan Edgar,1:3,4:11 - 11:8 - 6:11 - 4:11 - 0:0,1,3,Papyan Karen,Rafayelyan Edgar,fiurst,Papyan Karen - Rafayelyan Edgar,66,25,41,16,-16,15,19,17,15,0,7,-3,5,7,0,16,4:11 - 11:8 - 6:11 - 4:11 - 0:0
17059670,2024-02-23 10:55:00,Diaryan Aleksandr - Nazaryan Mushegh,3:0,11:6 - 11:8 - 11:5 - 0:0 - 0:0,3,0,Diaryan Aleksandr,Nazaryan Mushegh,fiurst,Diaryan Aleksandr - Nazaryan Mushegh,52,33,19,-14,14,17,19,16,0,0,-5,-3,-6,0,0,-14,11:6 - 11:8 - 11:5 - 0:0 - 0:0
17059654,2024-02-23 10:30:00,Mkrtchyan Andranik - Papyan Karen,3:0,11:9 - 11:6 - 11:6 - 0:0 - 0:0,3,0,Mkrtchyan Andranik,Papyan Karen,fiurst,Mkrtchyan Andranik - Papyan Karen,54,33,21,-12,12,20,17,17,0,0,-2,-5,-5,0,0,-12,11:9 - 11:6 - 11:6 - 0:0 - 0:0
17059650,2024-02-23 10:15:00,Nazaryan Mushegh - Rafayelyan Edgar,2:3,11:4 - 11:5 - 8:11 - 8:11 - 2:11,2,3,Nazaryan Mushegh,Rafayelyan Edgar,fiurst,Nazaryan Mushegh - Rafayelyan Edgar,82,40,42,2,-2,15,16,19,19,13,-7,-6,3,3,9,2,11:4 - 11:5 - 8:11 - 8:11 - 2:11
17059648,2024-02-23 10:00:00,Diaryan Aleksandr - Mkrtchyan Andranik,3:0,11:5 - 11:2 - 11:6 - 0:0 - 0:0,3,0,Diaryan Aleksandr,Mkrtchyan Andranik,fiurst,Diaryan Aleksandr - Mkrtchyan Andranik,46,33,13,-20,20,16,13,17,0,0,-6,-9,-5,0,0,-20,11:5 - 11:2 - 11:6 - 0:0 - 0:0
17041498,2024-02-22 18:00:00,Gevorgyan Hayk - Grigoryan Erik,3:0,11:1 - 11:8 - 11:4 - 0:0 - 0:0,3,0,Gevorgyan Hayk,Grigoryan Erik,fiurst,Gevorgyan Hayk - Grigoryan Erik,46,33,13,-20,20,12,19,15,0,0,-10,-3,-7,0,0,-20,11:1 - 11:8 - 11:4 - 0:0 - 0:0
17041494,2024-02-22 17:30:00,Karakhanyan Mher - Petrosyan Davit,1:3,11:6 - 5:11 - 5:11 - 7:11 - 0:0,1,3,Karakhanyan Mher,Petrosyan Davit,fiurst,Karakhanyan Mher - Petrosyan Davit,67,28,39,11,-11,17,16,16,18,0,-5,6,6,4,0,11,11:6 - 5:11 - 5:11 - 7:11 - 0:0
17041482,2024-02-22 17:20:00,Arutyunov Ruben - Gevorgyan Hayk,3:2,14:12 - 9:11 - 11:9 - 8:11 - 11:5,3,2,Arutyunov Ruben,Gevorgyan Hayk,fiurst,Arutyunov Ruben - Gevorgyan Hayk,101,53,48,-5,5,26,20,20,19,16,-2,2,-2,3,-6,-5,14:12 - 9:11 - 11:9 - 8:11 - 11:5
17041467,2024-02-22 17:00:00,Karakhanyan Mher - Grigoryan Erik,3:1,7:11 - 11:6 - 10:12 - 9:11 - 0:0,1,3,Karakhanyan Mher,Grigoryan Erik,fiurst,Grigoryan Erik - Karakhanyan Mher,77,40,37,-3,3,18,17,22,20,0,-4,5,-2,-2,0,-3,11:7 - 6:11 - 12:10 - 11:9 - 0:0
17041466,2024-02-22 16:45:00,Petrosyan Davit - Arutyunov Ruben,3:2,11:6 - 11:9 - 9:11 - 6:11 - 1:11,2,3,Petrosyan Davit,Arutyunov Ruben,fiurst,Arutyunov Ruben - Petrosyan Davit,86,48,38,-10,10,17,20,20,17,12,5,2,-2,-5,-10,-10,6:11 - 9:11 - 11:9 - 11:6 - 11:1
17041462,2024-02-22 16:35:00,Gevorgyan Hayk - Karakhanyan Mher,3:1,11:1 - 10:12 - 11:6 - 11:4 - 0:0,3,1,Gevorgyan Hayk,Karakhanyan Mher,fiurst,Gevorgyan Hayk - Karakhanyan Mher,66,43,23,-20,20,12,22,17,15,0,-10,2,-5,-7,0,-20,11:1 - 10:12 - 11:6 - 11:4 - 0:0
17041457,2024-02-22 16:20:00,Grigoryan Erik - Arutyunov Ruben,3:0,7:11 - 1:11 - 9:11 - 0:0 - 0:0,0,3,Grigoryan Erik,Arutyunov Ruben,fiurst,Arutyunov Ruben - Grigoryan Erik,50,33,17,-16,16,18,12,20,0,0,-4,-10,-2,0,0,-16,11:7 - 11:1 - 11:9 - 0:0 - 0:0
17041451,2024-02-22 16:05:00,Petrosyan Davit - Gevorgyan Hayk,3:2,5:11 - 6:11 - 11:8 - 11:9 - 3:11,2,3,Petrosyan Davit,Gevorgyan Hayk,fiurst,Gevorgyan Hayk - Petrosyan Davit,86,50,36,-14,14,16,17,19,20,14,-6,-5,3,2,-8,-14,11:5 - 11:6 - 8:11 - 9:11 - 11:3
17041446,2024-02-22 15:45:00,Arutyunov Ruben - Karakhanyan Mher,3:0,11:6 - 11:8 - 11:7 - 0:0 - 0:0,3,0,Arutyunov Ruben,Karakhanyan Mher,fiurst,Arutyunov Ruben - Karakhanyan Mher,54,33,21,-12,12,17,19,18,0,0,-5,-3,-4,0,0,-12,11:6 - 11:8 - 11:7 - 0:0 - 0:0
17041414,2024-02-22 15:30:00,Grigoryan Erik - Petrosyan Davit,1:3,5:11 - 11:7 - 7:11 - 5:11 - 0:0,1,3,Grigoryan Erik,Petrosyan Davit,fiurst,Grigoryan Erik - Petrosyan Davit,68,28,40,12,-12,16,18,18,16,0,6,-4,4,6,0,12,5:11 - 11:7 - 7:11 - 5:11 - 0:0
17041396,2024-02-22 15:15:00,Soghomonyan Hrayr - Diaryan Aleksandr,3:1,6:11 - 11:9 - 7:11 - 9:11 - 0:0,1,3,Soghomonyan Hrayr,Diaryan Aleksandr,fiurst,Diaryan Aleksandr - Soghomonyan Hrayr,75,42,33,-9,9,17,20,18,20,0,-5,2,-4,-2,0,-9,11:6 - 9:11 - 11:7 - 11:9 - 0:0
17041391,2024-02-22 15:10:00,Nazaryan Mushegh - Nikoghosyan Narek,3:0,11:9 - 11:6 - 11:6 - 0:0 - 0:0,3,0,Nazaryan Mushegh,Nikoghosyan Narek,fiurst,Nazaryan Mushegh - Nikoghosyan Narek,54,33,21,-12,12,20,17,17,0,0,-2,-5,-5,0,0,-12,11:9 - 11:6 - 11:6 - 0:0 - 0:0
17041383,2024-02-22 14:50:00,Diaryan Aleksandr - Nazaryan Mushegh,3:1,4:11 - 11:5 - 11:8 - 11:7 - 0:0,3,1,Diaryan Aleksandr,Nazaryan Mushegh,fiurst,Diaryan Aleksandr - Nazaryan Mushegh,68,37,31,-6,6,15,16,19,18,0,7,-6,-3,-4,0,-6,4:11 - 11:5 - 11:8 - 11:7 - 0:0
17041386,2024-02-22 14:45:00,Rafayelyan Edgar - Soghomonyan Hrayr,3:0,11:8 - 14:12 - 12:10 - 0:0 - 0:0,3,0,Rafayelyan Edgar,Soghomonyan Hrayr,fiurst,Rafayelyan Edgar - Soghomonyan Hrayr,67,37,30,-7,7,19,26,22,0,0,-3,-2,-2,0,0,-7,11:8 - 14:12 - 12:10 - 0:0 - 0:0
17041379,2024-02-22 14:25:00,Rafayelyan Edgar - Nikoghosyan Narek,0:3,11:6 - 11:7 - 11:7 - 0:0 - 0:0,3,0,Rafayelyan Edgar,Nikoghosyan Narek,fiurst,Nikoghosyan Narek - Rafayelyan Edgar,53,20,33,13,-13,17,18,18,0,0,5,4,4,0,0,13,6:11 - 7:11 - 7:11 - 0:0 - 0:0
17041369,2024-02-22 14:20:00,Soghomonyan Hrayr - Nazaryan Mushegh,2:3,6:11 - 11:6 - 9:11 - 11:7 - 11:8,3,2,Soghomonyan Hrayr,Nazaryan Mushegh,fiurst,Nazaryan Mushegh - Soghomonyan Hrayr,91,43,48,5,-5,17,17,20,18,19,-5,5,-2,4,3,5,11:6 - 6:11 - 11:9 - 7:11 - 8:11
17041366,2024-02-22 13:50:00,Diaryan Aleksandr - Rafayelyan Edgar,0:3,4:11 - 9:11 - 3:11 - 0:0 - 0:0,0,3,Diaryan Aleksandr,Rafayelyan Edgar,fiurst,Diaryan Aleksandr - Rafayelyan Edgar,49,16,33,17,-17,15,20,14,0,0,7,2,8,0,0,17,4:11 - 9:11 - 3:11 - 0:0 - 0:0
17041363,2024-02-22 13:45:00,Nikoghosyan Narek - Soghomonyan Hrayr,3:2,11:8 - 11:7 - 8:11 - 9:11 - 11:8,3,2,Nikoghosyan Narek,Soghomonyan Hrayr,fiurst,Nikoghosyan Narek - Soghomonyan Hrayr,95,50,45,-5,5,19,18,19,20,19,-3,-4,3,2,-3,-5,11:8 - 11:7 - 8:11 - 9:11 - 11:8
17041362,2024-02-22 13:20:00,Nazaryan Mushegh - Rafayelyan Edgar,2:3,13:11 - 7:11 - 4:11 - 12:10 - 3:11,2,3,Nazaryan Mushegh,Rafayelyan Edgar,fiurst,Nazaryan Mushegh - Rafayelyan Edgar,93,39,54,15,-15,24,18,15,22,14,-2,4,7,-2,8,15,13:11 - 7:11 - 4:11 - 12:10 - 3:11
17041357,2024-02-22 13:10:00,Nikoghosyan Narek - Diaryan Aleksandr,2:3,11:9 - 11:8 - 6:11 - 4:11 - 11:8,3,2,Nikoghosyan Narek,Diaryan Aleksandr,fiurst,Diaryan Aleksandr - Nikoghosyan Narek,90,47,43,-4,4,20,19,17,15,19,2,3,-5,-7,3,-4,9:11 - 8:11 - 11:6 - 11:4 - 8:11
17041354,2024-02-22 12:15:00,Soghomonyan Hrayr - Rafayelyan Edgar,3:1,8:11 - 8:11 - 11:6 - 7:11 - 0:0,1,3,Soghomonyan Hrayr,Rafayelyan Edgar,fiurst,Rafayelyan Edgar - Soghomonyan Hrayr,73,39,34,-5,5,19,19,17,18,0,-3,-3,5,-4,0,-5,11:8 - 11:8 - 6:11 - 11:7 - 0:0
17041353,2024-02-22 12:10:00,Nikoghosyan Narek - Nazaryan Mushegh,0:3,11:4 - 11:9 - 11:8 - 0:0 - 0:0,3,0,Nikoghosyan Narek,Nazaryan Mushegh,fiurst,Nazaryan Mushegh - Nikoghosyan Narek,54,21,33,12,-12,15,20,19,0,0,7,2,3,0,0,12,4:11 - 9:11 - 8:11 - 0:0 - 0:0
17041341,2024-02-22 11:45:00,Diaryan Aleksandr - Soghomonyan Hrayr,2:3,8:11 - 11:6 - 6:11 - 14:12 - 10:12,2,3,Diaryan Aleksandr,Soghomonyan Hrayr,fiurst,Diaryan Aleksandr - Soghomonyan Hrayr,101,49,52,3,-3,19,17,17,26,22,3,-5,5,-2,2,3,8:11 - 11:6 - 6:11 - 14:12 - 10:12
17041340,2024-02-22 11:30:00,Nikoghosyan Narek - Rafayelyan Edgar,0:3,10:12 - 8:11 - 4:11 - 0:0 - 0:0,0,3,Nikoghosyan Narek,Rafayelyan Edgar,fiurst,Nikoghosyan Narek - Rafayelyan Edgar,56,22,34,12,-12,22,19,15,0,0,2,3,7,0,0,12,10:12 - 8:11 - 4:11 - 0:0 - 0:0
17041338,2024-02-22 11:15:00,Nazaryan Mushegh - Diaryan Aleksandr,3:0,9:11 - 5:11 - 7:11 - 0:0 - 0:0,0,3,Nazaryan Mushegh,Diaryan Aleksandr,fiurst,Diaryan Aleksandr - Nazaryan Mushegh,54,33,21,-12,12,20,16,18,0,0,-2,-6,-4,0,0,-12,11:9 - 11:5 - 11:7 - 0:0 - 0:0
17041337,2024-02-22 11:00:00,Soghomonyan Hrayr - Nikoghosyan Narek,3:1,6:11 - 10:12 - 11:6 - 4:11 - 0:0,1,3,Soghomonyan Hrayr,Nikoghosyan Narek,fiurst,Nikoghosyan Narek - Soghomonyan Hrayr,71,40,31,-9,9,17,22,17,15,0,-5,-2,5,-7,0,-9,11:6 - 12:10 - 6:11 - 11:4 - 0:0
17041333,2024-02-22 10:45:00,Rafayelyan Edgar - Diaryan Aleksandr,1:3,6:11 - 11:6 - 12:10 - 11:5 - 0:0,3,1,Rafayelyan Edgar,Diaryan Aleksandr,fiurst,Diaryan Aleksandr - Rafayelyan Edgar,72,32,40,8,-8,17,17,22,16,0,-5,5,2,6,0,8,11:6 - 6:11 - 10:12 - 5:11 - 0:0
17041332,2024-02-22 10:30:00,Nazaryan Mushegh - Soghomonyan Hrayr,1:3,11:8 - 7:11 - 8:11 - 10:12 - 0:0,1,3,Nazaryan Mushegh,Soghomonyan Hrayr,fiurst,Nazaryan Mushegh - Soghomonyan Hrayr,78,36,42,6,-6,19,18,19,22,0,-3,4,3,2,0,6,11:8 - 7:11 - 8:11 - 10:12 - 0:0
17041328,2024-02-22 10:15:00,Diaryan Aleksandr - Nikoghosyan Narek,3:0,11:3 - 11:7 - 12:10 - 0:0 - 0:0,3,0,Diaryan Aleksandr,Nikoghosyan Narek,fiurst,Diaryan Aleksandr - Nikoghosyan Narek,54,34,20,-14,14,14,18,22,0,0,-8,-4,-2,0,0,-14,11:3 - 11:7 - 12:10 - 0:0 - 0:0
17041319,2024-02-22 10:00:00,Rafayelyan Edgar - Nazaryan Mushegh,0:3,15:13 - 12:10 - 11:8 - 0:0 - 0:0,3,0,Rafayelyan Edgar,Nazaryan Mushegh,fiurst,Nazaryan Mushegh - Rafayelyan Edgar,69,31,38,7,-7,28,22,19,0,0,2,2,3,0,0,7,13:15 - 10:12 - 8:11 - 0:0 - 0:0
17020476,2024-02-21 17:55:00,Gevorgyan Gegham - Gevorgyan Hayk,2:3,4:11 - 11:8 - 6:11 - 12:10 - 4:11,2,3,Gevorgyan Gegham,Gevorgyan Hayk,fiurst,Gevorgyan Gegham - Gevorgyan Hayk,88,37,51,14,-14,15,19,17,22,15,7,-3,5,-2,7,14,4:11 - 11:8 - 6:11 - 12:10 - 4:11
17020434,2024-02-21 17:15:00,Petrosyan Davit - Gevorgyan Gegham,3:1,6:11 - 11:5 - 5:11 - 10:12 - 0:0,1,3,Petrosyan Davit,Gevorgyan Gegham,fiurst,Gevorgyan Gegham - Petrosyan Davit,71,39,32,-7,7,17,16,16,22,0,-5,6,-6,-2,0,-7,11:6 - 5:11 - 11:5 - 12:10 - 0:0
17020417,2024-02-21 17:00:00,Karakhanyan Mher - Gevorgyan Hayk,3:0,5:11 - 10:12 - 3:11 - 0:0 - 0:0,0,3,Karakhanyan Mher,Gevorgyan Hayk,fiurst,Gevorgyan Hayk - Karakhanyan Mher,52,34,18,-16,16,16,22,14,0,0,-6,-2,-8,0,0,-16,11:5 - 12:10 - 11:3 - 0:0 - 0:0
17020359,2024-02-21 16:30:00,Gevorgyan Gegham - Karakhanyan Mher,0:3,9:11 - 4:11 - 10:12 - 0:0 - 0:0,0,3,Gevorgyan Gegham,Karakhanyan Mher,fiurst,Gevorgyan Gegham - Karakhanyan Mher,57,23,34,11,-11,20,15,22,0,0,2,7,2,0,0,11,9:11 - 4:11 - 10:12 - 0:0 - 0:0
17020319,2024-02-21 16:15:00,Gevorgyan Hayk - Petrosyan Davit,1:3,5:11 - 11:1 - 12:14 - 11:13 - 0:0,1,3,Gevorgyan Hayk,Petrosyan Davit,fiurst,Gevorgyan Hayk - Petrosyan Davit,78,39,39,0,0,16,12,26,24,0,6,-10,2,2,0,0,5:11 - 11:1 - 12:14 - 11:13 - 0:0
17020282,2024-02-21 15:45:00,Petrosyan Davit - Karakhanyan Mher,0:3,11:9 - 11:9 - 11:8 - 0:0 - 0:0,3,0,Petrosyan Davit,Karakhanyan Mher,fiurst,Karakhanyan Mher - Petrosyan Davit,59,26,33,7,-7,20,20,19,0,0,2,2,3,0,0,7,9:11 - 9:11 - 8:11 - 0:0 - 0:0
17020218,2024-02-21 15:30:00,Rafayelyan Edgar - Nazaryan Mushegh,1:3,11:8 - 8:11 - 11:6 - 11:4 - 0:0,3,1,Rafayelyan Edgar,Nazaryan Mushegh,fiurst,Nazaryan Mushegh - Rafayelyan Edgar,70,29,41,12,-12,19,19,17,15,0,3,-3,5,7,0,12,8:11 - 11:8 - 6:11 - 4:11 - 0:0
17020246,2024-02-21 15:30:00,Gevorgyan Hayk - Gevorgyan Gegham,1:3,11:7 - 11:8 - 5:11 - 12:10 - 0:0,3,1,Gevorgyan Hayk,Gevorgyan Gegham,fiurst,Gevorgyan Gegham - Gevorgyan Hayk,75,36,39,3,-3,18,19,16,22,0,4,3,-6,2,0,3,7:11 - 8:11 - 11:5 - 10:12 - 0:0
17020216,2024-02-21 15:05:00,Soghomonyan Hrayr - Mkrtchyan Andranik,1:3,11:5 - 8:11 - 11:9 - 11:4 - 0:0,3,1,Soghomonyan Hrayr,Mkrtchyan Andranik,fiurst,Mkrtchyan Andranik - Soghomonyan Hrayr,70,29,41,12,-12,16,19,20,15,0,6,-3,2,7,0,12,5:11 - 11:8 - 9:11 - 4:11 - 0:0
17020212,2024-02-21 14:45:00,Nikoghosyan Narek - Rafayelyan Edgar,3:2,7:11 - 15:13 - 11:9 - 6:11 - 11:9,3,2,Nikoghosyan Narek,Rafayelyan Edgar,fiurst,Nikoghosyan Narek - Rafayelyan Edgar,103,50,53,3,-3,18,28,20,17,20,4,-2,-2,5,-2,3,7:11 - 15:13 - 11:9 - 6:11 - 11:9
17020201,2024-02-21 14:40:00,Nazaryan Mushegh - Soghomonyan Hrayr,1:3,12:10 - 7:11 - 10:12 - 8:11 - 0:0,1,3,Nazaryan Mushegh,Soghomonyan Hrayr,fiurst,Nazaryan Mushegh - Soghomonyan Hrayr,81,37,44,7,-7,22,18,22,19,0,-2,4,2,3,0,7,12:10 - 7:11 - 10:12 - 8:11 - 0:0
17020198,2024-02-21 14:15:00,Nikoghosyan Narek - Mkrtchyan Andranik,0:3,12:10 - 11:3 - 11:9 - 0:0 - 0:0,3,0,Nikoghosyan Narek,Mkrtchyan Andranik,fiurst,Mkrtchyan Andranik - Nikoghosyan Narek,56,22,34,12,-12,22,14,20,0,0,2,8,2,0,0,12,10:12 - 3:11 - 9:11 - 0:0 - 0:0
17020196,2024-02-21 14:00:00,Rafayelyan Edgar - Soghomonyan Hrayr,3:2,11:7 - 10:12 - 11:7 - 9:11 - 12:10,3,2,Rafayelyan Edgar,Soghomonyan Hrayr,fiurst,Rafayelyan Edgar - Soghomonyan Hrayr,100,53,47,-6,6,18,22,18,20,22,-4,2,-4,2,-2,-6,11:7 - 10:12 - 11:7 - 9:11 - 12:10
17020194,2024-02-21 13:50:00,Nazaryan Mushegh - Nikoghosyan Narek,0:3,6:11 - 12:14 - 8:11 - 0:0 - 0:0,0,3,Nazaryan Mushegh,Nikoghosyan Narek,fiurst,Nazaryan Mushegh - Nikoghosyan Narek,62,26,36,10,-10,17,26,19,0,0,5,2,3,0,0,10,6:11 - 12:14 - 8:11 - 0:0 - 0:0
17020191,2024-02-21 13:35:00,Mkrtchyan Andranik - Rafayelyan Edgar,0:3,3:11 - 3:11 - 11:13 - 0:0 - 0:0,0,3,Mkrtchyan Andranik,Rafayelyan Edgar,fiurst,Mkrtchyan Andranik - Rafayelyan Edgar,52,17,35,18,-18,14,14,24,0,0,8,8,2,0,0,18,3:11 - 3:11 - 11:13 - 0:0 - 0:0
17020187,2024-02-21 13:15:00,Soghomonyan Hrayr - Nikoghosyan Narek,3:1,11:9 - 5:11 - 8:11 - 6:11 - 0:0,1,3,Soghomonyan Hrayr,Nikoghosyan Narek,fiurst,Nikoghosyan Narek - Soghomonyan Hrayr,72,42,30,-12,12,20,16,19,17,0,2,-6,-3,-5,0,-12,9:11 - 11:5 - 11:8 - 11:6 - 0:0
17020185,2024-02-21 13:00:00,Mkrtchyan Andranik - Nazaryan Mushegh,3:2,11:5 - 7:11 - 5:11 - 11:9 - 11:9,3,2,Mkrtchyan Andranik,Nazaryan Mushegh,fiurst,Mkrtchyan Andranik - Nazaryan Mushegh,90,45,45,0,0,16,18,16,20,20,-6,4,6,-2,-2,0,11:5 - 7:11 - 5:11 - 11:9 - 11:9
17020181,2024-02-21 12:15:00,Rafayelyan Edgar - Nikoghosyan Narek,1:3,5:11 - 11:6 - 11:6 - 11:6 - 0:0,3,1,Rafayelyan Edgar,Nikoghosyan Narek,fiurst,Nikoghosyan Narek - Rafayelyan Edgar,67,29,38,9,-9,16,17,17,17,0,-6,5,5,5,0,9,11:5 - 6:11 - 6:11 - 6:11 - 0:0
17020162,2024-02-21 12:00:00,Mkrtchyan Andranik - Soghomonyan Hrayr,0:3,3:11 - 11:13 - 4:11 - 0:0 - 0:0,0,3,Mkrtchyan Andranik,Soghomonyan Hrayr,fiurst,Mkrtchyan Andranik - Soghomonyan Hrayr,53,18,35,17,-17,14,24,15,0,0,8,2,7,0,0,17,3:11 - 11:13 - 4:11 - 0:0 - 0:0
17042512,2024-02-21 11:50:00,Rafayelyan Edgar - Nazaryan Mushegh,1:3,11:5 - 9:11 - 11:4 - 11:6 - 0:0,3,1,Rafayelyan Edgar,Nazaryan Mushegh,fiurst,Nazaryan Mushegh - Rafayelyan Edgar,68,26,42,16,-16,16,20,15,17,0,6,-2,7,5,0,16,5:11 - 11:9 - 4:11 - 6:11 - 0:0
17020069,2024-02-21 11:40:00,Nazaryan Mushegh - Rafayelyan Edgar,0:0,0:0 - 0:0 - 0:0 - 0:0 - 0:0,0,0,Nazaryan Mushegh,Rafayelyan Edgar,fiurst,Nazaryan Mushegh - Rafayelyan Edgar,0,0,0,0,0,0,0,0,0,0,0,0,0,0,0,0,0:0 - 0:0 - 0:0 - 0:0 - 0:0
17020065,2024-02-21 11:30:00,Mkrtchyan Andranik - Nikoghosyan Narek,0:3,7:11 - 8:11 - 10:12 - 0:0 - 0:0,0,3,Mkrtchyan Andranik,Nikoghosyan Narek,fiurst,Mkrtchyan Andranik - Nikoghosyan Narek,59,25,34,9,-9,18,19,22,0,0,4,3,2,0,0,9,7:11 - 8:11 - 10:12 - 0:0 - 0:0
17020059,2024-02-21 11:20:00,Soghomonyan Hrayr - Nazaryan Mushegh,3:2,11:5 - 4:11 - 11:9 - 9:11 - 5:11,2,3,Soghomonyan Hrayr,Nazaryan Mushegh,fiurst,Nazaryan Mushegh - Soghomonyan Hrayr,87,47,40,-7,7,16,15,20,20,16,6,-7,2,-2,-6,-7,5:11 - 11:4 - 9:11 - 11:9 - 11:5
17020056,2024-02-21 11:00:00,Rafayelyan Edgar - Mkrtchyan Andranik,0:3,11:5 - 11:5 - 12:10 - 0:0 - 0:0,3,0,Rafayelyan Edgar,Mkrtchyan Andranik,fiurst,Mkrtchyan Andranik - Rafayelyan Edgar,54,20,34,14,-14,16,16,22,0,0,6,6,2,0,0,14,5:11 - 5:11 - 10:12 - 0:0 - 0:0
17020051,2024-02-21 10:45:00,Nikoghosyan Narek - Nazaryan Mushegh,1:3,11:8 - 9:11 - 11:5 - 11:9 - 0:0,3,1,Nikoghosyan Narek,Nazaryan Mushegh,fiurst,Nazaryan Mushegh - Nikoghosyan Narek,75,33,42,9,-9,19,20,16,20,0,3,-2,6,2,0,9,8:11 - 11:9 - 5:11 - 9:11 - 0:0
17020042,2024-02-21 10:35:00,Soghomonyan Hrayr - Rafayelyan Edgar,3:0,6:11 - 5:11 - 9:11 - 0:0 - 0:0,0,3,Soghomonyan Hrayr,Rafayelyan Edgar,fiurst,Rafayelyan Edgar - Soghomonyan Hrayr,53,33,20,-13,13,17,16,20,0,0,-5,-6,-2,0,0,-13,11:6 - 11:5 - 11:9 - 0:0 - 0:0
17020037,2024-02-21 10:15:00,Nazaryan Mushegh - Mkrtchyan Andranik,0:3,11:5 - 11:5 - 11:7 - 0:0 - 0:0,3,0,Nazaryan Mushegh,Mkrtchyan Andranik,fiurst,Mkrtchyan Andranik - Nazaryan Mushegh,50,17,33,16,-16,16,16,18,0,0,6,6,4,0,0,16,5:11 - 5:11 - 7:11 - 0:0 - 0:0
17020036,2024-02-21 10:00:00,Nikoghosyan Narek - Soghomonyan Hrayr,2:3,11:5 - 8:11 - 8:11 - 11:8 - 10:12,2,3,Nikoghosyan Narek,Soghomonyan Hrayr,fiurst,Nikoghosyan Narek - Soghomonyan Hrayr,95,48,47,-1,1,16,19,19,19,22,-6,3,3,-3,2,-1,11:5 - 8:11 - 8:11 - 11:8 - 10:12
17001418,2024-02-20 17:45:00,Gevorgyan Gegham - Karakhanyan Mher,0:3,13:15 - 8:11 - 10:12 - 0:0 - 0:0,0,3,Gevorgyan Gegham,Karakhanyan Mher,fiurst,Gevorgyan Gegham - Karakhanyan Mher,69,31,38,7,-7,28,19,22,0,0,2,3,2,0,0,7,13:15 - 8:11 - 10:12 - 0:0 - 0:0
17001406,2024-02-20 17:30:00,Gevorgyan Hayk - Arutyunov Ruben,3:0,9:11 - 5:11 - 7:11 - 0:0 - 0:0,0,3,Gevorgyan Hayk,Arutyunov Ruben,fiurst,Arutyunov Ruben - Gevorgyan Hayk,54,33,21,-12,12,20,16,18,0,0,-2,-6,-4,0,0,-12,11:9 - 11:5 - 11:7 - 0:0 - 0:0
17001405,2024-02-20 17:15:00,Grigoryan Erik - Gevorgyan Gegham,1:3,9:11 - 11:7 - 11:4 - 14:12 - 0:0,3,1,Grigoryan Erik,Gevorgyan Gegham,fiurst,Gevorgyan Gegham - Grigoryan Erik,79,34,45,11,-11,20,18,15,26,0,-2,4,7,2,0,11,11:9 - 7:11 - 4:11 - 12:14 - 0:0
17001400,2024-02-20 17:00:00,Gevorgyan Hayk - Karakhanyan Mher,3:0,11:3 - 11:5 - 11:6 - 0:0 - 0:0,3,0,Gevorgyan Hayk,Karakhanyan Mher,fiurst,Gevorgyan Hayk - Karakhanyan Mher,47,33,14,-19,19,14,16,17,0,0,-8,-6,-5,0,0,-19,11:3 - 11:5 - 11:6 - 0:0 - 0:0
17001392,2024-02-20 16:45:00,Arutyunov Ruben - Grigoryan Erik,3:1,7:11 - 11:3 - 11:8 - 11:6 - 0:0,3,1,Arutyunov Ruben,Grigoryan Erik,fiurst,Arutyunov Ruben - Grigoryan Erik,68,40,28,-12,12,18,14,19,17,0,4,-8,-3,-5,0,-12,7:11 - 11:3 - 11:8 - 11:6 - 0:0
17001386,2024-02-20 16:30:00,Gevorgyan Gegham - Gevorgyan Hayk,0:3,8:11 - 9:11 - 7:11 - 0:0 - 0:0,0,3,Gevorgyan Gegham,Gevorgyan Hayk,fiurst,Gevorgyan Gegham - Gevorgyan Hayk,57,24,33,9,-9,19,20,18,0,0,3,2,4,0,0,9,8:11 - 9:11 - 7:11 - 0:0 - 0:0
17001384,2024-02-20 16:15:00,Karakhanyan Mher - Grigoryan Erik,3:0,9:11 - 8:11 - 7:11 - 0:0 - 0:0,0,3,Karakhanyan Mher,Grigoryan Erik,fiurst,Grigoryan Erik - Karakhanyan Mher,57,33,24,-9,9,20,19,18,0,0,-2,-3,-4,0,0,-9,11:9 - 11:8 - 11:7 - 0:0 - 0:0
17001370,2024-02-20 16:00:00,Arutyunov Ruben - Gevorgyan Gegham,3:0,11:3 - 11:8 - 11:6 - 0:0 - 0:0,3,0,Arutyunov Ruben,Gevorgyan Gegham,fiurst,Arutyunov Ruben - Gevorgyan Gegham,50,33,17,-16,16,14,19,17,0,0,-8,-3,-5,0,0,-16,11:3 - 11:8 - 11:6 - 0:0 - 0:0
17001368,2024-02-20 15:45:00,Grigoryan Erik - Gevorgyan Hayk,3:0,5:11 - 5:11 - 3:11 - 0:0 - 0:0,0,3,Grigoryan Erik,Gevorgyan Hayk,fiurst,Gevorgyan Hayk - Grigoryan Erik,46,33,13,-20,20,16,16,14,0,0,-6,-6,-8,0,0,-20,11:5 - 11:5 - 11:3 - 0:0 - 0:0
17001366,2024-02-20 15:30:00,Karakhanyan Mher - Arutyunov Ruben,3:0,5:11 - 10:12 - 4:11 - 0:0 - 0:0,0,3,Karakhanyan Mher,Arutyunov Ruben,fiurst,Arutyunov Ruben - Karakhanyan Mher,53,34,19,-15,15,16,22,15,0,0,-6,-2,-7,0,0,-15,11:5 - 12:10 - 11:4 - 0:0 - 0:0
17001362,2024-02-20 15:15:00,Mkrtchyan Andranik - Nikoghosyan Narek,1:3,16:14 - 6:11 - 7:11 - 7:11 - 0:0,1,3,Mkrtchyan Andranik,Nikoghosyan Narek,fiurst,Mkrtchyan Andranik - Nikoghosyan Narek,83,36,47,11,-11,30,17,18,18,0,-2,5,4,4,0,11,16:14 - 6:11 - 7:11 - 7:11 - 0:0
17001360,2024-02-20 15:00:00,Rafayelyan Edgar - Diaryan Aleksandr,3:2,11:7 - 5:11 - 9:11 - 11:9 - 7:11,2,3,Rafayelyan Edgar,Diaryan Aleksandr,fiurst,Diaryan Aleksandr - Rafayelyan Edgar,92,49,43,-6,6,18,16,20,20,18,4,-6,-2,2,-4,-6,7:11 - 11:5 - 11:9 - 9:11 - 11:7
17001359,2024-02-20 14:50:00,Nazaryan Mushegh - Mkrtchyan Andranik,2:3,11:4 - 4:11 - 11:8 - 8:11 - 11:9,3,2,Nazaryan Mushegh,Mkrtchyan Andranik,fiurst,Mkrtchyan Andranik - Nazaryan Mushegh,88,43,45,2,-2,15,15,19,19,20,7,-7,3,-3,2,2,4:11 - 11:4 - 8:11 - 11:8 - 9:11
17001348,2024-02-20 14:30:00,Nikoghosyan Narek - Rafayelyan Edgar,1:3,11:6 - 4:11 - 3:11 - 6:11 - 0:0,1,3,Nikoghosyan Narek,Rafayelyan Edgar,fiurst,Nikoghosyan Narek - Rafayelyan Edgar,63,24,39,15,-15,17,15,14,17,0,-5,7,8,5,0,15,11:6 - 4:11 - 3:11 - 6:11 - 0:0
17001345,2024-02-20 14:25:00,Nazaryan Mushegh - Diaryan Aleksandr,3:0,6:11 - 8:11 - 6:11 - 0:0 - 0:0,0,3,Nazaryan Mushegh,Diaryan Aleksandr,fiurst,Diaryan Aleksandr - Nazaryan Mushegh,53,33,20,-13,13,17,19,17,0,0,-5,-3,-5,0,0,-13,11:6 - 11:8 - 11:6 - 0:0 - 0:0
17001344,2024-02-20 14:00:00,Mkrtchyan Andranik - Rafayelyan Edgar,0:3,6:11 - 9:11 - 8:11 - 0:0 - 0:0,0,3,Mkrtchyan Andranik,Rafayelyan Edgar,fiurst,Mkrtchyan Andranik - Rafayelyan Edgar,56,23,33,10,-10,17,20,19,0,0,5,2,3,0,0,10,6:11 - 9:11 - 8:11 - 0:0 - 0:0
17001342,2024-02-20 13:50:00,Nikoghosyan Narek - Nazaryan Mushegh,3:2,9:11 - 8:11 - 11:6 - 11:6 - 9:11,2,3,Nikoghosyan Narek,Nazaryan Mushegh,fiurst,Nazaryan Mushegh - Nikoghosyan Narek,93,45,48,3,-3,20,19,17,17,20,-2,-3,5,5,-2,3,11:9 - 11:8 - 6:11 - 6:11 - 11:9
17001340,2024-02-20 13:30:00,Diaryan Aleksandr - Mkrtchyan Andranik,3:0,11:3 - 11:7 - 11:4 - 0:0 - 0:0,3,0,Diaryan Aleksandr,Mkrtchyan Andranik,fiurst,Diaryan Aleksandr - Mkrtchyan Andranik,47,33,14,-19,19,14,18,15,0,0,-8,-4,-7,0,0,-19,11:3 - 11:7 - 11:4 - 0:0 - 0:0
17001336,2024-02-20 13:15:00,Rafayelyan Edgar - Nazaryan Mushegh,3:0,8:11 - 6:11 - 9:11 - 0:0 - 0:0,0,3,Rafayelyan Edgar,Nazaryan Mushegh,fiurst,Nazaryan Mushegh - Rafayelyan Edgar,56,33,23,-10,10,19,17,20,0,0,-3,-5,-2,0,0,-10,11:8 - 11:6 - 11:9 - 0:0 - 0:0
17001334,2024-02-20 13:00:00,Diaryan Aleksandr - Nikoghosyan Narek,3:1,11:8 - 11:8 - 11:13 - 15:13 - 0:0,3,1,Diaryan Aleksandr,Nikoghosyan Narek,fiurst,Diaryan Aleksandr - Nikoghosyan Narek,90,48,42,-6,6,19,19,24,28,0,-3,-3,2,-2,0,-6,11:8 - 11:8 - 11:13 - 15:13 - 0:0
17001333,2024-02-20 12:20:00,Mkrtchyan Andranik - Nazaryan Mushegh,1:3,11:7 - 4:11 - 6:11 - 5:11 - 0:0,1,3,Mkrtchyan Andranik,Nazaryan Mushegh,fiurst,Mkrtchyan Andranik - Nazaryan Mushegh,66,26,40,14,-14,18,15,17,16,0,-4,7,5,6,0,14,11:7 - 4:11 - 6:11 - 5:11 - 0:0
17001330,2024-02-20 12:00:00,Diaryan Aleksandr - Rafayelyan Edgar,3:0,11:7 - 11:9 - 11:3 - 0:0 - 0:0,3,0,Diaryan Aleksandr,Rafayelyan Edgar,fiurst,Diaryan Aleksandr - Rafayelyan Edgar,52,33,19,-14,14,18,20,14,0,0,-4,-2,-8,0,0,-14,11:7 - 11:9 - 11:3 - 0:0 - 0:0
17001326,2024-02-20 11:50:00,Nikoghosyan Narek - Mkrtchyan Andranik,0:3,11:4 - 11:6 - 11:9 - 0:0 - 0:0,3,0,Nikoghosyan Narek,Mkrtchyan Andranik,fiurst,Mkrtchyan Andranik - Nikoghosyan Narek,52,19,33,14,-14,15,17,20,0,0,7,5,2,0,0,14,4:11 - 6:11 - 9:11 - 0:0 - 0:0
17001314,2024-02-20 11:30:00,Diaryan Aleksandr - Nazaryan Mushegh,3:0,13:11 - 11:8 - 11:6 - 0:0 - 0:0,3,0,Diaryan Aleksandr,Nazaryan Mushegh,fiurst,Diaryan Aleksandr - Nazaryan Mushegh,60,35,25,-10,10,24,19,17,0,0,-2,-3,-5,0,0,-10,13:11 - 11:8 - 11:6 - 0:0 - 0:0
17001312,2024-02-20 11:20:00,Rafayelyan Edgar - Nikoghosyan Narek,3:1,6:11 - 5:11 - 11:5 - 5:11 - 0:0,1,3,Rafayelyan Edgar,Nikoghosyan Narek,fiurst,Nikoghosyan Narek - Rafayelyan Edgar,65,38,27,-11,11,17,16,16,16,0,-5,-6,6,-6,0,-11,11:6 - 11:5 - 5:11 - 11:5 - 0:0
17001309,2024-02-20 11:00:00,Mkrtchyan Andranik - Diaryan Aleksandr,3:1,7:11 - 11:13 - 11:5 - 5:11 - 0:0,1,3,Mkrtchyan Andranik,Diaryan Aleksandr,fiurst,Diaryan Aleksandr - Mkrtchyan Andranik,74,40,34,-6,6,18,24,16,16,0,-4,-2,6,-6,0,-6,11:7 - 13:11 - 5:11 - 11:5 - 0:0
17001306,2024-02-20 10:50:00,Nazaryan Mushegh - Nikoghosyan Narek,0:3,8:11 - 9:11 - 7:11 - 0:0 - 0:0,0,3,Nazaryan Mushegh,Nikoghosyan Narek,fiurst,Nazaryan Mushegh - Nikoghosyan Narek,57,24,33,9,-9,19,20,18,0,0,3,2,4,0,0,9,8:11 - 9:11 - 7:11 - 0:0 - 0:0
17001304,2024-02-20 10:30:00,Rafayelyan Edgar - Mkrtchyan Andranik,0:3,11:6 - 11:9 - 11:5 - 0:0 - 0:0,3,0,Rafayelyan Edgar,Mkrtchyan Andranik,fiurst,Mkrtchyan Andranik - Rafayelyan Edgar,53,20,33,13,-13,17,20,16,0,0,5,2,6,0,0,13,6:11 - 9:11 - 5:11 - 0:0 - 0:0
17001303,2024-02-20 10:15:00,Nikoghosyan Narek - Diaryan Aleksandr,1:3,16:14 - 11:7 - 8:11 - 12:10 - 0:0,3,1,Nikoghosyan Narek,Diaryan Aleksandr,fiurst,Diaryan Aleksandr - Nikoghosyan Narek,89,42,47,5,-5,30,18,19,22,0,2,4,-3,2,0,5,14:16 - 7:11 - 11:8 - 10:12 - 0:0
17001292,2024-02-20 10:00:00,Nazaryan Mushegh - Rafayelyan Edgar,2:3,8:11 - 11:4 - 13:11 - 5:11 - 5:11,2,3,Nazaryan Mushegh,Rafayelyan Edgar,fiurst,Nazaryan Mushegh - Rafayelyan Edgar,90,42,48,6,-6,19,15,24,16,16,3,-7,-2,6,6,6,8:11 - 11:4 - 13:11 - 5:11 - 5:11
16981156,2024-02-19 17:45:00,Arutyunov Ruben - Gevorgyan Gegham,3:0,11:7 - 11:4 - 11:5 - 0:0 - 0:0,3,0,Arutyunov Ruben,Gevorgyan Gegham,fiurst,Arutyunov Ruben - Gevorgyan Gegham,49,33,16,-17,17,18,15,16,0,0,-4,-7,-6,0,0,-17,11:7 - 11:4 - 11:5 - 0:0 - 0:0
16981139,2024-02-19 17:15:00,Grigoryan Erik - Arutyunov Ruben,3:0,3:11 - 6:11 - 4:11 - 0:0 - 0:0,0,3,Grigoryan Erik,Arutyunov Ruben,fiurst,Arutyunov Ruben - Grigoryan Erik,46,33,13,-20,20,14,17,15,0,0,-8,-5,-7,0,0,-20,11:3 - 11:6 - 11:4 - 0:0 - 0:0
16981138,2024-02-19 17:05:00,Avakimyan Davit - Gevorgyan Gegham,0:0,0:0 - 0:0 - 0:0 - 0:0 - 0:0,0,0,Avakimyan Davit,Gevorgyan Gegham,fiurst,Avakimyan Davit - Gevorgyan Gegham,0,0,0,0,0,0,0,0,0,0,0,0,0,0,0,0,0:0 - 0:0 - 0:0 - 0:0 - 0:0
16981134,2024-02-19 16:50:00,Petrosyan Davit - Grigoryan Erik,0:3,11:2 - 11:7 - 11:5 - 0:0 - 0:0,3,0,Petrosyan Davit,Grigoryan Erik,fiurst,Grigoryan Erik - Petrosyan Davit,47,14,33,19,-19,13,18,16,0,0,9,4,6,0,0,19,2:11 - 7:11 - 5:11 - 0:0 - 0:0
16981132,2024-02-19 16:30:00,Arutyunov Ruben - Avakimyan Davit,3:0,11:7 - 13:11 - 11:8 - 0:0 - 0:0,3,0,Arutyunov Ruben,Avakimyan Davit,fiurst,Arutyunov Ruben - Avakimyan Davit,61,35,26,-9,9,18,24,19,0,0,-4,-2,-3,0,0,-9,11:7 - 13:11 - 11:8 - 0:0 - 0:0
16981131,2024-02-19 16:15:00,Gevorgyan Gegham - Grigoryan Erik,2:3,11:7 - 7:11 - 11:8 - 7:11 - 3:11,2,3,Gevorgyan Gegham,Grigoryan Erik,fiurst,Gevorgyan Gegham - Grigoryan Erik,87,39,48,9,-9,18,18,19,18,14,-4,4,-3,4,8,9,11:7 - 7:11 - 11:8 - 7:11 - 3:11
16981129,2024-02-19 16:00:00,Petrosyan Davit - Arutyunov Ruben,2:1,5:11 - 11:8 - 7:11 - 3:7 - 0:0,1,2,Petrosyan Davit,Arutyunov Ruben,fiurst,Arutyunov Ruben - Petrosyan Davit,63,37,26,-11,11,16,19,18,10,0,-6,3,-4,-4,0,-11,11:5 - 8:11 - 11:7 - 7:3 - 0:0
16981128,2024-02-19 15:45:00,Grigoryan Erik - Avakimyan Davit,0:3,11:1 - 11:5 - 11:8 - 0:0 - 0:0,3,0,Grigoryan Erik,Avakimyan Davit,fiurst,Avakimyan Davit - Grigoryan Erik,47,14,33,19,-19,12,16,19,0,0,10,6,3,0,0,19,1:11 - 5:11 - 8:11 - 0:0 - 0:0
16981121,2024-02-19 15:30:00,Gevorgyan Gegham - Petrosyan Davit,1:3,6:11 - 7:11 - 11:7 - 4:11 - 0:0,1,3,Gevorgyan Gegham,Petrosyan Davit,fiurst,Gevorgyan Gegham - Petrosyan Davit,68,28,40,12,-12,17,18,18,15,0,5,4,-4,7,0,12,6:11 - 7:11 - 11:7 - 4:11 - 0:0
16981109,2024-02-19 15:15:00,Papyan Karen - Soghomonyan Hrayr,3:0,11:8 - 11:5 - 11:2 - 0:0 - 0:0,3,0,Papyan Karen,Soghomonyan Hrayr,fiurst,Papyan Karen - Soghomonyan Hrayr,48,33,15,-18,18,19,16,13,0,0,-3,-6,-9,0,0,-18,11:8 - 11:5 - 11:2 - 0:0 - 0:0
16981106,2024-02-19 15:00:00,Rafayelyan Edgar - Diaryan Aleksandr,0:3,12:10 - 11:4 - 11:6 - 0:0 - 0:0,3,0,Rafayelyan Edgar,Diaryan Aleksandr,fiurst,Diaryan Aleksandr - Rafayelyan Edgar,54,20,34,14,-14,22,15,17,0,0,2,7,5,0,0,14,10:12 - 4:11 - 6:11 - 0:0 - 0:0
16981091,2024-02-19 14:45:00,Mkrtchyan Andranik - Papyan Karen,3:1,18:16 - 11:8 - 9:11 - 11:8 - 0:0,3,1,Mkrtchyan Andranik,Papyan Karen,fiurst,Mkrtchyan Andranik - Papyan Karen,92,49,43,-6,6,34,19,20,19,0,-2,-3,2,-3,0,-6,18:16 - 11:8 - 9:11 - 11:8 - 0:0
16981089,2024-02-19 14:30:00,Soghomonyan Hrayr - Rafayelyan Edgar,3:0,3:11 - 9:11 - 3:11 - 0:0 - 0:0,0,3,Soghomonyan Hrayr,Rafayelyan Edgar,fiurst,Rafayelyan Edgar - Soghomonyan Hrayr,48,33,15,-18,18,14,20,14,0,0,-8,-2,-8,0,0,-18,11:3 - 11:9 - 11:3 - 0:0 - 0:0
16981088,2024-02-19 14:20:00,Mkrtchyan Andranik - Diaryan Aleksandr,3:0,4:11 - 8:11 - 3:11 - 0:0 - 0:0,0,3,Mkrtchyan Andranik,Diaryan Aleksandr,fiurst,Diaryan Aleksandr - Mkrtchyan Andranik,48,33,15,-18,18,15,19,14,0,0,-7,-3,-8,0,0,-18,11:4 - 11:8 - 11:3 - 0:0 - 0:0
16981085,2024-02-19 14:10:00,Papyan Karen - Rafayelyan Edgar,1:3,11:13 - 12:10 - 5:11 - 2:11 - 0:0,1,3,Papyan Karen,Rafayelyan Edgar,fiurst,Papyan Karen - Rafayelyan Edgar,75,30,45,15,-15,24,22,16,13,0,2,-2,6,9,0,15,11:13 - 12:10 - 5:11 - 2:11 - 0:0
16981081,2024-02-19 13:45:00,Soghomonyan Hrayr - Mkrtchyan Andranik,3:2,7:11 - 14:12 - 6:11 - 11:7 - 7:11,2,3,Soghomonyan Hrayr,Mkrtchyan Andranik,fiurst,Mkrtchyan Andranik - Soghomonyan Hrayr,97,52,45,-7,7,18,26,17,18,18,-4,2,-5,4,-4,-7,11:7 - 12:14 - 11:6 - 7:11 - 11:7
16981078,2024-02-19 13:30:00,Diaryan Aleksandr - Papyan Karen,3:2,11:6 - 12:14 - 11:3 - 10:12 - 11:7,3,2,Diaryan Aleksandr,Papyan Karen,fiurst,Diaryan Aleksandr - Papyan Karen,97,55,42,-13,13,17,26,14,22,18,-5,2,-8,2,-4,-13,11:6 - 12:14 - 11:3 - 10:12 - 11:7
16981073,2024-02-19 13:15:00,Rafayelyan Edgar - Mkrtchyan Andranik,0:3,11:5 - 14:12 - 11:5 - 0:0 - 0:0,3,0,Rafayelyan Edgar,Mkrtchyan Andranik,fiurst,Mkrtchyan Andranik - Rafayelyan Edgar,58,22,36,14,-14,16,26,16,0,0,6,2,6,0,0,14,5:11 - 12:14 - 5:11 - 0:0 - 0:0
16981060,2024-02-19 13:00:00,Diaryan Aleksandr - Soghomonyan Hrayr,3:0,11:7 - 11:7 - 12:10 - 0:0 - 0:0,3,0,Diaryan Aleksandr,Soghomonyan Hrayr,fiurst,Diaryan Aleksandr - Soghomonyan Hrayr,58,34,24,-10,10,18,18,22,0,0,-4,-4,-2,0,0,-10,11:7 - 11:7 - 12:10 - 0:0 - 0:0
16981058,2024-02-19 12:15:00,Papyan Karen - Mkrtchyan Andranik,0:3,22:20 - 11:8 - 11:9 - 0:0 - 0:0,3,0,Papyan Karen,Mkrtchyan Andranik,fiurst,Mkrtchyan Andranik - Papyan Karen,81,37,44,7,-7,42,19,20,0,0,2,3,2,0,0,7,20:22 - 8:11 - 9:11 - 0:0 - 0:0
16981054,2024-02-19 12:00:00,Diaryan Aleksandr - Rafayelyan Edgar,2:3,11:6 - 11:2 - 9:11 - 6:11 - 6:11,2,3,Diaryan Aleksandr,Rafayelyan Edgar,fiurst,Diaryan Aleksandr - Rafayelyan Edgar,84,43,41,-2,2,17,13,20,17,17,-5,-9,2,5,5,-2,11:6 - 11:2 - 9:11 - 6:11 - 6:11
16981052,2024-02-19 11:45:00,Soghomonyan Hrayr - Papyan Karen,3:0,8:11 - 4:11 - 9:11 - 0:0 - 0:0,0,3,Soghomonyan Hrayr,Papyan Karen,fiurst,Papyan Karen - Soghomonyan Hrayr,54,33,21,-12,12,19,15,20,0,0,-3,-7,-2,0,0,-12,11:8 - 11:4 - 11:9 - 0:0 - 0:0
16981047,2024-02-19 11:30:00,Diaryan Aleksandr - Mkrtchyan Andranik,3:0,11:3 - 11:7 - 11:1 - 0:0 - 0:0,3,0,Diaryan Aleksandr,Mkrtchyan Andranik,fiurst,Diaryan Aleksandr - Mkrtchyan Andranik,44,33,11,-22,22,14,18,12,0,0,-8,-4,-10,0,0,-22,11:3 - 11:7 - 11:1 - 0:0 - 0:0
16961421,2024-02-19 11:15:00,Rafayelyan Edgar - Soghomonyan Hrayr,3:2,11:5 - 6:11 - 11:7 - 15:17 - 11:6,3,2,Rafayelyan Edgar,Soghomonyan Hrayr,fiurst,Rafayelyan Edgar - Soghomonyan Hrayr,100,54,46,-8,8,16,17,18,32,17,-6,5,-4,2,-5,-8,11:5 - 6:11 - 11:7 - 15:17 - 11:6
16980989,2024-02-19 11:00:00,Papyan Karen - Diaryan Aleksandr,3:1,11:5 - 6:11 - 4:11 - 5:11 - 0:0,1,3,Papyan Karen,Diaryan Aleksandr,fiurst,Diaryan Aleksandr - Papyan Karen,64,38,26,-12,12,16,17,15,16,0,6,-5,-7,-6,0,-12,5:11 - 11:6 - 11:4 - 11:5 - 0:0
16985279,2024-02-19 10:45:00,Mkrtchyan Andranik - Soghomonyan Hrayr,1:3,11:5 - 4:11 - 8:11 - 7:11 - 0:0,1,3,Mkrtchyan Andranik,Soghomonyan Hrayr,fiurst,Mkrtchyan Andranik - Soghomonyan Hrayr,68,30,38,8,-8,16,15,19,18,0,-6,7,3,4,0,8,11:5 - 4:11 - 8:11 - 7:11 - 0:0
16985266,2024-02-19 10:30:00,Rafayelyan Edgar - Papyan Karen,2:3,10:12 - 11:7 - 11:4 - 10:12 - 12:10,3,2,Rafayelyan Edgar,Papyan Karen,fiurst,Papyan Karen - Rafayelyan Edgar,99,45,54,9,-9,22,18,15,22,22,-2,4,7,-2,2,9,12:10 - 7:11 - 4:11 - 12:10 - 10:12
16985260,2024-02-19 10:15:00,Soghomonyan Hrayr - Diaryan Aleksandr,3:0,9:11 - 7:11 - 10:12 - 0:0 - 0:0,0,3,Soghomonyan Hrayr,Diaryan Aleksandr,fiurst,Diaryan Aleksandr - Soghomonyan Hrayr,60,34,26,-8,8,20,18,22,0,0,-2,-4,-2,0,0,-8,11:9 - 11:7 - 12:10 - 0:0 - 0:0
16985257,2024-02-19 10:00:00,Mkrtchyan Andranik - Rafayelyan Edgar,0:3,8:11 - 6:11 - 10:12 - 0:0 - 0:0,0,3,Mkrtchyan Andranik,Rafayelyan Edgar,fiurst,Mkrtchyan Andranik - Rafayelyan Edgar,58,24,34,10,-10,19,17,22,0,0,3,5,2,0,0,10,8:11 - 6:11 - 10:12 - 0:0 - 0:0
16961551,2024-02-18 17:45:00,Petrosyan Davit - Grigoryan Erik,0:3,11:7 - 11:8 - 11:6 - 0:0 - 0:0,3,0,Petrosyan Davit,Grigoryan Erik,fiurst,Grigoryan Erik - Petrosyan Davit,54,21,33,12,-12,18,19,17,0,0,4,3,5,0,0,12,7:11 - 8:11 - 6:11 - 0:0 - 0:0
16961553,2024-02-18 17:45:00,Gevorgyan Hayk - Avakimyan Davit,1:3,11:9 - 10:12 - 11:8 - 13:11 - 0:0,3,1,Gevorgyan Hayk,Avakimyan Davit,fiurst,Avakimyan Davit - Gevorgyan Hayk,85,40,45,5,-5,20,22,19,24,0,2,-2,3,2,0,5,9:11 - 12:10 - 8:11 - 11:13 - 0:0
16961549,2024-02-18 17:15:00,Karakhanyan Mher - Gevorgyan Hayk,3:2,11:9 - 11:9 - 3:11 - 5:11 - 1:11,2,3,Karakhanyan Mher,Gevorgyan Hayk,fiurst,Gevorgyan Hayk - Karakhanyan Mher,82,51,31,-20,20,20,20,14,16,12,2,2,-8,-6,-10,-20,9:11 - 9:11 - 11:3 - 11:5 - 11:1
16961535,2024-02-18 17:10:00,Petrosyan Davit - Avakimyan Davit,2:3,12:10 - 7:11 - 4:11 - 11:5 - 15:13,3,2,Petrosyan Davit,Avakimyan Davit,fiurst,Avakimyan Davit - Petrosyan Davit,99,50,49,-1,1,22,18,15,16,28,2,-4,-7,6,2,-1,10:12 - 11:7 - 11:4 - 5:11 - 13:15
16961520,2024-02-18 16:45:00,Grigoryan Erik - Karakhanyan Mher,1:3,8:11 - 11:8 - 7:11 - 11:13 - 0:0,1,3,Grigoryan Erik,Karakhanyan Mher,fiurst,Grigoryan Erik - Karakhanyan Mher,80,37,43,6,-6,19,19,18,24,0,3,-3,4,2,0,6,8:11 - 11:8 - 7:11 - 11:13 - 0:0
16961518,2024-02-18 16:35:00,Gevorgyan Hayk - Petrosyan Davit,2:3,15:13 - 10:12 - 13:11 - 4:11 - 9:11,2,3,Gevorgyan Hayk,Petrosyan Davit,fiurst,Gevorgyan Hayk - Petrosyan Davit,109,51,58,7,-7,28,22,24,15,20,-2,2,-2,7,2,7,15:13 - 10:12 - 13:11 - 4:11 - 9:11
16961510,2024-02-18 16:15:00,Avakimyan Davit - Karakhanyan Mher,3:0,11:9 - 11:3 - 12:10 - 0:0 - 0:0,3,0,Avakimyan Davit,Karakhanyan Mher,fiurst,Avakimyan Davit - Karakhanyan Mher,56,34,22,-12,12,20,14,22,0,0,-2,-8,-2,0,0,-12,11:9 - 11:3 - 12:10 - 0:0 - 0:0
16961502,2024-02-18 16:00:00,Grigoryan Erik - Gevorgyan Hayk,3:2,5:11 - 11:8 - 11:7 - 6:11 - 13:15,2,3,Grigoryan Erik,Gevorgyan Hayk,fiurst,Gevorgyan Hayk - Grigoryan Erik,98,52,46,-6,6,16,19,18,17,28,-6,3,4,-5,-2,-6,11:5 - 8:11 - 7:11 - 11:6 - 15:13
16961500,2024-02-18 15:45:00,Karakhanyan Mher - Petrosyan Davit,0:3,7:11 - 4:11 - 4:11 - 0:0 - 0:0,0,3,Karakhanyan Mher,Petrosyan Davit,fiurst,Karakhanyan Mher - Petrosyan Davit,48,15,33,18,-18,18,15,15,0,0,4,7,7,0,0,18,7:11 - 4:11 - 4:11 - 0:0 - 0:0
16961483,2024-02-18 15:35:00,Avakimyan Davit - Grigoryan Erik,3:1,11:6 - 11:6 - 9:11 - 11:7 - 0:0,3,1,Avakimyan Davit,Grigoryan Erik,fiurst,Avakimyan Davit - Grigoryan Erik,72,42,30,-12,12,17,17,20,18,0,-5,-5,2,-4,0,-12,11:6 - 11:6 - 9:11 - 11:7 - 0:0
16961477,2024-02-18 15:15:00,Nazaryan Mushegh - Diaryan Aleksandr,3:0,3:11 - 7:11 - 7:11 - 0:0 - 0:0,0,3,Nazaryan Mushegh,Diaryan Aleksandr,fiurst,Diaryan Aleksandr - Nazaryan Mushegh,50,33,17,-16,16,14,18,18,0,0,-8,-4,-4,0,0,-16,11:3 - 11:7 - 11:7 - 0:0 - 0:0
16961475,2024-02-18 15:00:00,Mkrtchyan Andranik - Nikoghosyan Narek,2:3,12:10 - 10:12 - 12:14 - 11:8 - 9:11,2,3,Mkrtchyan Andranik,Nikoghosyan Narek,fiurst,Mkrtchyan Andranik - Nikoghosyan Narek,109,54,55,1,-1,22,22,26,19,20,-2,2,2,-3,2,1,12:10 - 10:12 - 12:14 - 11:8 - 9:11
16961473,2024-02-18 14:45:00,Soghomonyan Hrayr - Nazaryan Mushegh,3:0,8:11 - 5:11 - 10:12 - 0:0 - 0:0,0,3,Soghomonyan Hrayr,Nazaryan Mushegh,fiurst,Nazaryan Mushegh - Soghomonyan Hrayr,57,34,23,-11,11,19,16,22,0,0,-3,-6,-2,0,0,-11,11:8 - 11:5 - 12:10 - 0:0 - 0:0
16961471,2024-02-18 14:30:00,Diaryan Aleksandr - Mkrtchyan Andranik,3:0,11:5 - 11:8 - 11:3 - 0:0 - 0:0,3,0,Diaryan Aleksandr,Mkrtchyan Andranik,fiurst,Diaryan Aleksandr - Mkrtchyan Andranik,49,33,16,-17,17,16,19,14,0,0,-6,-3,-8,0,0,-17,11:5 - 11:8 - 11:3 - 0:0 - 0:0
16961459,2024-02-18 14:15:00,Soghomonyan Hrayr - Nikoghosyan Narek,3:0,8:11 - 3:11 - 5:11 - 0:0 - 0:0,0,3,Soghomonyan Hrayr,Nikoghosyan Narek,fiurst,Nikoghosyan Narek - Soghomonyan Hrayr,49,33,16,-17,17,19,14,16,0,0,-3,-8,-6,0,0,-17,11:8 - 11:3 - 11:5 - 0:0 - 0:0
16961456,2024-02-18 14:00:00,Nazaryan Mushegh - Mkrtchyan Andranik,3:2,11:9 - 6:11 - 5:11 - 11:6 - 8:11,2,3,Nazaryan Mushegh,Mkrtchyan Andranik,fiurst,Mkrtchyan Andranik - Nazaryan Mushegh,89,48,41,-7,7,20,17,16,17,19,2,-5,-6,5,-3,-7,9:11 - 11:6 - 11:5 - 6:11 - 11:8
16961455,2024-02-18 13:45:00,Diaryan Aleksandr - Soghomonyan Hrayr,3:0,11:7 - 11:6 - 11:9 - 0:0 - 0:0,3,0,Diaryan Aleksandr,Soghomonyan Hrayr,fiurst,Diaryan Aleksandr - Soghomonyan Hrayr,55,33,22,-11,11,18,17,20,0,0,-4,-5,-2,0,0,-11,11:7 - 11:6 - 11:9 - 0:0 - 0:0
16961454,2024-02-18 13:35:00,Nikoghosyan Narek - Nazaryan Mushegh,0:3,11:8 - 11:6 - 13:11 - 0:0 - 0:0,3,0,Nikoghosyan Narek,Nazaryan Mushegh,fiurst,Nazaryan Mushegh - Nikoghosyan Narek,60,25,35,10,-10,19,17,24,0,0,3,5,2,0,0,10,8:11 - 6:11 - 11:13 - 0:0 - 0:0
16961452,2024-02-18 13:15:00,Mkrtchyan Andranik - Soghomonyan Hrayr,1:3,8:11 - 9:11 - 11:7 - 8:11 - 0:0,1,3,Mkrtchyan Andranik,Soghomonyan Hrayr,fiurst,Mkrtchyan Andranik - Soghomonyan Hrayr,76,36,40,4,-4,19,20,18,19,0,3,2,-4,3,0,4,8:11 - 9:11 - 11:7 - 8:11 - 0:0
16961448,2024-02-18 13:00:00,Nikoghosyan Narek - Diaryan Aleksandr,3:1,7:11 - 11:7 - 6:11 - 9:11 - 0:0,1,3,Nikoghosyan Narek,Diaryan Aleksandr,fiurst,Diaryan Aleksandr - Nikoghosyan Narek,73,40,33,-7,7,18,18,17,20,0,-4,4,-5,-2,0,-7,11:7 - 7:11 - 11:6 - 11:9 - 0:0
16961447,2024-02-18 12:15:00,Nazaryan Mushegh - Soghomonyan Hrayr,3:1,11:9 - 11:9 - 7:11 - 11:7 - 0:0,3,1,Nazaryan Mushegh,Soghomonyan Hrayr,fiurst,Nazaryan Mushegh - Soghomonyan Hrayr,76,40,36,-4,4,20,20,18,18,0,-2,-2,4,-4,0,-4,11:9 - 11:9 - 7:11 - 11:7 - 0:0
16961446,2024-02-18 12:00:00,Nikoghosyan Narek - Mkrtchyan Andranik,0:3,11:5 - 11:7 - 11:6 - 0:0 - 0:0,3,0,Nikoghosyan Narek,Mkrtchyan Andranik,fiurst,Mkrtchyan Andranik - Nikoghosyan Narek,51,18,33,15,-15,16,18,17,0,0,6,4,5,0,0,15,5:11 - 7:11 - 6:11 - 0:0 - 0:0
16961426,2024-02-18 11:45:00,Diaryan Aleksandr - Nazaryan Mushegh,3:0,13:11 - 11:5 - 11:6 - 0:0 - 0:0,3,0,Diaryan Aleksandr,Nazaryan Mushegh,fiurst,Diaryan Aleksandr - Nazaryan Mushegh,57,35,22,-13,13,24,16,17,0,0,-2,-6,-5,0,0,-13,13:11 - 11:5 - 11:6 - 0:0 - 0:0
16961424,2024-02-18 11:30:00,Nikoghosyan Narek - Soghomonyan Hrayr,3:0,11:3 - 11:8 - 11:4 - 0:0 - 0:0,3,0,Nikoghosyan Narek,Soghomonyan Hrayr,fiurst,Nikoghosyan Narek - Soghomonyan Hrayr,48,33,15,-18,18,14,19,15,0,0,-8,-3,-7,0,0,-18,11:3 - 11:8 - 11:4 - 0:0 - 0:0
16981007,2024-02-18 11:15:00,Mkrtchyan Andranik - Diaryan Aleksandr,3:0,3:11 - 6:11 - 4:11 - 0:0 - 0:0,0,3,Mkrtchyan Andranik,Diaryan Aleksandr,fiurst,Diaryan Aleksandr - Mkrtchyan Andranik,46,33,13,-20,20,14,17,15,0,0,-8,-5,-7,0,0,-20,11:3 - 11:6 - 11:4 - 0:0 - 0:0
16961419,2024-02-18 11:00:00,Nazaryan Mushegh - Nikoghosyan Narek,3:0,11:7 - 11:9 - 11:4 - 0:0 - 0:0,3,0,Nazaryan Mushegh,Nikoghosyan Narek,fiurst,Nazaryan Mushegh - Nikoghosyan Narek,53,33,20,-13,13,18,20,15,0,0,-4,-2,-7,0,0,-13,11:7 - 11:9 - 11:4 - 0:0 - 0:0
16961418,2024-02-18 10:45:00,Soghomonyan Hrayr - Diaryan Aleksandr,3:0,6:11 - 10:12 - 7:11 - 0:0 - 0:0,0,3,Soghomonyan Hrayr,Diaryan Aleksandr,fiurst,Diaryan Aleksandr - Soghomonyan Hrayr,57,34,23,-11,11,17,22,18,0,0,-5,-2,-4,0,0,-11,11:6 - 12:10 - 11:7 - 0:0 - 0:0
16961415,2024-02-18 10:30:00,Mkrtchyan Andranik - Nazaryan Mushegh,0:3,5:11 - 8:11 - 3:11 - 0:0 - 0:0,0,3,Mkrtchyan Andranik,Nazaryan Mushegh,fiurst,Mkrtchyan Andranik - Nazaryan Mushegh,49,16,33,17,-17,16,19,14,0,0,6,3,8,0,0,17,5:11 - 8:11 - 3:11 - 0:0 - 0:0
16961412,2024-02-18 10:15:00,Diaryan Aleksandr - Nikoghosyan Narek,1:3,6:11 - 11:13 - 11:4 - 9:11 - 0:0,1,3,Diaryan Aleksandr,Nikoghosyan Narek,fiurst,Diaryan Aleksandr - Nikoghosyan Narek,76,37,39,2,-2,17,24,15,20,0,5,2,-7,2,0,2,6:11 - 11:13 - 11:4 - 9:11 - 0:0
16961411,2024-02-18 10:00:00,Soghomonyan Hrayr - Mkrtchyan Andranik,3:0,9:11 - 5:11 - 6:11 - 0:0 - 0:0,0,3,Soghomonyan Hrayr,Mkrtchyan Andranik,fiurst,Mkrtchyan Andranik - Soghomonyan Hrayr,53,33,20,-13,13,20,16,17,0,0,-2,-6,-5,0,0,-13,11:9 - 11:5 - 11:6 - 0:0 - 0:0
16942864,2024-02-17 17:45:00,Avakimyan Davit - Arutyunov Ruben,3:0,4:11 - 7:11 - 3:11 - 0:0 - 0:0,0,3,Avakimyan Davit,Arutyunov Ruben,fiurst,Arutyunov Ruben - Avakimyan Davit,47,33,14,-19,19,15,18,14,0,0,-7,-4,-8,0,0,-19,11:4 - 11:7 - 11:3 - 0:0 - 0:0
16942862,2024-02-17 17:30:00,Karakhanyan Mher - Gevorgyan Hayk,3:0,5:11 - 3:11 - 10:12 - 0:0 - 0:0,0,3,Karakhanyan Mher,Gevorgyan Hayk,fiurst,Gevorgyan Hayk - Karakhanyan Mher,52,34,18,-16,16,16,14,22,0,0,-6,-8,-2,0,0,-16,11:5 - 11:3 - 12:10 - 0:0 - 0:0
16942851,2024-02-17 17:15:00,Gevorgyan Gegham - Avakimyan Davit,3:2,11:6 - 6:11 - 11:3 - 8:11 - 9:11,2,3,Gevorgyan Gegham,Avakimyan Davit,fiurst,Avakimyan Davit - Gevorgyan Gegham,87,42,45,3,-3,17,17,14,19,20,5,-5,8,-3,-2,3,6:11 - 11:6 - 3:11 - 11:8 - 11:9
16942849,2024-02-17 17:00:00,Karakhanyan Mher - Arutyunov Ruben,3:0,3:11 - 11:13 - 11:13 - 0:0 - 0:0,0,3,Karakhanyan Mher,Arutyunov Ruben,fiurst,Arutyunov Ruben - Karakhanyan Mher,62,37,25,-12,12,14,24,24,0,0,-8,-2,-2,0,0,-12,11:3 - 13:11 - 13:11 - 0:0 - 0:0
16942845,2024-02-17 16:45:00,Gevorgyan Hayk - Gevorgyan Gegham,1:3,11:5 - 6:11 - 11:3 - 11:9 - 0:0,3,1,Gevorgyan Hayk,Gevorgyan Gegham,fiurst,Gevorgyan Gegham - Gevorgyan Hayk,67,28,39,11,-11,16,17,14,20,0,6,-5,8,2,0,11,5:11 - 11:6 - 3:11 - 9:11 - 0:0
16942837,2024-02-17 16:35:00,Avakimyan Davit - Karakhanyan Mher,3:0,11:9 - 11:7 - 11:8 - 0:0 - 0:0,3,0,Avakimyan Davit,Karakhanyan Mher,fiurst,Avakimyan Davit - Karakhanyan Mher,57,33,24,-9,9,20,18,19,0,0,-2,-4,-3,0,0,-9,11:9 - 11:7 - 11:8 - 0:0 - 0:0
16942833,2024-02-17 16:15:00,Arutyunov Ruben - Gevorgyan Gegham,3:0,11:8 - 11:6 - 11:3 - 0:0 - 0:0,3,0,Arutyunov Ruben,Gevorgyan Gegham,fiurst,Arutyunov Ruben - Gevorgyan Gegham,50,33,17,-16,16,19,17,14,0,0,-3,-5,-8,0,0,-16,11:8 - 11:6 - 11:3 - 0:0 - 0:0
16942829,2024-02-17 16:00:00,Gevorgyan Hayk - Avakimyan Davit,1:3,6:11 - 11:8 - 11:3 - 11:4 - 0:0,3,1,Gevorgyan Hayk,Avakimyan Davit,fiurst,Avakimyan Davit - Gevorgyan Hayk,65,26,39,13,-13,17,19,14,15,0,-5,3,8,7,0,13,11:6 - 8:11 - 3:11 - 4:11 - 0:0
16942828,2024-02-17 15:45:00,Gevorgyan Gegham - Karakhanyan Mher,3:1,11:6 - 9:11 - 14:12 - 11:5 - 0:0,3,1,Gevorgyan Gegham,Karakhanyan Mher,fiurst,Gevorgyan Gegham - Karakhanyan Mher,79,45,34,-11,11,17,20,26,16,0,-5,2,-2,-6,0,-11,11:6 - 9:11 - 14:12 - 11:5 - 0:0
16942826,2024-02-17 15:40:00,Arutyunov Ruben - Gevorgyan Hayk,3:0,11:8 - 11:5 - 11:9 - 0:0 - 0:0,3,0,Arutyunov Ruben,Gevorgyan Hayk,fiurst,Arutyunov Ruben - Gevorgyan Hayk,55,33,22,-11,11,19,16,20,0,0,-3,-6,-2,0,0,-11,11:8 - 11:5 - 11:9 - 0:0 - 0:0
16942814,2024-02-17 15:20:00,Nikoghosyan Narek - Nazaryan Mushegh,1:3,11:7 - 8:11 - 11:4 - 11:5 - 0:0,3,1,Nikoghosyan Narek,Nazaryan Mushegh,fiurst,Nazaryan Mushegh - Nikoghosyan Narek,68,27,41,14,-14,18,19,15,16,0,4,-3,7,6,0,14,7:11 - 11:8 - 4:11 - 5:11 - 0:0
16942824,2024-02-17 15:15:00,Soghomonyan Hrayr - Rafayelyan Edgar,3:1,12:10 - 5:11 - 5:11 - 6:11 - 0:0,1,3,Soghomonyan Hrayr,Rafayelyan Edgar,fiurst,Rafayelyan Edgar - Soghomonyan Hrayr,71,43,28,-15,15,22,16,16,17,0,2,-6,-6,-5,0,-15,10:12 - 11:5 - 11:5 - 11:6 - 0:0
16942808,2024-02-17 14:50:00,Rafayelyan Edgar - Nikoghosyan Narek,3:1,5:11 - 5:11 - 11:7 - 6:11 - 0:0,1,3,Rafayelyan Edgar,Nikoghosyan Narek,fiurst,Nikoghosyan Narek - Rafayelyan Edgar,67,40,27,-13,13,16,16,18,17,0,-6,-6,4,-5,0,-13,11:5 - 11:5 - 7:11 - 11:6 - 0:0
16942811,2024-02-17 14:45:00,Papyan Karen - Soghomonyan Hrayr,3:0,11:0 - 11:6 - 11:7 - 0:0 - 0:0,3,0,Papyan Karen,Soghomonyan Hrayr,fiurst,Papyan Karen - Soghomonyan Hrayr,46,33,13,-20,20,11,17,18,0,0,-11,-5,-4,0,0,-20,11:0 - 11:6 - 11:7 - 0:0 - 0:0
16942807,2024-02-17 14:20:00,Papyan Karen - Nazaryan Mushegh,0:3,11:8 - 11:9 - 11:9 - 0:0 - 0:0,3,0,Papyan Karen,Nazaryan Mushegh,fiurst,Nazaryan Mushegh - Papyan Karen,59,26,33,7,-7,19,20,20,0,0,3,2,2,0,0,7,8:11 - 9:11 - 9:11 - 0:0 - 0:0
16942806,2024-02-17 14:10:00,Soghomonyan Hrayr - Nikoghosyan Narek,2:3,11:6 - 11:8 - 7:11 - 5:11 - 12:10,3,2,Soghomonyan Hrayr,Nikoghosyan Narek,fiurst,Nikoghosyan Narek - Soghomonyan Hrayr,92,46,46,0,0,17,19,18,16,22,5,3,-4,-6,2,0,6:11 - 8:11 - 11:7 - 11:5 - 10:12
16942804,2024-02-17 13:45:00,Rafayelyan Edgar - Papyan Karen,3:1,10:12 - 7:11 - 11:2 - 9:11 - 0:0,1,3,Rafayelyan Edgar,Papyan Karen,fiurst,Papyan Karen - Rafayelyan Edgar,73,36,37,1,-1,22,18,13,20,0,-2,-4,9,-2,0,1,12:10 - 11:7 - 2:11 - 11:9 - 0:0
16942802,2024-02-17 13:35:00,Nazaryan Mushegh - Soghomonyan Hrayr,2:3,9:11 - 11:7 - 9:11 - 11:8 - 8:11,2,3,Nazaryan Mushegh,Soghomonyan Hrayr,fiurst,Nazaryan Mushegh - Soghomonyan Hrayr,96,48,48,0,0,20,18,20,19,19,2,-4,2,-3,3,0,9:11 - 11:7 - 9:11 - 11:8 - 8:11
16942799,2024-02-17 13:15:00,Nikoghosyan Narek - Papyan Karen,3:1,11:3 - 11:8 - 10:12 - 11:7 - 0:0,3,1,Nikoghosyan Narek,Papyan Karen,fiurst,Nikoghosyan Narek - Papyan Karen,73,43,30,-13,13,14,19,22,18,0,-8,-3,2,-4,0,-13,11:3 - 11:8 - 10:12 - 11:7 - 0:0
16942798,2024-02-17 13:00:00,Nazaryan Mushegh - Rafayelyan Edgar,1:3,4:11 - 11:6 - 7:11 - 8:11 - 0:0,1,3,Nazaryan Mushegh,Rafayelyan Edgar,fiurst,Nazaryan Mushegh - Rafayelyan Edgar,69,30,39,9,-9,15,17,18,19,0,7,-5,4,3,0,9,4:11 - 11:6 - 7:11 - 8:11 - 0:0
16942785,2024-02-17 12:15:00,Soghomonyan Hrayr - Papyan Karen,3:1,9:11 - 11:5 - 8:11 - 8:11 - 0:0,1,3,Soghomonyan Hrayr,Papyan Karen,fiurst,Papyan Karen - Soghomonyan Hrayr,74,38,36,-2,2,20,16,19,19,0,-2,6,-3,-3,0,-2,11:9 - 5:11 - 11:8 - 11:8 - 0:0
16942775,2024-02-17 12:10:00,Nazaryan Mushegh - Nikoghosyan Narek,3:1,11:6 - 11:6 - 9:11 - 11:7 - 0:0,3,1,Nazaryan Mushegh,Nikoghosyan Narek,fiurst,Nazaryan Mushegh - Nikoghosyan Narek,72,42,30,-12,12,17,17,20,18,0,-5,-5,2,-4,0,-12,11:6 - 11:6 - 9:11 - 11:7 - 0:0
16942771,2024-02-17 11:45:00,Rafayelyan Edgar - Soghomonyan Hrayr,3:1,11:6 - 11:9 - 8:11 - 11:5 - 0:0,3,1,Rafayelyan Edgar,Soghomonyan Hrayr,fiurst,Rafayelyan Edgar - Soghomonyan Hrayr,72,41,31,-10,10,17,20,19,16,0,-5,-2,3,-6,0,-10,11:6 - 11:9 - 8:11 - 11:5 - 0:0
16942767,2024-02-17 11:35:00,Nazaryan Mushegh - Papyan Karen,1:3,5:11 - 13:11 - 4:11 - 10:12 - 0:0,1,3,Nazaryan Mushegh,Papyan Karen,fiurst,Nazaryan Mushegh - Papyan Karen,77,32,45,13,-13,16,24,15,22,0,6,-2,7,2,0,13,5:11 - 13:11 - 4:11 - 10:12 - 0:0
16942765,2024-02-17 11:20:00,Nikoghosyan Narek - Rafayelyan Edgar,3:1,7:11 - 12:10 - 11:4 - 11:6 - 0:0,3,1,Nikoghosyan Narek,Rafayelyan Edgar,fiurst,Nikoghosyan Narek - Rafayelyan Edgar,72,41,31,-10,10,18,22,15,17,0,4,-2,-7,-5,0,-10,7:11 - 12:10 - 11:4 - 11:6 - 0:0
16942758,2024-02-17 11:10:00,Soghomonyan Hrayr - Nazaryan Mushegh,0:3,11:8 - 11:8 - 13:11 - 0:0 - 0:0,3,0,Soghomonyan Hrayr,Nazaryan Mushegh,fiurst,Nazaryan Mushegh - Soghomonyan Hrayr,62,27,35,8,-8,19,19,24,0,0,3,3,2,0,0,8,8:11 - 8:11 - 11:13 - 0:0 - 0:0
16942757,2024-02-17 10:45:00,Papyan Karen - Rafayelyan Edgar,1:3,8:11 - 8:11 - 11:6 - 2:11 - 0:0,1,3,Papyan Karen,Rafayelyan Edgar,fiurst,Papyan Karen - Rafayelyan Edgar,68,29,39,10,-10,19,19,17,13,0,3,3,-5,9,0,10,8:11 - 8:11 - 11:6 - 2:11 - 0:0
16942739,2024-02-17 10:35:00,Nikoghosyan Narek - Soghomonyan Hrayr,3:2,6:11 - 11:7 - 18:20 - 11:6 - 11:7,3,2,Nikoghosyan Narek,Soghomonyan Hrayr,fiurst,Nikoghosyan Narek - Soghomonyan Hrayr,108,57,51,-6,6,17,18,38,17,18,5,-4,2,-5,-4,-6,6:11 - 11:7 - 18:20 - 11:6 - 11:7
16942738,2024-02-17 10:15:00,Rafayelyan Edgar - Nazaryan Mushegh,0:3,11:8 - 11:6 - 11:8 - 0:0 - 0:0,3,0,Rafayelyan Edgar,Nazaryan Mushegh,fiurst,Nazaryan Mushegh - Rafayelyan Edgar,55,22,33,11,-11,19,17,19,0,0,3,5,3,0,0,11,8:11 - 6:11 - 8:11 - 0:0 - 0:0
16942737,2024-02-17 10:00:00,Papyan Karen - Nikoghosyan Narek,3:2,11:7 - 11:8 - 4:11 - 7:11 - 5:11,2,3,Papyan Karen,Nikoghosyan Narek,fiurst,Nikoghosyan Narek - Papyan Karen,86,48,38,-10,10,18,19,15,18,16,4,3,-7,-4,-6,-10,7:11 - 8:11 - 11:4 - 11:7 - 11:5
16935142,2024-02-16 17:45:00,Petrosyan Davit - Grigoryan Erik,1:3,5:11 - 11:6 - 11:7 - 11:6 - 0:0,3,1,Petrosyan Davit,Grigoryan Erik,fiurst,Grigoryan Erik - Petrosyan Davit,68,30,38,8,-8,16,17,18,17,0,-6,5,4,5,0,8,11:5 - 6:11 - 7:11 - 6:11 - 0:0
16935141,2024-02-16 17:30:00,Karakhanyan Mher - Gevorgyan Gegham,3:0,9:11 - 5:11 - 6:11 - 0:0 - 0:0,0,3,Karakhanyan Mher,Gevorgyan Gegham,fiurst,Gevorgyan Gegham - Karakhanyan Mher,53,33,20,-13,13,20,16,17,0,0,-2,-6,-5,0,0,-13,11:9 - 11:5 - 11:6 - 0:0 - 0:0
16935140,2024-02-16 17:15:00,Arutyunov Ruben - Petrosyan Davit,3:0,11:7 - 11:3 - 11:4 - 0:0 - 0:0,3,0,Arutyunov Ruben,Petrosyan Davit,fiurst,Arutyunov Ruben - Petrosyan Davit,47,33,14,-19,19,18,14,15,0,0,-4,-8,-7,0,0,-19,11:7 - 11:3 - 11:4 - 0:0 - 0:0
16935137,2024-02-16 17:00:00,Karakhanyan Mher - Grigoryan Erik,2:3,6:11 - 12:10 - 11:8 - 6:11 - 11:9,3,2,Karakhanyan Mher,Grigoryan Erik,fiurst,Grigoryan Erik - Karakhanyan Mher,95,49,46,-3,3,17,22,19,17,20,-5,2,3,-5,2,-3,11:6 - 10:12 - 8:11 - 11:6 - 9:11
16935136,2024-02-16 16:45:00,Gevorgyan Gegham - Arutyunov Ruben,3:1,4:11 - 3:11 - 12:10 - 3:11 - 0:0,1,3,Gevorgyan Gegham,Arutyunov Ruben,fiurst,Arutyunov Ruben - Gevorgyan Gegham,65,43,22,-21,21,15,14,22,14,0,-7,-8,2,-8,0,-21,11:4 - 11:3 - 10:12 - 11:3 - 0:0
16935121,2024-02-16 16:40:00,Petrosyan Davit - Karakhanyan Mher,0:3,11:3 - 11:3 - 11:7 - 0:0 - 0:0,3,0,Petrosyan Davit,Karakhanyan Mher,fiurst,Karakhanyan Mher - Petrosyan Davit,46,13,33,20,-20,14,14,18,0,0,8,8,4,0,0,20,3:11 - 3:11 - 7:11 - 0:0 - 0:0
16935091,2024-02-16 16:15:00,Grigoryan Erik - Arutyunov Ruben,3:0,1:11 - 2:11 - 8:11 - 0:0 - 0:0,0,3,Grigoryan Erik,Arutyunov Ruben,fiurst,Arutyunov Ruben - Grigoryan Erik,44,33,11,-22,22,12,13,19,0,0,-10,-9,-3,0,0,-22,11:1 - 11:2 - 11:8 - 0:0 - 0:0
16935085,2024-02-16 16:05:00,Gevorgyan Gegham - Petrosyan Davit,2:3,6:11 - 7:11 - 11:8 - 11:6 - 6:11,2,3,Gevorgyan Gegham,Petrosyan Davit,fiurst,Gevorgyan Gegham - Petrosyan Davit,88,41,47,6,-6,17,18,19,17,17,5,4,-3,-5,5,6,6:11 - 7:11 - 11:8 - 11:6 - 6:11
16935084,2024-02-16 15:45:00,Arutyunov Ruben - Karakhanyan Mher,3:0,11:3 - 11:4 - 11:3 - 0:0 - 0:0,3,0,Arutyunov Ruben,Karakhanyan Mher,fiurst,Arutyunov Ruben - Karakhanyan Mher,43,33,10,-23,23,14,15,14,0,0,-8,-7,-8,0,0,-23,11:3 - 11:4 - 11:3 - 0:0 - 0:0
16935081,2024-02-16 15:30:00,Grigoryan Erik - Gevorgyan Gegham,3:1,7:11 - 9:11 - 11:8 - 15:17 - 0:0,1,3,Grigoryan Erik,Gevorgyan Gegham,fiurst,Gevorgyan Gegham - Grigoryan Erik,89,47,42,-5,5,18,20,19,32,0,-4,-2,3,-2,0,-5,11:7 - 11:9 - 8:11 - 17:15 - 0:0
16934546,2024-02-16 15:15:00,Mkrtchyan Andranik - Nazaryan Mushegh,1:3,8:11 - 11:5 - 7:11 - 9:11 - 0:0,1,3,Mkrtchyan Andranik,Nazaryan Mushegh,fiurst,Mkrtchyan Andranik - Nazaryan Mushegh,73,35,38,3,-3,19,16,18,20,0,3,-6,4,2,0,3,8:11 - 11:5 - 7:11 - 9:11 - 0:0
16934518,2024-02-16 15:00:00,Papyan Karen - Soghomonyan Hrayr,3:0,11:9 - 11:6 - 11:8 - 0:0 - 0:0,3,0,Papyan Karen,Soghomonyan Hrayr,fiurst,Papyan Karen - Soghomonyan Hrayr,56,33,23,-10,10,20,17,19,0,0,-2,-5,-3,0,0,-10,11:9 - 11:6 - 11:8 - 0:0 - 0:0
16934517,2024-02-16 14:45:00,Rafayelyan Edgar - Mkrtchyan Andranik,1:3,11:5 - 11:9 - 9:11 - 11:5 - 0:0,3,1,Rafayelyan Edgar,Mkrtchyan Andranik,fiurst,Mkrtchyan Andranik - Rafayelyan Edgar,72,30,42,12,-12,16,20,20,16,0,6,2,-2,6,0,12,5:11 - 9:11 - 11:9 - 5:11 - 0:0
16934500,2024-02-16 14:30:00,Nazaryan Mushegh - Papyan Karen,3:1,14:12 - 11:5 - 7:11 - 11:7 - 0:0,3,1,Nazaryan Mushegh,Papyan Karen,fiurst,Nazaryan Mushegh - Papyan Karen,78,43,35,-8,8,26,16,18,18,0,-2,-6,4,-4,0,-8,14:12 - 11:5 - 7:11 - 11:7 - 0:0
16934403,2024-02-16 14:15:00,Rafayelyan Edgar - Soghomonyan Hrayr,3:1,11:7 - 11:8 - 9:11 - 11:4 - 0:0,3,1,Rafayelyan Edgar,Soghomonyan Hrayr,fiurst,Rafayelyan Edgar - Soghomonyan Hrayr,72,42,30,-12,12,18,19,20,15,0,-4,-3,2,-7,0,-12,11:7 - 11:8 - 9:11 - 11:4 - 0:0
16934400,2024-02-16 14:00:00,Mkrtchyan Andranik - Papyan Karen,0:3,7:11 - 5:11 - 3:11 - 0:0 - 0:0,0,3,Mkrtchyan Andranik,Papyan Karen,fiurst,Mkrtchyan Andranik - Papyan Karen,48,15,33,18,-18,18,16,14,0,0,4,6,8,0,0,18,7:11 - 5:11 - 3:11 - 0:0 - 0:0
16934397,2024-02-16 13:45:00,Nazaryan Mushegh - Rafayelyan Edgar,3:0,12:10 - 11:5 - 11:9 - 0:0 - 0:0,3,0,Nazaryan Mushegh,Rafayelyan Edgar,fiurst,Nazaryan Mushegh - Rafayelyan Edgar,58,34,24,-10,10,22,16,20,0,0,-2,-6,-2,0,0,-10,12:10 - 11:5 - 11:9 - 0:0 - 0:0
16934380,2024-02-16 13:30:00,Soghomonyan Hrayr - Mkrtchyan Andranik,3:1,8:11 - 11:8 - 7:11 - 7:11 - 0:0,1,3,Soghomonyan Hrayr,Mkrtchyan Andranik,fiurst,Mkrtchyan Andranik - Soghomonyan Hrayr,74,41,33,-8,8,19,19,18,18,0,-3,3,-4,-4,0,-8,11:8 - 8:11 - 11:7 - 11:7 - 0:0
16934378,2024-02-16 13:15:00,Papyan Karen - Rafayelyan Edgar,3:1,9:11 - 11:8 - 11:7 - 11:8 - 0:0,3,1,Papyan Karen,Rafayelyan Edgar,fiurst,Papyan Karen - Rafayelyan Edgar,76,42,34,-8,8,20,19,18,19,0,2,-3,-4,-3,0,-8,9:11 - 11:8 - 11:7 - 11:8 - 0:0
16934377,2024-02-16 13:00:00,Soghomonyan Hrayr - Nazaryan Mushegh,1:3,12:10 - 11:5 - 8:11 - 11:7 - 0:0,3,1,Soghomonyan Hrayr,Nazaryan Mushegh,fiurst,Nazaryan Mushegh - Soghomonyan Hrayr,75,33,42,9,-9,22,16,19,18,0,2,6,-3,4,0,9,10:12 - 5:11 - 11:8 - 7:11 - 0:0
16934234,2024-02-16 12:20:00,Mkrtchyan Andranik - Rafayelyan Edgar,1:3,6:11 - 10:12 - 13:11 - 8:11 - 0:0,1,3,Mkrtchyan Andranik,Rafayelyan Edgar,fiurst,Mkrtchyan Andranik - Rafayelyan Edgar,82,37,45,8,-8,17,22,24,19,0,5,2,-2,3,0,8,6:11 - 10:12 - 13:11 - 8:11 - 0:0
16934214,2024-02-16 12:00:00,Soghomonyan Hrayr - Papyan Karen,1:3,10:12 - 11:7 - 11:9 - 11:7 - 0:0,3,1,Soghomonyan Hrayr,Papyan Karen,fiurst,Papyan Karen - Soghomonyan Hrayr,78,35,43,8,-8,22,18,20,18,0,-2,4,2,4,0,8,12:10 - 7:11 - 9:11 - 7:11 - 0:0
16934203,2024-02-16 11:50:00,Nazaryan Mushegh - Mkrtchyan Andranik,3:1,8:11 - 12:10 - 6:11 - 7:11 - 0:0,1,3,Nazaryan Mushegh,Mkrtchyan Andranik,fiurst,Mkrtchyan Andranik - Nazaryan Mushegh,76,43,33,-10,10,19,22,17,18,0,-3,2,-5,-4,0,-10,11:8 - 10:12 - 11:6 - 11:7 - 0:0
16934199,2024-02-16 11:30:00,Soghomonyan Hrayr - Rafayelyan Edgar,3:0,9:11 - 9:11 - 11:13 - 0:0 - 0:0,0,3,Soghomonyan Hrayr,Rafayelyan Edgar,fiurst,Rafayelyan Edgar - Soghomonyan Hrayr,64,35,29,-6,6,20,20,24,0,0,-2,-2,-2,0,0,-6,11:9 - 11:9 - 13:11 - 0:0 - 0:0
16934197,2024-02-16 11:20:00,Papyan Karen - Nazaryan Mushegh,3:1,8:11 - 11:7 - 11:13 - 8:11 - 0:0,1,3,Papyan Karen,Nazaryan Mushegh,fiurst,Nazaryan Mushegh - Papyan Karen,80,42,38,-4,4,19,18,24,19,0,-3,4,-2,-3,0,-4,11:8 - 7:11 - 13:11 - 11:8 - 0:0
16934194,2024-02-16 11:00:00,Mkrtchyan Andranik - Soghomonyan Hrayr,1:3,7:11 - 11:8 - 9:11 - 6:11 - 0:0,1,3,Mkrtchyan Andranik,Soghomonyan Hrayr,fiurst,Mkrtchyan Andranik - Soghomonyan Hrayr,74,33,41,8,-8,18,19,20,17,0,4,-3,2,5,0,8,7:11 - 11:8 - 9:11 - 6:11 - 0:0
16934012,2024-02-16 10:50:00,Rafayelyan Edgar - Nazaryan Mushegh,3:1,4:11 - 7:11 - 11:7 - 3:11 - 0:0,1,3,Rafayelyan Edgar,Nazaryan Mushegh,fiurst,Nazaryan Mushegh - Rafayelyan Edgar,65,40,25,-15,15,15,18,18,14,0,-7,-4,4,-8,0,-15,11:4 - 11:7 - 7:11 - 11:3 - 0:0
16934003,2024-02-16 10:30:00,Papyan Karen - Mkrtchyan Andranik,0:3,13:11 - 13:11 - 11:9 - 0:0 - 0:0,3,0,Papyan Karen,Mkrtchyan Andranik,fiurst,Mkrtchyan Andranik - Papyan Karen,68,31,37,6,-6,24,24,20,0,0,2,2,2,0,0,6,11:13 - 11:13 - 9:11 - 0:0 - 0:0
16933981,2024-02-16 10:15:00,Nazaryan Mushegh - Soghomonyan Hrayr,3:2,11:8 - 8:11 - 11:13 - 11:3 - 11:9,3,2,Nazaryan Mushegh,Soghomonyan Hrayr,fiurst,Nazaryan Mushegh - Soghomonyan Hrayr,96,52,44,-8,8,19,19,24,14,20,-3,3,2,-8,-2,-8,11:8 - 8:11 - 11:13 - 11:3 - 11:9
16933977,2024-02-16 10:00:00,Rafayelyan Edgar - Papyan Karen,0:3,11:7 - 11:7 - 11:9 - 0:0 - 0:0,3,0,Rafayelyan Edgar,Papyan Karen,fiurst,Papyan Karen - Rafayelyan Edgar,56,23,33,10,-10,18,18,20,0,0,4,4,2,0,0,10,7:11 - 7:11 - 9:11 - 0:0 - 0:0
16909470,2024-02-15 17:45:00,Avakimyan Davit - Petrosyan Davit,1:3,13:11 - 10:12 - 5:11 - 6:11 - 0:0,1,3,Avakimyan Davit,Petrosyan Davit,fiurst,Avakimyan Davit - Petrosyan Davit,79,34,45,11,-11,24,22,16,17,0,-2,2,6,5,0,11,13:11 - 10:12 - 5:11 - 6:11 - 0:0
16909465,2024-02-15 17:35:00,Gevorgyan Hayk - Arutyunov Ruben,3:0,4:11 - 8:11 - 5:11 - 0:0 - 0:0,0,3,Gevorgyan Hayk,Arutyunov Ruben,fiurst,Arutyunov Ruben - Gevorgyan Hayk,50,33,17,-16,16,15,19,16,0,0,-7,-3,-6,0,0,-16,11:4 - 11:8 - 11:5 - 0:0 - 0:0
16909463,2024-02-15 17:15:00,Grigoryan Erik - Avakimyan Davit,2:3,5:11 - 11:7 - 8:11 - 11:3 - 11:4,3,2,Grigoryan Erik,Avakimyan Davit,fiurst,Avakimyan Davit - Grigoryan Erik,82,36,46,10,-10,16,18,19,14,15,-6,4,-3,8,7,10,11:5 - 7:11 - 11:8 - 3:11 - 4:11
16909455,2024-02-15 17:00:00,Gevorgyan Hayk - Petrosyan Davit,2:3,8:11 - 12:10 - 11:6 - 9:11 - 9:11,2,3,Gevorgyan Hayk,Petrosyan Davit,fiurst,Gevorgyan Hayk - Petrosyan Davit,98,49,49,0,0,19,22,17,20,20,3,-2,-5,2,2,0,8:11 - 12:10 - 11:6 - 9:11 - 9:11
16909442,2024-02-15 16:50:00,Arutyunov Ruben - Grigoryan Erik,3:0,11:1 - 13:11 - 11:9 - 0:0 - 0:0,3,0,Arutyunov Ruben,Grigoryan Erik,fiurst,Arutyunov Ruben - Grigoryan Erik,56,35,21,-14,14,12,24,20,0,0,-10,-2,-2,0,0,-14,11:1 - 13:11 - 11:9 - 0:0 - 0:0
16909441,2024-02-15 16:30:00,Avakimyan Davit - Gevorgyan Hayk,0:3,4:11 - 10:12 - 4:11 - 0:0 - 0:0,0,3,Avakimyan Davit,Gevorgyan Hayk,fiurst,Avakimyan Davit - Gevorgyan Hayk,52,18,34,16,-16,15,22,15,0,0,7,2,7,0,0,16,4:11 - 10:12 - 4:11 - 0:0 - 0:0
16909437,2024-02-15 16:15:00,Petrosyan Davit - Grigoryan Erik,1:3,7:11 - 11:9 - 11:5 - 14:12 - 0:0,3,1,Petrosyan Davit,Grigoryan Erik,fiurst,Grigoryan Erik - Petrosyan Davit,80,37,43,6,-6,18,20,16,26,0,-4,2,6,2,0,6,11:7 - 9:11 - 5:11 - 12:14 - 0:0
16909435,2024-02-15 16:10:00,Arutyunov Ruben - Avakimyan Davit,3:0,11:2 - 11:3 - 11:4 - 0:0 - 0:0,3,0,Arutyunov Ruben,Avakimyan Davit,fiurst,Arutyunov Ruben - Avakimyan Davit,42,33,9,-24,24,13,14,15,0,0,-9,-8,-7,0,0,-24,11:2 - 11:3 - 11:4 - 0:0 - 0:0
16909434,2024-02-15 15:45:00,Grigoryan Erik - Gevorgyan Hayk,3:0,6:11 - 8:11 - 7:11 - 0:0 - 0:0,0,3,Grigoryan Erik,Gevorgyan Hayk,fiurst,Gevorgyan Hayk - Grigoryan Erik,54,33,21,-12,12,17,19,18,0,0,-5,-3,-4,0,0,-12,11:6 - 11:8 - 11:7 - 0:0 - 0:0
16909418,2024-02-15 15:30:00,Petrosyan Davit - Arutyunov Ruben,3:1,6:11 - 10:12 - 11:9 - 10:12 - 0:0,1,3,Petrosyan Davit,Arutyunov Ruben,fiurst,Arutyunov Ruben - Petrosyan Davit,81,44,37,-7,7,17,22,20,22,0,-5,-2,2,-2,0,-7,11:6 - 12:10 - 9:11 - 12:10 - 0:0
16909348,2024-02-15 15:15:00,Papyan Karen - Gevorgyan Hayk,3:0,5:11 - 8:11 - 3:11 - 0:0 - 0:0,0,3,Papyan Karen,Gevorgyan Hayk,fiurst,Gevorgyan Hayk - Papyan Karen,49,33,16,-17,17,16,19,14,0,0,-6,-3,-8,0,0,-17,11:5 - 11:8 - 11:3 - 0:0 - 0:0
16909346,2024-02-15 15:00:00,Rafayelyan Edgar - Nikoghosyan Narek,1:3,11:3 - 7:11 - 11:6 - 11:9 - 0:0,3,1,Rafayelyan Edgar,Nikoghosyan Narek,fiurst,Nikoghosyan Narek - Rafayelyan Edgar,69,29,40,11,-11,14,18,17,20,0,8,-4,5,2,0,11,3:11 - 11:7 - 6:11 - 9:11 - 0:0
16909340,2024-02-15 14:50:00,Soghomonyan Hrayr - Papyan Karen,3:2,12:10 - 8:11 - 9:11 - 11:3 - 9:11,2,3,Soghomonyan Hrayr,Papyan Karen,fiurst,Papyan Karen - Soghomonyan Hrayr,95,46,49,3,-3,22,19,20,14,20,2,-3,-2,8,-2,3,10:12 - 11:8 - 11:9 - 3:11 - 11:9
16909335,2024-02-15 14:30:00,Gevorgyan Hayk - Rafayelyan Edgar,0:3,8:11 - 1:11 - 8:11 - 0:0 - 0:0,0,3,Gevorgyan Hayk,Rafayelyan Edgar,fiurst,Gevorgyan Hayk - Rafayelyan Edgar,50,17,33,16,-16,19,12,19,0,0,3,10,3,0,0,16,8:11 - 1:11 - 8:11 - 0:0 - 0:0
16909329,2024-02-15 14:15:00,Soghomonyan Hrayr - Nikoghosyan Narek,3:2,6:11 - 11:7 - 8:11 - 11:7 - 8:11,2,3,Soghomonyan Hrayr,Nikoghosyan Narek,fiurst,Nikoghosyan Narek - Soghomonyan Hrayr,91,47,44,-3,3,17,18,19,18,19,-5,4,-3,4,-3,-3,11:6 - 7:11 - 11:8 - 7:11 - 11:8
16909327,2024-02-15 14:00:00,Papyan Karen - Rafayelyan Edgar,3:0,12:10 - 13:11 - 11:7 - 0:0 - 0:0,3,0,Papyan Karen,Rafayelyan Edgar,fiurst,Papyan Karen - Rafayelyan Edgar,64,36,28,-8,8,22,24,18,0,0,-2,-2,-4,0,0,-8,12:10 - 13:11 - 11:7 - 0:0 - 0:0
16909325,2024-02-15 13:45:00,Gevorgyan Hayk - Soghomonyan Hrayr,3:0,11:9 - 14:12 - 11:4 - 0:0 - 0:0,3,0,Gevorgyan Hayk,Soghomonyan Hrayr,fiurst,Gevorgyan Hayk - Soghomonyan Hrayr,61,36,25,-11,11,20,26,15,0,0,-2,-2,-7,0,0,-11,11:9 - 14:12 - 11:4 - 0:0 - 0:0
16909324,2024-02-15 13:30:00,Nikoghosyan Narek - Papyan Karen,3:0,11:5 - 11:7 - 11:4 - 0:0 - 0:0,3,0,Nikoghosyan Narek,Papyan Karen,fiurst,Nikoghosyan Narek - Papyan Karen,49,33,16,-17,17,16,18,15,0,0,-6,-4,-7,0,0,-17,11:5 - 11:7 - 11:4 - 0:0 - 0:0
16909322,2024-02-15 13:15:00,Rafayelyan Edgar - Soghomonyan Hrayr,3:0,11:2 - 11:6 - 11:7 - 0:0 - 0:0,3,0,Rafayelyan Edgar,Soghomonyan Hrayr,fiurst,Rafayelyan Edgar - Soghomonyan Hrayr,48,33,15,-18,18,13,17,18,0,0,-9,-5,-4,0,0,-18,11:2 - 11:6 - 11:7 - 0:0 - 0:0
16909321,2024-02-15 13:00:00,Nikoghosyan Narek - Gevorgyan Hayk,0:3,11:6 - 11:6 - 11:7 - 0:0 - 0:0,3,0,Nikoghosyan Narek,Gevorgyan Hayk,fiurst,Gevorgyan Hayk - Nikoghosyan Narek,52,19,33,14,-14,17,17,18,0,0,5,5,4,0,0,14,6:11 - 6:11 - 7:11 - 0:0 - 0:0
16909309,2024-02-15 12:20:00,Papyan Karen - Soghomonyan Hrayr,3:1,12:10 - 7:11 - 11:8 - 12:10 - 0:0,3,1,Papyan Karen,Soghomonyan Hrayr,fiurst,Papyan Karen - Soghomonyan Hrayr,81,42,39,-3,3,22,18,19,22,0,-2,4,-3,-2,0,-3,12:10 - 7:11 - 11:8 - 12:10 - 0:0
16908902,2024-02-15 12:00:00,Nikoghosyan Narek - Rafayelyan Edgar,0:3,7:11 - 5:11 - 9:11 - 0:0 - 0:0,0,3,Nikoghosyan Narek,Rafayelyan Edgar,fiurst,Nikoghosyan Narek - Rafayelyan Edgar,54,21,33,12,-12,18,16,20,0,0,4,6,2,0,0,12,7:11 - 5:11 - 9:11 - 0:0 - 0:0
16908890,2024-02-15 11:45:00,Gevorgyan Hayk - Papyan Karen,2:3,9:11 - 11:7 - 11:8 - 7:11 - 7:11,2,3,Gevorgyan Hayk,Papyan Karen,fiurst,Gevorgyan Hayk - Papyan Karen,93,45,48,3,-3,20,18,19,18,18,2,-4,-3,4,4,3,9:11 - 11:7 - 11:8 - 7:11 - 7:11
16908888,2024-02-15 11:30:00,Nikoghosyan Narek - Soghomonyan Hrayr,1:3,11:6 - 19:21 - 8:11 - 14:16 - 0:0,1,3,Nikoghosyan Narek,Soghomonyan Hrayr,fiurst,Nikoghosyan Narek - Soghomonyan Hrayr,106,52,54,2,-2,17,40,19,30,0,-5,2,3,2,0,2,11:6 - 19:21 - 8:11 - 14:16 - 0:0
16908887,2024-02-15 11:15:00,Rafayelyan Edgar - Gevorgyan Hayk,1:3,13:11 - 12:10 - 8:11 - 11:3 - 0:0,3,1,Rafayelyan Edgar,Gevorgyan Hayk,fiurst,Gevorgyan Hayk - Rafayelyan Edgar,79,35,44,9,-9,24,22,19,14,0,2,2,-3,8,0,9,11:13 - 10:12 - 11:8 - 3:11 - 0:0
16908886,2024-02-15 11:00:00,Papyan Karen - Nikoghosyan Narek,1:3,11:9 - 5:11 - 11:9 - 11:9 - 0:0,3,1,Papyan Karen,Nikoghosyan Narek,fiurst,Nikoghosyan Narek - Papyan Karen,76,38,38,0,0,20,16,20,20,0,2,-6,2,2,0,0,9:11 - 11:5 - 9:11 - 9:11 - 0:0
16908881,2024-02-15 10:45:00,Soghomonyan Hrayr - Gevorgyan Hayk,1:3,11:7 - 8:11 - 11:4 - 11:6 - 0:0,3,1,Soghomonyan Hrayr,Gevorgyan Hayk,fiurst,Gevorgyan Hayk - Soghomonyan Hrayr,69,28,41,13,-13,18,19,15,17,0,4,-3,7,5,0,13,7:11 - 11:8 - 4:11 - 6:11 - 0:0
16908877,2024-02-15 10:30:00,Rafayelyan Edgar - Papyan Karen,0:3,11:9 - 11:7 - 11:5 - 0:0 - 0:0,3,0,Rafayelyan Edgar,Papyan Karen,fiurst,Papyan Karen - Rafayelyan Edgar,54,21,33,12,-12,20,18,16,0,0,2,4,6,0,0,12,9:11 - 7:11 - 5:11 - 0:0 - 0:0
16908874,2024-02-15 10:15:00,Gevorgyan Hayk - Nikoghosyan Narek,0:3,5:11 - 5:11 - 7:11 - 0:0 - 0:0,0,3,Gevorgyan Hayk,Nikoghosyan Narek,fiurst,Gevorgyan Hayk - Nikoghosyan Narek,50,17,33,16,-16,16,16,18,0,0,6,6,4,0,0,16,5:11 - 5:11 - 7:11 - 0:0 - 0:0
16908871,2024-02-15 10:00:00,Soghomonyan Hrayr - Rafayelyan Edgar,3:1,7:11 - 11:7 - 4:11 - 7:11 - 0:0,1,3,Soghomonyan Hrayr,Rafayelyan Edgar,fiurst,Rafayelyan Edgar - Soghomonyan Hrayr,69,40,29,-11,11,18,18,15,18,0,-4,4,-7,-4,0,-11,11:7 - 7:11 - 11:4 - 11:7 - 0:0
16886199,2024-02-14 17:50:00,Petrosyan Davit - Grigoryan Erik,3:0,10:12 - 5:11 - 6:11 - 0:0 - 0:0,0,3,Petrosyan Davit,Grigoryan Erik,fiurst,Grigoryan Erik - Petrosyan Davit,55,34,21,-13,13,22,16,17,0,0,-2,-6,-5,0,0,-13,12:10 - 11:5 - 11:6 - 0:0 - 0:0
16886197,2024-02-14 17:30:00,Avakimyan Davit - Gevorgyan Gegham,3:1,11:3 - 11:7 - 5:11 - 11:5 - 0:0,3,1,Avakimyan Davit,Gevorgyan Gegham,fiurst,Avakimyan Davit - Gevorgyan Gegham,64,38,26,-12,12,14,18,16,16,0,-8,-4,6,-6,0,-12,11:3 - 11:7 - 5:11 - 11:5 - 0:0
16886179,2024-02-14 17:15:00,Karakhanyan Mher - Petrosyan Davit,2:3,7:11 - 7:11 - 11:9 - 11:8 - 5:11,2,3,Karakhanyan Mher,Petrosyan Davit,fiurst,Karakhanyan Mher - Petrosyan Davit,91,41,50,9,-9,18,18,20,19,16,4,4,-2,-3,6,9,7:11 - 7:11 - 11:9 - 11:8 - 5:11
16886178,2024-02-14 17:05:00,Avakimyan Davit - Grigoryan Erik,3:1,9:11 - 11:3 - 12:10 - 11:8 - 0:0,3,1,Avakimyan Davit,Grigoryan Erik,fiurst,Avakimyan Davit - Grigoryan Erik,75,43,32,-11,11,20,14,22,19,0,2,-8,-2,-3,0,-11,9:11 - 11:3 - 12:10 - 11:8 - 0:0
16886163,2024-02-14 16:45:00,Gevorgyan Gegham - Karakhanyan Mher,3:0,11:8 - 11:6 - 11:9 - 0:0 - 0:0,3,0,Gevorgyan Gegham,Karakhanyan Mher,fiurst,Gevorgyan Gegham - Karakhanyan Mher,56,33,23,-10,10,19,17,20,0,0,-3,-5,-2,0,0,-10,11:8 - 11:6 - 11:9 - 0:0 - 0:0
16886005,2024-02-14 16:40:00,Petrosyan Davit - Avakimyan Davit,3:0,9:11 - 8:11 - 10:12 - 0:0 - 0:0,0,3,Petrosyan Davit,Avakimyan Davit,fiurst,Avakimyan Davit - Petrosyan Davit,61,34,27,-7,7,20,19,22,0,0,-2,-3,-2,0,0,-7,11:9 - 11:8 - 12:10 - 0:0 - 0:0
16886002,2024-02-14 16:15:00,Grigoryan Erik - Karakhanyan Mher,3:1,13:11 - 12:10 - 9:11 - 12:10 - 0:0,3,1,Grigoryan Erik,Karakhanyan Mher,fiurst,Grigoryan Erik - Karakhanyan Mher,88,46,42,-4,4,24,22,20,22,0,-2,-2,2,-2,0,-4,13:11 - 12:10 - 9:11 - 12:10 - 0:0
16885999,2024-02-14 16:05:00,Gevorgyan Gegham - Petrosyan Davit,1:3,10:12 - 11:13 - 11:8 - 9:11 - 0:0,1,3,Gevorgyan Gegham,Petrosyan Davit,fiurst,Gevorgyan Gegham - Petrosyan Davit,85,41,44,3,-3,22,24,19,20,0,2,2,-3,2,0,3,10:12 - 11:13 - 11:8 - 9:11 - 0:0
16885998,2024-02-14 15:45:00,Karakhanyan Mher - Avakimyan Davit,3:1,16:14 - 6:11 - 9:11 - 8:11 - 0:0,1,3,Karakhanyan Mher,Avakimyan Davit,fiurst,Avakimyan Davit - Karakhanyan Mher,86,47,39,-8,8,30,17,20,19,0,2,-5,-2,-3,0,-8,14:16 - 11:6 - 11:9 - 11:8 - 0:0
16885984,2024-02-14 15:35:00,Grigoryan Erik - Gevorgyan Gegham,0:3,11:5 - 11:9 - 11:8 - 0:0 - 0:0,3,0,Grigoryan Erik,Gevorgyan Gegham,fiurst,Gevorgyan Gegham - Grigoryan Erik,55,22,33,11,-11,16,20,19,0,0,6,2,3,0,0,11,5:11 - 9:11 - 8:11 - 0:0 - 0:0
16885980,2024-02-14 15:15:00,Nazaryan Mushegh - Rafayelyan Edgar,0:3,6:11 - 7:11 - 3:11 - 0:0 - 0:0,0,3,Nazaryan Mushegh,Rafayelyan Edgar,fiurst,Nazaryan Mushegh - Rafayelyan Edgar,49,16,33,17,-17,17,18,14,0,0,5,4,8,0,0,17,6:11 - 7:11 - 3:11 - 0:0 - 0:0
16885979,2024-02-14 15:00:00,Mkrtchyan Andranik - Soghomonyan Hrayr,1:3,2:11 - 6:11 - 11:8 - 3:11 - 0:0,1,3,Mkrtchyan Andranik,Soghomonyan Hrayr,fiurst,Mkrtchyan Andranik - Soghomonyan Hrayr,63,22,41,19,-19,13,17,19,14,0,9,5,-3,8,0,19,2:11 - 6:11 - 11:8 - 3:11 - 0:0
16885978,2024-02-14 14:45:00,Nikoghosyan Narek - Nazaryan Mushegh,1:3,7:11 - 11:9 - 11:2 - 11:9 - 0:0,3,1,Nikoghosyan Narek,Nazaryan Mushegh,fiurst,Nazaryan Mushegh - Nikoghosyan Narek,71,31,40,9,-9,18,20,13,20,0,-4,2,9,2,0,9,11:7 - 9:11 - 2:11 - 9:11 - 0:0
16885976,2024-02-14 14:30:00,Rafayelyan Edgar - Mkrtchyan Andranik,1:3,7:11 - 11:8 - 11:5 - 11:8 - 0:0,3,1,Rafayelyan Edgar,Mkrtchyan Andranik,fiurst,Mkrtchyan Andranik - Rafayelyan Edgar,72,32,40,8,-8,18,19,16,19,0,-4,3,6,3,0,8,11:7 - 8:11 - 5:11 - 8:11 - 0:0
16885966,2024-02-14 14:15:00,Nikoghosyan Narek - Soghomonyan Hrayr,3:0,11:6 - 12:10 - 13:11 - 0:0 - 0:0,3,0,Nikoghosyan Narek,Soghomonyan Hrayr,fiurst,Nikoghosyan Narek - Soghomonyan Hrayr,63,36,27,-9,9,17,22,24,0,0,-5,-2,-2,0,0,-9,11:6 - 12:10 - 13:11 - 0:0 - 0:0
16885965,2024-02-14 14:00:00,Nazaryan Mushegh - Mkrtchyan Andranik,0:3,11:6 - 11:6 - 11:3 - 0:0 - 0:0,3,0,Nazaryan Mushegh,Mkrtchyan Andranik,fiurst,Mkrtchyan Andranik - Nazaryan Mushegh,48,15,33,18,-18,17,17,14,0,0,5,5,8,0,0,18,6:11 - 6:11 - 3:11 - 0:0 - 0:0
16885963,2024-02-14 13:45:00,Rafayelyan Edgar - Nikoghosyan Narek,1:3,16:14 - 11:5 - 10:12 - 11:8 - 0:0,3,1,Rafayelyan Edgar,Nikoghosyan Narek,fiurst,Nikoghosyan Narek - Rafayelyan Edgar,87,39,48,9,-9,30,16,22,19,0,2,6,-2,3,0,9,14:16 - 5:11 - 12:10 - 8:11 - 0:0
16885962,2024-02-14 13:30:00,Soghomonyan Hrayr - Nazaryan Mushegh,1:3,11:9 - 11:5 - 7:11 - 11:8 - 0:0,3,1,Soghomonyan Hrayr,Nazaryan Mushegh,fiurst,Nazaryan Mushegh - Soghomonyan Hrayr,73,33,40,7,-7,20,16,18,19,0,2,6,-4,3,0,7,9:11 - 5:11 - 11:7 - 8:11 - 0:0
16885959,2024-02-14 13:15:00,Mkrtchyan Andranik - Nikoghosyan Narek,0:3,3:11 - 4:11 - 4:11 - 0:0 - 0:0,0,3,Mkrtchyan Andranik,Nikoghosyan Narek,fiurst,Mkrtchyan Andranik - Nikoghosyan Narek,44,11,33,22,-22,14,15,15,0,0,8,7,7,0,0,22,3:11 - 4:11 - 4:11 - 0:0 - 0:0
16885957,2024-02-14 13:00:00,Soghomonyan Hrayr - Rafayelyan Edgar,3:1,11:9 - 5:11 - 3:11 - 9:11 - 0:0,1,3,Soghomonyan Hrayr,Rafayelyan Edgar,fiurst,Rafayelyan Edgar - Soghomonyan Hrayr,70,42,28,-14,14,20,16,14,20,0,2,-6,-8,-2,0,-14,9:11 - 11:5 - 11:3 - 11:9 - 0:0
16885956,2024-02-14 12:25:00,Nazaryan Mushegh - Nikoghosyan Narek,1:3,11:13 - 8:11 - 11:6 - 7:11 - 0:0,1,3,Nazaryan Mushegh,Nikoghosyan Narek,fiurst,Nazaryan Mushegh - Nikoghosyan Narek,78,37,41,4,-4,24,19,17,18,0,2,3,-5,4,0,4,11:13 - 8:11 - 11:6 - 7:11 - 0:0
16885955,2024-02-14 12:00:00,Soghomonyan Hrayr - Mkrtchyan Andranik,0:3,11:5 - 11:8 - 11:8 - 0:0 - 0:0,3,0,Soghomonyan Hrayr,Mkrtchyan Andranik,fiurst,Mkrtchyan Andranik - Soghomonyan Hrayr,54,21,33,12,-12,16,19,19,0,0,6,3,3,0,0,12,5:11 - 8:11 - 8:11 - 0:0 - 0:0
16885950,2024-02-14 11:45:00,Rafayelyan Edgar - Nazaryan Mushegh,2:3,9:11 - 15:17 - 11:7 - 11:6 - 11:7,3,2,Rafayelyan Edgar,Nazaryan Mushegh,fiurst,Nazaryan Mushegh - Rafayelyan Edgar,105,48,57,9,-9,20,32,18,17,18,-2,-2,4,5,4,9,11:9 - 17:15 - 7:11 - 6:11 - 7:11
16885942,2024-02-14 11:30:00,Soghomonyan Hrayr - Nikoghosyan Narek,3:1,5:11 - 11:7 - 9:11 - 2:11 - 0:0,1,3,Soghomonyan Hrayr,Nikoghosyan Narek,fiurst,Nikoghosyan Narek - Soghomonyan Hrayr,67,40,27,-13,13,16,18,20,13,0,-6,4,-2,-9,0,-13,11:5 - 7:11 - 11:9 - 11:2 - 0:0
16885940,2024-02-14 11:15:00,Mkrtchyan Andranik - Rafayelyan Edgar,0:3,3:11 - 5:11 - 5:11 - 0:0 - 0:0,0,3,Mkrtchyan Andranik,Rafayelyan Edgar,fiurst,Mkrtchyan Andranik - Rafayelyan Edgar,46,13,33,20,-20,14,16,16,0,0,8,6,6,0,0,20,3:11 - 5:11 - 5:11 - 0:0 - 0:0
16885938,2024-02-14 11:00:00,Nazaryan Mushegh - Soghomonyan Hrayr,3:0,11:7 - 11:8 - 11:7 - 0:0 - 0:0,3,0,Nazaryan Mushegh,Soghomonyan Hrayr,fiurst,Nazaryan Mushegh - Soghomonyan Hrayr,55,33,22,-11,11,18,19,18,0,0,-4,-3,-4,0,0,-11,11:7 - 11:8 - 11:7 - 0:0 - 0:0
16885936,2024-02-14 10:45:00,Nikoghosyan Narek - Rafayelyan Edgar,0:3,11:13 - 10:12 - 10:12 - 0:0 - 0:0,0,3,Nikoghosyan Narek,Rafayelyan Edgar,fiurst,Nikoghosyan Narek - Rafayelyan Edgar,68,31,37,6,-6,24,22,22,0,0,2,2,2,0,0,6,11:13 - 10:12 - 10:12 - 0:0 - 0:0
16885934,2024-02-14 10:30:00,Mkrtchyan Andranik - Nazaryan Mushegh,2:3,11:6 - 6:11 - 5:11 - 12:10 - 2:11,2,3,Mkrtchyan Andranik,Nazaryan Mushegh,fiurst,Mkrtchyan Andranik - Nazaryan Mushegh,85,36,49,13,-13,17,17,16,22,13,-5,5,6,-2,9,13,11:6 - 6:11 - 5:11 - 12:10 - 2:11
16885932,2024-02-14 10:15:00,Rafayelyan Edgar - Soghomonyan Hrayr,3:1,9:11 - 11:7 - 11:3 - 11:3 - 0:0,3,1,Rafayelyan Edgar,Soghomonyan Hrayr,fiurst,Rafayelyan Edgar - Soghomonyan Hrayr,66,42,24,-18,18,20,18,14,14,0,2,-4,-8,-8,0,-18,9:11 - 11:7 - 11:3 - 11:3 - 0:0
16885931,2024-02-14 10:00:00,Nikoghosyan Narek - Mkrtchyan Andranik,0:3,11:8 - 11:7 - 12:10 - 0:0 - 0:0,3,0,Nikoghosyan Narek,Mkrtchyan Andranik,fiurst,Mkrtchyan Andranik - Nikoghosyan Narek,59,25,34,9,-9,19,18,22,0,0,3,4,2,0,0,9,8:11 - 7:11 - 10:12 - 0:0 - 0:0
16868672,2024-02-13 17:45:00,Soghomonyan Hrayr - Karakhanyan Mher,0:3,11:5 - 11:6 - 11:2 - 0:0 - 0:0,3,0,Soghomonyan Hrayr,Karakhanyan Mher,fiurst,Karakhanyan Mher - Soghomonyan Hrayr,46,13,33,20,-20,16,17,13,0,0,6,5,9,0,0,20,5:11 - 6:11 - 2:11 - 0:0 - 0:0
16868669,2024-02-13 17:30:00,Gevorgyan Hayk - Arutyunov Ruben,3:1,10:12 - 5:11 - 12:10 - 7:11 - 0:0,1,3,Gevorgyan Hayk,Arutyunov Ruben,fiurst,Arutyunov Ruben - Gevorgyan Hayk,78,44,34,-10,10,22,16,22,18,0,-2,-6,2,-4,0,-10,12:10 - 11:5 - 10:12 - 11:7 - 0:0
16868666,2024-02-13 17:15:00,Avakimyan Davit - Soghomonyan Hrayr,3:1,7:11 - 11:7 - 11:7 - 16:14 - 0:0,3,1,Avakimyan Davit,Soghomonyan Hrayr,fiurst,Avakimyan Davit - Soghomonyan Hrayr,84,45,39,-6,6,18,18,18,30,0,4,-4,-4,-2,0,-6,7:11 - 11:7 - 11:7 - 16:14 - 0:0
16868665,2024-02-13 17:00:00,Gevorgyan Hayk - Karakhanyan Mher,3:0,14:12 - 11:4 - 11:5 - 0:0 - 0:0,3,0,Gevorgyan Hayk,Karakhanyan Mher,fiurst,Gevorgyan Hayk - Karakhanyan Mher,57,36,21,-15,15,26,15,16,0,0,-2,-7,-6,0,0,-15,14:12 - 11:4 - 11:5 - 0:0 - 0:0
16868662,2024-02-13 16:45:00,Arutyunov Ruben - Avakimyan Davit,3:0,11:4 - 11:1 - 11:9 - 0:0 - 0:0,3,0,Arutyunov Ruben,Avakimyan Davit,fiurst,Arutyunov Ruben - Avakimyan Davit,47,33,14,-19,19,15,12,20,0,0,-7,-10,-2,0,0,-19,11:4 - 11:1 - 11:9 - 0:0 - 0:0
16868660,2024-02-13 16:30:00,Soghomonyan Hrayr - Gevorgyan Hayk,3:0,2:11 - 9:11 - 7:11 - 0:0 - 0:0,0,3,Soghomonyan Hrayr,Gevorgyan Hayk,fiurst,Gevorgyan Hayk - Soghomonyan Hrayr,51,33,18,-15,15,13,20,18,0,0,-9,-2,-4,0,0,-15,11:2 - 11:9 - 11:7 - 0:0 - 0:0
16868658,2024-02-13 16:15:00,Karakhanyan Mher - Avakimyan Davit,3:0,11:13 - 8:11 - 7:11 - 0:0 - 0:0,0,3,Karakhanyan Mher,Avakimyan Davit,fiurst,Avakimyan Davit - Karakhanyan Mher,61,35,26,-9,9,24,19,18,0,0,-2,-3,-4,0,0,-9,13:11 - 11:8 - 11:7 - 0:0 - 0:0
16868654,2024-02-13 16:00:00,Arutyunov Ruben - Soghomonyan Hrayr,2:3,11:13 - 10:12 - 11:8 - 12:10 - 6:11,2,3,Arutyunov Ruben,Soghomonyan Hrayr,fiurst,Arutyunov Ruben - Soghomonyan Hrayr,104,50,54,4,-4,24,22,19,22,17,2,2,-3,-2,5,4,11:13 - 10:12 - 11:8 - 12:10 - 6:11
16868653,2024-02-13 15:45:00,Avakimyan Davit - Gevorgyan Hayk,2:3,11:6 - 13:11 - 4:11 - 4:11 - 6:11,2,3,Avakimyan Davit,Gevorgyan Hayk,fiurst,Avakimyan Davit - Gevorgyan Hayk,88,38,50,12,-12,17,24,15,15,17,-5,-2,7,7,5,12,11:6 - 13:11 - 4:11 - 4:11 - 6:11
16868643,2024-02-13 15:30:00,Karakhanyan Mher - Arutyunov Ruben,3:0,5:11 - 9:11 - 9:11 - 0:0 - 0:0,0,3,Karakhanyan Mher,Arutyunov Ruben,fiurst,Arutyunov Ruben - Karakhanyan Mher,56,33,23,-10,10,16,20,20,0,0,-6,-2,-2,0,0,-10,11:5 - 11:9 - 11:9 - 0:0 - 0:0
16867412,2024-02-13 15:15:00,Nikoghosyan Narek - Mkrtchyan Andranik,0:3,11:9 - 11:5 - 11:8 - 0:0 - 0:0,3,0,Nikoghosyan Narek,Mkrtchyan Andranik,fiurst,Mkrtchyan Andranik - Nikoghosyan Narek,55,22,33,11,-11,20,16,19,0,0,2,6,3,0,0,11,9:11 - 5:11 - 8:11 - 0:0 - 0:0
16867409,2024-02-13 15:00:00,Papyan Karen - Diaryan Aleksandr,3:0,5:11 - 8:11 - 4:11 - 0:0 - 0:0,0,3,Papyan Karen,Diaryan Aleksandr,fiurst,Diaryan Aleksandr - Papyan Karen,50,33,17,-16,16,16,19,15,0,0,-6,-3,-7,0,0,-16,11:5 - 11:8 - 11:4 - 0:0 - 0:0
16867406,2024-02-13 14:50:00,Nazaryan Mushegh - Nikoghosyan Narek,0:3,5:11 - 7:11 - 7:11 - 0:0 - 0:0,0,3,Nazaryan Mushegh,Nikoghosyan Narek,fiurst,Nazaryan Mushegh - Nikoghosyan Narek,52,19,33,14,-14,16,18,18,0,0,6,4,4,0,0,14,5:11 - 7:11 - 7:11 - 0:0 - 0:0
16867403,2024-02-13 14:30:00,Mkrtchyan Andranik - Papyan Karen,0:3,9:11 - 8:11 - 8:11 - 0:0 - 0:0,0,3,Mkrtchyan Andranik,Papyan Karen,fiurst,Mkrtchyan Andranik - Papyan Karen,58,25,33,8,-8,20,19,19,0,0,2,3,3,0,0,8,9:11 - 8:11 - 8:11 - 0:0 - 0:0
16867399,2024-02-13 14:25:00,Nazaryan Mushegh - Diaryan Aleksandr,3:0,10:12 - 7:11 - 7:11 - 0:0 - 0:0,0,3,Nazaryan Mushegh,Diaryan Aleksandr,fiurst,Diaryan Aleksandr - Nazaryan Mushegh,58,34,24,-10,10,22,18,18,0,0,-2,-4,-4,0,0,-10,12:10 - 11:7 - 11:7 - 0:0 - 0:0
16867397,2024-02-13 14:00:00,Nikoghosyan Narek - Papyan Karen,3:0,11:7 - 11:2 - 11:9 - 0:0 - 0:0,3,0,Nikoghosyan Narek,Papyan Karen,fiurst,Nikoghosyan Narek - Papyan Karen,51,33,18,-15,15,18,13,20,0,0,-4,-9,-2,0,0,-15,11:7 - 11:2 - 11:9 - 0:0 - 0:0
16867394,2024-02-13 13:55:00,Mkrtchyan Andranik - Nazaryan Mushegh,1:3,6:11 - 9:11 - 11:8 - 9:11 - 0:0,1,3,Mkrtchyan Andranik,Nazaryan Mushegh,fiurst,Mkrtchyan Andranik - Nazaryan Mushegh,76,35,41,6,-6,17,20,19,20,0,5,2,-3,2,0,6,6:11 - 9:11 - 11:8 - 9:11 - 0:0
16867383,2024-02-13 13:30:00,Diaryan Aleksandr - Nikoghosyan Narek,3:1,11:7 - 11:8 - 6:11 - 11:9 - 0:0,3,1,Diaryan Aleksandr,Nikoghosyan Narek,fiurst,Diaryan Aleksandr - Nikoghosyan Narek,74,39,35,-4,4,18,19,17,20,0,-4,-3,5,-2,0,-4,11:7 - 11:8 - 6:11 - 11:9 - 0:0
16867381,2024-02-13 13:15:00,Papyan Karen - Nazaryan Mushegh,3:2,7:11 - 6:11 - 12:10 - 12:10 - 2:11,2,3,Papyan Karen,Nazaryan Mushegh,fiurst,Nazaryan Mushegh - Papyan Karen,92,53,39,-14,14,18,17,22,22,13,-4,-5,2,2,-9,-14,11:7 - 11:6 - 10:12 - 10:12 - 11:2
16867379,2024-02-13 13:00:00,Diaryan Aleksandr - Mkrtchyan Andranik,3:0,11:4 - 11:5 - 12:10 - 0:0 - 0:0,3,0,Diaryan Aleksandr,Mkrtchyan Andranik,fiurst,Diaryan Aleksandr - Mkrtchyan Andranik,53,34,19,-15,15,15,16,22,0,0,-7,-6,-2,0,0,-15,11:4 - 11:5 - 12:10 - 0:0 - 0:0
16867370,2024-02-13 12:15:00,Nikoghosyan Narek - Nazaryan Mushegh,1:3,4:11 - 11:6 - 11:8 - 11:6 - 0:0,3,1,Nikoghosyan Narek,Nazaryan Mushegh,fiurst,Nazaryan Mushegh - Nikoghosyan Narek,68,31,37,6,-6,15,17,19,17,0,-7,5,3,5,0,6,11:4 - 6:11 - 8:11 - 6:11 - 0:0
16867364,2024-02-13 12:00:00,Diaryan Aleksandr - Papyan Karen,3:0,11:5 - 11:5 - 11:7 - 0:0 - 0:0,3,0,Diaryan Aleksandr,Papyan Karen,fiurst,Diaryan Aleksandr - Papyan Karen,50,33,17,-16,16,16,16,18,0,0,-6,-6,-4,0,0,-16,11:5 - 11:5 - 11:7 - 0:0 - 0:0
16867363,2024-02-13 11:45:00,Mkrtchyan Andranik - Nikoghosyan Narek,0:3,5:11 - 3:11 - 9:11 - 0:0 - 0:0,0,3,Mkrtchyan Andranik,Nikoghosyan Narek,fiurst,Mkrtchyan Andranik - Nikoghosyan Narek,50,17,33,16,-16,16,14,20,0,0,6,8,2,0,0,16,5:11 - 3:11 - 9:11 - 0:0 - 0:0
16867361,2024-02-13 11:35:00,Diaryan Aleksandr - Nazaryan Mushegh,3:1,11:7 - 11:3 - 5:11 - 11:4 - 0:0,3,1,Diaryan Aleksandr,Nazaryan Mushegh,fiurst,Diaryan Aleksandr - Nazaryan Mushegh,63,38,25,-13,13,18,14,16,15,0,-4,-8,6,-7,0,-13,11:7 - 11:3 - 5:11 - 11:4 - 0:0
16867359,2024-02-13 11:15:00,Papyan Karen - Mkrtchyan Andranik,1:3,11:5 - 8:11 - 11:7 - 11:7 - 0:0,3,1,Papyan Karen,Mkrtchyan Andranik,fiurst,Mkrtchyan Andranik - Papyan Karen,71,30,41,11,-11,16,19,18,18,0,6,-3,4,4,0,11,5:11 - 11:8 - 7:11 - 7:11 - 0:0
16867356,2024-02-13 11:00:00,Nikoghosyan Narek - Diaryan Aleksandr,3:2,9:11 - 11:7 - 9:11 - 11:9 - 9:11,2,3,Nikoghosyan Narek,Diaryan Aleksandr,fiurst,Diaryan Aleksandr - Nikoghosyan Narek,98,49,49,0,0,20,18,20,20,20,-2,4,-2,2,-2,0,11:9 - 7:11 - 11:9 - 9:11 - 11:9
16867346,2024-02-13 10:45:00,Nazaryan Mushegh - Mkrtchyan Andranik,0:3,11:8 - 11:5 - 11:7 - 0:0 - 0:0,3,0,Nazaryan Mushegh,Mkrtchyan Andranik,fiurst,Mkrtchyan Andranik - Nazaryan Mushegh,53,20,33,13,-13,19,16,18,0,0,3,6,4,0,0,13,8:11 - 5:11 - 7:11 - 0:0 - 0:0
16867344,2024-02-13 10:30:00,Papyan Karen - Nikoghosyan Narek,0:3,16:14 - 12:10 - 11:4 - 0:0 - 0:0,3,0,Papyan Karen,Nikoghosyan Narek,fiurst,Nikoghosyan Narek - Papyan Karen,67,28,39,11,-11,30,22,15,0,0,2,2,7,0,0,11,14:16 - 10:12 - 4:11 - 0:0 - 0:0
16867340,2024-02-13 10:15:00,Mkrtchyan Andranik - Diaryan Aleksandr,3:0,10:12 - 8:11 - 5:11 - 0:0 - 0:0,0,3,Mkrtchyan Andranik,Diaryan Aleksandr,fiurst,Diaryan Aleksandr - Mkrtchyan Andranik,57,34,23,-11,11,22,19,16,0,0,-2,-3,-6,0,0,-11,12:10 - 11:8 - 11:5 - 0:0 - 0:0
16867336,2024-02-13 10:10:00,Nazaryan Mushegh - Papyan Karen,3:1,8:11 - 11:7 - 11:4 - 11:7 - 0:0,3,1,Nazaryan Mushegh,Papyan Karen,fiurst,Nazaryan Mushegh - Papyan Karen,70,41,29,-12,12,19,18,15,18,0,3,-4,-7,-4,0,-12,8:11 - 11:7 - 11:4 - 11:7 - 0:0
16847543,2024-02-12 17:45:00,Petrosyan Davit - Gevorgyan Hayk,3:1,13:11 - 9:11 - 9:11 - 6:11 - 0:0,1,3,Petrosyan Davit,Gevorgyan Hayk,fiurst,Gevorgyan Hayk - Petrosyan Davit,81,44,37,-7,7,24,20,20,17,0,2,-2,-2,-5,0,-7,11:13 - 11:9 - 11:9 - 11:6 - 0:0
16847542,2024-02-12 17:30:00,Grigoryan Erik - Gevorgyan Gegham,1:3,11:8 - 11:8 - 9:11 - 11:9 - 0:0,3,1,Grigoryan Erik,Gevorgyan Gegham,fiurst,Gevorgyan Gegham - Grigoryan Erik,78,36,42,6,-6,19,19,20,20,0,3,3,-2,2,0,6,8:11 - 8:11 - 11:9 - 9:11 - 0:0
16847529,2024-02-12 17:15:00,Arutyunov Ruben - Petrosyan Davit,3:0,11:4 - 11:4 - 11:7 - 0:0 - 0:0,3,0,Arutyunov Ruben,Petrosyan Davit,fiurst,Arutyunov Ruben - Petrosyan Davit,48,33,15,-18,18,15,15,18,0,0,-7,-7,-4,0,0,-18,11:4 - 11:4 - 11:7 - 0:0 - 0:0
16847526,2024-02-12 17:00:00,Grigoryan Erik - Gevorgyan Hayk,3:0,10:12 - 6:11 - 6:11 - 0:0 - 0:0,0,3,Grigoryan Erik,Gevorgyan Hayk,fiurst,Gevorgyan Hayk - Grigoryan Erik,56,34,22,-12,12,22,17,17,0,0,-2,-5,-5,0,0,-12,12:10 - 11:6 - 11:6 - 0:0 - 0:0
16847524,2024-02-12 16:45:00,Gevorgyan Gegham - Arutyunov Ruben,3:0,5:11 - 3:11 - 3:11 - 0:0 - 0:0,0,3,Gevorgyan Gegham,Arutyunov Ruben,fiurst,Arutyunov Ruben - Gevorgyan Gegham,44,33,11,-22,22,16,14,14,0,0,-6,-8,-8,0,0,-22,11:5 - 11:3 - 11:3 - 0:0 - 0:0
16847522,2024-02-12 16:30:00,Petrosyan Davit - Grigoryan Erik,3:0,8:11 - 8:11 - 9:11 - 0:0 - 0:0,0,3,Petrosyan Davit,Grigoryan Erik,fiurst,Grigoryan Erik - Petrosyan Davit,58,33,25,-8,8,19,19,20,0,0,-3,-3,-2,0,0,-8,11:8 - 11:8 - 11:9 - 0:0 - 0:0
16847519,2024-02-12 16:15:00,Gevorgyan Hayk - Arutyunov Ruben,3:0,7:11 - 10:12 - 9:11 - 0:0 - 0:0,0,3,Gevorgyan Hayk,Arutyunov Ruben,fiurst,Arutyunov Ruben - Gevorgyan Hayk,60,34,26,-8,8,18,22,20,0,0,-4,-2,-2,0,0,-8,11:7 - 12:10 - 11:9 - 0:0 - 0:0
16847518,2024-02-12 16:00:00,Gevorgyan Gegham - Petrosyan Davit,0:3,7:11 - 8:11 - 4:11 - 0:0 - 0:0,0,3,Gevorgyan Gegham,Petrosyan Davit,fiurst,Gevorgyan Gegham - Petrosyan Davit,52,19,33,14,-14,18,19,15,0,0,4,3,7,0,0,14,7:11 - 8:11 - 4:11 - 0:0 - 0:0
16847516,2024-02-12 15:45:00,Arutyunov Ruben - Grigoryan Erik,3:0,11:5 - 11:1 - 11:2 - 0:0 - 0:0,3,0,Arutyunov Ruben,Grigoryan Erik,fiurst,Arutyunov Ruben - Grigoryan Erik,41,33,8,-25,25,16,12,13,0,0,-6,-10,-9,0,0,-25,11:5 - 11:1 - 11:2 - 0:0 - 0:0
16847514,2024-02-12 15:30:00,Gevorgyan Hayk - Gevorgyan Gegham,1:3,9:11 - 11:9 - 11:2 - 11:7 - 0:0,3,1,Gevorgyan Hayk,Gevorgyan Gegham,fiurst,Gevorgyan Gegham - Gevorgyan Hayk,71,29,42,13,-13,20,20,13,18,0,-2,2,9,4,0,13,11:9 - 9:11 - 2:11 - 7:11 - 0:0
16847512,2024-02-12 15:20:00,Soghomonyan Hrayr - Papyan Karen,3:0,7:11 - 9:11 - 7:11 - 0:0 - 0:0,0,3,Soghomonyan Hrayr,Papyan Karen,fiurst,Papyan Karen - Soghomonyan Hrayr,56,33,23,-10,10,18,20,18,0,0,-4,-2,-4,0,0,-10,11:7 - 11:9 - 11:7 - 0:0 - 0:0
16847508,2024-02-12 15:05:00,Mkrtchyan Andranik - Rafayelyan Edgar,2:3,11:9 - 6:11 - 11:4 - 11:13 - 5:11,2,3,Mkrtchyan Andranik,Rafayelyan Edgar,fiurst,Mkrtchyan Andranik - Rafayelyan Edgar,92,44,48,4,-4,20,17,15,24,16,-2,5,-7,2,6,4,11:9 - 6:11 - 11:4 - 11:13 - 5:11
16847507,2024-02-12 14:55:00,Diaryan Aleksandr - Soghomonyan Hrayr,3:1,11:5 - 11:4 - 5:11 - 11:7 - 0:0,3,1,Diaryan Aleksandr,Soghomonyan Hrayr,fiurst,Diaryan Aleksandr - Soghomonyan Hrayr,65,38,27,-11,11,16,15,16,18,0,-6,-7,6,-4,0,-11,11:5 - 11:4 - 5:11 - 11:7 - 0:0
16847502,2024-02-12 14:35:00,Papyan Karen - Mkrtchyan Andranik,2:3,6:11 - 8:11 - 11:8 - 11:8 - 11:9,3,2,Papyan Karen,Mkrtchyan Andranik,fiurst,Mkrtchyan Andranik - Papyan Karen,94,47,47,0,0,17,19,19,19,20,-5,-3,3,3,2,0,11:6 - 11:8 - 8:11 - 8:11 - 9:11
16847493,2024-02-12 14:15:00,Diaryan Aleksandr - Rafayelyan Edgar,3:2,11:8 - 9:11 - 11:8 - 11:13 - 14:12,3,2,Diaryan Aleksandr,Rafayelyan Edgar,fiurst,Diaryan Aleksandr - Rafayelyan Edgar,108,56,52,-4,4,19,20,19,24,26,-3,2,-3,2,-2,-4,11:8 - 9:11 - 11:8 - 11:13 - 14:12
16847491,2024-02-12 14:00:00,Soghomonyan Hrayr - Mkrtchyan Andranik,1:3,5:11 - 11:4 - 11:7 - 12:10 - 0:0,3,1,Soghomonyan Hrayr,Mkrtchyan Andranik,fiurst,Mkrtchyan Andranik - Soghomonyan Hrayr,71,32,39,7,-7,16,15,18,22,0,-6,7,4,2,0,7,11:5 - 4:11 - 7:11 - 10:12 - 0:0
16847488,2024-02-12 13:45:00,Papyan Karen - Diaryan Aleksandr,1:3,11:8 - 7:11 - 11:9 - 17:15 - 0:0,3,1,Papyan Karen,Diaryan Aleksandr,fiurst,Diaryan Aleksandr - Papyan Karen,89,43,46,3,-3,19,18,20,32,0,3,-4,2,2,0,3,8:11 - 11:7 - 9:11 - 15:17 - 0:0
16847485,2024-02-12 13:30:00,Rafayelyan Edgar - Soghomonyan Hrayr,3:1,11:5 - 15:17 - 11:7 - 11:8 - 0:0,3,1,Rafayelyan Edgar,Soghomonyan Hrayr,fiurst,Rafayelyan Edgar - Soghomonyan Hrayr,85,48,37,-11,11,16,32,18,19,0,-6,2,-4,-3,0,-11,11:5 - 15:17 - 11:7 - 11:8 - 0:0
16847483,2024-02-12 13:15:00,Mkrtchyan Andranik - Diaryan Aleksandr,3:0,3:11 - 5:11 - 7:11 - 0:0 - 0:0,0,3,Mkrtchyan Andranik,Diaryan Aleksandr,fiurst,Diaryan Aleksandr - Mkrtchyan Andranik,48,33,15,-18,18,14,16,18,0,0,-8,-6,-4,0,0,-18,11:3 - 11:5 - 11:7 - 0:0 - 0:0
16847481,2024-02-12 13:00:00,Rafayelyan Edgar - Papyan Karen,3:1,5:11 - 8:11 - 11:5 - 8:11 - 0:0,1,3,Rafayelyan Edgar,Papyan Karen,fiurst,Papyan Karen - Rafayelyan Edgar,70,38,32,-6,6,16,19,16,19,0,-6,-3,6,-3,0,-6,11:5 - 11:8 - 5:11 - 11:8 - 0:0
16847477,2024-02-12 12:15:00,Soghomonyan Hrayr - Diaryan Aleksandr,3:0,10:12 - 3:11 - 7:11 - 0:0 - 0:0,0,3,Soghomonyan Hrayr,Diaryan Aleksandr,fiurst,Diaryan Aleksandr - Soghomonyan Hrayr,54,34,20,-14,14,22,14,18,0,0,-2,-8,-4,0,0,-14,12:10 - 11:3 - 11:7 - 0:0 - 0:0
16847471,2024-02-12 12:00:00,Rafayelyan Edgar - Mkrtchyan Andranik,0:3,11:0 - 11:8 - 11:6 - 0:0 - 0:0,3,0,Rafayelyan Edgar,Mkrtchyan Andranik,fiurst,Mkrtchyan Andranik - Rafayelyan Edgar,47,14,33,19,-19,11,19,17,0,0,11,3,5,0,0,19,0:11 - 8:11 - 6:11 - 0:0 - 0:0
16847463,2024-02-12 11:45:00,Papyan Karen - Soghomonyan Hrayr,3:1,13:11 - 11:6 - 9:11 - 11:6 - 0:0,3,1,Papyan Karen,Soghomonyan Hrayr,fiurst,Papyan Karen - Soghomonyan Hrayr,78,44,34,-10,10,24,17,20,17,0,-2,-5,2,-5,0,-10,13:11 - 11:6 - 9:11 - 11:6 - 0:0
16847461,2024-02-12 11:30:00,Rafayelyan Edgar - Diaryan Aleksandr,3:0,4:11 - 6:11 - 8:11 - 0:0 - 0:0,0,3,Rafayelyan Edgar,Diaryan Aleksandr,fiurst,Diaryan Aleksandr - Rafayelyan Edgar,51,33,18,-15,15,15,17,19,0,0,-7,-5,-3,0,0,-15,11:4 - 11:6 - 11:8 - 0:0 - 0:0
16847459,2024-02-12 11:15:00,Mkrtchyan Andranik - Papyan Karen,0:3,10:12 - 7:11 - 7:11 - 0:0 - 0:0,0,3,Mkrtchyan Andranik,Papyan Karen,fiurst,Mkrtchyan Andranik - Papyan Karen,58,24,34,10,-10,22,18,18,0,0,2,4,4,0,0,10,10:12 - 7:11 - 7:11 - 0:0 - 0:0
16847458,2024-02-12 11:00:00,Soghomonyan Hrayr - Rafayelyan Edgar,3:0,5:11 - 7:11 - 11:13 - 0:0 - 0:0,0,3,Soghomonyan Hrayr,Rafayelyan Edgar,fiurst,Rafayelyan Edgar - Soghomonyan Hrayr,58,35,23,-12,12,16,18,24,0,0,-6,-4,-2,0,0,-12,11:5 - 11:7 - 13:11 - 0:0 - 0:0
16847457,2024-02-12 10:45:00,Diaryan Aleksandr - Papyan Karen,3:2,7:11 - 11:6 - 11:8 - 8:11 - 11:3,3,2,Diaryan Aleksandr,Papyan Karen,fiurst,Diaryan Aleksandr - Papyan Karen,87,48,39,-9,9,18,17,19,19,14,4,-5,-3,3,-8,-9,7:11 - 11:6 - 11:8 - 8:11 - 11:3
16847455,2024-02-12 10:30:00,Mkrtchyan Andranik - Soghomonyan Hrayr,1:3,11:7 - 9:11 - 13:15 - 9:11 - 0:0,1,3,Mkrtchyan Andranik,Soghomonyan Hrayr,fiurst,Mkrtchyan Andranik - Soghomonyan Hrayr,86,42,44,2,-2,18,20,28,20,0,-4,2,2,2,0,2,11:7 - 9:11 - 13:15 - 9:11 - 0:0
16847453,2024-02-12 10:15:00,Papyan Karen - Rafayelyan Edgar,0:3,4:11 - 9:11 - 3:11 - 0:0 - 0:0,0,3,Papyan Karen,Rafayelyan Edgar,fiurst,Papyan Karen - Rafayelyan Edgar,49,16,33,17,-17,15,20,14,0,0,7,2,8,0,0,17,4:11 - 9:11 - 3:11 - 0:0 - 0:0
16847447,2024-02-12 10:00:00,Diaryan Aleksandr - Mkrtchyan Andranik,3:1,11:6 - 9:11 - 11:9 - 11:3 - 0:0,3,1,Diaryan Aleksandr,Mkrtchyan Andranik,fiurst,Diaryan Aleksandr - Mkrtchyan Andranik,71,42,29,-13,13,17,20,20,14,0,-5,2,-2,-8,0,-13,11:6 - 9:11 - 11:9 - 11:3 - 0:0
16832400,2024-02-11 17:45:00,Karakhanyan Mher - Avakimyan Davit,3:0,3:11 - 6:11 - 4:11 - 0:0 - 0:0,0,3,Karakhanyan Mher,Avakimyan Davit,fiurst,Avakimyan Davit - Karakhanyan Mher,46,33,13,-20,20,14,17,15,0,0,-8,-5,-7,0,0,-20,11:3 - 11:6 - 11:4 - 0:0 - 0:0
16832399,2024-02-11 17:40:00,Grigoryan Erik - Petrosyan Davit,0:3,5:11 - 6:11 - 3:11 - 0:0 - 0:0,0,3,Grigoryan Erik,Petrosyan Davit,fiurst,Grigoryan Erik - Petrosyan Davit,47,14,33,19,-19,16,17,14,0,0,6,5,8,0,0,19,5:11 - 6:11 - 3:11 - 0:0 - 0:0
16832396,2024-02-11 17:15:00,Gevorgyan Hayk - Karakhanyan Mher,3:0,11:4 - 11:7 - 12:10 - 0:0 - 0:0,3,0,Gevorgyan Hayk,Karakhanyan Mher,fiurst,Gevorgyan Hayk - Karakhanyan Mher,55,34,21,-13,13,15,18,22,0,0,-7,-4,-2,0,0,-13,11:4 - 11:7 - 12:10 - 0:0 - 0:0
16832393,2024-02-11 17:00:00,Grigoryan Erik - Avakimyan Davit,3:2,9:11 - 12:10 - 14:12 - 12:14 - 6:11,2,3,Grigoryan Erik,Avakimyan Davit,fiurst,Avakimyan Davit - Grigoryan Erik,111,58,53,-5,5,20,22,26,26,17,-2,2,2,-2,-5,-5,11:9 - 10:12 - 12:14 - 14:12 - 11:6
16832391,2024-02-11 16:50:00,Petrosyan Davit - Gevorgyan Hayk,3:0,9:11 - 5:11 - 9:11 - 0:0 - 0:0,0,3,Petrosyan Davit,Gevorgyan Hayk,fiurst,Gevorgyan Hayk - Petrosyan Davit,56,33,23,-10,10,20,16,20,0,0,-2,-6,-2,0,0,-10,11:9 - 11:5 - 11:9 - 0:0 - 0:0
16832388,2024-02-11 16:30:00,Karakhanyan Mher - Grigoryan Erik,3:0,9:11 - 7:11 - 10:12 - 0:0 - 0:0,0,3,Karakhanyan Mher,Grigoryan Erik,fiurst,Grigoryan Erik - Karakhanyan Mher,60,34,26,-8,8,20,18,22,0,0,-2,-4,-2,0,0,-8,11:9 - 11:7 - 12:10 - 0:0 - 0:0
16832385,2024-02-11 16:15:00,Avakimyan Davit - Gevorgyan Hayk,2:3,11:7 - 11:8 - 7:11 - 14:16 - 3:11,2,3,Avakimyan Davit,Gevorgyan Hayk,fiurst,Avakimyan Davit - Gevorgyan Hayk,99,46,53,7,-7,18,19,18,30,14,-4,-3,4,2,8,7,11:7 - 11:8 - 7:11 - 14:16 - 3:11
16832383,2024-02-11 16:00:00,Petrosyan Davit - Karakhanyan Mher,0:3,11:8 - 11:7 - 11:9 - 0:0 - 0:0,3,0,Petrosyan Davit,Karakhanyan Mher,fiurst,Karakhanyan Mher - Petrosyan Davit,57,24,33,9,-9,19,18,20,0,0,3,4,2,0,0,9,8:11 - 7:11 - 9:11 - 0:0 - 0:0
16832362,2024-02-11 15:45:00,Gevorgyan Hayk - Grigoryan Erik,2:3,12:14 - 5:11 - 13:11 - 11:9 - 3:11,2,3,Gevorgyan Hayk,Grigoryan Erik,fiurst,Gevorgyan Hayk - Grigoryan Erik,100,44,56,12,-12,26,16,24,20,14,2,6,-2,-2,8,12,12:14 - 5:11 - 13:11 - 11:9 - 3:11
16832344,2024-02-11 15:30:00,Avakimyan Davit - Petrosyan Davit,3:1,12:14 - 12:10 - 11:8 - 11:3 - 0:0,3,1,Avakimyan Davit,Petrosyan Davit,fiurst,Avakimyan Davit - Petrosyan Davit,81,46,35,-11,11,26,22,19,14,0,2,-2,-3,-8,0,-11,12:14 - 12:10 - 11:8 - 11:3 - 0:0
16831407,2024-02-11 15:15:00,Diaryan Aleksandr - Rafayelyan Edgar,0:3,10:12 - 9:11 - 10:12 - 0:0 - 0:0,0,3,Diaryan Aleksandr,Rafayelyan Edgar,fiurst,Diaryan Aleksandr - Rafayelyan Edgar,64,29,35,6,-6,22,20,22,0,0,2,2,2,0,0,6,10:12 - 9:11 - 10:12 - 0:0 - 0:0
16831405,2024-02-11 15:00:00,Nikoghosyan Narek - Soghomonyan Hrayr,3:0,12:10 - 11:8 - 11:6 - 0:0 - 0:0,3,0,Nikoghosyan Narek,Soghomonyan Hrayr,fiurst,Nikoghosyan Narek - Soghomonyan Hrayr,58,34,24,-10,10,22,19,17,0,0,-2,-3,-5,0,0,-10,12:10 - 11:8 - 11:6 - 0:0 - 0:0
16831403,2024-02-11 14:45:00,Nazaryan Mushegh - Diaryan Aleksandr,3:0,3:11 - 3:11 - 9:11 - 0:0 - 0:0,0,3,Nazaryan Mushegh,Diaryan Aleksandr,fiurst,Diaryan Aleksandr - Nazaryan Mushegh,48,33,15,-18,18,14,14,20,0,0,-8,-8,-2,0,0,-18,11:3 - 11:3 - 11:9 - 0:0 - 0:0
16831401,2024-02-11 14:30:00,Rafayelyan Edgar - Nikoghosyan Narek,0:3,12:10 - 11:8 - 11:6 - 0:0 - 0:0,3,0,Rafayelyan Edgar,Nikoghosyan Narek,fiurst,Nikoghosyan Narek - Rafayelyan Edgar,58,24,34,10,-10,22,19,17,0,0,2,3,5,0,0,10,10:12 - 8:11 - 6:11 - 0:0 - 0:0
16831400,2024-02-11 14:15:00,Nazaryan Mushegh - Soghomonyan Hrayr,3:1,11:4 - 11:7 - 7:11 - 11:7 - 0:0,3,1,Nazaryan Mushegh,Soghomonyan Hrayr,fiurst,Nazaryan Mushegh - Soghomonyan Hrayr,69,40,29,-11,11,15,18,18,18,0,-7,-4,4,-4,0,-11,11:4 - 11:7 - 7:11 - 11:7 - 0:0
16831390,2024-02-11 14:00:00,Diaryan Aleksandr - Nikoghosyan Narek,3:1,18:16 - 11:6 - 5:11 - 11:9 - 0:0,3,1,Diaryan Aleksandr,Nikoghosyan Narek,fiurst,Diaryan Aleksandr - Nikoghosyan Narek,87,45,42,-3,3,34,17,16,20,0,-2,-5,6,-2,0,-3,18:16 - 11:6 - 5:11 - 11:9 - 0:0
16831386,2024-02-11 13:45:00,Rafayelyan Edgar - Nazaryan Mushegh,0:3,11:4 - 11:5 - 11:8 - 0:0 - 0:0,3,0,Rafayelyan Edgar,Nazaryan Mushegh,fiurst,Nazaryan Mushegh - Rafayelyan Edgar,50,17,33,16,-16,15,16,19,0,0,7,6,3,0,0,16,4:11 - 5:11 - 8:11 - 0:0 - 0:0
16831342,2024-02-11 13:30:00,Soghomonyan Hrayr - Diaryan Aleksandr,3:1,11:5 - 6:11 - 9:11 - 5:11 - 0:0,1,3,Soghomonyan Hrayr,Diaryan Aleksandr,fiurst,Diaryan Aleksandr - Soghomonyan Hrayr,69,38,31,-7,7,16,17,20,16,0,6,-5,-2,-6,0,-7,5:11 - 11:6 - 11:9 - 11:5 - 0:0
16831329,2024-02-11 13:15:00,Nikoghosyan Narek - Nazaryan Mushegh,3:0,8:11 - 6:11 - 7:11 - 0:0 - 0:0,0,3,Nikoghosyan Narek,Nazaryan Mushegh,fiurst,Nazaryan Mushegh - Nikoghosyan Narek,54,33,21,-12,12,19,17,18,0,0,-3,-5,-4,0,0,-12,11:8 - 11:6 - 11:7 - 0:0 - 0:0
16831324,2024-02-11 13:00:00,Soghomonyan Hrayr - Rafayelyan Edgar,3:1,5:11 - 12:14 - 11:7 - 9:11 - 0:0,1,3,Soghomonyan Hrayr,Rafayelyan Edgar,fiurst,Rafayelyan Edgar - Soghomonyan Hrayr,80,43,37,-6,6,16,26,18,20,0,-6,-2,4,-2,0,-6,11:5 - 14:12 - 7:11 - 11:9 - 0:0
16831318,2024-02-11 12:15:00,Diaryan Aleksandr - Nazaryan Mushegh,3:0,13:11 - 15:13 - 11:5 - 0:0 - 0:0,3,0,Diaryan Aleksandr,Nazaryan Mushegh,fiurst,Diaryan Aleksandr - Nazaryan Mushegh,68,39,29,-10,10,24,28,16,0,0,-2,-2,-6,0,0,-10,13:11 - 15:13 - 11:5 - 0:0 - 0:0
16831317,2024-02-11 12:00:00,Soghomonyan Hrayr - Nikoghosyan Narek,3:1,10:12 - 11:8 - 8:11 - 9:11 - 0:0,1,3,Soghomonyan Hrayr,Nikoghosyan Narek,fiurst,Nikoghosyan Narek - Soghomonyan Hrayr,80,42,38,-4,4,22,19,19,20,0,-2,3,-3,-2,0,-4,12:10 - 8:11 - 11:8 - 11:9 - 0:0
16831315,2024-02-11 11:45:00,Rafayelyan Edgar - Diaryan Aleksandr,3:0,4:11 - 8:11 - 1:11 - 0:0 - 0:0,0,3,Rafayelyan Edgar,Diaryan Aleksandr,fiurst,Diaryan Aleksandr - Rafayelyan Edgar,46,33,13,-20,20,15,19,12,0,0,-7,-3,-10,0,0,-20,11:4 - 11:8 - 11:1 - 0:0 - 0:0
16831312,2024-02-11 11:30:00,Soghomonyan Hrayr - Nazaryan Mushegh,2:3,7:11 - 11:7 - 13:11 - 6:11 - 14:12,3,2,Soghomonyan Hrayr,Nazaryan Mushegh,fiurst,Nazaryan Mushegh - Soghomonyan Hrayr,103,52,51,-1,1,18,18,24,17,26,-4,4,2,-5,2,-1,11:7 - 7:11 - 11:13 - 11:6 - 12:14
16831309,2024-02-11 11:15:00,Nikoghosyan Narek - Rafayelyan Edgar,0:3,9:11 - 0:11 - 4:11 - 0:0 - 0:0,0,3,Nikoghosyan Narek,Rafayelyan Edgar,fiurst,Nikoghosyan Narek - Rafayelyan Edgar,46,13,33,20,-20,20,11,15,0,0,2,11,7,0,0,20,9:11 - 0:11 - 4:11 - 0:0 - 0:0
16831301,2024-02-11 11:00:00,Diaryan Aleksandr - Soghomonyan Hrayr,3:1,11:7 - 11:3 - 12:14 - 11:4 - 0:0,3,1,Diaryan Aleksandr,Soghomonyan Hrayr,fiurst,Diaryan Aleksandr - Soghomonyan Hrayr,73,45,28,-17,17,18,14,26,15,0,-4,-8,2,-7,0,-17,11:7 - 11:3 - 12:14 - 11:4 - 0:0
16831291,2024-02-11 10:45:00,Nazaryan Mushegh - Rafayelyan Edgar,3:1,10:12 - 11:6 - 11:5 - 11:3 - 0:0,3,1,Nazaryan Mushegh,Rafayelyan Edgar,fiurst,Nazaryan Mushegh - Rafayelyan Edgar,69,43,26,-17,17,22,17,16,14,0,2,-5,-6,-8,0,-17,10:12 - 11:6 - 11:5 - 11:3 - 0:0
16831290,2024-02-11 10:30:00,Nikoghosyan Narek - Diaryan Aleksandr,2:3,11:9 - 4:11 - 11:7 - 8:11 - 11:8,3,2,Nikoghosyan Narek,Diaryan Aleksandr,fiurst,Diaryan Aleksandr - Nikoghosyan Narek,91,46,45,-1,1,20,15,18,19,19,2,-7,4,-3,3,-1,9:11 - 11:4 - 7:11 - 11:8 - 8:11
16831288,2024-02-11 10:15:00,Rafayelyan Edgar - Soghomonyan Hrayr,3:0,11:5 - 11:5 - 11:6 - 0:0 - 0:0,3,0,Rafayelyan Edgar,Soghomonyan Hrayr,fiurst,Rafayelyan Edgar - Soghomonyan Hrayr,49,33,16,-17,17,16,16,17,0,0,-6,-6,-5,0,0,-17,11:5 - 11:5 - 11:6 - 0:0 - 0:0
16831286,2024-02-11 10:00:00,Nazaryan Mushegh - Nikoghosyan Narek,0:3,11:13 - 8:11 - 5:11 - 0:0 - 0:0,0,3,Nazaryan Mushegh,Nikoghosyan Narek,fiurst,Nazaryan Mushegh - Nikoghosyan Narek,59,24,35,11,-11,24,19,16,0,0,2,3,6,0,0,11,11:13 - 8:11 - 5:11 - 0:0 - 0:0
16810231,2024-02-10 17:50:00,Gevorgyan Hayk - Arutyunov Ruben,3:2,11:9 - 7:11 - 11:9 - 9:11 - 7:11,2,3,Gevorgyan Hayk,Arutyunov Ruben,fiurst,Arutyunov Ruben - Gevorgyan Hayk,96,51,45,-6,6,20,18,20,20,18,2,-4,2,-2,-4,-6,9:11 - 11:7 - 9:11 - 11:9 - 11:7
16810221,2024-02-10 17:30:00,Karakhanyan Mher - Gevorgyan Gegham,2:3,11:6 - 11:13 - 11:4 - 8:11 - 11:3,3,2,Karakhanyan Mher,Gevorgyan Gegham,fiurst,Gevorgyan Gegham - Karakhanyan Mher,89,37,52,15,-15,17,24,15,19,14,5,-2,7,-3,8,15,6:11 - 13:11 - 4:11 - 11:8 - 3:11
16810216,2024-02-10 17:15:00,Grigoryan Erik - Gevorgyan Hayk,3:2,7:11 - 11:8 - 11:7 - 11:13 - 4:11,2,3,Grigoryan Erik,Gevorgyan Hayk,fiurst,Gevorgyan Hayk - Grigoryan Erik,94,50,44,-6,6,18,19,18,24,15,-4,3,4,-2,-7,-6,11:7 - 8:11 - 7:11 - 13:11 - 11:4
16810214,2024-02-10 17:00:00,Karakhanyan Mher - Arutyunov Ruben,3:0,5:11 - 7:11 - 6:11 - 0:0 - 0:0,0,3,Karakhanyan Mher,Arutyunov Ruben,fiurst,Arutyunov Ruben - Karakhanyan Mher,51,33,18,-15,15,16,18,17,0,0,-6,-4,-5,0,0,-15,11:5 - 11:7 - 11:6 - 0:0 - 0:0
16810212,2024-02-10 16:50:00,Gevorgyan Gegham - Grigoryan Erik,3:0,11:5 - 11:2 - 11:8 - 0:0 - 0:0,3,0,Gevorgyan Gegham,Grigoryan Erik,fiurst,Gevorgyan Gegham - Grigoryan Erik,48,33,15,-18,18,16,13,19,0,0,-6,-9,-3,0,0,-18,11:5 - 11:2 - 11:8 - 0:0 - 0:0
16810210,2024-02-10 16:30:00,Gevorgyan Hayk - Karakhanyan Mher,3:0,11:6 - 11:7 - 11:7 - 0:0 - 0:0,3,0,Gevorgyan Hayk,Karakhanyan Mher,fiurst,Gevorgyan Hayk - Karakhanyan Mher,53,33,20,-13,13,17,18,18,0,0,-5,-4,-4,0,0,-13,11:6 - 11:7 - 11:7 - 0:0 - 0:0
16810203,2024-02-10 16:20:00,Arutyunov Ruben - Grigoryan Erik,3:0,15:13 - 11:1 - 11:4 - 0:0 - 0:0,3,0,Arutyunov Ruben,Grigoryan Erik,fiurst,Arutyunov Ruben - Grigoryan Erik,55,37,18,-19,19,28,12,15,0,0,-2,-10,-7,0,0,-19,15:13 - 11:1 - 11:4 - 0:0 - 0:0
16810197,2024-02-10 16:00:00,Gevorgyan Gegham - Gevorgyan Hayk,0:3,8:11 - 8:11 - 2:11 - 0:0 - 0:0,0,3,Gevorgyan Gegham,Gevorgyan Hayk,fiurst,Gevorgyan Gegham - Gevorgyan Hayk,51,18,33,15,-15,19,19,13,0,0,3,3,9,0,0,15,8:11 - 8:11 - 2:11 - 0:0 - 0:0
16810196,2024-02-10 15:50:00,Grigoryan Erik - Karakhanyan Mher,3:1,7:11 - 16:14 - 11:4 - 11:7 - 0:0,3,1,Grigoryan Erik,Karakhanyan Mher,fiurst,Grigoryan Erik - Karakhanyan Mher,81,45,36,-9,9,18,30,15,18,0,4,-2,-7,-4,0,-9,7:11 - 16:14 - 11:4 - 11:7 - 0:0
16810193,2024-02-10 15:30:00,Arutyunov Ruben - Gevorgyan Gegham,3:1,11:6 - 11:4 - 12:14 - 11:7 - 0:0,3,1,Arutyunov Ruben,Gevorgyan Gegham,fiurst,Arutyunov Ruben - Gevorgyan Gegham,76,45,31,-14,14,17,15,26,18,0,-5,-7,2,-4,0,-14,11:6 - 11:4 - 12:14 - 11:7 - 0:0
16810178,2024-02-10 15:25:00,Papyan Karen - Nikoghosyan Narek,1:3,11:6 - 10:12 - 11:7 - 11:9 - 0:0,3,1,Papyan Karen,Nikoghosyan Narek,fiurst,Nikoghosyan Narek - Papyan Karen,77,34,43,9,-9,17,22,18,20,0,5,-2,4,2,0,9,6:11 - 12:10 - 7:11 - 9:11 - 0:0
16810174,2024-02-10 15:00:00,Nazaryan Mushegh - Soghomonyan Hrayr,3:0,13:11 - 12:10 - 11:9 - 0:0 - 0:0,3,0,Nazaryan Mushegh,Soghomonyan Hrayr,fiurst,Nazaryan Mushegh - Soghomonyan Hrayr,66,36,30,-6,6,24,22,20,0,0,-2,-2,-2,0,0,-6,13:11 - 12:10 - 11:9 - 0:0 - 0:0
16810171,2024-02-10 14:45:00,Rafayelyan Edgar - Papyan Karen,2:3,12:14 - 8:11 - 11:7 - 11:6 - 11:8,3,2,Rafayelyan Edgar,Papyan Karen,fiurst,Papyan Karen - Rafayelyan Edgar,99,46,53,7,-7,26,19,18,17,19,-2,-3,4,5,3,7,14:12 - 11:8 - 7:11 - 6:11 - 8:11
16810170,2024-02-10 14:35:00,Nikoghosyan Narek - Nazaryan Mushegh,1:3,6:11 - 11:7 - 11:8 - 11:9 - 0:0,3,1,Nikoghosyan Narek,Nazaryan Mushegh,fiurst,Nazaryan Mushegh - Nikoghosyan Narek,74,35,39,4,-4,17,18,19,20,0,-5,4,3,2,0,4,11:6 - 7:11 - 8:11 - 9:11 - 0:0
16810169,2024-02-10 14:15:00,Rafayelyan Edgar - Soghomonyan Hrayr,3:0,11:3 - 11:5 - 11:7 - 0:0 - 0:0,3,0,Rafayelyan Edgar,Soghomonyan Hrayr,fiurst,Rafayelyan Edgar - Soghomonyan Hrayr,48,33,15,-18,18,14,16,18,0,0,-8,-6,-4,0,0,-18,11:3 - 11:5 - 11:7 - 0:0 - 0:0
16810167,2024-02-10 14:05:00,Papyan Karen - Nazaryan Mushegh,3:1,3:11 - 11:8 - 7:11 - 5:11 - 0:0,1,3,Papyan Karen,Nazaryan Mushegh,fiurst,Nazaryan Mushegh - Papyan Karen,67,41,26,-15,15,14,19,18,16,0,-8,3,-4,-6,0,-15,11:3 - 8:11 - 11:7 - 11:5 - 0:0
16810156,2024-02-10 13:45:00,Nikoghosyan Narek - Rafayelyan Edgar,1:3,7:11 - 11:13 - 11:5 - 11:13 - 0:0,1,3,Nikoghosyan Narek,Rafayelyan Edgar,fiurst,Nikoghosyan Narek - Rafayelyan Edgar,82,40,42,2,-2,18,24,16,24,0,4,2,-6,2,0,2,7:11 - 11:13 - 11:5 - 11:13 - 0:0
16810155,2024-02-10 13:30:00,Soghomonyan Hrayr - Papyan Karen,3:2,5:11 - 11:9 - 7:11 - 11:6 - 9:11,2,3,Soghomonyan Hrayr,Papyan Karen,fiurst,Papyan Karen - Soghomonyan Hrayr,91,48,43,-5,5,16,20,18,17,20,-6,2,-4,5,-2,-5,11:5 - 9:11 - 11:7 - 6:11 - 11:9
16810154,2024-02-10 13:15:00,Nazaryan Mushegh - Rafayelyan Edgar,1:3,4:11 - 8:11 - 11:9 - 3:11 - 0:0,1,3,Nazaryan Mushegh,Rafayelyan Edgar,fiurst,Nazaryan Mushegh - Rafayelyan Edgar,68,26,42,16,-16,15,19,20,14,0,7,3,-2,8,0,16,4:11 - 8:11 - 11:9 - 3:11 - 0:0
16810152,2024-02-10 13:00:00,Soghomonyan Hrayr - Nikoghosyan Narek,3:0,8:11 - 9:11 - 5:11 - 0:0 - 0:0,0,3,Soghomonyan Hrayr,Nikoghosyan Narek,fiurst,Nikoghosyan Narek - Soghomonyan Hrayr,55,33,22,-11,11,19,20,16,0,0,-3,-2,-6,0,0,-11,11:8 - 11:9 - 11:5 - 0:0 - 0:0
16786413,2024-02-10 12:15:00,Papyan Karen - Rafayelyan Edgar,3:2,11:9 - 10:12 - 3:11 - 11:7 - 11:6,3,2,Papyan Karen,Rafayelyan Edgar,fiurst,Papyan Karen - Rafayelyan Edgar,91,46,45,-1,1,20,22,14,18,17,-2,2,8,-4,-5,-1,11:9 - 10:12 - 3:11 - 11:7 - 11:6
16786411,2024-02-10 12:00:00,Soghomonyan Hrayr - Nazaryan Mushegh,0:3,11:7 - 11:8 - 11:8 - 0:0 - 0:0,3,0,Soghomonyan Hrayr,Nazaryan Mushegh,fiurst,Nazaryan Mushegh - Soghomonyan Hrayr,56,23,33,10,-10,18,19,19,0,0,4,3,3,0,0,10,7:11 - 8:11 - 8:11 - 0:0 - 0:0
16786404,2024-02-10 11:45:00,Nikoghosyan Narek - Papyan Karen,0:3,11:13 - 12:14 - 10:12 - 0:0 - 0:0,0,3,Nikoghosyan Narek,Papyan Karen,fiurst,Nikoghosyan Narek - Papyan Karen,72,33,39,6,-6,24,26,22,0,0,2,2,2,0,0,6,11:13 - 12:14 - 10:12 - 0:0 - 0:0
16786398,2024-02-10 11:30:00,Soghomonyan Hrayr - Rafayelyan Edgar,3:1,11:9 - 6:11 - 6:11 - 10:12 - 0:0,1,3,Soghomonyan Hrayr,Rafayelyan Edgar,fiurst,Rafayelyan Edgar - Soghomonyan Hrayr,76,43,33,-10,10,20,17,17,22,0,2,-5,-5,-2,0,-10,9:11 - 11:6 - 11:6 - 12:10 - 0:0
16786397,2024-02-10 11:15:00,Nazaryan Mushegh - Nikoghosyan Narek,1:3,5:11 - 6:11 - 11:9 - 6:11 - 0:0,1,3,Nazaryan Mushegh,Nikoghosyan Narek,fiurst,Nazaryan Mushegh - Nikoghosyan Narek,70,28,42,14,-14,16,17,20,17,0,6,5,-2,5,0,14,5:11 - 6:11 - 11:9 - 6:11 - 0:0
16786383,2024-02-10 11:10:00,Papyan Karen - Soghomonyan Hrayr,3:1,12:10 - 11:6 - 6:11 - 11:6 - 0:0,3,1,Papyan Karen,Soghomonyan Hrayr,fiurst,Papyan Karen - Soghomonyan Hrayr,73,40,33,-7,7,22,17,17,17,0,-2,-5,5,-5,0,-7,12:10 - 11:6 - 6:11 - 11:6 - 0:0
16786371,2024-02-10 10:45:00,Rafayelyan Edgar - Nikoghosyan Narek,0:3,11:7 - 11:5 - 12:10 - 0:0 - 0:0,3,0,Rafayelyan Edgar,Nikoghosyan Narek,fiurst,Nikoghosyan Narek - Rafayelyan Edgar,56,22,34,12,-12,18,16,22,0,0,4,6,2,0,0,12,7:11 - 5:11 - 10:12 - 0:0 - 0:0
16786369,2024-02-10 10:35:00,Nazaryan Mushegh - Papyan Karen,1:3,7:11 - 11:7 - 9:11 - 8:11 - 0:0,1,3,Nazaryan Mushegh,Papyan Karen,fiurst,Nazaryan Mushegh - Papyan Karen,75,35,40,5,-5,18,18,20,19,0,4,-4,2,3,0,5,7:11 - 11:7 - 9:11 - 8:11 - 0:0
16786361,2024-02-10 10:15:00,Nikoghosyan Narek - Soghomonyan Hrayr,3:0,11:8 - 11:5 - 11:5 - 0:0 - 0:0,3,0,Nikoghosyan Narek,Soghomonyan Hrayr,fiurst,Nikoghosyan Narek - Soghomonyan Hrayr,51,33,18,-15,15,19,16,16,0,0,-3,-6,-6,0,0,-15,11:8 - 11:5 - 11:5 - 0:0 - 0:0
16786360,2024-02-10 10:00:00,Rafayelyan Edgar - Nazaryan Mushegh,1:3,11:5 - 8:11 - 11:8 - 12:10 - 0:0,3,1,Rafayelyan Edgar,Nazaryan Mushegh,fiurst,Nazaryan Mushegh - Rafayelyan Edgar,76,34,42,8,-8,16,19,19,22,0,6,-3,3,2,0,8,5:11 - 11:8 - 8:11 - 10:12 - 0:0
16786346,2024-02-09 17:50:00,Karakhanyan Mher - Gevorgyan Gegham,1:3,11:7 - 11:6 - 8:11 - 11:8 - 0:0,3,1,Karakhanyan Mher,Gevorgyan Gegham,fiurst,Gevorgyan Gegham - Karakhanyan Mher,73,32,41,9,-9,18,17,19,19,0,4,5,-3,3,0,9,7:11 - 6:11 - 11:8 - 8:11 - 0:0
16786315,2024-02-09 17:30:00,Petrosyan Davit - Avakimyan Davit,3:0,7:11 - 8:11 - 7:11 - 0:0 - 0:0,0,3,Petrosyan Davit,Avakimyan Davit,fiurst,Avakimyan Davit - Petrosyan Davit,55,33,22,-11,11,18,19,18,0,0,-4,-3,-4,0,0,-11,11:7 - 11:8 - 11:7 - 0:0 - 0:0
16786310,2024-02-09 17:15:00,Arutyunov Ruben - Karakhanyan Mher,3:1,11:6 - 8:11 - 11:5 - 11:3 - 0:0,3,1,Arutyunov Ruben,Karakhanyan Mher,fiurst,Arutyunov Ruben - Karakhanyan Mher,66,41,25,-16,16,17,19,16,14,0,-5,3,-6,-8,0,-16,11:6 - 8:11 - 11:5 - 11:3 - 0:0
16786287,2024-02-09 17:00:00,Petrosyan Davit - Gevorgyan Gegham,0:3,11:9 - 11:3 - 11:4 - 0:0 - 0:0,3,0,Petrosyan Davit,Gevorgyan Gegham,fiurst,Gevorgyan Gegham - Petrosyan Davit,49,16,33,17,-17,20,14,15,0,0,2,8,7,0,0,17,9:11 - 3:11 - 4:11 - 0:0 - 0:0
16786280,2024-02-09 16:45:00,Avakimyan Davit - Arutyunov Ruben,3:0,5:11 - 6:11 - 3:11 - 0:0 - 0:0,0,3,Avakimyan Davit,Arutyunov Ruben,fiurst,Arutyunov Ruben - Avakimyan Davit,47,33,14,-19,19,16,17,14,0,0,-6,-5,-8,0,0,-19,11:5 - 11:6 - 11:3 - 0:0 - 0:0
16786271,2024-02-09 16:30:00,Karakhanyan Mher - Petrosyan Davit,0:3,6:11 - 8:11 - 6:11 - 0:0 - 0:0,0,3,Karakhanyan Mher,Petrosyan Davit,fiurst,Karakhanyan Mher - Petrosyan Davit,53,20,33,13,-13,17,19,17,0,0,5,3,5,0,0,13,6:11 - 8:11 - 6:11 - 0:0 - 0:0
16786268,2024-02-09 16:15:00,Gevorgyan Gegham - Arutyunov Ruben,3:0,6:11 - 7:11 - 4:11 - 0:0 - 0:0,0,3,Gevorgyan Gegham,Arutyunov Ruben,fiurst,Arutyunov Ruben - Gevorgyan Gegham,50,33,17,-16,16,17,18,15,0,0,-5,-4,-7,0,0,-16,11:6 - 11:7 - 11:4 - 0:0 - 0:0
16786253,2024-02-09 16:00:00,Avakimyan Davit - Karakhanyan Mher,3:0,11:6 - 11:4 - 11:6 - 0:0 - 0:0,3,0,Avakimyan Davit,Karakhanyan Mher,fiurst,Avakimyan Davit - Karakhanyan Mher,49,33,16,-17,17,17,15,17,0,0,-5,-7,-5,0,0,-17,11:6 - 11:4 - 11:6 - 0:0 - 0:0
16786251,2024-02-09 15:45:00,Arutyunov Ruben - Petrosyan Davit,3:0,11:3 - 11:7 - 11:9 - 0:0 - 0:0,3,0,Arutyunov Ruben,Petrosyan Davit,fiurst,Arutyunov Ruben - Petrosyan Davit,52,33,19,-14,14,14,18,20,0,0,-8,-4,-2,0,0,-14,11:3 - 11:7 - 11:9 - 0:0 - 0:0
16786239,2024-02-09 15:30:00,Gevorgyan Gegham - Avakimyan Davit,2:3,11:6 - 7:11 - 8:11 - 11:9 - 11:9,3,2,Gevorgyan Gegham,Avakimyan Davit,fiurst,Avakimyan Davit - Gevorgyan Gegham,94,46,48,2,-2,17,18,19,20,20,5,-4,-3,2,2,2,6:11 - 11:7 - 11:8 - 9:11 - 9:11
16797749,2024-02-09 15:20:00,Nazaryan Mushegh - Diaryan Aleksandr,3:0,5:11 - 4:11 - 4:11 - 0:0 - 0:0,0,3,Nazaryan Mushegh,Diaryan Aleksandr,fiurst,Diaryan Aleksandr - Nazaryan Mushegh,46,33,13,-20,20,16,15,15,0,0,-6,-7,-7,0,0,-20,11:5 - 11:4 - 11:4 - 0:0 - 0:0
16797731,2024-02-09 14:55:00,Papyan Karen - Nazaryan Mushegh,3:2,11:9 - 11:9 - 10:12 - 4:11 - 11:13,2,3,Papyan Karen,Nazaryan Mushegh,fiurst,Nazaryan Mushegh - Papyan Karen,101,54,47,-7,7,20,20,22,15,24,2,2,-2,-7,-2,-7,9:11 - 9:11 - 12:10 - 11:4 - 13:11
16797724,2024-02-09 14:15:00,Papyan Karen - Rafayelyan Edgar,1:3,9:11 - 10:12 - 17:15 - 10:12 - 0:0,1,3,Papyan Karen,Rafayelyan Edgar,fiurst,Papyan Karen - Rafayelyan Edgar,96,46,50,4,-4,20,22,32,22,0,2,2,-2,2,0,4,9:11 - 10:12 - 17:15 - 10:12 - 0:0
16797709,2024-02-09 13:45:00,Diaryan Aleksandr - Papyan Karen,3:1,11:13 - 11:5 - 11:6 - 11:3 - 0:0,3,1,Diaryan Aleksandr,Papyan Karen,fiurst,Diaryan Aleksandr - Papyan Karen,71,44,27,-17,17,24,16,17,14,0,2,-6,-5,-8,0,-17,11:13 - 11:5 - 11:6 - 11:3 - 0:0
16797706,2024-02-09 13:30:00,Rafayelyan Edgar - Nazaryan Mushegh,3:1,7:11 - 10:12 - 11:2 - 9:11 - 0:0,1,3,Rafayelyan Edgar,Nazaryan Mushegh,fiurst,Nazaryan Mushegh - Rafayelyan Edgar,73,36,37,1,-1,18,22,13,20,0,-4,-2,9,-2,0,1,11:7 - 12:10 - 2:11 - 11:9 - 0:0
16797700,2024-02-09 13:00:00,Rafayelyan Edgar - Diaryan Aleksandr,0:3,16:14 - 11:7 - 11:6 - 0:0 - 0:0,3,0,Rafayelyan Edgar,Diaryan Aleksandr,fiurst,Diaryan Aleksandr - Rafayelyan Edgar,65,27,38,11,-11,30,18,17,0,0,2,4,5,0,0,11,14:16 - 7:11 - 6:11 - 0:0 - 0:0
16786492,2024-02-09 12:15:00,Nazaryan Mushegh - Papyan Karen,2:3,11:8 - 11:9 - 8:11 - 9:11 - 7:11,2,3,Nazaryan Mushegh,Papyan Karen,fiurst,Nazaryan Mushegh - Papyan Karen,96,46,50,4,-4,19,20,19,20,18,-3,-2,3,2,4,4,11:8 - 11:9 - 8:11 - 9:11 - 7:11
16786489,2024-02-09 12:00:00,Rafayelyan Edgar - Mkrtchyan Andranik,0:3,11:3 - 11:5 - 11:3 - 0:0 - 0:0,3,0,Rafayelyan Edgar,Mkrtchyan Andranik,fiurst,Mkrtchyan Andranik - Rafayelyan Edgar,44,11,33,22,-22,14,16,14,0,0,8,6,8,0,0,22,3:11 - 5:11 - 3:11 - 0:0 - 0:0
16786484,2024-02-09 11:45:00,Diaryan Aleksandr - Nazaryan Mushegh,3:0,12:10 - 11:7 - 18:16 - 0:0 - 0:0,3,0,Diaryan Aleksandr,Nazaryan Mushegh,fiurst,Diaryan Aleksandr - Nazaryan Mushegh,74,41,33,-8,8,22,18,34,0,0,-2,-4,-2,0,0,-8,12:10 - 11:7 - 18:16 - 0:0 - 0:0
16786483,2024-02-09 11:40:00,Rafayelyan Edgar - Papyan Karen,1:3,11:6 - 7:11 - 11:5 - 11:1 - 0:0,3,1,Rafayelyan Edgar,Papyan Karen,fiurst,Papyan Karen - Rafayelyan Edgar,63,23,40,17,-17,17,18,16,12,0,5,-4,6,10,0,17,6:11 - 11:7 - 5:11 - 1:11 - 0:0
16786482,2024-02-09 11:15:00,Mkrtchyan Andranik - Diaryan Aleksandr,3:0,3:11 - 5:11 - 10:12 - 0:0 - 0:0,0,3,Mkrtchyan Andranik,Diaryan Aleksandr,fiurst,Diaryan Aleksandr - Mkrtchyan Andranik,52,34,18,-16,16,14,16,22,0,0,-8,-6,-2,0,0,-16,11:3 - 11:5 - 12:10 - 0:0 - 0:0
16786466,2024-02-09 11:00:00,Nazaryan Mushegh - Rafayelyan Edgar,2:3,11:8 - 11:5 - 5:11 - 10:12 - 8:11,2,3,Nazaryan Mushegh,Rafayelyan Edgar,fiurst,Nazaryan Mushegh - Rafayelyan Edgar,92,45,47,2,-2,19,16,16,22,19,-3,-6,6,2,3,2,11:8 - 11:5 - 5:11 - 10:12 - 8:11
16786457,2024-02-09 10:45:00,Papyan Karen - Diaryan Aleksandr,3:1,2:11 - 11:8 - 11:13 - 9:11 - 0:0,1,3,Papyan Karen,Diaryan Aleksandr,fiurst,Diaryan Aleksandr - Papyan Karen,76,43,33,-10,10,13,19,24,20,0,-9,3,-2,-2,0,-10,11:2 - 8:11 - 13:11 - 11:9 - 0:0
16786431,2024-02-09 10:15:00,Diaryan Aleksandr - Rafayelyan Edgar,3:1,11:9 - 11:6 - 10:12 - 11:4 - 0:0,3,1,Diaryan Aleksandr,Rafayelyan Edgar,fiurst,Diaryan Aleksandr - Rafayelyan Edgar,74,43,31,-12,12,20,17,22,15,0,-2,-5,2,-7,0,-12,11:9 - 11:6 - 10:12 - 11:4 - 0:0
16786429,2024-02-09 10:00:00,Papyan Karen - Mkrtchyan Andranik,0:0,0:0 - 0:0 - 0:0 - 0:0 - 0:0,0,0,Papyan Karen,Mkrtchyan Andranik,fiurst,Mkrtchyan Andranik - Papyan Karen,0,0,0,0,0,0,0,0,0,0,0,0,0,0,0,0,0:0 - 0:0 - 0:0 - 0:0 - 0:0
16793009,2024-02-08 17:50:00,Diaryan Aleksandr - Rafayelyan Edgar,2:3,9:11 - 9:11 - 12:10 - 13:11 - 10:12,2,3,Diaryan Aleksandr,Rafayelyan Edgar,fiurst,Diaryan Aleksandr - Rafayelyan Edgar,108,53,55,2,-2,20,20,22,24,22,2,2,-2,-2,2,2,9:11 - 9:11 - 12:10 - 13:11 - 10:12
16777490,2024-02-08 17:40:00,Rafayelyan Edgar - Diaryan Aleksandr,0:0,0:0 - 0:0 - 0:0 - 0:0 - 0:0,0,0,Rafayelyan Edgar,Diaryan Aleksandr,fiurst,Diaryan Aleksandr - Rafayelyan Edgar,0,0,0,0,0,0,0,0,0,0,0,0,0,0,0,0,0:0 - 0:0 - 0:0 - 0:0 - 0:0
16777488,2024-02-08 17:35:00,Nikoghosyan Narek - Soghomonyan Hrayr,3:0,11:7 - 11:4 - 11:4 - 0:0 - 0:0,3,0,Nikoghosyan Narek,Soghomonyan Hrayr,fiurst,Nikoghosyan Narek - Soghomonyan Hrayr,48,33,15,-18,18,18,15,15,0,0,-4,-7,-7,0,0,-18,11:7 - 11:4 - 11:4 - 0:0 - 0:0
16777487,2024-02-08 17:20:00,Papyan Karen - Rafayelyan Edgar,2:3,11:4 - 4:11 - 11:9 - 7:11 - 3:11,2,3,Papyan Karen,Rafayelyan Edgar,fiurst,Papyan Karen - Rafayelyan Edgar,82,36,46,10,-10,15,15,20,18,14,-7,7,-2,4,8,10,11:4 - 4:11 - 11:9 - 7:11 - 3:11
16777474,2024-02-08 17:00:00,Nikoghosyan Narek - Diaryan Aleksandr,3:0,10:12 - 4:11 - 8:11 - 0:0 - 0:0,0,3,Nikoghosyan Narek,Diaryan Aleksandr,fiurst,Diaryan Aleksandr - Nikoghosyan Narek,56,34,22,-12,12,22,15,19,0,0,-2,-7,-3,0,0,-12,12:10 - 11:4 - 11:8 - 0:0 - 0:0
16777472,2024-02-08 16:45:00,Soghomonyan Hrayr - Papyan Karen,3:2,11:7 - 5:11 - 6:11 - 12:10 - 11:13,2,3,Soghomonyan Hrayr,Papyan Karen,fiurst,Papyan Karen - Soghomonyan Hrayr,97,52,45,-7,7,18,16,17,22,24,4,-6,-5,2,-2,-7,7:11 - 11:5 - 11:6 - 10:12 - 13:11
16777470,2024-02-08 16:30:00,Rafayelyan Edgar - Nikoghosyan Narek,3:2,5:11 - 6:11 - 11:5 - 11:8 - 4:11,2,3,Rafayelyan Edgar,Nikoghosyan Narek,fiurst,Nikoghosyan Narek - Rafayelyan Edgar,83,46,37,-9,9,16,17,16,19,15,-6,-5,6,3,-7,-9,11:5 - 11:6 - 5:11 - 8:11 - 11:4
16777466,2024-02-08 16:15:00,Diaryan Aleksandr - Papyan Karen,0:3,11:13 - 11:13 - 11:13 - 0:0 - 0:0,0,3,Diaryan Aleksandr,Papyan Karen,fiurst,Diaryan Aleksandr - Papyan Karen,72,33,39,6,-6,24,24,24,0,0,2,2,2,0,0,6,11:13 - 11:13 - 11:13 - 0:0 - 0:0
16777456,2024-02-08 16:00:00,Soghomonyan Hrayr - Rafayelyan Edgar,3:0,8:11 - 5:11 - 3:11 - 0:0 - 0:0,0,3,Soghomonyan Hrayr,Rafayelyan Edgar,fiurst,Rafayelyan Edgar - Soghomonyan Hrayr,49,33,16,-17,17,19,16,14,0,0,-3,-6,-8,0,0,-17,11:8 - 11:5 - 11:3 - 0:0 - 0:0
16777455,2024-02-08 15:45:00,Papyan Karen - Nikoghosyan Narek,0:3,11:8 - 12:10 - 11:8 - 0:0 - 0:0,3,0,Papyan Karen,Nikoghosyan Narek,fiurst,Nikoghosyan Narek - Papyan Karen,60,26,34,8,-8,19,22,19,0,0,3,2,3,0,0,8,8:11 - 10:12 - 8:11 - 0:0 - 0:0
16777454,2024-02-08 15:30:00,Diaryan Aleksandr - Soghomonyan Hrayr,3:1,11:8 - 11:5 - 9:11 - 11:3 - 0:0,3,1,Diaryan Aleksandr,Soghomonyan Hrayr,fiurst,Diaryan Aleksandr - Soghomonyan Hrayr,69,42,27,-15,15,19,16,20,14,0,-3,-6,2,-8,0,-15,11:8 - 11:5 - 9:11 - 11:3 - 0:0
16777453,2024-02-08 15:15:00,Avakimyan Davit - Gevorgyan Gegham,3:0,11:8 - 11:3 - 11:8 - 0:0 - 0:0,3,0,Avakimyan Davit,Gevorgyan Gegham,fiurst,Avakimyan Davit - Gevorgyan Gegham,52,33,19,-14,14,19,14,19,0,0,-3,-8,-3,0,0,-14,11:8 - 11:3 - 11:8 - 0:0 - 0:0
16777442,2024-02-08 15:00:00,Grigoryan Erik - Arutyunov Ruben,3:1,6:11 - 11:9 - 4:11 - 4:11 - 0:0,1,3,Grigoryan Erik,Arutyunov Ruben,fiurst,Arutyunov Ruben - Grigoryan Erik,67,42,25,-17,17,17,20,15,15,0,-5,2,-7,-7,0,-17,11:6 - 9:11 - 11:4 - 11:4 - 0:0
16777440,2024-02-08 14:45:00,Petrosyan Davit - Avakimyan Davit,1:3,5:11 - 11:9 - 11:9 - 11:8 - 0:0,3,1,Petrosyan Davit,Avakimyan Davit,fiurst,Avakimyan Davit - Petrosyan Davit,75,37,38,1,-1,16,20,20,19,0,-6,2,2,3,0,1,11:5 - 9:11 - 9:11 - 8:11 - 0:0
16777439,2024-02-08 14:30:00,Gevorgyan Gegham - Grigoryan Erik,3:1,7:11 - 11:4 - 11:6 - 11:6 - 0:0,3,1,Gevorgyan Gegham,Grigoryan Erik,fiurst,Gevorgyan Gegham - Grigoryan Erik,67,40,27,-13,13,18,15,17,17,0,4,-7,-5,-5,0,-13,7:11 - 11:4 - 11:6 - 11:6 - 0:0
16777436,2024-02-08 14:15:00,Petrosyan Davit - Arutyunov Ruben,3:1,6:11 - 11:8 - 10:12 - 2:11 - 0:0,1,3,Petrosyan Davit,Arutyunov Ruben,fiurst,Arutyunov Ruben - Petrosyan Davit,71,42,29,-13,13,17,19,22,13,0,-5,3,-2,-9,0,-13,11:6 - 8:11 - 12:10 - 11:2 - 0:0
16777434,2024-02-08 14:00:00,Avakimyan Davit - Grigoryan Erik,3:0,11:7 - 11:5 - 11:9 - 0:0 - 0:0,3,0,Avakimyan Davit,Grigoryan Erik,fiurst,Avakimyan Davit - Grigoryan Erik,54,33,21,-12,12,18,16,20,0,0,-4,-6,-2,0,0,-12,11:7 - 11:5 - 11:9 - 0:0 - 0:0
16777432,2024-02-08 13:45:00,Gevorgyan Gegham - Petrosyan Davit,0:3,7:11 - 7:11 - 6:11 - 0:0 - 0:0,0,3,Gevorgyan Gegham,Petrosyan Davit,fiurst,Gevorgyan Gegham - Petrosyan Davit,53,20,33,13,-13,18,18,17,0,0,4,4,5,0,0,13,7:11 - 7:11 - 6:11 - 0:0 - 0:0
16777431,2024-02-08 13:30:00,Arutyunov Ruben - Avakimyan Davit,3:0,11:6 - 11:6 - 11:5 - 0:0 - 0:0,3,0,Arutyunov Ruben,Avakimyan Davit,fiurst,Arutyunov Ruben - Avakimyan Davit,50,33,17,-16,16,17,17,16,0,0,-5,-5,-6,0,0,-16,11:6 - 11:6 - 11:5 - 0:0 - 0:0
16777429,2024-02-08 13:15:00,Grigoryan Erik - Petrosyan Davit,3:2,3:11 - 11:6 - 4:11 - 11:9 - 11:7,3,2,Grigoryan Erik,Petrosyan Davit,fiurst,Grigoryan Erik - Petrosyan Davit,84,40,44,4,-4,14,17,15,20,18,8,-5,7,-2,-4,4,3:11 - 11:6 - 4:11 - 11:9 - 11:7
16777425,2024-02-08 13:00:00,Arutyunov Ruben - Gevorgyan Gegham,3:0,11:6 - 11:5 - 11:4 - 0:0 - 0:0,3,0,Arutyunov Ruben,Gevorgyan Gegham,fiurst,Arutyunov Ruben - Gevorgyan Gegham,48,33,15,-18,18,17,16,15,0,0,-5,-6,-7,0,0,-18,11:6 - 11:5 - 11:4 - 0:0 - 0:0
16777424,2024-02-08 12:40:00,Avakimyan Davit - Petrosyan Davit,3:2,9:11 - 9:11 - 11:8 - 11:9 - 11:8,3,2,Avakimyan Davit,Petrosyan Davit,fiurst,Avakimyan Davit - Petrosyan Davit,98,51,47,-4,4,20,20,19,20,19,2,2,-3,-2,-3,-4,9:11 - 9:11 - 11:8 - 11:9 - 11:8
16777411,2024-02-08 12:05:00,Gevorgyan Gegham - Avakimyan Davit,3:2,11:9 - 3:11 - 7:11 - 11:5 - 6:11,2,3,Gevorgyan Gegham,Avakimyan Davit,fiurst,Avakimyan Davit - Gevorgyan Gegham,85,47,38,-9,9,20,14,18,16,17,2,-8,-4,6,-5,-9,9:11 - 11:3 - 11:7 - 5:11 - 11:6
16777412,2024-02-08 12:00:00,Arutyunov Ruben - Grigoryan Erik,3:2,11:5 - 13:11 - 9:11 - 9:11 - 11:8,3,2,Arutyunov Ruben,Grigoryan Erik,fiurst,Arutyunov Ruben - Grigoryan Erik,99,53,46,-7,7,16,24,20,20,19,-6,-2,2,2,-3,-7,11:5 - 13:11 - 9:11 - 9:11 - 11:8
16777410,2024-02-08 11:30:00,Arutyunov Ruben - Petrosyan Davit,3:0,11:7 - 11:6 - 11:3 - 0:0 - 0:0,3,0,Arutyunov Ruben,Petrosyan Davit,fiurst,Arutyunov Ruben - Petrosyan Davit,49,33,16,-17,17,18,17,14,0,0,-4,-5,-8,0,0,-17,11:7 - 11:6 - 11:3 - 0:0 - 0:0
16777409,2024-02-08 11:25:00,Grigoryan Erik - Gevorgyan Gegham,3:2,11:1 - 8:11 - 16:14 - 5:11 - 9:11,2,3,Grigoryan Erik,Gevorgyan Gegham,fiurst,Gevorgyan Gegham - Grigoryan Erik,97,48,49,1,-1,12,19,30,16,20,10,-3,2,-6,-2,1,1:11 - 11:8 - 14:16 - 11:5 - 11:9
16777406,2024-02-08 11:00:00,Avakimyan Davit - Arutyunov Ruben,3:0,6:11 - 7:11 - 7:11 - 0:0 - 0:0,0,3,Avakimyan Davit,Arutyunov Ruben,fiurst,Arutyunov Ruben - Avakimyan Davit,53,33,20,-13,13,17,18,18,0,0,-5,-4,-4,0,0,-13,11:6 - 11:7 - 11:7 - 0:0 - 0:0
16777404,2024-02-08 10:50:00,Petrosyan Davit - Gevorgyan Gegham,1:3,12:10 - 12:10 - 9:11 - 11:9 - 0:0,3,1,Petrosyan Davit,Gevorgyan Gegham,fiurst,Gevorgyan Gegham - Petrosyan Davit,84,40,44,4,-4,22,22,20,20,0,2,2,-2,2,0,4,10:12 - 10:12 - 11:9 - 9:11 - 0:0
16777403,2024-02-08 10:30:00,Grigoryan Erik - Avakimyan Davit,3:0,6:11 - 8:11 - 6:11 - 0:0 - 0:0,0,3,Grigoryan Erik,Avakimyan Davit,fiurst,Avakimyan Davit - Grigoryan Erik,53,33,20,-13,13,17,19,17,0,0,-5,-3,-5,0,0,-13,11:6 - 11:8 - 11:6 - 0:0 - 0:0
16777400,2024-02-08 10:15:00,Gevorgyan Gegham - Arutyunov Ruben,2:3,8:11 - 11:9 - 9:11 - 11:9 - 11:8,3,2,Gevorgyan Gegham,Arutyunov Ruben,fiurst,Arutyunov Ruben - Gevorgyan Gegham,98,48,50,2,-2,19,20,20,20,19,-3,2,-2,2,3,2,11:8 - 9:11 - 11:9 - 9:11 - 8:11
16777388,2024-02-08 10:00:00,Petrosyan Davit - Grigoryan Erik,1:3,11:6 - 8:11 - 11:9 - 11:5 - 0:0,3,1,Petrosyan Davit,Grigoryan Erik,fiurst,Grigoryan Erik - Petrosyan Davit,72,31,41,10,-10,17,19,20,16,0,5,-3,2,6,0,10,6:11 - 11:8 - 9:11 - 5:11 - 0:0
16751694,2024-02-07 20:15:00,Mkrtchyan Andranik - Soghomonyan Hrayr,3:1,11:6 - 10:12 - 11:6 - 11:5 - 0:0,3,1,Mkrtchyan Andranik,Soghomonyan Hrayr,fiurst,Mkrtchyan Andranik - Soghomonyan Hrayr,72,43,29,-14,14,17,22,17,16,0,-5,2,-5,-6,0,-14,11:6 - 10:12 - 11:6 - 11:5 - 0:0
16751692,2024-02-07 20:00:00,Rafayelyan Edgar - Nazaryan Mushegh,0:3,11:6 - 11:6 - 11:2 - 0:0 - 0:0,3,0,Rafayelyan Edgar,Nazaryan Mushegh,fiurst,Nazaryan Mushegh - Rafayelyan Edgar,47,14,33,19,-19,17,17,13,0,0,5,5,9,0,0,19,6:11 - 6:11 - 2:11 - 0:0 - 0:0
16751690,2024-02-07 19:45:00,Nikoghosyan Narek - Mkrtchyan Andranik,0:3,11:2 - 11:7 - 11:4 - 0:0 - 0:0,3,0,Nikoghosyan Narek,Mkrtchyan Andranik,fiurst,Mkrtchyan Andranik - Nikoghosyan Narek,46,13,33,20,-20,13,18,15,0,0,9,4,7,0,0,20,2:11 - 7:11 - 4:11 - 0:0 - 0:0
16751689,2024-02-07 19:30:00,Soghomonyan Hrayr - Rafayelyan Edgar,3:1,6:11 - 12:10 - 7:11 - 6:11 - 0:0,1,3,Soghomonyan Hrayr,Rafayelyan Edgar,fiurst,Rafayelyan Edgar - Soghomonyan Hrayr,74,43,31,-12,12,17,22,18,17,0,-5,2,-4,-5,0,-12,11:6 - 10:12 - 11:7 - 11:6 - 0:0
16751688,2024-02-07 19:15:00,Nikoghosyan Narek - Nazaryan Mushegh,3:0,4:11 - 12:14 - 13:15 - 0:0 - 0:0,0,3,Nikoghosyan Narek,Nazaryan Mushegh,fiurst,Nazaryan Mushegh - Nikoghosyan Narek,69,40,29,-11,11,15,26,28,0,0,-7,-2,-2,0,0,-11,11:4 - 14:12 - 15:13 - 0:0 - 0:0
16751687,2024-02-07 19:05:00,Mkrtchyan Andranik - Rafayelyan Edgar,0:3,7:11 - 5:11 - 9:11 - 0:0 - 0:0,0,3,Mkrtchyan Andranik,Rafayelyan Edgar,fiurst,Mkrtchyan Andranik - Rafayelyan Edgar,54,21,33,12,-12,18,16,20,0,0,4,6,2,0,0,12,7:11 - 5:11 - 9:11 - 0:0 - 0:0
16751669,2024-02-07 18:50:00,Soghomonyan Hrayr - Nikoghosyan Narek,3:1,11:9 - 6:11 - 4:11 - 7:11 - 0:0,1,3,Soghomonyan Hrayr,Nikoghosyan Narek,fiurst,Nikoghosyan Narek - Soghomonyan Hrayr,70,42,28,-14,14,20,17,15,18,0,2,-5,-7,-4,0,-14,9:11 - 11:6 - 11:4 - 11:7 - 0:0
16751665,2024-02-07 18:40:00,Nazaryan Mushegh - Mkrtchyan Andranik,0:3,11:2 - 11:8 - 11:5 - 0:0 - 0:0,3,0,Nazaryan Mushegh,Mkrtchyan Andranik,fiurst,Mkrtchyan Andranik - Nazaryan Mushegh,48,15,33,18,-18,13,19,16,0,0,9,3,6,0,0,18,2:11 - 8:11 - 5:11 - 0:0 - 0:0
16751664,2024-02-07 18:30:00,Rafayelyan Edgar - Nikoghosyan Narek,0:3,13:11 - 11:4 - 11:5 - 0:0 - 0:0,3,0,Rafayelyan Edgar,Nikoghosyan Narek,fiurst,Nikoghosyan Narek - Rafayelyan Edgar,55,20,35,15,-15,24,15,16,0,0,2,7,6,0,0,15,11:13 - 4:11 - 5:11 - 0:0 - 0:0
16751657,2024-02-07 18:10:00,Nazaryan Mushegh - Soghomonyan Hrayr,3:1,11:6 - 11:9 - 5:11 - 11:7 - 0:0,3,1,Nazaryan Mushegh,Soghomonyan Hrayr,fiurst,Nazaryan Mushegh - Soghomonyan Hrayr,71,38,33,-5,5,17,20,16,18,0,-5,-2,6,-4,0,-5,11:6 - 11:9 - 5:11 - 11:7 - 0:0
16751655,2024-02-07 18:00:00,Mkrtchyan Andranik - Nikoghosyan Narek,3:2,11:9 - 11:9 - 5:11 - 9:11 - 11:8,3,2,Mkrtchyan Andranik,Nikoghosyan Narek,fiurst,Mkrtchyan Andranik - Nikoghosyan Narek,95,47,48,1,-1,20,20,16,20,19,-2,-2,6,2,-3,1,11:9 - 11:9 - 5:11 - 9:11 - 11:8
16751652,2024-02-07 17:30:00,Nazaryan Mushegh - Rafayelyan Edgar,2:3,10:12 - 9:11 - 11:7 - 12:10 - 8:11,2,3,Nazaryan Mushegh,Rafayelyan Edgar,fiurst,Nazaryan Mushegh - Rafayelyan Edgar,101,50,51,1,-1,22,20,18,22,19,2,2,-4,-2,3,1,10:12 - 9:11 - 11:7 - 12:10 - 8:11
16751648,2024-02-07 17:20:00,Soghomonyan Hrayr - Mkrtchyan Andranik,3:2,11:5 - 7:11 - 7:11 - 11:5 - 9:11,2,3,Soghomonyan Hrayr,Mkrtchyan Andranik,fiurst,Mkrtchyan Andranik - Soghomonyan Hrayr,88,43,45,2,-2,16,18,18,16,20,6,-4,-4,6,-2,2,5:11 - 11:7 - 11:7 - 5:11 - 11:9
16751637,2024-02-07 17:05:00,Nazaryan Mushegh - Nikoghosyan Narek,0:3,3:11 - 5:11 - 11:13 - 0:0 - 0:0,0,3,Nazaryan Mushegh,Nikoghosyan Narek,fiurst,Nazaryan Mushegh - Nikoghosyan Narek,54,19,35,16,-16,14,16,24,0,0,8,6,2,0,0,16,3:11 - 5:11 - 11:13 - 0:0 - 0:0
16751631,2024-02-07 16:50:00,Rafayelyan Edgar - Soghomonyan Hrayr,3:1,12:10 - 10:12 - 11:2 - 11:7 - 0:0,3,1,Rafayelyan Edgar,Soghomonyan Hrayr,fiurst,Rafayelyan Edgar - Soghomonyan Hrayr,75,44,31,-13,13,22,22,13,18,0,-2,2,-9,-4,0,-13,12:10 - 10:12 - 11:2 - 11:7 - 0:0
16751622,2024-02-07 16:30:00,Mkrtchyan Andranik - Nazaryan Mushegh,2:3,11:9 - 5:11 - 8:11 - 11:9 - 7:11,2,3,Mkrtchyan Andranik,Nazaryan Mushegh,fiurst,Mkrtchyan Andranik - Nazaryan Mushegh,93,42,51,9,-9,20,16,19,20,18,-2,6,3,-2,4,9,11:9 - 5:11 - 8:11 - 11:9 - 7:11
16751618,2024-02-07 16:15:00,Nikoghosyan Narek - Soghomonyan Hrayr,3:1,11:7 - 12:10 - 9:11 - 11:4 - 0:0,3,1,Nikoghosyan Narek,Soghomonyan Hrayr,fiurst,Nikoghosyan Narek - Soghomonyan Hrayr,75,43,32,-11,11,18,22,20,15,0,-4,-2,2,-7,0,-11,11:7 - 12:10 - 9:11 - 11:4 - 0:0
16751610,2024-02-07 16:00:00,Rafayelyan Edgar - Mkrtchyan Andranik,0:3,11:7 - 11:1 - 11:2 - 0:0 - 0:0,3,0,Rafayelyan Edgar,Mkrtchyan Andranik,fiurst,Mkrtchyan Andranik - Rafayelyan Edgar,43,10,33,23,-23,18,12,13,0,0,4,10,9,0,0,23,7:11 - 1:11 - 2:11 - 0:0 - 0:0
16751607,2024-02-07 15:45:00,Soghomonyan Hrayr - Nazaryan Mushegh,3:1,11:6 - 6:11 - 8:11 - 7:11 - 0:0,1,3,Soghomonyan Hrayr,Nazaryan Mushegh,fiurst,Nazaryan Mushegh - Soghomonyan Hrayr,71,39,32,-7,7,17,17,19,18,0,5,-5,-3,-4,0,-7,6:11 - 11:6 - 11:8 - 11:7 - 0:0
16751603,2024-02-07 15:30:00,Nikoghosyan Narek - Rafayelyan Edgar,0:3,11:13 - 9:11 - 7:11 - 0:0 - 0:0,0,3,Nikoghosyan Narek,Rafayelyan Edgar,fiurst,Nikoghosyan Narek - Rafayelyan Edgar,62,27,35,8,-8,24,20,18,0,0,2,2,4,0,0,8,11:13 - 9:11 - 7:11 - 0:0 - 0:0
16755142,2024-02-07 15:15:00,Petrosyan Davit - Gevorgyan Hayk,3:0,2:11 - 6:11 - 6:11 - 0:0 - 0:0,0,3,Petrosyan Davit,Gevorgyan Hayk,fiurst,Gevorgyan Hayk - Petrosyan Davit,47,33,14,-19,19,13,17,17,0,0,-9,-5,-5,0,0,-19,11:2 - 11:6 - 11:6 - 0:0 - 0:0
16755141,2024-02-07 15:00:00,Grigoryan Erik - Avakimyan Davit,3:0,9:11 - 8:11 - 7:11 - 0:0 - 0:0,0,3,Grigoryan Erik,Avakimyan Davit,fiurst,Avakimyan Davit - Grigoryan Erik,57,33,24,-9,9,20,19,18,0,0,-2,-3,-4,0,0,-9,11:9 - 11:8 - 11:7 - 0:0 - 0:0
16755128,2024-02-07 14:45:00,Karakhanyan Mher - Petrosyan Davit,0:3,8:11 - 8:11 - 2:11 - 0:0 - 0:0,0,3,Karakhanyan Mher,Petrosyan Davit,fiurst,Karakhanyan Mher - Petrosyan Davit,51,18,33,15,-15,19,19,13,0,0,3,3,9,0,0,15,8:11 - 8:11 - 2:11 - 0:0 - 0:0
16755123,2024-02-07 14:30:00,Gevorgyan Hayk - Grigoryan Erik,3:0,11:7 - 12:10 - 11:3 - 0:0 - 0:0,3,0,Gevorgyan Hayk,Grigoryan Erik,fiurst,Gevorgyan Hayk - Grigoryan Erik,54,34,20,-14,14,18,22,14,0,0,-4,-2,-8,0,0,-14,11:7 - 12:10 - 11:3 - 0:0 - 0:0
16755122,2024-02-07 14:15:00,Karakhanyan Mher - Avakimyan Davit,3:2,8:11 - 11:8 - 3:11 - 11:5 - 9:11,2,3,Karakhanyan Mher,Avakimyan Davit,fiurst,Avakimyan Davit - Karakhanyan Mher,88,46,42,-4,4,19,19,14,16,20,-3,3,-8,6,-2,-4,11:8 - 8:11 - 11:3 - 5:11 - 11:9
16755111,2024-02-07 14:00:00,Petrosyan Davit - Grigoryan Erik,1:3,8:11 - 11:8 - 11:3 - 11:5 - 0:0,3,1,Petrosyan Davit,Grigoryan Erik,fiurst,Grigoryan Erik - Petrosyan Davit,68,27,41,14,-14,19,19,14,16,0,-3,3,8,6,0,14,11:8 - 8:11 - 3:11 - 5:11 - 0:0
16755108,2024-02-07 13:45:00,Gevorgyan Hayk - Karakhanyan Mher,3:0,11:6 - 11:7 - 11:8 - 0:0 - 0:0,3,0,Gevorgyan Hayk,Karakhanyan Mher,fiurst,Gevorgyan Hayk - Karakhanyan Mher,54,33,21,-12,12,17,18,19,0,0,-5,-4,-3,0,0,-12,11:6 - 11:7 - 11:8 - 0:0 - 0:0
16755107,2024-02-07 13:30:00,Avakimyan Davit - Petrosyan Davit,1:3,13:15 - 11:4 - 5:11 - 7:11 - 0:0,1,3,Avakimyan Davit,Petrosyan Davit,fiurst,Avakimyan Davit - Petrosyan Davit,77,36,41,5,-5,28,15,16,18,0,2,-7,6,4,0,5,13:15 - 11:4 - 5:11 - 7:11 - 0:0
16755103,2024-02-07 13:15:00,Grigoryan Erik - Karakhanyan Mher,1:3,5:11 - 9:11 - 11:7 - 9:11 - 0:0,1,3,Grigoryan Erik,Karakhanyan Mher,fiurst,Grigoryan Erik - Karakhanyan Mher,74,34,40,6,-6,16,20,18,20,0,6,2,-4,2,0,6,5:11 - 9:11 - 11:7 - 9:11 - 0:0
16755102,2024-02-07 13:00:00,Avakimyan Davit - Gevorgyan Hayk,0:3,11:13 - 3:11 - 4:11 - 0:0 - 0:0,0,3,Avakimyan Davit,Gevorgyan Hayk,fiurst,Avakimyan Davit - Gevorgyan Hayk,53,18,35,17,-17,24,14,15,0,0,2,8,7,0,0,17,11:13 - 3:11 - 4:11 - 0:0 - 0:0
16751750,2024-02-07 12:15:00,Petrosyan Davit - Karakhanyan Mher,1:3,11:9 - 11:7 - 10:12 - 11:5 - 0:0,3,1,Petrosyan Davit,Karakhanyan Mher,fiurst,Karakhanyan Mher - Petrosyan Davit,76,33,43,10,-10,20,18,22,16,0,2,4,-2,6,0,10,9:11 - 7:11 - 12:10 - 5:11 - 0:0
16751741,2024-02-07 12:00:00,Avakimyan Davit - Grigoryan Erik,3:0,11:5 - 11:6 - 11:9 - 0:0 - 0:0,3,0,Avakimyan Davit,Grigoryan Erik,fiurst,Avakimyan Davit - Grigoryan Erik,53,33,20,-13,13,16,17,20,0,0,-6,-5,-2,0,0,-13,11:5 - 11:6 - 11:9 - 0:0 - 0:0
16751728,2024-02-07 11:45:00,Gevorgyan Hayk - Petrosyan Davit,3:0,11:2 - 12:10 - 11:7 - 0:0 - 0:0,3,0,Gevorgyan Hayk,Petrosyan Davit,fiurst,Gevorgyan Hayk - Petrosyan Davit,53,34,19,-15,15,13,22,18,0,0,-9,-2,-4,0,0,-15,11:2 - 12:10 - 11:7 - 0:0 - 0:0
16751727,2024-02-07 11:30:00,Avakimyan Davit - Karakhanyan Mher,3:1,12:10 - 11:7 - 9:11 - 11:6 - 0:0,3,1,Avakimyan Davit,Karakhanyan Mher,fiurst,Avakimyan Davit - Karakhanyan Mher,77,43,34,-9,9,22,18,20,17,0,-2,-4,2,-5,0,-9,12:10 - 11:7 - 9:11 - 11:6 - 0:0
16751725,2024-02-07 11:15:00,Grigoryan Erik - Gevorgyan Hayk,3:0,5:11 - 6:11 - 5:11 - 0:0 - 0:0,0,3,Grigoryan Erik,Gevorgyan Hayk,fiurst,Gevorgyan Hayk - Grigoryan Erik,49,33,16,-17,17,16,17,16,0,0,-6,-5,-6,0,0,-17,11:5 - 11:6 - 11:5 - 0:0 - 0:0
16751722,2024-02-07 11:00:00,Petrosyan Davit - Avakimyan Davit,3:0,10:12 - 9:11 - 7:11 - 0:0 - 0:0,0,3,Petrosyan Davit,Avakimyan Davit,fiurst,Avakimyan Davit - Petrosyan Davit,60,34,26,-8,8,22,20,18,0,0,-2,-2,-4,0,0,-8,12:10 - 11:9 - 11:7 - 0:0 - 0:0
16751721,2024-02-07 10:45:00,Karakhanyan Mher - Gevorgyan Hayk,3:0,9:11 - 9:11 - 10:12 - 0:0 - 0:0,0,3,Karakhanyan Mher,Gevorgyan Hayk,fiurst,Gevorgyan Hayk - Karakhanyan Mher,62,34,28,-6,6,20,20,22,0,0,-2,-2,-2,0,0,-6,11:9 - 11:9 - 12:10 - 0:0 - 0:0
16751711,2024-02-07 10:30:00,Grigoryan Erik - Petrosyan Davit,1:3,13:15 - 12:10 - 4:11 - 4:11 - 0:0,1,3,Grigoryan Erik,Petrosyan Davit,fiurst,Grigoryan Erik - Petrosyan Davit,80,33,47,14,-14,28,22,15,15,0,2,-2,7,7,0,14,13:15 - 12:10 - 4:11 - 4:11 - 0:0
16751709,2024-02-07 10:15:00,Gevorgyan Hayk - Avakimyan Davit,0:3,11:6 - 11:3 - 12:10 - 0:0 - 0:0,3,0,Gevorgyan Hayk,Avakimyan Davit,fiurst,Avakimyan Davit - Gevorgyan Hayk,53,19,34,15,-15,17,14,22,0,0,5,8,2,0,0,15,6:11 - 3:11 - 10:12 - 0:0 - 0:0
16751697,2024-02-07 10:00:00,Karakhanyan Mher - Grigoryan Erik,0:3,11:6 - 11:4 - 11:7 - 0:0 - 0:0,3,0,Karakhanyan Mher,Grigoryan Erik,fiurst,Grigoryan Erik - Karakhanyan Mher,50,17,33,16,-16,17,15,18,0,0,5,7,4,0,0,16,6:11 - 4:11 - 7:11 - 0:0 - 0:0
16734106,2024-02-06 17:45:00,Arutyunov Ruben - Gevorgyan Hayk,3:1,11:5 - 11:8 - 6:11 - 11:9 - 0:0,3,1,Arutyunov Ruben,Gevorgyan Hayk,fiurst,Arutyunov Ruben - Gevorgyan Hayk,72,39,33,-6,6,16,19,17,20,0,-6,-3,5,-2,0,-6,11:5 - 11:8 - 6:11 - 11:9 - 0:0
16734096,2024-02-06 17:30:00,Petrosyan Davit - Karakhanyan Mher,0:3,11:4 - 11:7 - 11:4 - 0:0 - 0:0,3,0,Petrosyan Davit,Karakhanyan Mher,fiurst,Karakhanyan Mher - Petrosyan Davit,48,15,33,18,-18,15,18,15,0,0,7,4,7,0,0,18,4:11 - 7:11 - 4:11 - 0:0 - 0:0
16734094,2024-02-06 17:15:00,Avakimyan Davit - Arutyunov Ruben,3:0,0:11 - 2:11 - 4:11 - 0:0 - 0:0,0,3,Avakimyan Davit,Arutyunov Ruben,fiurst,Arutyunov Ruben - Avakimyan Davit,39,33,6,-27,27,11,13,15,0,0,-11,-9,-7,0,0,-27,11:0 - 11:2 - 11:4 - 0:0 - 0:0
16734091,2024-02-06 17:00:00,Petrosyan Davit - Gevorgyan Hayk,2:3,13:11 - 7:11 - 11:7 - 7:11 - 11:8,3,2,Petrosyan Davit,Gevorgyan Hayk,fiurst,Gevorgyan Hayk - Petrosyan Davit,97,48,49,1,-1,24,18,18,18,19,2,-4,4,-4,3,1,11:13 - 11:7 - 7:11 - 11:7 - 8:11
16734090,2024-02-06 16:45:00,Karakhanyan Mher - Avakimyan Davit,3:1,9:11 - 11:5 - 7:11 - 8:11 - 0:0,1,3,Karakhanyan Mher,Avakimyan Davit,fiurst,Avakimyan Davit - Karakhanyan Mher,73,38,35,-3,3,20,16,18,19,0,-2,6,-4,-3,0,-3,11:9 - 5:11 - 11:7 - 11:8 - 0:0
16734074,2024-02-06 16:30:00,Arutyunov Ruben - Petrosyan Davit,3:0,11:7 - 11:1 - 11:6 - 0:0 - 0:0,3,0,Arutyunov Ruben,Petrosyan Davit,fiurst,Arutyunov Ruben - Petrosyan Davit,47,33,14,-19,19,18,12,17,0,0,-4,-10,-5,0,0,-19,11:7 - 11:1 - 11:6 - 0:0 - 0:0
16734072,2024-02-06 16:15:00,Gevorgyan Hayk - Avakimyan Davit,3:0,11:13 - 8:11 - 8:11 - 0:0 - 0:0,0,3,Gevorgyan Hayk,Avakimyan Davit,fiurst,Avakimyan Davit - Gevorgyan Hayk,62,35,27,-8,8,24,19,19,0,0,-2,-3,-3,0,0,-8,13:11 - 11:8 - 11:8 - 0:0 - 0:0
16734070,2024-02-06 16:00:00,Karakhanyan Mher - Arutyunov Ruben,3:1,8:11 - 7:11 - 11:9 - 10:12 - 0:0,1,3,Karakhanyan Mher,Arutyunov Ruben,fiurst,Arutyunov Ruben - Karakhanyan Mher,79,43,36,-7,7,19,18,20,22,0,-3,-4,2,-2,0,-7,11:8 - 11:7 - 9:11 - 12:10 - 0:0
16734069,2024-02-06 15:45:00,Avakimyan Davit - Petrosyan Davit,1:3,8:11 - 11:8 - 4:11 - 1:11 - 0:0,1,3,Avakimyan Davit,Petrosyan Davit,fiurst,Avakimyan Davit - Petrosyan Davit,65,24,41,17,-17,19,19,15,12,0,3,-3,7,10,0,17,8:11 - 11:8 - 4:11 - 1:11 - 0:0
16734056,2024-02-06 15:30:00,Gevorgyan Hayk - Karakhanyan Mher,3:0,11:7 - 11:3 - 11:6 - 0:0 - 0:0,3,0,Gevorgyan Hayk,Karakhanyan Mher,fiurst,Gevorgyan Hayk - Karakhanyan Mher,49,33,16,-17,17,18,14,17,0,0,-4,-8,-5,0,0,-17,11:7 - 11:3 - 11:6 - 0:0 - 0:0
16734053,2024-02-06 15:15:00,Diaryan Aleksandr - Nikoghosyan Narek,3:0,11:5 - 11:7 - 11:7 - 0:0 - 0:0,3,0,Diaryan Aleksandr,Nikoghosyan Narek,fiurst,Diaryan Aleksandr - Nikoghosyan Narek,52,33,19,-14,14,16,18,18,0,0,-6,-4,-4,0,0,-14,11:5 - 11:7 - 11:7 - 0:0 - 0:0
16734032,2024-02-06 15:05:00,Nazaryan Mushegh - Mkrtchyan Andranik,0:3,11:8 - 11:8 - 11:7 - 0:0 - 0:0,3,0,Nazaryan Mushegh,Mkrtchyan Andranik,fiurst,Mkrtchyan Andranik - Nazaryan Mushegh,56,23,33,10,-10,19,19,18,0,0,3,3,4,0,0,10,8:11 - 8:11 - 7:11 - 0:0 - 0:0
16734029,2024-02-06 14:50:00,Papyan Karen - Diaryan Aleksandr,3:0,3:11 - 7:11 - 5:11 - 0:0 - 0:0,0,3,Papyan Karen,Diaryan Aleksandr,fiurst,Diaryan Aleksandr - Papyan Karen,48,33,15,-18,18,14,18,16,0,0,-8,-4,-6,0,0,-18,11:3 - 11:7 - 11:5 - 0:0 - 0:0
16734021,2024-02-06 14:35:00,Nikoghosyan Narek - Nazaryan Mushegh,2:3,11:3 - 7:11 - 9:11 - 11:4 - 11:5,3,2,Nikoghosyan Narek,Nazaryan Mushegh,fiurst,Nazaryan Mushegh - Nikoghosyan Narek,83,34,49,15,-15,14,18,20,15,16,8,-4,-2,7,6,15,3:11 - 11:7 - 11:9 - 4:11 - 5:11
16734016,2024-02-06 14:20:00,Papyan Karen - Mkrtchyan Andranik,0:3,11:5 - 12:10 - 11:8 - 0:0 - 0:0,3,0,Papyan Karen,Mkrtchyan Andranik,fiurst,Mkrtchyan Andranik - Papyan Karen,57,23,34,11,-11,16,22,19,0,0,6,2,3,0,0,11,5:11 - 10:12 - 8:11 - 0:0 - 0:0
16733999,2024-02-06 14:00:00,Diaryan Aleksandr - Nazaryan Mushegh,3:0,11:7 - 11:8 - 11:4 - 0:0 - 0:0,3,0,Diaryan Aleksandr,Nazaryan Mushegh,fiurst,Diaryan Aleksandr - Nazaryan Mushegh,52,33,19,-14,14,18,19,15,0,0,-4,-3,-7,0,0,-14,11:7 - 11:8 - 11:4 - 0:0 - 0:0
16733984,2024-02-06 13:45:00,Nikoghosyan Narek - Papyan Karen,3:1,9:11 - 11:8 - 11:4 - 14:12 - 0:0,3,1,Nikoghosyan Narek,Papyan Karen,fiurst,Nikoghosyan Narek - Papyan Karen,80,45,35,-10,10,20,19,15,26,0,2,-3,-7,-2,0,-10,9:11 - 11:8 - 11:4 - 14:12 - 0:0
16733972,2024-02-06 13:30:00,Mkrtchyan Andranik - Diaryan Aleksandr,3:1,9:11 - 13:11 - 9:11 - 8:11 - 0:0,1,3,Mkrtchyan Andranik,Diaryan Aleksandr,fiurst,Diaryan Aleksandr - Mkrtchyan Andranik,83,44,39,-5,5,20,24,20,19,0,-2,2,-2,-3,0,-5,11:9 - 11:13 - 11:9 - 11:8 - 0:0
16733967,2024-02-06 13:15:00,Nazaryan Mushegh - Papyan Karen,1:3,11:8 - 9:11 - 15:17 - 9:11 - 0:0,1,3,Nazaryan Mushegh,Papyan Karen,fiurst,Nazaryan Mushegh - Papyan Karen,91,44,47,3,-3,19,20,32,20,0,-3,2,2,2,0,3,11:8 - 9:11 - 15:17 - 9:11 - 0:0
16733956,2024-02-06 13:00:00,Mkrtchyan Andranik - Nikoghosyan Narek,0:3,9:11 - 5:11 - 9:11 - 0:0 - 0:0,0,3,Mkrtchyan Andranik,Nikoghosyan Narek,fiurst,Mkrtchyan Andranik - Nikoghosyan Narek,56,23,33,10,-10,20,16,20,0,0,2,6,2,0,0,10,9:11 - 5:11 - 9:11 - 0:0 - 0:0
16733942,2024-02-06 12:15:00,Diaryan Aleksandr - Papyan Karen,3:0,11:3 - 11:6 - 11:6 - 0:0 - 0:0,3,0,Diaryan Aleksandr,Papyan Karen,fiurst,Diaryan Aleksandr - Papyan Karen,48,33,15,-18,18,14,17,17,0,0,-8,-5,-5,0,0,-18,11:3 - 11:6 - 11:6 - 0:0 - 0:0
16733936,2024-02-06 12:10:00,Mkrtchyan Andranik - Nazaryan Mushegh,3:0,11:6 - 11:9 - 11:9 - 0:0 - 0:0,3,0,Mkrtchyan Andranik,Nazaryan Mushegh,fiurst,Mkrtchyan Andranik - Nazaryan Mushegh,57,33,24,-9,9,17,20,20,0,0,-5,-2,-2,0,0,-9,11:6 - 11:9 - 11:9 - 0:0 - 0:0
16733625,2024-02-06 11:45:00,Nikoghosyan Narek - Diaryan Aleksandr,1:3,7:11 - 11:8 - 16:14 - 11:6 - 0:0,3,1,Nikoghosyan Narek,Diaryan Aleksandr,fiurst,Diaryan Aleksandr - Nikoghosyan Narek,84,39,45,6,-6,18,19,30,17,0,-4,3,2,5,0,6,11:7 - 8:11 - 14:16 - 6:11 - 0:0
16733618,2024-02-06 11:30:00,Mkrtchyan Andranik - Papyan Karen,3:2,11:8 - 5:11 - 18:16 - 6:11 - 11:7,3,2,Mkrtchyan Andranik,Papyan Karen,fiurst,Mkrtchyan Andranik - Papyan Karen,104,51,53,2,-2,19,16,34,17,18,-3,6,-2,5,-4,2,11:8 - 5:11 - 18:16 - 6:11 - 11:7
16733616,2024-02-06 11:25:00,Nazaryan Mushegh - Nikoghosyan Narek,3:0,11:6 - 11:6 - 11:9 - 0:0 - 0:0,3,0,Nazaryan Mushegh,Nikoghosyan Narek,fiurst,Nazaryan Mushegh - Nikoghosyan Narek,54,33,21,-12,12,17,17,20,0,0,-5,-5,-2,0,0,-12,11:6 - 11:6 - 11:9 - 0:0 - 0:0
16733614,2024-02-06 11:00:00,Diaryan Aleksandr - Mkrtchyan Andranik,3:0,11:6 - 11:5 - 11:5 - 0:0 - 0:0,3,0,Diaryan Aleksandr,Mkrtchyan Andranik,fiurst,Diaryan Aleksandr - Mkrtchyan Andranik,49,33,16,-17,17,17,16,16,0,0,-5,-6,-6,0,0,-17,11:6 - 11:5 - 11:5 - 0:0 - 0:0
16733599,2024-02-06 10:45:00,Papyan Karen - Nikoghosyan Narek,2:3,11:9 - 11:5 - 7:11 - 8:11 - 11:8,3,2,Papyan Karen,Nikoghosyan Narek,fiurst,Nikoghosyan Narek - Papyan Karen,92,44,48,4,-4,20,16,18,19,19,2,6,-4,-3,3,4,9:11 - 5:11 - 11:7 - 11:8 - 8:11
16733594,2024-02-06 10:30:00,Nazaryan Mushegh - Diaryan Aleksandr,3:0,7:11 - 9:11 - 6:11 - 0:0 - 0:0,0,3,Nazaryan Mushegh,Diaryan Aleksandr,fiurst,Diaryan Aleksandr - Nazaryan Mushegh,55,33,22,-11,11,18,20,17,0,0,-4,-2,-5,0,0,-11,11:7 - 11:9 - 11:6 - 0:0 - 0:0
16733589,2024-02-06 10:15:00,Nikoghosyan Narek - Mkrtchyan Andranik,0:3,11:9 - 11:4 - 11:4 - 0:0 - 0:0,3,0,Nikoghosyan Narek,Mkrtchyan Andranik,fiurst,Mkrtchyan Andranik - Nikoghosyan Narek,50,17,33,16,-16,20,15,15,0,0,2,7,7,0,0,16,9:11 - 4:11 - 4:11 - 0:0 - 0:0
16733586,2024-02-06 10:00:00,Papyan Karen - Nazaryan Mushegh,0:3,11:5 - 11:8 - 11:9 - 0:0 - 0:0,3,0,Papyan Karen,Nazaryan Mushegh,fiurst,Nazaryan Mushegh - Papyan Karen,55,22,33,11,-11,16,19,20,0,0,6,3,2,0,0,11,5:11 - 8:11 - 9:11 - 0:0 - 0:0
16716786,2024-02-05 17:45:00,Karakhanyan Mher - Grigoryan Erik,3:0,10:12 - 7:11 - 12:14 - 0:0 - 0:0,0,3,Karakhanyan Mher,Grigoryan Erik,fiurst,Grigoryan Erik - Karakhanyan Mher,66,37,29,-8,8,22,18,26,0,0,-2,-4,-2,0,0,-8,12:10 - 11:7 - 14:12 - 0:0 - 0:0
16716768,2024-02-05 17:30:00,Petrosyan Davit - Arutyunov Ruben,3:0,9:11 - 2:11 - 6:11 - 0:0 - 0:0,0,3,Petrosyan Davit,Arutyunov Ruben,fiurst,Arutyunov Ruben - Petrosyan Davit,50,33,17,-16,16,20,13,17,0,0,-2,-9,-5,0,0,-16,11:9 - 11:2 - 11:6 - 0:0 - 0:0
16716763,2024-02-05 17:15:00,Gevorgyan Hayk - Karakhanyan Mher,3:0,11:7 - 11:6 - 11:9 - 0:0 - 0:0,3,0,Gevorgyan Hayk,Karakhanyan Mher,fiurst,Gevorgyan Hayk - Karakhanyan Mher,55,33,22,-11,11,18,17,20,0,0,-4,-5,-2,0,0,-11,11:7 - 11:6 - 11:9 - 0:0 - 0:0
16716565,2024-02-05 17:00:00,Petrosyan Davit - Grigoryan Erik,1:3,9:11 - 11:3 - 11:5 - 11:9 - 0:0,3,1,Petrosyan Davit,Grigoryan Erik,fiurst,Grigoryan Erik - Petrosyan Davit,70,28,42,14,-14,20,14,16,20,0,-2,8,6,2,0,14,11:9 - 3:11 - 5:11 - 9:11 - 0:0
16716562,2024-02-05 16:45:00,Arutyunov Ruben - Gevorgyan Hayk,0:3,7:11 - 6:11 - 7:11 - 0:0 - 0:0,0,3,Arutyunov Ruben,Gevorgyan Hayk,fiurst,Arutyunov Ruben - Gevorgyan Hayk,53,20,33,13,-13,18,17,18,0,0,4,5,4,0,0,13,7:11 - 6:11 - 7:11 - 0:0 - 0:0
16716554,2024-02-05 16:30:00,Karakhanyan Mher - Petrosyan Davit,0:3,6:11 - 8:11 - 6:11 - 0:0 - 0:0,0,3,Karakhanyan Mher,Petrosyan Davit,fiurst,Karakhanyan Mher - Petrosyan Davit,53,20,33,13,-13,17,19,17,0,0,5,3,5,0,0,13,6:11 - 8:11 - 6:11 - 0:0 - 0:0
16716541,2024-02-05 16:15:00,Grigoryan Erik - Gevorgyan Hayk,3:0,6:11 - 7:11 - 5:11 - 0:0 - 0:0,0,3,Grigoryan Erik,Gevorgyan Hayk,fiurst,Gevorgyan Hayk - Grigoryan Erik,51,33,18,-15,15,17,18,16,0,0,-5,-4,-6,0,0,-15,11:6 - 11:7 - 11:5 - 0:0 - 0:0
16716539,2024-02-05 16:00:00,Arutyunov Ruben - Karakhanyan Mher,3:0,11:8 - 11:3 - 12:10 - 0:0 - 0:0,3,0,Arutyunov Ruben,Karakhanyan Mher,fiurst,Arutyunov Ruben - Karakhanyan Mher,55,34,21,-13,13,19,14,22,0,0,-3,-8,-2,0,0,-13,11:8 - 11:3 - 12:10 - 0:0 - 0:0
16716535,2024-02-05 15:45:00,Gevorgyan Hayk - Petrosyan Davit,3:0,11:5 - 11:8 - 11:8 - 0:0 - 0:0,3,0,Gevorgyan Hayk,Petrosyan Davit,fiurst,Gevorgyan Hayk - Petrosyan Davit,54,33,21,-12,12,16,19,19,0,0,-6,-3,-3,0,0,-12,11:5 - 11:8 - 11:8 - 0:0 - 0:0
16716527,2024-02-05 15:30:00,Grigoryan Erik - Arutyunov Ruben,3:0,6:11 - 9:11 - 9:11 - 0:0 - 0:0,0,3,Grigoryan Erik,Arutyunov Ruben,fiurst,Arutyunov Ruben - Grigoryan Erik,57,33,24,-9,9,17,20,20,0,0,-5,-2,-2,0,0,-9,11:6 - 11:9 - 11:9 - 0:0 - 0:0
16716444,2024-02-05 15:15:00,Mkrtchyan Andranik - Rafayelyan Edgar,0:3,7:11 - 6:11 - 7:11 - 0:0 - 0:0,0,3,Mkrtchyan Andranik,Rafayelyan Edgar,fiurst,Mkrtchyan Andranik - Rafayelyan Edgar,53,20,33,13,-13,18,17,18,0,0,4,5,4,0,0,13,7:11 - 6:11 - 7:11 - 0:0 - 0:0
16716432,2024-02-05 15:00:00,Papyan Karen - Diaryan Aleksandr,3:0,6:11 - 7:11 - 6:11 - 0:0 - 0:0,0,3,Papyan Karen,Diaryan Aleksandr,fiurst,Diaryan Aleksandr - Papyan Karen,52,33,19,-14,14,17,18,17,0,0,-5,-4,-5,0,0,-14,11:6 - 11:7 - 11:6 - 0:0 - 0:0
16716431,2024-02-05 14:45:00,Soghomonyan Hrayr - Mkrtchyan Andranik,1:3,11:7 - 13:11 - 5:11 - 11:9 - 0:0,3,1,Soghomonyan Hrayr,Mkrtchyan Andranik,fiurst,Mkrtchyan Andranik - Soghomonyan Hrayr,78,38,40,2,-2,18,24,16,20,0,4,2,-6,2,0,2,7:11 - 11:13 - 11:5 - 9:11 - 0:0
16716430,2024-02-05 14:35:00,Rafayelyan Edgar - Papyan Karen,0:3,13:11 - 11:8 - 13:11 - 0:0 - 0:0,3,0,Rafayelyan Edgar,Papyan Karen,fiurst,Papyan Karen - Rafayelyan Edgar,67,30,37,7,-7,24,19,24,0,0,2,3,2,0,0,7,11:13 - 8:11 - 11:13 - 0:0 - 0:0
16716424,2024-02-05 14:15:00,Soghomonyan Hrayr - Diaryan Aleksandr,3:0,7:11 - 5:11 - 10:12 - 0:0 - 0:0,0,3,Soghomonyan Hrayr,Diaryan Aleksandr,fiurst,Diaryan Aleksandr - Soghomonyan Hrayr,56,34,22,-12,12,18,16,22,0,0,-4,-6,-2,0,0,-12,11:7 - 11:5 - 12:10 - 0:0 - 0:0
16716420,2024-02-05 14:00:00,Mkrtchyan Andranik - Papyan Karen,0:3,9:11 - 9:11 - 11:13 - 0:0 - 0:0,0,3,Mkrtchyan Andranik,Papyan Karen,fiurst,Mkrtchyan Andranik - Papyan Karen,64,29,35,6,-6,20,20,24,0,0,2,2,2,0,0,6,9:11 - 9:11 - 11:13 - 0:0 - 0:0
16716411,2024-02-05 13:45:00,Rafayelyan Edgar - Soghomonyan Hrayr,3:0,11:8 - 27:25 - 11:4 - 0:0 - 0:0,3,0,Rafayelyan Edgar,Soghomonyan Hrayr,fiurst,Rafayelyan Edgar - Soghomonyan Hrayr,86,49,37,-12,12,19,52,15,0,0,-3,-2,-7,0,0,-12,11:8 - 27:25 - 11:4 - 0:0 - 0:0
16716404,2024-02-05 13:35:00,Diaryan Aleksandr - Mkrtchyan Andranik,3:1,11:4 - 9:11 - 11:4 - 11:6 - 0:0,3,1,Diaryan Aleksandr,Mkrtchyan Andranik,fiurst,Diaryan Aleksandr - Mkrtchyan Andranik,67,42,25,-17,17,15,20,15,17,0,-7,2,-7,-5,0,-17,11:4 - 9:11 - 11:4 - 11:6 - 0:0
16716403,2024-02-05 13:15:00,Papyan Karen - Soghomonyan Hrayr,3:0,11:8 - 11:5 - 11:7 - 0:0 - 0:0,3,0,Papyan Karen,Soghomonyan Hrayr,fiurst,Papyan Karen - Soghomonyan Hrayr,53,33,20,-13,13,19,16,18,0,0,-3,-6,-4,0,0,-13,11:8 - 11:5 - 11:7 - 0:0 - 0:0
16716397,2024-02-05 13:00:00,Diaryan Aleksandr - Rafayelyan Edgar,3:1,11:7 - 7:11 - 11:9 - 11:5 - 0:0,3,1,Diaryan Aleksandr,Rafayelyan Edgar,fiurst,Diaryan Aleksandr - Rafayelyan Edgar,72,40,32,-8,8,18,18,20,16,0,-4,4,-2,-6,0,-8,11:7 - 7:11 - 11:9 - 11:5 - 0:0
16716394,2024-02-05 12:25:00,Mkrtchyan Andranik - Soghomonyan Hrayr,3:1,12:10 - 10:12 - 13:11 - 11:9 - 0:0,3,1,Mkrtchyan Andranik,Soghomonyan Hrayr,fiurst,Mkrtchyan Andranik - Soghomonyan Hrayr,88,46,42,-4,4,22,22,24,20,0,-2,2,-2,-2,0,-4,12:10 - 10:12 - 13:11 - 11:9 - 0:0
16716378,2024-02-05 12:00:00,Diaryan Aleksandr - Papyan Karen,2:3,6:11 - 5:11 - 11:6 - 11:4 - 9:11,2,3,Diaryan Aleksandr,Papyan Karen,fiurst,Diaryan Aleksandr - Papyan Karen,85,42,43,1,-1,17,16,17,15,20,5,6,-5,-7,2,1,6:11 - 5:11 - 11:6 - 11:4 - 9:11
16716375,2024-02-05 11:45:00,Rafayelyan Edgar - Mkrtchyan Andranik,2:3,11:13 - 11:9 - 8:11 - 11:7 - 12:10,3,2,Rafayelyan Edgar,Mkrtchyan Andranik,fiurst,Mkrtchyan Andranik - Rafayelyan Edgar,103,50,53,3,-3,24,20,19,18,22,-2,2,-3,4,2,3,13:11 - 9:11 - 11:8 - 7:11 - 10:12
16716349,2024-02-05 11:30:00,Diaryan Aleksandr - Soghomonyan Hrayr,3:0,11:4 - 11:8 - 11:6 - 0:0 - 0:0,3,0,Diaryan Aleksandr,Soghomonyan Hrayr,fiurst,Diaryan Aleksandr - Soghomonyan Hrayr,51,33,18,-15,15,15,19,17,0,0,-7,-3,-5,0,0,-15,11:4 - 11:8 - 11:6 - 0:0 - 0:0
16716061,2024-02-05 11:15:00,Papyan Karen - Rafayelyan Edgar,1:3,10:12 - 9:11 - 11:7 - 7:11 - 0:0,1,3,Papyan Karen,Rafayelyan Edgar,fiurst,Papyan Karen - Rafayelyan Edgar,78,37,41,4,-4,22,20,18,18,0,2,2,-4,4,0,4,10:12 - 9:11 - 11:7 - 7:11 - 0:0
16716057,2024-02-05 11:00:00,Mkrtchyan Andranik - Diaryan Aleksandr,3:0,2:11 - 4:11 - 11:13 - 0:0 - 0:0,0,3,Mkrtchyan Andranik,Diaryan Aleksandr,fiurst,Diaryan Aleksandr - Mkrtchyan Andranik,52,35,17,-18,18,13,15,24,0,0,-9,-7,-2,0,0,-18,11:2 - 11:4 - 13:11 - 0:0 - 0:0
16716047,2024-02-05 10:45:00,Soghomonyan Hrayr - Rafayelyan Edgar,3:0,3:11 - 6:11 - 9:11 - 0:0 - 0:0,0,3,Soghomonyan Hrayr,Rafayelyan Edgar,fiurst,Rafayelyan Edgar - Soghomonyan Hrayr,51,33,18,-15,15,14,17,20,0,0,-8,-5,-2,0,0,-15,11:3 - 11:6 - 11:9 - 0:0 - 0:0
16716046,2024-02-05 10:30:00,Papyan Karen - Mkrtchyan Andranik,1:3,11:5 - 11:13 - 11:6 - 11:4 - 0:0,3,1,Papyan Karen,Mkrtchyan Andranik,fiurst,Mkrtchyan Andranik - Papyan Karen,72,28,44,16,-16,16,24,17,15,0,6,-2,5,7,0,16,5:11 - 13:11 - 6:11 - 4:11 - 0:0
16716035,2024-02-05 10:15:00,Rafayelyan Edgar - Diaryan Aleksandr,3:2,11:7 - 11:6 - 6:11 - 7:11 - 6:11,2,3,Rafayelyan Edgar,Diaryan Aleksandr,fiurst,Diaryan Aleksandr - Rafayelyan Edgar,87,46,41,-5,5,18,17,17,18,17,4,5,-5,-4,-5,-5,7:11 - 6:11 - 11:6 - 11:7 - 11:6
16716033,2024-02-05 10:00:00,Soghomonyan Hrayr - Papyan Karen,3:0,5:11 - 7:11 - 9:11 - 0:0 - 0:0,0,3,Soghomonyan Hrayr,Papyan Karen,fiurst,Papyan Karen - Soghomonyan Hrayr,54,33,21,-12,12,16,18,20,0,0,-6,-4,-2,0,0,-12,11:5 - 11:7 - 11:9 - 0:0 - 0:0
16696245,2024-02-04 17:50:00,Karakhanyan Mher - Avakimyan Davit,3:1,11:9 - 9:11 - 10:12 - 5:11 - 0:0,1,3,Karakhanyan Mher,Avakimyan Davit,fiurst,Avakimyan Davit - Karakhanyan Mher,78,43,35,-8,8,20,20,22,16,0,2,-2,-2,-6,0,-8,9:11 - 11:9 - 12:10 - 11:5 - 0:0
16696234,2024-02-04 17:30:00,Grigoryan Erik - Karakhanyan Mher,3:2,9:11 - 13:11 - 3:11 - 12:10 - 11:5,3,2,Grigoryan Erik,Karakhanyan Mher,fiurst,Grigoryan Erik - Karakhanyan Mher,96,48,48,0,0,20,24,14,22,16,2,-2,8,-2,-6,0,9:11 - 13:11 - 3:11 - 12:10 - 11:5
16696235,2024-02-04 17:30:00,Soghomonyan Hrayr - Gevorgyan Hayk,1:3,11:6 - 11:3 - 6:11 - 11:8 - 0:0,3,1,Soghomonyan Hrayr,Gevorgyan Hayk,fiurst,Gevorgyan Hayk - Soghomonyan Hrayr,67,28,39,11,-11,17,14,17,19,0,5,8,-5,3,0,11,6:11 - 3:11 - 11:6 - 8:11 - 0:0
16696233,2024-02-04 17:00:00,Soghomonyan Hrayr - Avakimyan Davit,0:3,11:5 - 11:9 - 11:9 - 0:0 - 0:0,3,0,Soghomonyan Hrayr,Avakimyan Davit,fiurst,Avakimyan Davit - Soghomonyan Hrayr,56,23,33,10,-10,16,20,20,0,0,6,2,2,0,0,10,5:11 - 9:11 - 9:11 - 0:0 - 0:0
16696231,2024-02-04 16:55:00,Gevorgyan Hayk - Grigoryan Erik,3:2,6:11 - 13:11 - 8:11 - 11:6 - 11:7,3,2,Gevorgyan Hayk,Grigoryan Erik,fiurst,Gevorgyan Hayk - Grigoryan Erik,95,49,46,-3,3,17,24,19,17,18,5,-2,3,-5,-4,-3,6:11 - 13:11 - 8:11 - 11:6 - 11:7
16696212,2024-02-04 16:30:00,Karakhanyan Mher - Soghomonyan Hrayr,0:3,5:11 - 4:11 - 6:11 - 0:0 - 0:0,0,3,Karakhanyan Mher,Soghomonyan Hrayr,fiurst,Karakhanyan Mher - Soghomonyan Hrayr,48,15,33,18,-18,16,15,17,0,0,6,7,5,0,0,18,5:11 - 4:11 - 6:11 - 0:0 - 0:0
16696211,2024-02-04 16:20:00,Avakimyan Davit - Grigoryan Erik,1:3,8:11 - 11:13 - 11:4 - 12:14 - 0:0,1,3,Avakimyan Davit,Grigoryan Erik,fiurst,Avakimyan Davit - Grigoryan Erik,84,42,42,0,0,19,24,15,26,0,3,2,-7,2,0,0,8:11 - 11:13 - 11:4 - 12:14 - 0:0
16696208,2024-02-04 16:15:00,Gevorgyan Hayk - Karakhanyan Mher,3:0,11:7 - 14:12 - 11:5 - 0:0 - 0:0,3,0,Gevorgyan Hayk,Karakhanyan Mher,fiurst,Gevorgyan Hayk - Karakhanyan Mher,60,36,24,-12,12,18,26,16,0,0,-4,-2,-6,0,0,-12,11:7 - 14:12 - 11:5 - 0:0 - 0:0
16696204,2024-02-04 15:45:00,Avakimyan Davit - Gevorgyan Hayk,1:3,11:5 - 9:11 - 12:14 - 12:14 - 0:0,1,3,Avakimyan Davit,Gevorgyan Hayk,fiurst,Avakimyan Davit - Gevorgyan Hayk,88,44,44,0,0,16,20,26,26,0,-6,2,2,2,0,0,11:5 - 9:11 - 12:14 - 12:14 - 0:0
16696206,2024-02-04 15:45:00,Grigoryan Erik - Soghomonyan Hrayr,0:3,9:11 - 6:11 - 5:11 - 0:0 - 0:0,0,3,Grigoryan Erik,Soghomonyan Hrayr,fiurst,Grigoryan Erik - Soghomonyan Hrayr,53,20,33,13,-13,20,17,16,0,0,2,5,6,0,0,13,9:11 - 6:11 - 5:11 - 0:0 - 0:0
16696201,2024-02-04 15:20:00,Rafayelyan Edgar - Nikoghosyan Narek,2:3,11:5 - 9:11 - 11:3 - 4:11 - 11:9,3,2,Rafayelyan Edgar,Nikoghosyan Narek,fiurst,Nikoghosyan Narek - Rafayelyan Edgar,85,39,46,7,-7,16,20,14,15,20,6,-2,8,-7,2,7,5:11 - 11:9 - 3:11 - 11:4 - 9:11
16696203,2024-02-04 15:15:00,Soghomonyan Hrayr - Diaryan Aleksandr,3:0,4:11 - 7:11 - 4:11 - 0:0 - 0:0,0,3,Soghomonyan Hrayr,Diaryan Aleksandr,fiurst,Diaryan Aleksandr - Soghomonyan Hrayr,48,33,15,-18,18,15,18,15,0,0,-7,-4,-7,0,0,-18,11:4 - 11:7 - 11:4 - 0:0 - 0:0
16696190,2024-02-04 14:45:00,Nazaryan Mushegh - Soghomonyan Hrayr,3:1,11:9 - 8:11 - 11:5 - 11:6 - 0:0,3,1,Nazaryan Mushegh,Soghomonyan Hrayr,fiurst,Nazaryan Mushegh - Soghomonyan Hrayr,72,41,31,-10,10,20,19,16,17,0,-2,3,-6,-5,0,-10,11:9 - 8:11 - 11:5 - 11:6 - 0:0
16696179,2024-02-04 14:30:00,Diaryan Aleksandr - Rafayelyan Edgar,3:2,10:12 - 6:11 - 11:5 - 12:10 - 11:8,3,2,Diaryan Aleksandr,Rafayelyan Edgar,fiurst,Diaryan Aleksandr - Rafayelyan Edgar,96,50,46,-4,4,22,17,16,22,19,2,5,-6,-2,-3,-4,10:12 - 6:11 - 11:5 - 12:10 - 11:8
16696178,2024-02-04 14:25:00,Nazaryan Mushegh - Nikoghosyan Narek,0:3,6:11 - 4:11 - 4:11 - 0:0 - 0:0,0,3,Nazaryan Mushegh,Nikoghosyan Narek,fiurst,Nazaryan Mushegh - Nikoghosyan Narek,47,14,33,19,-19,17,15,15,0,0,5,7,7,0,0,19,6:11 - 4:11 - 4:11 - 0:0 - 0:0
16696177,2024-02-04 14:00:00,Soghomonyan Hrayr - Rafayelyan Edgar,3:0,9:11 - 9:11 - 3:11 - 0:0 - 0:0,0,3,Soghomonyan Hrayr,Rafayelyan Edgar,fiurst,Rafayelyan Edgar - Soghomonyan Hrayr,54,33,21,-12,12,20,20,14,0,0,-2,-2,-8,0,0,-12,11:9 - 11:9 - 11:3 - 0:0 - 0:0
16696174,2024-02-04 13:55:00,Diaryan Aleksandr - Nazaryan Mushegh,3:0,11:5 - 11:9 - 11:6 - 0:0 - 0:0,3,0,Diaryan Aleksandr,Nazaryan Mushegh,fiurst,Diaryan Aleksandr - Nazaryan Mushegh,53,33,20,-13,13,16,20,17,0,0,-6,-2,-5,0,0,-13,11:5 - 11:9 - 11:6 - 0:0 - 0:0
16696165,2024-02-04 13:30:00,Nikoghosyan Narek - Soghomonyan Hrayr,3:1,11:3 - 10:12 - 11:8 - 11:6 - 0:0,3,1,Nikoghosyan Narek,Soghomonyan Hrayr,fiurst,Nikoghosyan Narek - Soghomonyan Hrayr,72,43,29,-14,14,14,22,19,17,0,-8,2,-3,-5,0,-14,11:3 - 10:12 - 11:8 - 11:6 - 0:0
16696160,2024-02-04 13:15:00,Rafayelyan Edgar - Nazaryan Mushegh,2:3,11:9 - 7:11 - 8:11 - 15:13 - 11:6,3,2,Rafayelyan Edgar,Nazaryan Mushegh,fiurst,Nazaryan Mushegh - Rafayelyan Edgar,102,50,52,2,-2,20,18,19,28,17,2,-4,-3,2,5,2,9:11 - 11:7 - 11:8 - 13:15 - 6:11
16696148,2024-02-04 13:00:00,Nikoghosyan Narek - Diaryan Aleksandr,3:2,11:7 - 11:8 - 10:12 - 6:11 - 11:13,2,3,Nikoghosyan Narek,Diaryan Aleksandr,fiurst,Diaryan Aleksandr - Nikoghosyan Narek,100,51,49,-2,2,18,19,22,17,24,4,3,-2,-5,-2,-2,7:11 - 8:11 - 12:10 - 11:6 - 13:11
16696146,2024-02-04 12:20:00,Soghomonyan Hrayr - Nazaryan Mushegh,1:3,11:7 - 11:8 - 8:11 - 11:8 - 0:0,3,1,Soghomonyan Hrayr,Nazaryan Mushegh,fiurst,Nazaryan Mushegh - Soghomonyan Hrayr,75,34,41,7,-7,18,19,19,19,0,4,3,-3,3,0,7,7:11 - 8:11 - 11:8 - 8:11 - 0:0
16696143,2024-02-04 12:05:00,Nikoghosyan Narek - Rafayelyan Edgar,1:3,9:11 - 11:3 - 8:11 - 3:11 - 0:0,1,3,Nikoghosyan Narek,Rafayelyan Edgar,fiurst,Nikoghosyan Narek - Rafayelyan Edgar,67,31,36,5,-5,20,14,19,14,0,2,-8,3,8,0,5,9:11 - 11:3 - 8:11 - 3:11 - 0:0
16696137,2024-02-04 11:55:00,Diaryan Aleksandr - Soghomonyan Hrayr,3:0,11:8 - 11:4 - 11:4 - 0:0 - 0:0,3,0,Diaryan Aleksandr,Soghomonyan Hrayr,fiurst,Diaryan Aleksandr - Soghomonyan Hrayr,49,33,16,-17,17,19,15,15,0,0,-3,-7,-7,0,0,-17,11:8 - 11:4 - 11:4 - 0:0 - 0:0
16696134,2024-02-04 11:35:00,Nikoghosyan Narek - Nazaryan Mushegh,1:3,4:11 - 11:6 - 11:4 - 11:7 - 0:0,3,1,Nikoghosyan Narek,Nazaryan Mushegh,fiurst,Nazaryan Mushegh - Nikoghosyan Narek,65,28,37,9,-9,15,17,15,18,0,-7,5,7,4,0,9,11:4 - 6:11 - 4:11 - 7:11 - 0:0
16695972,2024-02-04 11:15:00,Rafayelyan Edgar - Diaryan Aleksandr,2:3,7:11 - 11:9 - 11:7 - 9:11 - 11:6,3,2,Rafayelyan Edgar,Diaryan Aleksandr,fiurst,Diaryan Aleksandr - Rafayelyan Edgar,93,44,49,5,-5,18,20,18,20,17,-4,2,4,-2,5,5,11:7 - 9:11 - 7:11 - 11:9 - 6:11
16695958,2024-02-04 11:00:00,Soghomonyan Hrayr - Nikoghosyan Narek,3:0,5:11 - 9:11 - 7:11 - 0:0 - 0:0,0,3,Soghomonyan Hrayr,Nikoghosyan Narek,fiurst,Nikoghosyan Narek - Soghomonyan Hrayr,54,33,21,-12,12,16,20,18,0,0,-6,-2,-4,0,0,-12,11:5 - 11:9 - 11:7 - 0:0 - 0:0
16695956,2024-02-04 10:45:00,Nazaryan Mushegh - Diaryan Aleksandr,3:0,11:13 - 5:11 - 5:11 - 0:0 - 0:0,0,3,Nazaryan Mushegh,Diaryan Aleksandr,fiurst,Diaryan Aleksandr - Nazaryan Mushegh,56,35,21,-14,14,24,16,16,0,0,-2,-6,-6,0,0,-14,13:11 - 11:5 - 11:5 - 0:0 - 0:0
16695952,2024-02-04 10:30:00,Rafayelyan Edgar - Soghomonyan Hrayr,3:1,11:5 - 11:6 - 14:16 - 11:2 - 0:0,3,1,Rafayelyan Edgar,Soghomonyan Hrayr,fiurst,Rafayelyan Edgar - Soghomonyan Hrayr,76,47,29,-18,18,16,17,30,13,0,-6,-5,2,-9,0,-18,11:5 - 11:6 - 14:16 - 11:2 - 0:0
16695949,2024-02-04 10:15:00,Diaryan Aleksandr - Nikoghosyan Narek,3:1,11:6 - 11:6 - 8:11 - 12:10 - 0:0,3,1,Diaryan Aleksandr,Nikoghosyan Narek,fiurst,Diaryan Aleksandr - Nikoghosyan Narek,75,42,33,-9,9,17,17,19,22,0,-5,-5,3,-2,0,-9,11:6 - 11:6 - 8:11 - 12:10 - 0:0
16695945,2024-02-04 10:00:00,Nazaryan Mushegh - Rafayelyan Edgar,0:3,8:11 - 5:11 - 7:11 - 0:0 - 0:0,0,3,Nazaryan Mushegh,Rafayelyan Edgar,fiurst,Nazaryan Mushegh - Rafayelyan Edgar,53,20,33,13,-13,19,16,18,0,0,3,6,4,0,0,13,8:11 - 5:11 - 7:11 - 0:0 - 0:0
16671902,2024-02-03 17:45:00,Arutyunov Ruben - Gevorgyan Gegham,3:0,11:8 - 11:9 - 11:9 - 0:0 - 0:0,3,0,Arutyunov Ruben,Gevorgyan Gegham,fiurst,Arutyunov Ruben - Gevorgyan Gegham,59,33,26,-7,7,19,20,20,0,0,-3,-2,-2,0,0,-7,11:8 - 11:9 - 11:9 - 0:0 - 0:0
16671901,2024-02-03 17:30:00,Karakhanyan Mher - Avakimyan Davit,3:1,11:5 - 4:11 - 11:13 - 9:11 - 0:0,1,3,Karakhanyan Mher,Avakimyan Davit,fiurst,Avakimyan Davit - Karakhanyan Mher,75,40,35,-5,5,16,15,24,20,0,6,-7,-2,-2,0,-5,5:11 - 11:4 - 13:11 - 11:9 - 0:0
16671900,2024-02-03 17:15:00,Gevorgyan Hayk - Arutyunov Ruben,3:0,9:11 - 8:11 - 10:12 - 0:0 - 0:0,0,3,Gevorgyan Hayk,Arutyunov Ruben,fiurst,Arutyunov Ruben - Gevorgyan Hayk,61,34,27,-7,7,20,19,22,0,0,-2,-3,-2,0,0,-7,11:9 - 11:8 - 12:10 - 0:0 - 0:0
16671898,2024-02-03 17:00:00,Karakhanyan Mher - Gevorgyan Gegham,3:1,6:11 - 12:14 - 11:7 - 9:11 - 0:0,1,3,Karakhanyan Mher,Gevorgyan Gegham,fiurst,Gevorgyan Gegham - Karakhanyan Mher,81,43,38,-5,5,17,26,18,20,0,-5,-2,4,-2,0,-5,11:6 - 14:12 - 7:11 - 11:9 - 0:0
16671887,2024-02-03 16:45:00,Avakimyan Davit - Gevorgyan Hayk,1:3,9:11 - 9:11 - 11:8 - 4:11 - 0:0,1,3,Avakimyan Davit,Gevorgyan Hayk,fiurst,Avakimyan Davit - Gevorgyan Hayk,74,33,41,8,-8,20,20,19,15,0,2,2,-3,7,0,8,9:11 - 9:11 - 11:8 - 4:11 - 0:0
16671886,2024-02-03 16:30:00,Arutyunov Ruben - Karakhanyan Mher,3:0,11:8 - 11:8 - 11:9 - 0:0 - 0:0,3,0,Arutyunov Ruben,Karakhanyan Mher,fiurst,Arutyunov Ruben - Karakhanyan Mher,58,33,25,-8,8,19,19,20,0,0,-3,-3,-2,0,0,-8,11:8 - 11:8 - 11:9 - 0:0 - 0:0
16671875,2024-02-03 16:15:00,Gevorgyan Gegham - Gevorgyan Hayk,0:3,7:11 - 6:11 - 8:11 - 0:0 - 0:0,0,3,Gevorgyan Gegham,Gevorgyan Hayk,fiurst,Gevorgyan Gegham - Gevorgyan Hayk,54,21,33,12,-12,18,17,19,0,0,4,5,3,0,0,12,7:11 - 6:11 - 8:11 - 0:0 - 0:0
16671866,2024-02-03 16:00:00,Avakimyan Davit - Arutyunov Ruben,3:1,10:12 - 6:11 - 11:5 - 7:11 - 0:0,1,3,Avakimyan Davit,Arutyunov Ruben,fiurst,Arutyunov Ruben - Avakimyan Davit,73,39,34,-5,5,22,17,16,18,0,-2,-5,6,-4,0,-5,12:10 - 11:6 - 5:11 - 11:7 - 0:0
16671861,2024-02-03 15:45:00,Gevorgyan Hayk - Karakhanyan Mher,3:1,4:11 - 11:7 - 11:5 - 12:10 - 0:0,3,1,Gevorgyan Hayk,Karakhanyan Mher,fiurst,Gevorgyan Hayk - Karakhanyan Mher,71,38,33,-5,5,15,18,16,22,0,7,-4,-6,-2,0,-5,4:11 - 11:7 - 11:5 - 12:10 - 0:0
16671858,2024-02-03 15:30:00,Gevorgyan Gegham - Avakimyan Davit,3:0,10:12 - 9:11 - 2:11 - 0:0 - 0:0,0,3,Gevorgyan Gegham,Avakimyan Davit,fiurst,Avakimyan Davit - Gevorgyan Gegham,55,34,21,-13,13,22,20,13,0,0,-2,-2,-9,0,0,-13,12:10 - 11:9 - 11:2 - 0:0 - 0:0
16671854,2024-02-03 15:20:00,Nikoghosyan Narek - Soghomonyan Hrayr,3:0,11:4 - 11:7 - 11:6 - 0:0 - 0:0,3,0,Nikoghosyan Narek,Soghomonyan Hrayr,fiurst,Nikoghosyan Narek - Soghomonyan Hrayr,50,33,17,-16,16,15,18,17,0,0,-7,-4,-5,0,0,-16,11:4 - 11:7 - 11:6 - 0:0 - 0:0
16671852,2024-02-03 15:10:00,Papyan Karen - Nazaryan Mushegh,3:1,10:12 - 11:7 - 4:11 - 6:11 - 0:0,1,3,Papyan Karen,Nazaryan Mushegh,fiurst,Nazaryan Mushegh - Papyan Karen,72,41,31,-10,10,22,18,15,17,0,-2,4,-7,-5,0,-10,12:10 - 7:11 - 11:4 - 11:6 - 0:0
16671847,2024-02-03 14:45:00,Mkrtchyan Andranik - Nikoghosyan Narek,0:3,7:11 - 7:11 - 3:11 - 0:0 - 0:0,0,3,Mkrtchyan Andranik,Nikoghosyan Narek,fiurst,Mkrtchyan Andranik - Nikoghosyan Narek,50,17,33,16,-16,18,18,14,0,0,4,4,8,0,0,16,7:11 - 7:11 - 3:11 - 0:0 - 0:0
16671842,2024-02-03 14:30:00,Soghomonyan Hrayr - Papyan Karen,3:2,11:8 - 9:11 - 11:8 - 10:12 - 14:16,2,3,Soghomonyan Hrayr,Papyan Karen,fiurst,Papyan Karen - Soghomonyan Hrayr,110,55,55,0,0,19,20,19,22,30,3,-2,3,-2,-2,0,8:11 - 11:9 - 8:11 - 12:10 - 16:14
16671839,2024-02-03 14:15:00,Mkrtchyan Andranik - Nazaryan Mushegh,2:3,15:17 - 12:10 - 7:11 - 13:11 - 2:11,2,3,Mkrtchyan Andranik,Nazaryan Mushegh,fiurst,Mkrtchyan Andranik - Nazaryan Mushegh,109,49,60,11,-11,32,22,18,24,13,2,-2,4,-2,9,11,15:17 - 12:10 - 7:11 - 13:11 - 2:11
16671835,2024-02-03 14:05:00,Nikoghosyan Narek - Papyan Karen,2:3,11:6 - 11:9 - 10:12 - 8:11 - 4:11,2,3,Nikoghosyan Narek,Papyan Karen,fiurst,Nikoghosyan Narek - Papyan Karen,93,44,49,5,-5,17,20,22,19,15,-5,-2,2,3,7,5,11:6 - 11:9 - 10:12 - 8:11 - 4:11
16671833,2024-02-03 13:45:00,Soghomonyan Hrayr - Mkrtchyan Andranik,3:0,10:12 - 8:11 - 2:11 - 0:0 - 0:0,0,3,Soghomonyan Hrayr,Mkrtchyan Andranik,fiurst,Mkrtchyan Andranik - Soghomonyan Hrayr,54,34,20,-14,14,22,19,13,0,0,-2,-3,-9,0,0,-14,12:10 - 11:8 - 11:2 - 0:0 - 0:0
16671817,2024-02-03 13:30:00,Nazaryan Mushegh - Nikoghosyan Narek,1:3,6:11 - 11:7 - 6:11 - 6:11 - 0:0,1,3,Nazaryan Mushegh,Nikoghosyan Narek,fiurst,Nazaryan Mushegh - Nikoghosyan Narek,69,29,40,11,-11,17,18,17,17,0,5,-4,5,5,0,11,6:11 - 11:7 - 6:11 - 6:11 - 0:0
16671814,2024-02-03 13:15:00,Papyan Karen - Mkrtchyan Andranik,2:3,5:11 - 10:12 - 11:7 - 11:8 - 11:4,3,2,Papyan Karen,Mkrtchyan Andranik,fiurst,Mkrtchyan Andranik - Papyan Karen,90,42,48,6,-6,16,22,18,19,15,-6,-2,4,3,7,6,11:5 - 12:10 - 7:11 - 8:11 - 4:11
16671810,2024-02-03 13:00:00,Nazaryan Mushegh - Soghomonyan Hrayr,1:3,7:11 - 10:12 - 11:7 - 6:11 - 0:0,1,3,Nazaryan Mushegh,Soghomonyan Hrayr,fiurst,Nazaryan Mushegh - Soghomonyan Hrayr,75,34,41,7,-7,18,22,18,17,0,4,2,-4,5,0,7,7:11 - 10:12 - 11:7 - 6:11 - 0:0
16671784,2024-02-03 12:20:00,Nikoghosyan Narek - Mkrtchyan Andranik,0:3,11:7 - 11:9 - 11:9 - 0:0 - 0:0,3,0,Nikoghosyan Narek,Mkrtchyan Andranik,fiurst,Mkrtchyan Andranik - Nikoghosyan Narek,58,25,33,8,-8,18,20,20,0,0,4,2,2,0,0,8,7:11 - 9:11 - 9:11 - 0:0 - 0:0
16671762,2024-02-03 12:10:00,Nazaryan Mushegh - Papyan Karen,3:0,11:9 - 11:5 - 11:9 - 0:0 - 0:0,3,0,Nazaryan Mushegh,Papyan Karen,fiurst,Nazaryan Mushegh - Papyan Karen,56,33,23,-10,10,20,16,20,0,0,-2,-6,-2,0,0,-10,11:9 - 11:5 - 11:9 - 0:0 - 0:0
16671754,2024-02-03 11:50:00,Nazaryan Mushegh - Mkrtchyan Andranik,1:3,11:6 - 7:11 - 11:9 - 11:7 - 0:0,3,1,Nazaryan Mushegh,Mkrtchyan Andranik,fiurst,Mkrtchyan Andranik - Nazaryan Mushegh,73,33,40,7,-7,17,18,20,18,0,5,-4,2,4,0,7,6:11 - 11:7 - 9:11 - 7:11 - 0:0
16671758,2024-02-03 11:45:00,Soghomonyan Hrayr - Nikoghosyan Narek,3:0,5:11 - 6:11 - 8:11 - 0:0 - 0:0,0,3,Soghomonyan Hrayr,Nikoghosyan Narek,fiurst,Nikoghosyan Narek - Soghomonyan Hrayr,52,33,19,-14,14,16,17,19,0,0,-6,-5,-3,0,0,-14,11:5 - 11:6 - 11:8 - 0:0 - 0:0
16671742,2024-02-03 11:25:00,Papyan Karen - Soghomonyan Hrayr,3:1,11:7 - 4:11 - 11:7 - 12:10 - 0:0,3,1,Papyan Karen,Soghomonyan Hrayr,fiurst,Papyan Karen - Soghomonyan Hrayr,73,38,35,-3,3,18,15,18,22,0,-4,7,-4,-2,0,-3,11:7 - 4:11 - 11:7 - 12:10 - 0:0
16671740,2024-02-03 11:20:00,Nikoghosyan Narek - Nazaryan Mushegh,1:3,8:11 - 11:6 - 11:6 - 11:7 - 0:0,3,1,Nikoghosyan Narek,Nazaryan Mushegh,fiurst,Nazaryan Mushegh - Nikoghosyan Narek,71,30,41,11,-11,19,17,17,18,0,-3,5,5,4,0,11,11:8 - 6:11 - 6:11 - 7:11 - 0:0
16671713,2024-02-03 10:45:00,Papyan Karen - Nikoghosyan Narek,3:2,11:9 - 2:11 - 11:7 - 7:11 - 7:11,2,3,Papyan Karen,Nikoghosyan Narek,fiurst,Nikoghosyan Narek - Papyan Karen,87,49,38,-11,11,20,13,18,18,18,2,-9,4,-4,-4,-11,9:11 - 11:2 - 7:11 - 11:7 - 11:7
16671734,2024-02-03 10:45:00,Mkrtchyan Andranik - Soghomonyan Hrayr,3:0,11:9 - 11:4 - 11:6 - 0:0 - 0:0,3,0,Mkrtchyan Andranik,Soghomonyan Hrayr,fiurst,Mkrtchyan Andranik - Soghomonyan Hrayr,52,33,19,-14,14,20,15,17,0,0,-2,-7,-5,0,0,-14,11:9 - 11:4 - 11:6 - 0:0 - 0:0
16671710,2024-02-03 10:15:00,Soghomonyan Hrayr - Nazaryan Mushegh,3:1,8:11 - 13:11 - 5:11 - 6:11 - 0:0,1,3,Soghomonyan Hrayr,Nazaryan Mushegh,fiurst,Nazaryan Mushegh - Soghomonyan Hrayr,76,44,32,-12,12,19,24,16,17,0,-3,2,-6,-5,0,-12,11:8 - 11:13 - 11:5 - 11:6 - 0:0
16671708,2024-02-03 10:00:00,Mkrtchyan Andranik - Papyan Karen,3:2,11:9 - 7:11 - 11:7 - 9:11 - 13:11,3,2,Mkrtchyan Andranik,Papyan Karen,fiurst,Mkrtchyan Andranik - Papyan Karen,100,51,49,-2,2,20,18,18,20,24,-2,4,-4,2,-2,-2,11:9 - 7:11 - 11:7 - 9:11 - 13:11
16653352,2024-02-02 17:45:00,Petrosyan Davit - Grigoryan Erik,1:3,11:5 - 6:11 - 11:4 - 11:5 - 0:0,3,1,Petrosyan Davit,Grigoryan Erik,fiurst,Grigoryan Erik - Petrosyan Davit,64,25,39,14,-14,16,17,15,16,0,6,-5,7,6,0,14,5:11 - 11:6 - 4:11 - 5:11 - 0:0
16653345,2024-02-02 17:30:00,Karakhanyan Mher - Arutyunov Ruben,3:0,2:11 - 3:11 - 6:11 - 0:0 - 0:0,0,3,Karakhanyan Mher,Arutyunov Ruben,fiurst,Arutyunov Ruben - Karakhanyan Mher,44,33,11,-22,22,13,14,17,0,0,-9,-8,-5,0,0,-22,11:2 - 11:3 - 11:6 - 0:0 - 0:0
16653337,2024-02-02 17:25:00,Gevorgyan Gegham - Petrosyan Davit,0:3,5:11 - 8:11 - 4:11 - 0:0 - 0:0,0,3,Gevorgyan Gegham,Petrosyan Davit,fiurst,Gevorgyan Gegham - Petrosyan Davit,50,17,33,16,-16,16,19,15,0,0,6,3,7,0,0,16,5:11 - 8:11 - 4:11 - 0:0 - 0:0
16653335,2024-02-02 17:00:00,Karakhanyan Mher - Grigoryan Erik,1:3,11:8 - 13:11 - 11:13 - 13:11 - 0:0,3,1,Karakhanyan Mher,Grigoryan Erik,fiurst,Grigoryan Erik - Karakhanyan Mher,91,43,48,5,-5,19,24,24,24,0,3,2,-2,2,0,5,8:11 - 11:13 - 13:11 - 11:13 - 0:0
16653333,2024-02-02 16:55:00,Arutyunov Ruben - Gevorgyan Gegham,3:1,11:5 - 9:11 - 11:8 - 11:5 - 0:0,3,1,Arutyunov Ruben,Gevorgyan Gegham,fiurst,Arutyunov Ruben - Gevorgyan Gegham,71,42,29,-13,13,16,20,19,16,0,-6,2,-3,-6,0,-13,11:5 - 9:11 - 11:8 - 11:5 - 0:0
16653329,2024-02-02 16:30:00,Petrosyan Davit - Karakhanyan Mher,0:3,11:3 - 11:5 - 11:6 - 0:0 - 0:0,3,0,Petrosyan Davit,Karakhanyan Mher,fiurst,Karakhanyan Mher - Petrosyan Davit,47,14,33,19,-19,14,16,17,0,0,8,6,5,0,0,19,3:11 - 5:11 - 6:11 - 0:0 - 0:0
16653317,2024-02-02 16:15:00,Grigoryan Erik - Gevorgyan Gegham,2:3,11:7 - 11:7 - 7:11 - 9:11 - 12:10,3,2,Grigoryan Erik,Gevorgyan Gegham,fiurst,Gevorgyan Gegham - Grigoryan Erik,96,46,50,4,-4,18,18,18,20,22,4,4,-4,-2,2,4,7:11 - 7:11 - 11:7 - 11:9 - 10:12
16653312,2024-02-02 16:00:00,Arutyunov Ruben - Petrosyan Davit,3:1,9:11 - 11:6 - 11:6 - 11:1 - 0:0,3,1,Arutyunov Ruben,Petrosyan Davit,fiurst,Arutyunov Ruben - Petrosyan Davit,66,42,24,-18,18,20,17,17,12,0,2,-5,-5,-10,0,-18,9:11 - 11:6 - 11:6 - 11:1 - 0:0
16653308,2024-02-02 15:45:00,Gevorgyan Gegham - Karakhanyan Mher,0:3,11:13 - 10:12 - 6:11 - 0:0 - 0:0,0,3,Gevorgyan Gegham,Karakhanyan Mher,fiurst,Gevorgyan Gegham - Karakhanyan Mher,63,27,36,9,-9,24,22,17,0,0,2,2,5,0,0,9,11:13 - 10:12 - 6:11 - 0:0 - 0:0
16653306,2024-02-02 15:30:00,Grigoryan Erik - Arutyunov Ruben,3:0,6:11 - 5:11 - 9:11 - 0:0 - 0:0,0,3,Grigoryan Erik,Arutyunov Ruben,fiurst,Arutyunov Ruben - Grigoryan Erik,53,33,20,-13,13,17,16,20,0,0,-5,-6,-2,0,0,-13,11:6 - 11:5 - 11:9 - 0:0 - 0:0
16653303,2024-02-02 15:15:00,Mkrtchyan Andranik - Papyan Karen,0:3,1:11 - 5:11 - 7:11 - 0:0 - 0:0,0,3,Mkrtchyan Andranik,Papyan Karen,fiurst,Mkrtchyan Andranik - Papyan Karen,46,13,33,20,-20,12,16,18,0,0,10,6,4,0,0,20,1:11 - 5:11 - 7:11 - 0:0 - 0:0
16653286,2024-02-02 15:00:00,Nazaryan Mushegh - Rafayelyan Edgar,0:3,6:11 - 8:11 - 8:11 - 0:0 - 0:0,0,3,Nazaryan Mushegh,Rafayelyan Edgar,fiurst,Nazaryan Mushegh - Rafayelyan Edgar,55,22,33,11,-11,17,19,19,0,0,5,3,3,0,0,11,6:11 - 8:11 - 8:11 - 0:0 - 0:0
16653281,2024-02-02 14:50:00,Diaryan Aleksandr - Mkrtchyan Andranik,3:0,11:2 - 11:4 - 11:4 - 0:0 - 0:0,3,0,Diaryan Aleksandr,Mkrtchyan Andranik,fiurst,Diaryan Aleksandr - Mkrtchyan Andranik,43,33,10,-23,23,13,15,15,0,0,-9,-7,-7,0,0,-23,11:2 - 11:4 - 11:4 - 0:0 - 0:0
16653276,2024-02-02 14:30:00,Papyan Karen - Nazaryan Mushegh,2:3,7:11 - 11:5 - 11:8 - 8:11 - 11:8,3,2,Papyan Karen,Nazaryan Mushegh,fiurst,Nazaryan Mushegh - Papyan Karen,91,43,48,5,-5,18,16,19,19,19,-4,6,3,-3,3,5,11:7 - 5:11 - 8:11 - 11:8 - 8:11
16653274,2024-02-02 14:15:00,Diaryan Aleksandr - Rafayelyan Edgar,3:1,11:9 - 11:6 - 9:11 - 11:8 - 0:0,3,1,Diaryan Aleksandr,Rafayelyan Edgar,fiurst,Diaryan Aleksandr - Rafayelyan Edgar,76,42,34,-8,8,20,17,20,19,0,-2,-5,2,-3,0,-8,11:9 - 11:6 - 9:11 - 11:8 - 0:0
16653269,2024-02-02 14:00:00,Mkrtchyan Andranik - Nazaryan Mushegh,2:3,10:12 - 17:15 - 8:11 - 11:5 - 8:11,2,3,Mkrtchyan Andranik,Nazaryan Mushegh,fiurst,Mkrtchyan Andranik - Nazaryan Mushegh,108,54,54,0,0,22,32,19,16,19,2,-2,3,-6,3,0,10:12 - 17:15 - 8:11 - 11:5 - 8:11
16653250,2024-02-02 13:45:00,Papyan Karen - Diaryan Aleksandr,3:0,7:11 - 2:11 - 7:11 - 0:0 - 0:0,0,3,Papyan Karen,Diaryan Aleksandr,fiurst,Diaryan Aleksandr - Papyan Karen,49,33,16,-17,17,18,13,18,0,0,-4,-9,-4,0,0,-17,11:7 - 11:2 - 11:7 - 0:0 - 0:0
16653243,2024-02-02 13:30:00,Rafayelyan Edgar - Mkrtchyan Andranik,0:3,11:6 - 11:6 - 11:8 - 0:0 - 0:0,3,0,Rafayelyan Edgar,Mkrtchyan Andranik,fiurst,Mkrtchyan Andranik - Rafayelyan Edgar,53,20,33,13,-13,17,17,19,0,0,5,5,3,0,0,13,6:11 - 6:11 - 8:11 - 0:0 - 0:0
16653240,2024-02-02 13:15:00,Nazaryan Mushegh - Diaryan Aleksandr,3:1,11:9 - 2:11 - 3:11 - 4:11 - 0:0,1,3,Nazaryan Mushegh,Diaryan Aleksandr,fiurst,Diaryan Aleksandr - Nazaryan Mushegh,62,42,20,-22,22,20,13,14,15,0,2,-9,-8,-7,0,-22,9:11 - 11:2 - 11:3 - 11:4 - 0:0
16653222,2024-02-02 13:05:00,Rafayelyan Edgar - Papyan Karen,3:0,10:12 - 4:11 - 4:11 - 0:0 - 0:0,0,3,Rafayelyan Edgar,Papyan Karen,fiurst,Papyan Karen - Rafayelyan Edgar,52,34,18,-16,16,22,15,15,0,0,-2,-7,-7,0,0,-16,12:10 - 11:4 - 11:4 - 0:0 - 0:0
16653213,2024-02-02 12:15:00,Mkrtchyan Andranik - Diaryan Aleksandr,3:1,11:13 - 8:11 - 11:9 - 8:11 - 0:0,1,3,Mkrtchyan Andranik,Diaryan Aleksandr,fiurst,Diaryan Aleksandr - Mkrtchyan Andranik,82,44,38,-6,6,24,19,20,19,0,-2,-3,2,-3,0,-6,13:11 - 11:8 - 9:11 - 11:8 - 0:0
16653210,2024-02-02 12:00:00,Rafayelyan Edgar - Nazaryan Mushegh,2:3,11:9 - 8:11 - 7:11 - 11:2 - 11:8,3,2,Rafayelyan Edgar,Nazaryan Mushegh,fiurst,Nazaryan Mushegh - Rafayelyan Edgar,89,41,48,7,-7,20,19,18,13,19,2,-3,-4,9,3,7,9:11 - 11:8 - 11:7 - 2:11 - 8:11
16653208,2024-02-02 11:45:00,Papyan Karen - Mkrtchyan Andranik,1:3,12:10 - 11:6 - 10:12 - 11:8 - 0:0,3,1,Papyan Karen,Mkrtchyan Andranik,fiurst,Mkrtchyan Andranik - Papyan Karen,80,36,44,8,-8,22,17,22,19,0,2,5,-2,3,0,8,10:12 - 6:11 - 12:10 - 8:11 - 0:0
16653205,2024-02-02 11:30:00,Rafayelyan Edgar - Diaryan Aleksandr,3:1,3:11 - 11:8 - 9:11 - 9:11 - 0:0,1,3,Rafayelyan Edgar,Diaryan Aleksandr,fiurst,Diaryan Aleksandr - Rafayelyan Edgar,73,41,32,-9,9,14,19,20,20,0,-8,3,-2,-2,0,-9,11:3 - 8:11 - 11:9 - 11:9 - 0:0
16653191,2024-02-02 11:25:00,Nazaryan Mushegh - Papyan Karen,1:3,8:11 - 8:11 - 11:8 - 6:11 - 0:0,1,3,Nazaryan Mushegh,Papyan Karen,fiurst,Nazaryan Mushegh - Papyan Karen,74,33,41,8,-8,19,19,19,17,0,3,3,-3,5,0,8,8:11 - 8:11 - 11:8 - 6:11 - 0:0
16653187,2024-02-02 11:00:00,Mkrtchyan Andranik - Rafayelyan Edgar,0:3,10:12 - 12:14 - 5:11 - 0:0 - 0:0,0,3,Mkrtchyan Andranik,Rafayelyan Edgar,fiurst,Mkrtchyan Andranik - Rafayelyan Edgar,64,27,37,10,-10,22,26,16,0,0,2,2,6,0,0,10,10:12 - 12:14 - 5:11 - 0:0 - 0:0
16653181,2024-02-02 10:45:00,Diaryan Aleksandr - Papyan Karen,3:2,11:8 - 7:11 - 6:11 - 11:5 - 11:8,3,2,Diaryan Aleksandr,Papyan Karen,fiurst,Diaryan Aleksandr - Papyan Karen,89,46,43,-3,3,19,18,17,16,19,-3,4,5,-6,-3,-3,11:8 - 7:11 - 6:11 - 11:5 - 11:8
16653179,2024-02-02 10:30:00,Nazaryan Mushegh - Mkrtchyan Andranik,0:3,11:8 - 11:5 - 11:4 - 0:0 - 0:0,3,0,Nazaryan Mushegh,Mkrtchyan Andranik,fiurst,Mkrtchyan Andranik - Nazaryan Mushegh,50,17,33,16,-16,19,16,15,0,0,3,6,7,0,0,16,8:11 - 5:11 - 4:11 - 0:0 - 0:0
16653177,2024-02-02 10:15:00,Papyan Karen - Rafayelyan Edgar,3:0,11:4 - 11:6 - 11:9 - 0:0 - 0:0,3,0,Papyan Karen,Rafayelyan Edgar,fiurst,Papyan Karen - Rafayelyan Edgar,52,33,19,-14,14,15,17,20,0,0,-7,-5,-2,0,0,-14,11:4 - 11:6 - 11:9 - 0:0 - 0:0
16653172,2024-02-02 10:00:00,Diaryan Aleksandr - Nazaryan Mushegh,3:1,11:9 - 6:11 - 11:5 - 11:4 - 0:0,3,1,Diaryan Aleksandr,Nazaryan Mushegh,fiurst,Diaryan Aleksandr - Nazaryan Mushegh,68,39,29,-10,10,20,17,16,15,0,-2,5,-6,-7,0,-10,11:9 - 6:11 - 11:5 - 11:4 - 0:0
16638049,2024-02-01 17:45:00,Grigoryan Erik - Mkrtchyan Andranik,2:3,11:9 - 4:11 - 8:11 - 11:9 - 5:11,2,3,Grigoryan Erik,Mkrtchyan Andranik,fiurst,Grigoryan Erik - Mkrtchyan Andranik,90,39,51,12,-12,20,15,19,20,16,-2,7,3,-2,6,12,11:9 - 4:11 - 8:11 - 11:9 - 5:11
16638047,2024-02-01 17:30:00,Arutyunov Ruben - Avakimyan Davit,3:0,11:6 - 11:3 - 11:2 - 0:0 - 0:0,3,0,Arutyunov Ruben,Avakimyan Davit,fiurst,Arutyunov Ruben - Avakimyan Davit,44,33,11,-22,22,17,14,13,0,0,-5,-8,-9,0,0,-22,11:6 - 11:3 - 11:2 - 0:0 - 0:0
16638040,2024-02-01 17:15:00,Petrosyan Davit - Grigoryan Erik,0:3,11:2 - 11:6 - 11:7 - 0:0 - 0:0,3,0,Petrosyan Davit,Grigoryan Erik,fiurst,Grigoryan Erik - Petrosyan Davit,48,15,33,18,-18,13,17,18,0,0,9,5,4,0,0,18,2:11 - 6:11 - 7:11 - 0:0 - 0:0
16638035,2024-02-01 17:00:00,Arutyunov Ruben - Mkrtchyan Andranik,2:3,11:9 - 12:10 - 7:11 - 10:12 - 7:11,2,3,Arutyunov Ruben,Mkrtchyan Andranik,fiurst,Arutyunov Ruben - Mkrtchyan Andranik,100,47,53,6,-6,20,22,18,22,18,-2,-2,4,2,4,6,11:9 - 12:10 - 7:11 - 10:12 - 7:11
16638023,2024-02-01 16:45:00,Avakimyan Davit - Petrosyan Davit,3:2,8:11 - 11:7 - 11:9 - 7:11 - 11:4,3,2,Avakimyan Davit,Petrosyan Davit,fiurst,Avakimyan Davit - Petrosyan Davit,90,48,42,-6,6,19,18,20,18,15,3,-4,-2,4,-7,-6,8:11 - 11:7 - 11:9 - 7:11 - 11:4
16638020,2024-02-01 16:30:00,Grigoryan Erik - Arutyunov Ruben,3:0,6:11 - 3:11 - 9:11 - 0:0 - 0:0,0,3,Grigoryan Erik,Arutyunov Ruben,fiurst,Arutyunov Ruben - Grigoryan Erik,51,33,18,-15,15,17,14,20,0,0,-5,-8,-2,0,0,-15,11:6 - 11:3 - 11:9 - 0:0 - 0:0
16638016,2024-02-01 16:15:00,Mkrtchyan Andranik - Petrosyan Davit,3:0,12:10 - 11:7 - 11:9 - 0:0 - 0:0,3,0,Mkrtchyan Andranik,Petrosyan Davit,fiurst,Mkrtchyan Andranik - Petrosyan Davit,60,34,26,-8,8,22,18,20,0,0,-2,-4,-2,0,0,-8,12:10 - 11:7 - 11:9 - 0:0 - 0:0
16638013,2024-02-01 16:00:00,Avakimyan Davit - Grigoryan Erik,3:0,13:11 - 11:7 - 11:4 - 0:0 - 0:0,3,0,Avakimyan Davit,Grigoryan Erik,fiurst,Avakimyan Davit - Grigoryan Erik,57,35,22,-13,13,24,18,15,0,0,-2,-4,-7,0,0,-13,13:11 - 11:7 - 11:4 - 0:0 - 0:0
16638009,2024-02-01 15:45:00,Petrosyan Davit - Arutyunov Ruben,3:0,2:11 - 6:11 - 5:11 - 0:0 - 0:0,0,3,Petrosyan Davit,Arutyunov Ruben,fiurst,Arutyunov Ruben - Petrosyan Davit,46,33,13,-20,20,13,17,16,0,0,-9,-5,-6,0,0,-20,11:2 - 11:6 - 11:5 - 0:0 - 0:0
16638005,2024-02-01 15:30:00,Mkrtchyan Andranik - Avakimyan Davit,3:1,6:11 - 4:11 - 11:3 - 7:11 - 0:0,1,3,Mkrtchyan Andranik,Avakimyan Davit,fiurst,Avakimyan Davit - Mkrtchyan Andranik,64,36,28,-8,8,17,15,14,18,0,-5,-7,8,-4,0,-8,11:6 - 11:4 - 3:11 - 11:7 - 0:0
16637963,2024-02-01 15:15:00,Nazaryan Mushegh - Papyan Karen,3:0,13:11 - 11:4 - 11:9 - 0:0 - 0:0,3,0,Nazaryan Mushegh,Papyan Karen,fiurst,Nazaryan Mushegh - Papyan Karen,59,35,24,-11,11,24,15,20,0,0,-2,-7,-2,0,0,-11,13:11 - 11:4 - 11:9 - 0:0 - 0:0
16637950,2024-02-01 15:00:00,Rafayelyan Edgar - Nazaryan Mushegh,0:3,11:5 - 11:8 - 11:6 - 0:0 - 0:0,3,0,Rafayelyan Edgar,Nazaryan Mushegh,fiurst,Nazaryan Mushegh - Rafayelyan Edgar,52,19,33,14,-14,16,19,17,0,0,6,3,5,0,0,14,5:11 - 8:11 - 6:11 - 0:0 - 0:0
16637951,2024-02-01 15:00:00,Soghomonyan Hrayr - Nikoghosyan Narek,3:1,11:7 - 8:11 - 2:11 - 4:11 - 0:0,1,3,Soghomonyan Hrayr,Nikoghosyan Narek,fiurst,Nikoghosyan Narek - Soghomonyan Hrayr,65,40,25,-15,15,18,19,13,15,0,4,-3,-9,-7,0,-15,7:11 - 11:8 - 11:2 - 11:4 - 0:0
16637949,2024-02-01 14:45:00,Papyan Karen - Soghomonyan Hrayr,3:1,11:9 - 13:15 - 11:4 - 11:6 - 0:0,3,1,Papyan Karen,Soghomonyan Hrayr,fiurst,Papyan Karen - Soghomonyan Hrayr,80,46,34,-12,12,20,28,15,17,0,-2,2,-7,-5,0,-12,11:9 - 13:15 - 11:4 - 11:6 - 0:0
16637948,2024-02-01 14:30:00,Rafayelyan Edgar - Nikoghosyan Narek,1:3,11:5 - 3:11 - 11:8 - 11:1 - 0:0,3,1,Rafayelyan Edgar,Nikoghosyan Narek,fiurst,Nikoghosyan Narek - Rafayelyan Edgar,61,25,36,11,-11,16,14,19,12,0,6,-8,3,10,0,11,5:11 - 11:3 - 8:11 - 1:11 - 0:0
16637947,2024-02-01 14:25:00,Nazaryan Mushegh - Soghomonyan Hrayr,3:0,11:9 - 11:6 - 11:8 - 0:0 - 0:0,3,0,Nazaryan Mushegh,Soghomonyan Hrayr,fiurst,Nazaryan Mushegh - Soghomonyan Hrayr,56,33,23,-10,10,20,17,19,0,0,-2,-5,-3,0,0,-10,11:9 - 11:6 - 11:8 - 0:0 - 0:0
16637943,2024-02-01 13:55:00,Papyan Karen - Rafayelyan Edgar,1:3,11:5 - 8:11 - 10:12 - 3:11 - 0:0,1,3,Papyan Karen,Rafayelyan Edgar,fiurst,Papyan Karen - Rafayelyan Edgar,71,32,39,7,-7,16,19,22,14,0,-6,3,2,8,0,7,11:5 - 8:11 - 10:12 - 3:11 - 0:0
16637938,2024-02-01 13:50:00,Nikoghosyan Narek - Nazaryan Mushegh,2:3,11:9 - 11:4 - 7:11 - 12:14 - 11:6,3,2,Nikoghosyan Narek,Nazaryan Mushegh,fiurst,Nazaryan Mushegh - Nikoghosyan Narek,96,44,52,8,-8,20,15,18,26,17,2,7,-4,-2,5,8,9:11 - 4:11 - 11:7 - 14:12 - 6:11
16637935,2024-02-01 13:25:00,Soghomonyan Hrayr - Rafayelyan Edgar,3:0,8:11 - 2:11 - 2:11 - 0:0 - 0:0,0,3,Soghomonyan Hrayr,Rafayelyan Edgar,fiurst,Rafayelyan Edgar - Soghomonyan Hrayr,45,33,12,-21,21,19,13,13,0,0,-3,-9,-9,0,0,-21,11:8 - 11:2 - 11:2 - 0:0 - 0:0
16637932,2024-02-01 13:05:00,Nikoghosyan Narek - Papyan Karen,2:3,11:13 - 11:9 - 5:11 - 11:8 - 6:11,2,3,Nikoghosyan Narek,Papyan Karen,fiurst,Nikoghosyan Narek - Papyan Karen,96,44,52,8,-8,24,20,16,19,17,2,-2,6,-3,5,8,11:13 - 11:9 - 5:11 - 11:8 - 6:11
16637911,2024-02-01 12:40:00,Nikoghosyan Narek - Soghomonyan Hrayr,3:0,11:4 - 11:3 - 11:5 - 0:0 - 0:0,3,0,Nikoghosyan Narek,Soghomonyan Hrayr,fiurst,Nikoghosyan Narek - Soghomonyan Hrayr,45,33,12,-21,21,15,14,16,0,0,-7,-8,-6,0,0,-21,11:4 - 11:3 - 11:5 - 0:0 - 0:0
16637915,2024-02-01 12:40:00,Nazaryan Mushegh - Rafayelyan Edgar,0:3,9:11 - 8:11 - 9:11 - 0:0 - 0:0,0,3,Nazaryan Mushegh,Rafayelyan Edgar,fiurst,Nazaryan Mushegh - Rafayelyan Edgar,59,26,33,7,-7,20,19,20,0,0,2,3,2,0,0,7,9:11 - 8:11 - 9:11 - 0:0 - 0:0
16637910,2024-02-01 12:00:00,Papyan Karen - Nazaryan Mushegh,1:3,11:9 - 11:9 - 4:11 - 12:10 - 0:0,3,1,Papyan Karen,Nazaryan Mushegh,fiurst,Nazaryan Mushegh - Papyan Karen,77,39,38,-1,1,20,20,15,22,0,2,2,-7,2,0,-1,9:11 - 9:11 - 11:4 - 10:12 - 0:0
16637909,2024-02-01 11:55:00,Nikoghosyan Narek - Rafayelyan Edgar,2:3,8:11 - 11:8 - 7:11 - 11:9 - 7:11,2,3,Nikoghosyan Narek,Rafayelyan Edgar,fiurst,Nikoghosyan Narek - Rafayelyan Edgar,94,44,50,6,-6,19,19,18,20,18,3,-3,4,-2,4,6,8:11 - 11:8 - 7:11 - 11:9 - 7:11
16637905,2024-02-01 11:40:00,Soghomonyan Hrayr - Papyan Karen,3:0,9:11 - 9:11 - 7:11 - 0:0 - 0:0,0,3,Soghomonyan Hrayr,Papyan Karen,fiurst,Papyan Karen - Soghomonyan Hrayr,58,33,25,-8,8,20,20,18,0,0,-2,-2,-4,0,0,-8,11:9 - 11:9 - 11:7 - 0:0 - 0:0
16637902,2024-02-01 11:10:00,Rafayelyan Edgar - Papyan Karen,1:3,11:13 - 11:9 - 11:9 - 11:7 - 0:0,3,1,Rafayelyan Edgar,Papyan Karen,fiurst,Papyan Karen - Rafayelyan Edgar,82,38,44,6,-6,24,20,20,18,0,-2,2,2,4,0,6,13:11 - 9:11 - 9:11 - 7:11 - 0:0
16637904,2024-02-01 11:10:00,Nazaryan Mushegh - Nikoghosyan Narek,2:3,11:9 - 14:12 - 8:11 - 6:11 - 9:11,2,3,Nazaryan Mushegh,Nikoghosyan Narek,fiurst,Nazaryan Mushegh - Nikoghosyan Narek,102,48,54,6,-6,20,26,19,17,20,-2,-2,3,5,2,6,11:9 - 14:12 - 8:11 - 6:11 - 9:11
16637901,2024-02-01 10:30:00,Soghomonyan Hrayr - Nazaryan Mushegh,3:2,11:8 - 6:11 - 4:11 - 12:10 - 8:11,2,3,Soghomonyan Hrayr,Nazaryan Mushegh,fiurst,Nazaryan Mushegh - Soghomonyan Hrayr,92,51,41,-10,10,19,17,15,22,19,3,-5,-7,2,-3,-10,8:11 - 11:6 - 11:4 - 10:12 - 11:8
16637890,2024-02-01 10:15:00,Papyan Karen - Nikoghosyan Narek,2:3,11:9 - 8:11 - 12:10 - 14:16 - 11:9,3,2,Papyan Karen,Nikoghosyan Narek,fiurst,Nikoghosyan Narek - Papyan Karen,111,55,56,1,-1,20,19,22,30,20,2,-3,2,-2,2,1,9:11 - 11:8 - 10:12 - 16:14 - 9:11
16637888,2024-02-01 10:00:00,Rafayelyan Edgar - Soghomonyan Hrayr,3:0,11:6 - 11:8 - 11:3 - 0:0 - 0:0,3,0,Rafayelyan Edgar,Soghomonyan Hrayr,fiurst,Rafayelyan Edgar - Soghomonyan Hrayr,50,33,17,-16,16,17,19,14,0,0,-5,-3,-8,0,0,-16,11:6 - 11:8 - 11:3 - 0:0 - 0:0
16615729,2024-01-31 17:45:00,Avakimyan Davit - Karakhanyan Mher,3:0,13:11 - 11:6 - 11:8 - 0:0 - 0:0,3,0,Avakimyan Davit,Karakhanyan Mher,fiurst,Avakimyan Davit - Karakhanyan Mher,60,35,25,-10,10,24,17,19,0,0,-2,-5,-3,0,0,-10,13:11 - 11:6 - 11:8 - 0:0 - 0:0
16615727,2024-01-31 17:30:00,Petrosyan Davit - Gevorgyan Gegham,0:3,11:4 - 11:8 - 11:7 - 0:0 - 0:0,3,0,Petrosyan Davit,Gevorgyan Gegham,fiurst,Gevorgyan Gegham - Petrosyan Davit,52,19,33,14,-14,15,19,18,0,0,7,3,4,0,0,14,4:11 - 8:11 - 7:11 - 0:0 - 0:0
16615723,2024-01-31 17:15:00,Gevorgyan Hayk - Avakimyan Davit,1:1,11:2 - 4:11 - 7:7 - 0:0 - 0:0,1,1,Gevorgyan Hayk,Avakimyan Davit,fiurst,Avakimyan Davit - Gevorgyan Hayk,42,20,22,2,-2,13,15,14,0,0,9,-7,0,0,0,2,2:11 - 11:4 - 7:7 - 0:0 - 0:0
16615721,2024-01-31 17:00:00,Petrosyan Davit - Karakhanyan Mher,1:3,11:9 - 8:11 - 11:6 - 11:7 - 0:0,3,1,Petrosyan Davit,Karakhanyan Mher,fiurst,Karakhanyan Mher - Petrosyan Davit,74,33,41,8,-8,20,19,17,18,0,2,-3,5,4,0,8,9:11 - 11:8 - 6:11 - 7:11 - 0:0
16615703,2024-01-31 16:45:00,Gevorgyan Gegham - Gevorgyan Hayk,1:3,11:6 - 7:11 - 9:11 - 8:11 - 0:0,1,3,Gevorgyan Gegham,Gevorgyan Hayk,fiurst,Gevorgyan Gegham - Gevorgyan Hayk,74,35,39,4,-4,17,18,20,19,0,-5,4,2,3,0,4,11:6 - 7:11 - 9:11 - 8:11 - 0:0
16615700,2024-01-31 16:30:00,Avakimyan Davit - Petrosyan Davit,3:2,10:12 - 9:11 - 11:6 - 12:10 - 11:5,3,2,Avakimyan Davit,Petrosyan Davit,fiurst,Avakimyan Davit - Petrosyan Davit,97,53,44,-9,9,22,20,17,22,16,2,2,-5,-2,-6,-9,10:12 - 9:11 - 11:6 - 12:10 - 11:5
16615699,2024-01-31 16:15:00,Karakhanyan Mher - Gevorgyan Hayk,3:1,7:11 - 11:6 - 7:11 - 5:11 - 0:0,1,3,Karakhanyan Mher,Gevorgyan Hayk,fiurst,Gevorgyan Hayk - Karakhanyan Mher,69,39,30,-9,9,18,17,18,16,0,-4,5,-4,-6,0,-9,11:7 - 6:11 - 11:7 - 11:5 - 0:0
16615697,2024-01-31 16:00:00,Gevorgyan Gegham - Avakimyan Davit,3:2,4:11 - 11:9 - 9:11 - 11:5 - 9:11,2,3,Gevorgyan Gegham,Avakimyan Davit,fiurst,Avakimyan Davit - Gevorgyan Gegham,91,47,44,-3,3,15,20,20,16,20,-7,2,-2,6,-2,-3,11:4 - 9:11 - 11:9 - 5:11 - 11:9
16615694,2024-01-31 15:45:00,Gevorgyan Hayk - Petrosyan Davit,1:3,11:6 - 10:12 - 6:11 - 4:11 - 0:0,1,3,Gevorgyan Hayk,Petrosyan Davit,fiurst,Gevorgyan Hayk - Petrosyan Davit,71,31,40,9,-9,17,22,17,15,0,-5,2,5,7,0,9,11:6 - 10:12 - 6:11 - 4:11 - 0:0
16615681,2024-01-31 15:30:00,Karakhanyan Mher - Gevorgyan Gegham,3:0,7:11 - 11:13 - 6:11 - 0:0 - 0:0,0,3,Karakhanyan Mher,Gevorgyan Gegham,fiurst,Gevorgyan Gegham - Karakhanyan Mher,59,35,24,-11,11,18,24,17,0,0,-4,-2,-5,0,0,-11,11:7 - 13:11 - 11:6 - 0:0 - 0:0
16615657,2024-01-31 15:15:00,Rafayelyan Edgar - Soghomonyan Hrayr,3:0,11:4 - 11:6 - 12:10 - 0:0 - 0:0,3,0,Rafayelyan Edgar,Soghomonyan Hrayr,fiurst,Rafayelyan Edgar - Soghomonyan Hrayr,54,34,20,-14,14,15,17,22,0,0,-7,-5,-2,0,0,-14,11:4 - 11:6 - 12:10 - 0:0 - 0:0
16615655,2024-01-31 15:00:00,Mkrtchyan Andranik - Diaryan Aleksandr,3:0,2:11 - 2:11 - 4:11 - 0:0 - 0:0,0,3,Mkrtchyan Andranik,Diaryan Aleksandr,fiurst,Diaryan Aleksandr - Mkrtchyan Andranik,41,33,8,-25,25,13,13,15,0,0,-9,-9,-7,0,0,-25,11:2 - 11:2 - 11:4 - 0:0 - 0:0
16615644,2024-01-31 14:50:00,Nikoghosyan Narek - Rafayelyan Edgar,3:0,11:7 - 11:4 - 11:7 - 0:0 - 0:0,3,0,Nikoghosyan Narek,Rafayelyan Edgar,fiurst,Nikoghosyan Narek - Rafayelyan Edgar,51,33,18,-15,15,18,15,18,0,0,-4,-7,-4,0,0,-15,11:7 - 11:4 - 11:7 - 0:0 - 0:0
16615242,2024-01-31 14:30:00,Soghomonyan Hrayr - Mkrtchyan Andranik,3:0,7:11 - 4:11 - 6:11 - 0:0 - 0:0,0,3,Soghomonyan Hrayr,Mkrtchyan Andranik,fiurst,Mkrtchyan Andranik - Soghomonyan Hrayr,50,33,17,-16,16,18,15,17,0,0,-4,-7,-5,0,0,-16,11:7 - 11:4 - 11:6 - 0:0 - 0:0
16615221,2024-01-31 14:15:00,Nikoghosyan Narek - Diaryan Aleksandr,0:3,11:4 - 15:13 - 14:12 - 0:0 - 0:0,3,0,Nikoghosyan Narek,Diaryan Aleksandr,fiurst,Diaryan Aleksandr - Nikoghosyan Narek,69,29,40,11,-11,15,28,26,0,0,7,2,2,0,0,11,4:11 - 13:15 - 12:14 - 0:0 - 0:0
16615220,2024-01-31 14:00:00,Rafayelyan Edgar - Mkrtchyan Andranik,0:3,11:5 - 11:9 - 11:6 - 0:0 - 0:0,3,0,Rafayelyan Edgar,Mkrtchyan Andranik,fiurst,Mkrtchyan Andranik - Rafayelyan Edgar,53,20,33,13,-13,16,20,17,0,0,6,2,5,0,0,13,5:11 - 9:11 - 6:11 - 0:0 - 0:0
16615216,2024-01-31 13:45:00,Soghomonyan Hrayr - Nikoghosyan Narek,3:0,4:11 - 5:11 - 4:11 - 0:0 - 0:0,0,3,Soghomonyan Hrayr,Nikoghosyan Narek,fiurst,Nikoghosyan Narek - Soghomonyan Hrayr,46,33,13,-20,20,15,16,15,0,0,-7,-6,-7,0,0,-20,11:4 - 11:5 - 11:4 - 0:0 - 0:0
16615201,2024-01-31 13:30:00,Diaryan Aleksandr - Rafayelyan Edgar,3:1,11:6 - 11:5 - 4:11 - 11:9 - 0:0,3,1,Diaryan Aleksandr,Rafayelyan Edgar,fiurst,Diaryan Aleksandr - Rafayelyan Edgar,68,37,31,-6,6,17,16,15,20,0,-5,-6,7,-2,0,-6,11:6 - 11:5 - 4:11 - 11:9 - 0:0
16615195,2024-01-31 13:15:00,Mkrtchyan Andranik - Nikoghosyan Narek,0:3,8:11 - 3:11 - 11:13 - 0:0 - 0:0,0,3,Mkrtchyan Andranik,Nikoghosyan Narek,fiurst,Mkrtchyan Andranik - Nikoghosyan Narek,57,22,35,13,-13,19,14,24,0,0,3,8,2,0,0,13,8:11 - 3:11 - 11:13 - 0:0 - 0:0
16615192,2024-01-31 13:00:00,Diaryan Aleksandr - Soghomonyan Hrayr,3:0,11:3 - 11:5 - 11:5 - 0:0 - 0:0,3,0,Diaryan Aleksandr,Soghomonyan Hrayr,fiurst,Diaryan Aleksandr - Soghomonyan Hrayr,46,33,13,-20,20,14,16,16,0,0,-8,-6,-6,0,0,-20,11:3 - 11:5 - 11:5 - 0:0 - 0:0
16615189,2024-01-31 12:20:00,Rafayelyan Edgar - Nikoghosyan Narek,2:3,6:11 - 11:5 - 11:8 - 9:11 - 11:3,3,2,Rafayelyan Edgar,Nikoghosyan Narek,fiurst,Nikoghosyan Narek - Rafayelyan Edgar,86,38,48,10,-10,17,16,19,20,14,-5,6,3,-2,8,10,11:6 - 5:11 - 8:11 - 11:9 - 3:11
16615186,2024-01-31 12:15:00,Diaryan Aleksandr - Mkrtchyan Andranik,3:0,11:3 - 11:2 - 11:5 - 0:0 - 0:0,3,0,Diaryan Aleksandr,Mkrtchyan Andranik,fiurst,Diaryan Aleksandr - Mkrtchyan Andranik,43,33,10,-23,23,14,13,16,0,0,-8,-9,-6,0,0,-23,11:3 - 11:2 - 11:5 - 0:0 - 0:0
16615183,2024-01-31 11:45:00,Soghomonyan Hrayr - Rafayelyan Edgar,3:0,6:11 - 10:12 - 6:11 - 0:0 - 0:0,0,3,Soghomonyan Hrayr,Rafayelyan Edgar,fiurst,Rafayelyan Edgar - Soghomonyan Hrayr,56,34,22,-12,12,17,22,17,0,0,-5,-2,-5,0,0,-12,11:6 - 12:10 - 11:6 - 0:0 - 0:0
16615182,2024-01-31 11:30:00,Diaryan Aleksandr - Nikoghosyan Narek,3:2,11:5 - 6:11 - 11:4 - 11:13 - 11:4,3,2,Diaryan Aleksandr,Nikoghosyan Narek,fiurst,Diaryan Aleksandr - Nikoghosyan Narek,87,50,37,-13,13,16,17,15,24,15,-6,5,-7,2,-7,-13,11:5 - 6:11 - 11:4 - 11:13 - 11:4
16615176,2024-01-31 11:15:00,Mkrtchyan Andranik - Soghomonyan Hrayr,3:0,11:8 - 13:11 - 11:8 - 0:0 - 0:0,3,0,Mkrtchyan Andranik,Soghomonyan Hrayr,fiurst,Mkrtchyan Andranik - Soghomonyan Hrayr,62,35,27,-8,8,19,24,19,0,0,-3,-2,-3,0,0,-8,11:8 - 13:11 - 11:8 - 0:0 - 0:0
16615158,2024-01-31 11:00:00,Rafayelyan Edgar - Diaryan Aleksandr,3:1,11:8 - 10:12 - 11:13 - 7:11 - 0:0,1,3,Rafayelyan Edgar,Diaryan Aleksandr,fiurst,Diaryan Aleksandr - Rafayelyan Edgar,83,44,39,-5,5,19,22,24,18,0,3,-2,-2,-4,0,-5,8:11 - 12:10 - 13:11 - 11:7 - 0:0
16615155,2024-01-31 10:45:00,Nikoghosyan Narek - Soghomonyan Hrayr,3:0,11:9 - 11:6 - 11:3 - 0:0 - 0:0,3,0,Nikoghosyan Narek,Soghomonyan Hrayr,fiurst,Nikoghosyan Narek - Soghomonyan Hrayr,51,33,18,-15,15,20,17,14,0,0,-2,-5,-8,0,0,-15,11:9 - 11:6 - 11:3 - 0:0 - 0:0
16615151,2024-01-31 10:30:00,Mkrtchyan Andranik - Rafayelyan Edgar,1:3,8:11 - 9:11 - 11:7 - 7:11 - 0:0,1,3,Mkrtchyan Andranik,Rafayelyan Edgar,fiurst,Mkrtchyan Andranik - Rafayelyan Edgar,75,35,40,5,-5,19,20,18,18,0,3,2,-4,4,0,5,8:11 - 9:11 - 11:7 - 7:11 - 0:0
16615143,2024-01-31 10:15:00,Soghomonyan Hrayr - Diaryan Aleksandr,3:0,2:11 - 9:11 - 1:11 - 0:0 - 0:0,0,3,Soghomonyan Hrayr,Diaryan Aleksandr,fiurst,Diaryan Aleksandr - Soghomonyan Hrayr,45,33,12,-21,21,13,20,12,0,0,-9,-2,-10,0,0,-21,11:2 - 11:9 - 11:1 - 0:0 - 0:0
16615142,2024-01-31 10:00:00,Nikoghosyan Narek - Mkrtchyan Andranik,0:3,11:7 - 12:10 - 11:5 - 0:0 - 0:0,3,0,Nikoghosyan Narek,Mkrtchyan Andranik,fiurst,Mkrtchyan Andranik - Nikoghosyan Narek,56,22,34,12,-12,18,22,16,0,0,4,2,6,0,0,12,7:11 - 10:12 - 5:11 - 0:0 - 0:0
16596708,2024-01-30 17:45:00,Karakhanyan Mher - Avakimyan Davit,3:0,12:14 - 9:11 - 10:12 - 0:0 - 0:0,0,3,Karakhanyan Mher,Avakimyan Davit,fiurst,Avakimyan Davit - Karakhanyan Mher,68,37,31,-6,6,26,20,22,0,0,-2,-2,-2,0,0,-6,14:12 - 11:9 - 12:10 - 0:0 - 0:0
16596702,2024-01-30 17:30:00,Arutyunov Ruben - Gevorgyan Gegham,3:0,11:7 - 11:2 - 11:8 - 0:0 - 0:0,3,0,Arutyunov Ruben,Gevorgyan Gegham,fiurst,Arutyunov Ruben - Gevorgyan Gegham,50,33,17,-16,16,18,13,19,0,0,-4,-9,-3,0,0,-16,11:7 - 11:2 - 11:8 - 0:0 - 0:0
16596700,2024-01-30 17:15:00,Grigoryan Erik - Karakhanyan Mher,0:3,6:11 - 3:11 - 5:11 - 0:0 - 0:0,0,3,Grigoryan Erik,Karakhanyan Mher,fiurst,Grigoryan Erik - Karakhanyan Mher,47,14,33,19,-19,17,14,16,0,0,5,8,6,0,0,19,6:11 - 3:11 - 5:11 - 0:0 - 0:0
16596698,2024-01-30 17:00:00,Arutyunov Ruben - Avakimyan Davit,3:0,11:7 - 11:3 - 11:3 - 0:0 - 0:0,3,0,Arutyunov Ruben,Avakimyan Davit,fiurst,Arutyunov Ruben - Avakimyan Davit,46,33,13,-20,20,18,14,14,0,0,-4,-8,-8,0,0,-20,11:7 - 11:3 - 11:3 - 0:0 - 0:0
16596687,2024-01-30 16:45:00,Gevorgyan Gegham - Grigoryan Erik,3:1,11:9 - 11:4 - 6:11 - 11:8 - 0:0,3,1,Gevorgyan Gegham,Grigoryan Erik,fiurst,Gevorgyan Gegham - Grigoryan Erik,71,39,32,-7,7,20,15,17,19,0,-2,-7,5,-3,0,-7,11:9 - 11:4 - 6:11 - 11:8 - 0:0
16596682,2024-01-30 16:30:00,Karakhanyan Mher - Arutyunov Ruben,3:2,11:7 - 7:11 - 12:10 - 8:11 - 7:11,2,3,Karakhanyan Mher,Arutyunov Ruben,fiurst,Arutyunov Ruben - Karakhanyan Mher,95,50,45,-5,5,18,18,22,19,18,4,-4,2,-3,-4,-5,7:11 - 11:7 - 10:12 - 11:8 - 11:7
16596679,2024-01-30 16:15:00,Avakimyan Davit - Grigoryan Erik,3:0,11:5 - 11:6 - 11:6 - 0:0 - 0:0,3,0,Avakimyan Davit,Grigoryan Erik,fiurst,Avakimyan Davit - Grigoryan Erik,50,33,17,-16,16,16,17,17,0,0,-6,-5,-5,0,0,-16,11:5 - 11:6 - 11:6 - 0:0 - 0:0
16596676,2024-01-30 16:00:00,Gevorgyan Gegham - Karakhanyan Mher,3:0,11:3 - 11:9 - 11:7 - 0:0 - 0:0,3,0,Gevorgyan Gegham,Karakhanyan Mher,fiurst,Gevorgyan Gegham - Karakhanyan Mher,52,33,19,-14,14,14,20,18,0,0,-8,-2,-4,0,0,-14,11:3 - 11:9 - 11:7 - 0:0 - 0:0
16596674,2024-01-30 15:45:00,Grigoryan Erik - Arutyunov Ruben,3:0,8:11 - 6:11 - 9:11 - 0:0 - 0:0,0,3,Grigoryan Erik,Arutyunov Ruben,fiurst,Arutyunov Ruben - Grigoryan Erik,56,33,23,-10,10,19,17,20,0,0,-3,-5,-2,0,0,-10,11:8 - 11:6 - 11:9 - 0:0 - 0:0
16596668,2024-01-30 15:30:00,Avakimyan Davit - Gevorgyan Gegham,3:2,11:9 - 11:7 - 7:11 - 2:11 - 11:7,3,2,Avakimyan Davit,Gevorgyan Gegham,fiurst,Avakimyan Davit - Gevorgyan Gegham,87,42,45,3,-3,20,18,18,13,18,-2,-4,4,9,-4,3,11:9 - 11:7 - 7:11 - 2:11 - 11:7
16596666,2024-01-30 15:15:00,Diaryan Aleksandr - Mkrtchyan Andranik,3:2,11:3 - 11:8 - 8:11 - 7:11 - 11:3,3,2,Diaryan Aleksandr,Mkrtchyan Andranik,fiurst,Diaryan Aleksandr - Mkrtchyan Andranik,84,48,36,-12,12,14,19,19,18,14,-8,-3,3,4,-8,-12,11:3 - 11:8 - 8:11 - 7:11 - 11:3
16596661,2024-01-30 15:05:00,Nikoghosyan Narek - Papyan Karen,1:3,9:11 - 9:11 - 11:1 - 6:11 - 0:0,1,3,Nikoghosyan Narek,Papyan Karen,fiurst,Nikoghosyan Narek - Papyan Karen,69,35,34,-1,1,20,20,12,17,0,2,2,-10,5,0,-1,9:11 - 9:11 - 11:1 - 6:11 - 0:0
16596658,2024-01-30 14:45:00,Papyan Karen - Diaryan Aleksandr,3:1,3:11 - 4:11 - 11:7 - 9:11 - 0:0,1,3,Papyan Karen,Diaryan Aleksandr,fiurst,Diaryan Aleksandr - Papyan Karen,67,40,27,-13,13,14,15,18,20,0,-8,-7,4,-2,0,-13,11:3 - 11:4 - 7:11 - 11:9 - 0:0
16596643,2024-01-30 14:40:00,Mkrtchyan Andranik - Nikoghosyan Narek,0:3,6:11 - 4:11 - 8:11 - 0:0 - 0:0,0,3,Mkrtchyan Andranik,Nikoghosyan Narek,fiurst,Mkrtchyan Andranik - Nikoghosyan Narek,51,18,33,15,-15,17,15,19,0,0,5,7,3,0,0,15,6:11 - 4:11 - 8:11 - 0:0 - 0:0
16596634,2024-01-30 14:00:00,Diaryan Aleksandr - Nikoghosyan Narek,3:2,11:9 - 11:13 - 11:5 - 4:11 - 11:6,3,2,Diaryan Aleksandr,Nikoghosyan Narek,fiurst,Diaryan Aleksandr - Nikoghosyan Narek,92,48,44,-4,4,20,24,16,15,17,-2,2,-6,7,-5,-4,11:9 - 11:13 - 11:5 - 4:11 - 11:6
16596628,2024-01-30 13:45:00,Mkrtchyan Andranik - Papyan Karen,0:3,7:11 - 8:11 - 8:11 - 0:0 - 0:0,0,3,Mkrtchyan Andranik,Papyan Karen,fiurst,Mkrtchyan Andranik - Papyan Karen,56,23,33,10,-10,18,19,19,0,0,4,3,3,0,0,10,7:11 - 8:11 - 8:11 - 0:0 - 0:0
16596620,2024-01-30 13:15:00,Nikoghosyan Narek - Papyan Karen,3:1,12:10 - 8:11 - 11:4 - 11:8 - 0:0,3,1,Nikoghosyan Narek,Papyan Karen,fiurst,Nikoghosyan Narek - Papyan Karen,75,42,33,-9,9,22,19,15,19,0,-2,3,-7,-3,0,-9,12:10 - 8:11 - 11:4 - 11:8 - 0:0
16596613,2024-01-30 13:00:00,Diaryan Aleksandr - Mkrtchyan Andranik,3:0,11:7 - 11:6 - 11:7 - 0:0 - 0:0,3,0,Diaryan Aleksandr,Mkrtchyan Andranik,fiurst,Diaryan Aleksandr - Mkrtchyan Andranik,53,33,20,-13,13,18,17,18,0,0,-4,-5,-4,0,0,-13,11:7 - 11:6 - 11:7 - 0:0 - 0:0
16596600,2024-01-30 12:20:00,Diaryan Aleksandr - Papyan Karen,2:3,11:3 - 11:5 - 7:11 - 6:11 - 6:11,2,3,Diaryan Aleksandr,Papyan Karen,fiurst,Diaryan Aleksandr - Papyan Karen,82,41,41,0,0,14,16,18,17,17,-8,-6,4,5,5,0,11:3 - 11:5 - 7:11 - 6:11 - 6:11
16596596,2024-01-30 12:00:00,Nazaryan Mushegh - Nikoghosyan Narek,0:3,7:11 - 7:11 - 9:11 - 0:0 - 0:0,0,3,Nazaryan Mushegh,Nikoghosyan Narek,fiurst,Nazaryan Mushegh - Nikoghosyan Narek,56,23,33,10,-10,18,18,20,0,0,4,4,2,0,0,10,7:11 - 7:11 - 9:11 - 0:0 - 0:0
16596584,2024-01-30 11:55:00,Mkrtchyan Andranik - Diaryan Aleksandr,3:0,5:11 - 6:11 - 14:16 - 0:0 - 0:0,0,3,Mkrtchyan Andranik,Diaryan Aleksandr,fiurst,Diaryan Aleksandr - Mkrtchyan Andranik,63,38,25,-13,13,16,17,30,0,0,-6,-5,-2,0,0,-13,11:5 - 11:6 - 16:14 - 0:0 - 0:0
16596571,2024-01-30 11:30:00,Nazaryan Mushegh - Papyan Karen,0:3,8:11 - 5:11 - 9:11 - 0:0 - 0:0,0,3,Nazaryan Mushegh,Papyan Karen,fiurst,Nazaryan Mushegh - Papyan Karen,55,22,33,11,-11,19,16,20,0,0,3,6,2,0,0,11,8:11 - 5:11 - 9:11 - 0:0 - 0:0
16596569,2024-01-30 11:25:00,Nikoghosyan Narek - Mkrtchyan Andranik,1:3,3:11 - 11:7 - 11:4 - 11:4 - 0:0,3,1,Nikoghosyan Narek,Mkrtchyan Andranik,fiurst,Mkrtchyan Andranik - Nikoghosyan Narek,62,26,36,10,-10,14,18,15,15,0,-8,4,7,7,0,10,11:3 - 7:11 - 4:11 - 4:11 - 0:0
16596568,2024-01-30 11:00:00,Diaryan Aleksandr - Nazaryan Mushegh,3:0,11:7 - 11:7 - 11:3 - 0:0 - 0:0,3,0,Diaryan Aleksandr,Nazaryan Mushegh,fiurst,Diaryan Aleksandr - Nazaryan Mushegh,50,33,17,-16,16,18,18,14,0,0,-4,-4,-8,0,0,-16,11:7 - 11:7 - 11:3 - 0:0 - 0:0
16596564,2024-01-30 10:45:00,Papyan Karen - Mkrtchyan Andranik,2:3,6:11 - 11:7 - 11:9 - 10:12 - 12:10,3,2,Papyan Karen,Mkrtchyan Andranik,fiurst,Mkrtchyan Andranik - Papyan Karen,99,49,50,1,-1,17,18,20,22,22,-5,4,2,-2,2,1,11:6 - 7:11 - 9:11 - 12:10 - 10:12
16596561,2024-01-30 10:35:00,Nikoghosyan Narek - Diaryan Aleksandr,0:3,11:6 - 11:9 - 12:10 - 0:0 - 0:0,3,0,Nikoghosyan Narek,Diaryan Aleksandr,fiurst,Diaryan Aleksandr - Nikoghosyan Narek,59,25,34,9,-9,17,20,22,0,0,5,2,2,0,0,9,6:11 - 9:11 - 10:12 - 0:0 - 0:0
16596560,2024-01-30 10:15:00,Mkrtchyan Andranik - Nazaryan Mushegh,3:1,11:2 - 7:11 - 11:9 - 11:4 - 0:0,3,1,Mkrtchyan Andranik,Nazaryan Mushegh,fiurst,Mkrtchyan Andranik - Nazaryan Mushegh,66,40,26,-14,14,13,18,20,15,0,-9,4,-2,-7,0,-14,11:2 - 7:11 - 11:9 - 11:4 - 0:0
16596559,2024-01-30 10:05:00,Papyan Karen - Nikoghosyan Narek,0:3,11:9 - 11:3 - 13:11 - 0:0 - 0:0,3,0,Papyan Karen,Nikoghosyan Narek,fiurst,Nikoghosyan Narek - Papyan Karen,58,23,35,12,-12,20,14,24,0,0,2,8,2,0,0,12,9:11 - 3:11 - 11:13 - 0:0 - 0:0
16581391,2024-01-29 17:45:00,Petrosyan Davit - Arutyunov Ruben,3:0,10:12 - 8:11 - 4:11 - 0:0 - 0:0,0,3,Petrosyan Davit,Arutyunov Ruben,fiurst,Arutyunov Ruben - Petrosyan Davit,56,34,22,-12,12,22,19,15,0,0,-2,-3,-7,0,0,-12,12:10 - 11:8 - 11:4 - 0:0 - 0:0
16581390,2024-01-29 17:40:00,Gevorgyan Hayk - Grigoryan Erik,1:3,8:11 - 11:9 - 8:11 - 8:11 - 0:0,1,3,Gevorgyan Hayk,Grigoryan Erik,fiurst,Gevorgyan Hayk - Grigoryan Erik,77,35,42,7,-7,19,20,19,19,0,3,-2,3,3,0,7,8:11 - 11:9 - 8:11 - 8:11 - 0:0
16581378,2024-01-29 17:20:00,Gevorgyan Gegham - Petrosyan Davit,1:3,2:11 - 11:6 - 3:11 - 7:11 - 0:0,1,3,Gevorgyan Gegham,Petrosyan Davit,fiurst,Gevorgyan Gegham - Petrosyan Davit,62,23,39,16,-16,13,17,14,18,0,9,-5,8,4,0,16,2:11 - 11:6 - 3:11 - 7:11 - 0:0
16581377,2024-01-29 17:00:00,Gevorgyan Hayk - Arutyunov Ruben,0:0,0:0 - 0:0 - 0:0 - 0:0 - 0:0,0,0,Gevorgyan Hayk,Arutyunov Ruben,fiurst,Arutyunov Ruben - Gevorgyan Hayk,0,0,0,0,0,0,0,0,0,0,0,0,0,0,0,0,0:0 - 0:0 - 0:0 - 0:0 - 0:0
16602726,2024-01-29 17:00:00,Arutyunov Ruben - Gevorgyan Hayk,2:3,11:8 - 11:9 - 10:12 - 6:11 - 7:11,2,3,Arutyunov Ruben,Gevorgyan Hayk,fiurst,Arutyunov Ruben - Gevorgyan Hayk,96,45,51,6,-6,19,20,22,17,18,-3,-2,2,5,4,6,11:8 - 11:9 - 10:12 - 6:11 - 7:11
16581376,2024-01-29 16:45:00,Grigoryan Erik - Gevorgyan Gegham,2:3,11:9 - 11:13 - 11:7 - 9:11 - 11:7,3,2,Grigoryan Erik,Gevorgyan Gegham,fiurst,Gevorgyan Gegham - Grigoryan Erik,100,47,53,6,-6,20,24,18,20,18,2,-2,4,-2,4,6,9:11 - 13:11 - 7:11 - 11:9 - 7:11
16581373,2024-01-29 16:30:00,Petrosyan Davit - Gevorgyan Hayk,2:3,3:11 - 11:9 - 3:11 - 11:7 - 11:9,3,2,Petrosyan Davit,Gevorgyan Hayk,fiurst,Gevorgyan Hayk - Petrosyan Davit,86,47,39,-8,8,14,20,14,18,20,-8,2,-8,4,2,-8,11:3 - 9:11 - 11:3 - 7:11 - 9:11
16581344,2024-01-29 16:15:00,Arutyunov Ruben - Gevorgyan Gegham,3:0,11:8 - 11:7 - 11:5 - 0:0 - 0:0,3,0,Arutyunov Ruben,Gevorgyan Gegham,fiurst,Arutyunov Ruben - Gevorgyan Gegham,53,33,20,-13,13,19,18,16,0,0,-3,-4,-6,0,0,-13,11:8 - 11:7 - 11:5 - 0:0 - 0:0
16581339,2024-01-29 16:00:00,Grigoryan Erik - Petrosyan Davit,3:1,11:9 - 11:8 - 10:12 - 11:9 - 0:0,3,1,Grigoryan Erik,Petrosyan Davit,fiurst,Grigoryan Erik - Petrosyan Davit,81,43,38,-5,5,20,19,22,20,0,-2,-3,2,-2,0,-5,11:9 - 11:8 - 10:12 - 11:9 - 0:0
16581324,2024-01-29 15:45:00,Gevorgyan Gegham - Gevorgyan Hayk,0:3,2:11 - 7:11 - 5:11 - 0:0 - 0:0,0,3,Gevorgyan Gegham,Gevorgyan Hayk,fiurst,Gevorgyan Gegham - Gevorgyan Hayk,47,14,33,19,-19,13,18,16,0,0,9,4,6,0,0,19,2:11 - 7:11 - 5:11 - 0:0 - 0:0
16581319,2024-01-29 15:30:00,Arutyunov Ruben - Grigoryan Erik,3:0,11:5 - 11:6 - 11:7 - 0:0 - 0:0,3,0,Arutyunov Ruben,Grigoryan Erik,fiurst,Arutyunov Ruben - Grigoryan Erik,51,33,18,-15,15,16,17,18,0,0,-6,-5,-4,0,0,-15,11:5 - 11:6 - 11:7 - 0:0 - 0:0
16581314,2024-01-29 15:15:00,Nazaryan Mushegh - Rafayelyan Edgar,0:3,3:11 - 4:11 - 7:11 - 0:0 - 0:0,0,3,Nazaryan Mushegh,Rafayelyan Edgar,fiurst,Nazaryan Mushegh - Rafayelyan Edgar,47,14,33,19,-19,14,15,18,0,0,8,7,4,0,0,19,3:11 - 4:11 - 7:11 - 0:0 - 0:0
16581307,2024-01-29 15:10:00,Papyan Karen - Diaryan Aleksandr,0:3,12:10 - 11:7 - 11:9 - 0:0 - 0:0,3,0,Papyan Karen,Diaryan Aleksandr,fiurst,Diaryan Aleksandr - Papyan Karen,60,26,34,8,-8,22,18,20,0,0,2,4,2,0,0,8,10:12 - 7:11 - 9:11 - 0:0 - 0:0
16581296,2024-01-29 15:00:00,Mkrtchyan Andranik - Nazaryan Mushegh,3:0,11:3 - 11:5 - 11:8 - 0:0 - 0:0,3,0,Mkrtchyan Andranik,Nazaryan Mushegh,fiurst,Mkrtchyan Andranik - Nazaryan Mushegh,49,33,16,-17,17,14,16,19,0,0,-8,-6,-3,0,0,-17,11:3 - 11:5 - 11:8 - 0:0 - 0:0
16581294,2024-01-29 14:30:00,Rafayelyan Edgar - Papyan Karen,3:1,9:11 - 12:10 - 7:11 - 8:11 - 0:0,1,3,Rafayelyan Edgar,Papyan Karen,fiurst,Papyan Karen - Rafayelyan Edgar,79,43,36,-7,7,20,22,18,19,0,-2,2,-4,-3,0,-7,11:9 - 10:12 - 11:7 - 11:8 - 0:0
16581293,2024-01-29 14:15:00,Mkrtchyan Andranik - Diaryan Aleksandr,3:1,6:11 - 9:11 - 11:8 - 8:11 - 0:0,1,3,Mkrtchyan Andranik,Diaryan Aleksandr,fiurst,Diaryan Aleksandr - Mkrtchyan Andranik,75,41,34,-7,7,17,20,19,19,0,-5,-2,3,-3,0,-7,11:6 - 11:9 - 8:11 - 11:8 - 0:0
16581288,2024-01-29 14:00:00,Nazaryan Mushegh - Papyan Karen,1:3,11:5 - 10:12 - 6:11 - 7:11 - 0:0,1,3,Nazaryan Mushegh,Papyan Karen,fiurst,Nazaryan Mushegh - Papyan Karen,73,34,39,5,-5,16,22,17,18,0,-6,2,5,4,0,5,11:5 - 10:12 - 6:11 - 7:11 - 0:0
16581272,2024-01-29 13:45:00,Rafayelyan Edgar - Mkrtchyan Andranik,0:3,11:8 - 11:9 - 11:3 - 0:0 - 0:0,3,0,Rafayelyan Edgar,Mkrtchyan Andranik,fiurst,Mkrtchyan Andranik - Rafayelyan Edgar,53,20,33,13,-13,19,20,14,0,0,3,2,8,0,0,13,8:11 - 9:11 - 3:11 - 0:0 - 0:0
16581268,2024-01-29 13:30:00,Diaryan Aleksandr - Nazaryan Mushegh,3:0,11:3 - 11:5 - 11:3 - 0:0 - 0:0,3,0,Diaryan Aleksandr,Nazaryan Mushegh,fiurst,Diaryan Aleksandr - Nazaryan Mushegh,44,33,11,-22,22,14,16,14,0,0,-8,-6,-8,0,0,-22,11:3 - 11:5 - 11:3 - 0:0 - 0:0
16581267,2024-01-29 13:20:00,Papyan Karen - Mkrtchyan Andranik,0:3,11:4 - 13:11 - 11:9 - 0:0 - 0:0,3,0,Papyan Karen,Mkrtchyan Andranik,fiurst,Mkrtchyan Andranik - Papyan Karen,59,24,35,11,-11,15,24,20,0,0,7,2,2,0,0,11,4:11 - 11:13 - 9:11 - 0:0 - 0:0
16581263,2024-01-29 13:00:00,Diaryan Aleksandr - Rafayelyan Edgar,3:0,16:14 - 11:7 - 11:7 - 0:0 - 0:0,3,0,Diaryan Aleksandr,Rafayelyan Edgar,fiurst,Diaryan Aleksandr - Rafayelyan Edgar,66,38,28,-10,10,30,18,18,0,0,-2,-4,-4,0,0,-10,16:14 - 11:7 - 11:7 - 0:0 - 0:0
16581261,2024-01-29 12:20:00,Nazaryan Mushegh - Mkrtchyan Andranik,3:0,8:11 - 5:11 - 8:11 - 0:0 - 0:0,0,3,Nazaryan Mushegh,Mkrtchyan Andranik,fiurst,Mkrtchyan Andranik - Nazaryan Mushegh,54,33,21,-12,12,19,16,19,0,0,-3,-6,-3,0,0,-12,11:8 - 11:5 - 11:8 - 0:0 - 0:0
16581258,2024-01-29 12:00:00,Diaryan Aleksandr - Papyan Karen,1:3,11:5 - 10:12 - 5:11 - 12:14 - 0:0,1,3,Diaryan Aleksandr,Papyan Karen,fiurst,Diaryan Aleksandr - Papyan Karen,80,38,42,4,-4,16,22,16,26,0,-6,2,6,2,0,4,11:5 - 10:12 - 5:11 - 12:14 - 0:0
16581255,2024-01-29 11:55:00,Rafayelyan Edgar - Nazaryan Mushegh,0:3,11:4 - 11:6 - 11:4 - 0:0 - 0:0,3,0,Rafayelyan Edgar,Nazaryan Mushegh,fiurst,Nazaryan Mushegh - Rafayelyan Edgar,47,14,33,19,-19,15,17,15,0,0,7,5,7,0,0,19,4:11 - 6:11 - 4:11 - 0:0 - 0:0
16581243,2024-01-29 11:30:00,Diaryan Aleksandr - Mkrtchyan Andranik,3:1,6:11 - 11:4 - 11:6 - 11:8 - 0:0,3,1,Diaryan Aleksandr,Mkrtchyan Andranik,fiurst,Diaryan Aleksandr - Mkrtchyan Andranik,68,39,29,-10,10,17,15,17,19,0,5,-7,-5,-3,0,-10,6:11 - 11:4 - 11:6 - 11:8 - 0:0
16581241,2024-01-29 11:15:00,Papyan Karen - Rafayelyan Edgar,3:1,8:11 - 11:9 - 11:6 - 11:7 - 0:0,3,1,Papyan Karen,Rafayelyan Edgar,fiurst,Papyan Karen - Rafayelyan Edgar,74,41,33,-8,8,19,20,17,18,0,3,-2,-5,-4,0,-8,8:11 - 11:9 - 11:6 - 11:7 - 0:0
16581240,2024-01-29 11:05:00,Nazaryan Mushegh - Diaryan Aleksandr,3:1,6:11 - 11:8 - 3:11 - 4:11 - 0:0,1,3,Nazaryan Mushegh,Diaryan Aleksandr,fiurst,Diaryan Aleksandr - Nazaryan Mushegh,65,41,24,-17,17,17,19,14,15,0,-5,3,-8,-7,0,-17,11:6 - 8:11 - 11:3 - 11:4 - 0:0
16581237,2024-01-29 10:50:00,Mkrtchyan Andranik - Rafayelyan Edgar,0:3,6:11 - 6:11 - 6:11 - 0:0 - 0:0,0,3,Mkrtchyan Andranik,Rafayelyan Edgar,fiurst,Mkrtchyan Andranik - Rafayelyan Edgar,51,18,33,15,-15,17,17,17,0,0,5,5,5,0,0,15,6:11 - 6:11 - 6:11 - 0:0 - 0:0
16581234,2024-01-29 10:35:00,Papyan Karen - Nazaryan Mushegh,1:3,12:14 - 11:3 - 11:7 - 11:8 - 0:0,3,1,Papyan Karen,Nazaryan Mushegh,fiurst,Nazaryan Mushegh - Papyan Karen,77,32,45,13,-13,26,14,18,19,0,-2,8,4,3,0,13,14:12 - 3:11 - 7:11 - 8:11 - 0:0
16581231,2024-01-29 10:15:00,Rafayelyan Edgar - Diaryan Aleksandr,2:3,11:8 - 13:15 - 11:6 - 5:11 - 11:6,3,2,Rafayelyan Edgar,Diaryan Aleksandr,fiurst,Diaryan Aleksandr - Rafayelyan Edgar,97,46,51,5,-5,19,28,17,16,17,3,-2,5,-6,5,5,8:11 - 15:13 - 6:11 - 11:5 - 6:11
16581228,2024-01-29 10:00:00,Mkrtchyan Andranik - Papyan Karen,1:3,11:9 - 6:11 - 9:11 - 11:13 - 0:0,1,3,Mkrtchyan Andranik,Papyan Karen,fiurst,Mkrtchyan Andranik - Papyan Karen,81,37,44,7,-7,20,17,20,24,0,-2,5,2,2,0,7,11:9 - 6:11 - 9:11 - 11:13 - 0:0
16558418,2024-01-28 17:45:00,Grigoryan Erik - Petrosyan Davit,1:3,3:11 - 14:12 - 5:11 - 6:11 - 0:0,1,3,Grigoryan Erik,Petrosyan Davit,fiurst,Grigoryan Erik - Petrosyan Davit,73,28,45,17,-17,14,26,16,17,0,8,-2,6,5,0,17,3:11 - 14:12 - 5:11 - 6:11 - 0:0
16558409,2024-01-28 17:30:00,Karakhanyan Mher - Avakimyan Davit,3:0,10:12 - 14:16 - 7:11 - 0:0 - 0:0,0,3,Karakhanyan Mher,Avakimyan Davit,fiurst,Avakimyan Davit - Karakhanyan Mher,70,39,31,-8,8,22,30,18,0,0,-2,-2,-4,0,0,-8,12:10 - 16:14 - 11:7 - 0:0 - 0:0
16558408,2024-01-28 17:15:00,Gevorgyan Hayk - Grigoryan Erik,3:2,10:12 - 9:11 - 11:6 - 11:3 - 14:12,3,2,Gevorgyan Hayk,Grigoryan Erik,fiurst,Gevorgyan Hayk - Grigoryan Erik,99,55,44,-11,11,22,20,17,14,26,2,2,-5,-8,-2,-11,10:12 - 9:11 - 11:6 - 11:3 - 14:12
16558405,2024-01-28 17:00:00,Karakhanyan Mher - Petrosyan Davit,1:3,12:14 - 11:4 - 8:11 - 8:11 - 0:0,1,3,Karakhanyan Mher,Petrosyan Davit,fiurst,Karakhanyan Mher - Petrosyan Davit,79,39,40,1,-1,26,15,19,19,0,2,-7,3,3,0,1,12:14 - 11:4 - 8:11 - 8:11 - 0:0
16558402,2024-01-28 16:45:00,Avakimyan Davit - Gevorgyan Hayk,3:0,11:3 - 11:8 - 11:7 - 0:0 - 0:0,3,0,Avakimyan Davit,Gevorgyan Hayk,fiurst,Avakimyan Davit - Gevorgyan Hayk,51,33,18,-15,15,14,19,18,0,0,-8,-3,-4,0,0,-15,11:3 - 11:8 - 11:7 - 0:0 - 0:0
16558399,2024-01-28 16:30:00,Grigoryan Erik - Karakhanyan Mher,2:3,11:8 - 11:6 - 11:13 - 7:11 - 5:11,2,3,Grigoryan Erik,Karakhanyan Mher,fiurst,Grigoryan Erik - Karakhanyan Mher,94,45,49,4,-4,19,17,24,18,16,-3,-5,2,4,6,4,11:8 - 11:6 - 11:13 - 7:11 - 5:11
16558395,2024-01-28 16:15:00,Petrosyan Davit - Gevorgyan Hayk,3:0,6:11 - 4:11 - 12:14 - 0:0 - 0:0,0,3,Petrosyan Davit,Gevorgyan Hayk,fiurst,Gevorgyan Hayk - Petrosyan Davit,58,36,22,-14,14,17,15,26,0,0,-5,-7,-2,0,0,-14,11:6 - 11:4 - 14:12 - 0:0 - 0:0
16558391,2024-01-28 16:00:00,Avakimyan Davit - Grigoryan Erik,3:0,11:4 - 11:7 - 11:7 - 0:0 - 0:0,3,0,Avakimyan Davit,Grigoryan Erik,fiurst,Avakimyan Davit - Grigoryan Erik,51,33,18,-15,15,15,18,18,0,0,-7,-4,-4,0,0,-15,11:4 - 11:7 - 11:7 - 0:0 - 0:0
16558376,2024-01-28 15:45:00,Gevorgyan Hayk - Karakhanyan Mher,3:0,11:7 - 11:4 - 11:7 - 0:0 - 0:0,3,0,Gevorgyan Hayk,Karakhanyan Mher,fiurst,Gevorgyan Hayk - Karakhanyan Mher,51,33,18,-15,15,18,15,18,0,0,-4,-7,-4,0,0,-15,11:7 - 11:4 - 11:7 - 0:0 - 0:0
16558370,2024-01-28 15:30:00,Petrosyan Davit - Avakimyan Davit,3:1,7:11 - 10:12 - 11:9 - 4:11 - 0:0,1,3,Petrosyan Davit,Avakimyan Davit,fiurst,Avakimyan Davit - Petrosyan Davit,75,43,32,-11,11,18,22,20,15,0,-4,-2,2,-7,0,-11,11:7 - 12:10 - 9:11 - 11:4 - 0:0
16558365,2024-01-28 15:15:00,Papyan Karen - Nikoghosyan Narek,2:3,11:9 - 8:11 - 7:11 - 11:5 - 13:11,3,2,Papyan Karen,Nikoghosyan Narek,fiurst,Nikoghosyan Narek - Papyan Karen,97,47,50,3,-3,20,19,18,16,24,2,-3,-4,6,2,3,9:11 - 11:8 - 11:7 - 5:11 - 11:13
16558363,2024-01-28 15:10:00,Rafayelyan Edgar - Mkrtchyan Andranik,1:3,11:2 - 11:6 - 5:11 - 11:5 - 0:0,3,1,Rafayelyan Edgar,Mkrtchyan Andranik,fiurst,Mkrtchyan Andranik - Rafayelyan Edgar,62,24,38,14,-14,13,17,16,16,0,9,5,-6,6,0,14,2:11 - 6:11 - 11:5 - 5:11 - 0:0
16558362,2024-01-28 14:45:00,Diaryan Aleksandr - Papyan Karen,3:1,7:11 - 11:3 - 11:5 - 11:8 - 0:0,3,1,Diaryan Aleksandr,Papyan Karen,fiurst,Diaryan Aleksandr - Papyan Karen,67,40,27,-13,13,18,14,16,19,0,4,-8,-6,-3,0,-13,7:11 - 11:3 - 11:5 - 11:8 - 0:0
16558361,2024-01-28 14:40:00,Nikoghosyan Narek - Rafayelyan Edgar,2:3,6:11 - 11:0 - 11:9 - 3:11 - 5:11,2,3,Nikoghosyan Narek,Rafayelyan Edgar,fiurst,Nikoghosyan Narek - Rafayelyan Edgar,78,36,42,6,-6,17,11,20,14,16,5,-11,-2,8,6,6,6:11 - 11:0 - 11:9 - 3:11 - 5:11
16558358,2024-01-28 14:15:00,Diaryan Aleksandr - Mkrtchyan Andranik,3:0,11:9 - 11:1 - 11:4 - 0:0 - 0:0,3,0,Diaryan Aleksandr,Mkrtchyan Andranik,fiurst,Diaryan Aleksandr - Mkrtchyan Andranik,47,33,14,-19,19,20,12,15,0,0,-2,-10,-7,0,0,-19,11:9 - 11:1 - 11:4 - 0:0 - 0:0
16558356,2024-01-28 14:05:00,Papyan Karen - Rafayelyan Edgar,1:3,9:11 - 11:8 - 9:11 - 4:11 - 0:0,1,3,Papyan Karen,Rafayelyan Edgar,fiurst,Papyan Karen - Rafayelyan Edgar,74,33,41,8,-8,20,19,20,15,0,2,-3,2,7,0,8,9:11 - 11:8 - 9:11 - 4:11 - 0:0
16558353,2024-01-28 13:45:00,Nikoghosyan Narek - Diaryan Aleksandr,3:0,8:11 - 4:11 - 6:11 - 0:0 - 0:0,0,3,Nikoghosyan Narek,Diaryan Aleksandr,fiurst,Diaryan Aleksandr - Nikoghosyan Narek,51,33,18,-15,15,19,15,17,0,0,-3,-7,-5,0,0,-15,11:8 - 11:4 - 11:6 - 0:0 - 0:0
16558341,2024-01-28 13:30:00,Mkrtchyan Andranik - Papyan Karen,2:3,11:7 - 10:12 - 11:9 - 9:11 - 4:11,2,3,Mkrtchyan Andranik,Papyan Karen,fiurst,Mkrtchyan Andranik - Papyan Karen,95,45,50,5,-5,18,22,20,20,15,-4,2,-2,2,7,5,11:7 - 10:12 - 11:9 - 9:11 - 4:11
16558336,2024-01-28 13:15:00,Rafayelyan Edgar - Diaryan Aleksandr,1:3,11:5 - 11:2 - 6:11 - 11:8 - 0:0,3,1,Rafayelyan Edgar,Diaryan Aleksandr,fiurst,Diaryan Aleksandr - Rafayelyan Edgar,65,26,39,13,-13,16,13,17,19,0,6,9,-5,3,0,13,5:11 - 2:11 - 11:6 - 8:11 - 0:0
16558293,2024-01-28 13:00:00,Mkrtchyan Andranik - Nikoghosyan Narek,1:3,8:11 - 8:11 - 12:10 - 8:11 - 0:0,1,3,Mkrtchyan Andranik,Nikoghosyan Narek,fiurst,Mkrtchyan Andranik - Nikoghosyan Narek,79,36,43,7,-7,19,19,22,19,0,3,3,-2,3,0,7,8:11 - 8:11 - 12:10 - 8:11 - 0:0
16558284,2024-01-28 12:35:00,Papyan Karen - Diaryan Aleksandr,3:1,4:11 - 11:7 - 4:11 - 6:11 - 0:0,1,3,Papyan Karen,Diaryan Aleksandr,fiurst,Diaryan Aleksandr - Papyan Karen,65,40,25,-15,15,15,18,15,17,0,-7,4,-7,-5,0,-15,11:4 - 7:11 - 11:4 - 11:6 - 0:0
16558272,2024-01-28 12:00:00,Mkrtchyan Andranik - Rafayelyan Edgar,0:3,3:11 - 7:11 - 6:11 - 0:0 - 0:0,0,3,Mkrtchyan Andranik,Rafayelyan Edgar,fiurst,Mkrtchyan Andranik - Rafayelyan Edgar,49,16,33,17,-17,14,18,17,0,0,8,4,5,0,0,17,3:11 - 7:11 - 6:11 - 0:0 - 0:0
16558259,2024-01-28 11:55:00,Nikoghosyan Narek - Papyan Karen,2:3,11:3 - 9:11 - 11:9 - 10:12 - 10:12,2,3,Nikoghosyan Narek,Papyan Karen,fiurst,Nikoghosyan Narek - Papyan Karen,98,51,47,-4,4,14,20,20,22,22,-8,2,-2,2,2,-4,11:3 - 9:11 - 11:9 - 10:12 - 10:12
16558256,2024-01-28 11:30:00,Mkrtchyan Andranik - Diaryan Aleksandr,3:0,11:13 - 8:11 - 3:11 - 0:0 - 0:0,0,3,Mkrtchyan Andranik,Diaryan Aleksandr,fiurst,Diaryan Aleksandr - Mkrtchyan Andranik,57,35,22,-13,13,24,19,14,0,0,-2,-3,-8,0,0,-13,13:11 - 11:8 - 11:3 - 0:0 - 0:0
16558252,2024-01-28 11:25:00,Rafayelyan Edgar - Nikoghosyan Narek,3:0,7:11 - 9:11 - 8:11 - 0:0 - 0:0,0,3,Rafayelyan Edgar,Nikoghosyan Narek,fiurst,Nikoghosyan Narek - Rafayelyan Edgar,57,33,24,-9,9,18,20,19,0,0,-4,-2,-3,0,0,-9,11:7 - 11:9 - 11:8 - 0:0 - 0:0
16558247,2024-01-28 11:00:00,Papyan Karen - Mkrtchyan Andranik,0:3,11:9 - 11:4 - 11:8 - 0:0 - 0:0,3,0,Papyan Karen,Mkrtchyan Andranik,fiurst,Mkrtchyan Andranik - Papyan Karen,54,21,33,12,-12,20,15,19,0,0,2,7,3,0,0,12,9:11 - 4:11 - 8:11 - 0:0 - 0:0
16558246,2024-01-28 10:45:00,Diaryan Aleksandr - Nikoghosyan Narek,3:1,6:11 - 11:5 - 11:5 - 11:9 - 0:0,3,1,Diaryan Aleksandr,Nikoghosyan Narek,fiurst,Diaryan Aleksandr - Nikoghosyan Narek,69,39,30,-9,9,17,16,16,20,0,5,-6,-6,-2,0,-9,6:11 - 11:5 - 11:5 - 11:9 - 0:0
16558243,2024-01-28 10:30:00,Rafayelyan Edgar - Papyan Karen,0:3,11:5 - 11:9 - 12:10 - 0:0 - 0:0,3,0,Rafayelyan Edgar,Papyan Karen,fiurst,Papyan Karen - Rafayelyan Edgar,58,24,34,10,-10,16,20,22,0,0,6,2,2,0,0,10,5:11 - 9:11 - 10:12 - 0:0 - 0:0
16558242,2024-01-28 10:15:00,Nikoghosyan Narek - Mkrtchyan Andranik,1:3,11:8 - 11:2 - 9:11 - 11:7 - 0:0,3,1,Nikoghosyan Narek,Mkrtchyan Andranik,fiurst,Mkrtchyan Andranik - Nikoghosyan Narek,70,28,42,14,-14,19,13,20,18,0,3,9,-2,4,0,14,8:11 - 2:11 - 11:9 - 7:11 - 0:0
16558240,2024-01-28 10:00:00,Diaryan Aleksandr - Rafayelyan Edgar,3:0,11:9 - 12:10 - 11:6 - 0:0 - 0:0,3,0,Diaryan Aleksandr,Rafayelyan Edgar,fiurst,Diaryan Aleksandr - Rafayelyan Edgar,59,34,25,-9,9,20,22,17,0,0,-2,-2,-5,0,0,-9,11:9 - 12:10 - 11:6 - 0:0 - 0:0
16539840,2024-01-27 17:45:00,Karakhanyan Mher - Petrosyan Davit,0:3,3:11 - 8:11 - 6:11 - 0:0 - 0:0,0,3,Karakhanyan Mher,Petrosyan Davit,fiurst,Karakhanyan Mher - Petrosyan Davit,50,17,33,16,-16,14,19,17,0,0,8,3,5,0,0,16,3:11 - 8:11 - 6:11 - 0:0 - 0:0
16539838,2024-01-27 17:40:00,Gevorgyan Gegham - Avakimyan Davit,3:0,8:11 - 4:11 - 8:11 - 0:0 - 0:0,0,3,Gevorgyan Gegham,Avakimyan Davit,fiurst,Avakimyan Davit - Gevorgyan Gegham,53,33,20,-13,13,19,15,19,0,0,-3,-7,-3,0,0,-13,11:8 - 11:4 - 11:8 - 0:0 - 0:0
16539828,2024-01-27 17:15:00,Arutyunov Ruben - Karakhanyan Mher,3:0,12:10 - 11:8 - 12:10 - 0:0 - 0:0,3,0,Arutyunov Ruben,Karakhanyan Mher,fiurst,Arutyunov Ruben - Karakhanyan Mher,63,35,28,-7,7,22,19,22,0,0,-2,-3,-2,0,0,-7,12:10 - 11:8 - 12:10 - 0:0 - 0:0
16539824,2024-01-27 17:00:00,Gevorgyan Gegham - Petrosyan Davit,3:2,5:11 - 11:9 - 4:11 - 13:11 - 11:9,3,2,Gevorgyan Gegham,Petrosyan Davit,fiurst,Gevorgyan Gegham - Petrosyan Davit,95,44,51,7,-7,16,20,15,24,20,6,-2,7,-2,-2,7,5:11 - 11:9 - 4:11 - 13:11 - 11:9
16539821,2024-01-27 16:45:00,Avakimyan Davit - Arutyunov Ruben,3:0,8:11 - 5:11 - 4:11 - 0:0 - 0:0,0,3,Avakimyan Davit,Arutyunov Ruben,fiurst,Arutyunov Ruben - Avakimyan Davit,50,33,17,-16,16,19,16,15,0,0,-3,-6,-7,0,0,-16,11:8 - 11:5 - 11:4 - 0:0 - 0:0
16539819,2024-01-27 16:30:00,Karakhanyan Mher - Gevorgyan Gegham,3:0,10:12 - 8:11 - 9:11 - 0:0 - 0:0,0,3,Karakhanyan Mher,Gevorgyan Gegham,fiurst,Gevorgyan Gegham - Karakhanyan Mher,61,34,27,-7,7,22,19,20,0,0,-2,-3,-2,0,0,-7,12:10 - 11:8 - 11:9 - 0:0 - 0:0
16539815,2024-01-27 16:15:00,Petrosyan Davit - Arutyunov Ruben,3:0,9:11 - 5:11 - 7:11 - 0:0 - 0:0,0,3,Petrosyan Davit,Arutyunov Ruben,fiurst,Arutyunov Ruben - Petrosyan Davit,54,33,21,-12,12,20,16,18,0,0,-2,-6,-4,0,0,-12,11:9 - 11:5 - 11:7 - 0:0 - 0:0
16539792,2024-01-27 16:00:00,Avakimyan Davit - Karakhanyan Mher,3:0,11:9 - 11:7 - 11:8 - 0:0 - 0:0,3,0,Avakimyan Davit,Karakhanyan Mher,fiurst,Avakimyan Davit - Karakhanyan Mher,57,33,24,-9,9,20,18,19,0,0,-2,-4,-3,0,0,-9,11:9 - 11:7 - 11:8 - 0:0 - 0:0
16539787,2024-01-27 15:45:00,Arutyunov Ruben - Gevorgyan Gegham,3:1,11:3 - 8:11 - 11:3 - 11:7 - 0:0,3,1,Arutyunov Ruben,Gevorgyan Gegham,fiurst,Arutyunov Ruben - Gevorgyan Gegham,65,41,24,-17,17,14,19,14,18,0,-8,3,-8,-4,0,-17,11:3 - 8:11 - 11:3 - 11:7 - 0:0
16539784,2024-01-27 15:30:00,Petrosyan Davit - Avakimyan Davit,3:1,12:14 - 11:7 - 2:11 - 8:11 - 0:0,1,3,Petrosyan Davit,Avakimyan Davit,fiurst,Avakimyan Davit - Petrosyan Davit,76,43,33,-10,10,26,18,13,19,0,-2,4,-9,-3,0,-10,14:12 - 7:11 - 11:2 - 11:8 - 0:0
16539780,2024-01-27 15:15:00,Rafayelyan Edgar - Mkrtchyan Andranik,1:3,11:6 - 11:5 - 11:13 - 17:15 - 0:0,3,1,Rafayelyan Edgar,Mkrtchyan Andranik,fiurst,Mkrtchyan Andranik - Rafayelyan Edgar,89,39,50,11,-11,17,16,24,32,0,5,6,-2,2,0,11,6:11 - 5:11 - 13:11 - 15:17 - 0:0
16539778,2024-01-27 15:00:00,Nazaryan Mushegh - Nikoghosyan Narek,0:3,8:11 - 9:11 - 3:11 - 0:0 - 0:0,0,3,Nazaryan Mushegh,Nikoghosyan Narek,fiurst,Nazaryan Mushegh - Nikoghosyan Narek,53,20,33,13,-13,19,20,14,0,0,3,2,8,0,0,13,8:11 - 9:11 - 3:11 - 0:0 - 0:0
16539773,2024-01-27 14:45:00,Gevorgyan Hayk - Rafayelyan Edgar,0:3,11:13 - 1:11 - 7:11 - 0:0 - 0:0,0,3,Gevorgyan Hayk,Rafayelyan Edgar,fiurst,Gevorgyan Hayk - Rafayelyan Edgar,54,19,35,16,-16,24,12,18,0,0,2,10,4,0,0,16,11:13 - 1:11 - 7:11 - 0:0 - 0:0
16539761,2024-01-27 14:35:00,Mkrtchyan Andranik - Nazaryan Mushegh,2:3,9:11 - 11:5 - 7:11 - 11:9 - 7:11,2,3,Mkrtchyan Andranik,Nazaryan Mushegh,fiurst,Mkrtchyan Andranik - Nazaryan Mushegh,92,45,47,2,-2,20,16,18,20,18,2,-6,4,-2,4,2,9:11 - 11:5 - 7:11 - 11:9 - 7:11
16539759,2024-01-27 14:15:00,Gevorgyan Hayk - Nikoghosyan Narek,0:3,2:11 - 2:11 - 2:11 - 0:0 - 0:0,0,3,Gevorgyan Hayk,Nikoghosyan Narek,fiurst,Gevorgyan Hayk - Nikoghosyan Narek,39,6,33,27,-27,13,13,13,0,0,9,9,9,0,0,27,2:11 - 2:11 - 2:11 - 0:0 - 0:0
16539756,2024-01-27 14:00:00,Rafayelyan Edgar - Nazaryan Mushegh,2:3,5:11 - 11:6 - 7:11 - 11:6 - 11:9,3,2,Rafayelyan Edgar,Nazaryan Mushegh,fiurst,Nazaryan Mushegh - Rafayelyan Edgar,88,43,45,2,-2,16,17,18,17,20,-6,5,-4,5,2,2,11:5 - 6:11 - 11:7 - 6:11 - 9:11
16539754,2024-01-27 13:45:00,Mkrtchyan Andranik - Gevorgyan Hayk,3:0,6:11 - 13:15 - 6:11 - 0:0 - 0:0,0,3,Mkrtchyan Andranik,Gevorgyan Hayk,fiurst,Gevorgyan Hayk - Mkrtchyan Andranik,62,37,25,-12,12,17,28,17,0,0,-5,-2,-5,0,0,-12,11:6 - 15:13 - 11:6 - 0:0 - 0:0
16539753,2024-01-27 13:30:00,Nikoghosyan Narek - Rafayelyan Edgar,0:3,12:14 - 5:11 - 9:11 - 0:0 - 0:0,0,3,Nikoghosyan Narek,Rafayelyan Edgar,fiurst,Nikoghosyan Narek - Rafayelyan Edgar,62,26,36,10,-10,26,16,20,0,0,2,6,2,0,0,10,12:14 - 5:11 - 9:11 - 0:0 - 0:0
16539749,2024-01-27 13:15:00,Nazaryan Mushegh - Gevorgyan Hayk,1:3,11:7 - 10:12 - 11:5 - 11:9 - 0:0,3,1,Nazaryan Mushegh,Gevorgyan Hayk,fiurst,Gevorgyan Hayk - Nazaryan Mushegh,76,33,43,10,-10,18,22,16,20,0,4,-2,6,2,0,10,7:11 - 12:10 - 5:11 - 9:11 - 0:0
16539748,2024-01-27 13:00:00,Nikoghosyan Narek - Mkrtchyan Andranik,0:3,13:11 - 11:9 - 13:11 - 0:0 - 0:0,3,0,Nikoghosyan Narek,Mkrtchyan Andranik,fiurst,Mkrtchyan Andranik - Nikoghosyan Narek,68,31,37,6,-6,24,20,24,0,0,2,2,2,0,0,6,11:13 - 9:11 - 11:13 - 0:0 - 0:0
16539745,2024-01-27 12:15:00,Rafayelyan Edgar - Gevorgyan Hayk,0:3,11:8 - 11:4 - 11:6 - 0:0 - 0:0,3,0,Rafayelyan Edgar,Gevorgyan Hayk,fiurst,Gevorgyan Hayk - Rafayelyan Edgar,51,18,33,15,-15,19,15,17,0,0,3,7,5,0,0,15,8:11 - 4:11 - 6:11 - 0:0 - 0:0
16539743,2024-01-27 12:05:00,Nikoghosyan Narek - Nazaryan Mushegh,0:3,11:6 - 11:6 - 11:7 - 0:0 - 0:0,3,0,Nikoghosyan Narek,Nazaryan Mushegh,fiurst,Nazaryan Mushegh - Nikoghosyan Narek,52,19,33,14,-14,17,17,18,0,0,5,5,4,0,0,14,6:11 - 6:11 - 7:11 - 0:0 - 0:0
16539734,2024-01-27 11:45:00,Mkrtchyan Andranik - Rafayelyan Edgar,1:3,10:12 - 12:10 - 9:11 - 9:11 - 0:0,1,3,Mkrtchyan Andranik,Rafayelyan Edgar,fiurst,Mkrtchyan Andranik - Rafayelyan Edgar,84,40,44,4,-4,22,22,20,20,0,2,-2,2,2,0,4,10:12 - 12:10 - 9:11 - 9:11 - 0:0
16539720,2024-01-27 11:35:00,Nikoghosyan Narek - Gevorgyan Hayk,1:3,7:11 - 11:8 - 13:11 - 11:7 - 0:0,3,1,Nikoghosyan Narek,Gevorgyan Hayk,fiurst,Gevorgyan Hayk - Nikoghosyan Narek,79,37,42,5,-5,18,19,24,18,0,-4,3,2,4,0,5,11:7 - 8:11 - 11:13 - 7:11 - 0:0
16539717,2024-01-27 11:15:00,Nazaryan Mushegh - Mkrtchyan Andranik,3:1,8:11 - 11:9 - 9:11 - 9:11 - 0:0,1,3,Nazaryan Mushegh,Mkrtchyan Andranik,fiurst,Mkrtchyan Andranik - Nazaryan Mushegh,79,42,37,-5,5,19,20,20,20,0,-3,2,-2,-2,0,-5,11:8 - 9:11 - 11:9 - 11:9 - 0:0
16539715,2024-01-27 11:00:00,Rafayelyan Edgar - Nikoghosyan Narek,3:1,11:5 - 2:11 - 9:11 - 4:11 - 0:0,1,3,Rafayelyan Edgar,Nikoghosyan Narek,fiurst,Nikoghosyan Narek - Rafayelyan Edgar,64,38,26,-12,12,16,13,20,15,0,6,-9,-2,-7,0,-12,5:11 - 11:2 - 11:9 - 11:4 - 0:0
16539712,2024-01-27 10:45:00,Gevorgyan Hayk - Mkrtchyan Andranik,0:3,7:11 - 9:11 - 10:12 - 0:0 - 0:0,0,3,Gevorgyan Hayk,Mkrtchyan Andranik,fiurst,Gevorgyan Hayk - Mkrtchyan Andranik,60,26,34,8,-8,18,20,22,0,0,4,2,2,0,0,8,7:11 - 9:11 - 10:12 - 0:0 - 0:0
16539707,2024-01-27 10:30:00,Nazaryan Mushegh - Rafayelyan Edgar,0:3,10:12 - 5:11 - 6:11 - 0:0 - 0:0,0,3,Nazaryan Mushegh,Rafayelyan Edgar,fiurst,Nazaryan Mushegh - Rafayelyan Edgar,55,21,34,13,-13,22,16,17,0,0,2,6,5,0,0,13,10:12 - 5:11 - 6:11 - 0:0 - 0:0
16539704,2024-01-27 10:15:00,Mkrtchyan Andranik - Nikoghosyan Narek,1:3,11:13 - 11:4 - 7:11 - 10:12 - 0:0,1,3,Mkrtchyan Andranik,Nikoghosyan Narek,fiurst,Mkrtchyan Andranik - Nikoghosyan Narek,79,39,40,1,-1,24,15,18,22,0,2,-7,4,2,0,1,11:13 - 11:4 - 7:11 - 10:12 - 0:0
16539688,2024-01-27 10:00:00,Gevorgyan Hayk - Nazaryan Mushegh,1:3,7:11 - 4:11 - 11:8 - 6:11 - 0:0,1,3,Gevorgyan Hayk,Nazaryan Mushegh,fiurst,Gevorgyan Hayk - Nazaryan Mushegh,69,28,41,13,-13,18,15,19,17,0,4,7,-3,5,0,13,7:11 - 4:11 - 11:8 - 6:11 - 0:0
16520634,2024-01-26 17:45:00,Petrosyan Davit - Karakhanyan Mher,0:3,12:10 - 11:5 - 11:6 - 0:0 - 0:0,3,0,Petrosyan Davit,Karakhanyan Mher,fiurst,Karakhanyan Mher - Petrosyan Davit,55,21,34,13,-13,22,16,17,0,0,2,6,5,0,0,13,10:12 - 5:11 - 6:11 - 0:0 - 0:0
16520631,2024-01-26 17:30:00,Grigoryan Erik - Arutyunov Ruben,3:0,8:11 - 5:11 - 7:11 - 0:0 - 0:0,0,3,Grigoryan Erik,Arutyunov Ruben,fiurst,Arutyunov Ruben - Grigoryan Erik,53,33,20,-13,13,19,16,18,0,0,-3,-6,-4,0,0,-13,11:8 - 11:5 - 11:7 - 0:0 - 0:0
16520629,2024-01-26 17:15:00,Gevorgyan Gegham - Petrosyan Davit,1:3,11:9 - 11:13 - 5:11 - 3:11 - 0:0,1,3,Gevorgyan Gegham,Petrosyan Davit,fiurst,Gevorgyan Gegham - Petrosyan Davit,74,30,44,14,-14,20,24,16,14,0,-2,2,6,8,0,14,11:9 - 11:13 - 5:11 - 3:11 - 0:0
16520627,2024-01-26 17:05:00,Grigoryan Erik - Karakhanyan Mher,3:0,11:9 - 12:10 - 11:9 - 0:0 - 0:0,3,0,Grigoryan Erik,Karakhanyan Mher,fiurst,Grigoryan Erik - Karakhanyan Mher,62,34,28,-6,6,20,22,20,0,0,-2,-2,-2,0,0,-6,11:9 - 12:10 - 11:9 - 0:0 - 0:0
16520612,2024-01-26 16:45:00,Arutyunov Ruben - Gevorgyan Gegham,3:0,11:2 - 11:2 - 12:10 - 0:0 - 0:0,3,0,Arutyunov Ruben,Gevorgyan Gegham,fiurst,Arutyunov Ruben - Gevorgyan Gegham,48,34,14,-20,20,13,13,22,0,0,-9,-9,-2,0,0,-20,11:2 - 11:2 - 12:10 - 0:0 - 0:0
16520608,2024-01-26 16:30:00,Petrosyan Davit - Grigoryan Erik,3:2,11:5 - 8:11 - 11:7 - 10:12 - 6:11,2,3,Petrosyan Davit,Grigoryan Erik,fiurst,Grigoryan Erik - Petrosyan Davit,92,46,46,0,0,16,19,18,22,17,6,-3,4,-2,-5,0,5:11 - 11:8 - 7:11 - 12:10 - 11:6
16520600,2024-01-26 16:15:00,Karakhanyan Mher - Gevorgyan Gegham,3:2,3:11 - 11:13 - 11:5 - 11:5 - 6:11,2,3,Karakhanyan Mher,Gevorgyan Gegham,fiurst,Gevorgyan Gegham - Karakhanyan Mher,87,45,42,-3,3,14,24,16,16,17,-8,-2,6,6,-5,-3,11:3 - 13:11 - 5:11 - 5:11 - 11:6
16520595,2024-01-26 16:00:00,Arutyunov Ruben - Petrosyan Davit,3:0,14:12 - 11:5 - 11:5 - 0:0 - 0:0,3,0,Arutyunov Ruben,Petrosyan Davit,fiurst,Arutyunov Ruben - Petrosyan Davit,58,36,22,-14,14,26,16,16,0,0,-2,-6,-6,0,0,-14,14:12 - 11:5 - 11:5 - 0:0 - 0:0
16520591,2024-01-26 15:45:00,Gevorgyan Gegham - Grigoryan Erik,1:3,8:11 - 11:7 - 10:12 - 10:12 - 0:0,1,3,Gevorgyan Gegham,Grigoryan Erik,fiurst,Gevorgyan Gegham - Grigoryan Erik,81,39,42,3,-3,19,18,22,22,0,3,-4,2,2,0,3,8:11 - 11:7 - 10:12 - 10:12 - 0:0
16520589,2024-01-26 15:30:00,Karakhanyan Mher - Arutyunov Ruben,3:1,3:11 - 11:6 - 4:11 - 7:11 - 0:0,1,3,Karakhanyan Mher,Arutyunov Ruben,fiurst,Arutyunov Ruben - Karakhanyan Mher,64,39,25,-14,14,14,17,15,18,0,-8,5,-7,-4,0,-14,11:3 - 6:11 - 11:4 - 11:7 - 0:0
16520575,2024-01-26 15:15:00,Nikoghosyan Narek - Nazaryan Mushegh,0:3,11:7 - 11:7 - 11:6 - 0:0 - 0:0,3,0,Nikoghosyan Narek,Nazaryan Mushegh,fiurst,Nazaryan Mushegh - Nikoghosyan Narek,53,20,33,13,-13,18,18,17,0,0,4,4,5,0,0,13,7:11 - 7:11 - 6:11 - 0:0 - 0:0
16520572,2024-01-26 15:00:00,Diaryan Aleksandr - Papyan Karen,3:0,12:10 - 11:6 - 11:2 - 0:0 - 0:0,3,0,Diaryan Aleksandr,Papyan Karen,fiurst,Diaryan Aleksandr - Papyan Karen,52,34,18,-16,16,22,17,13,0,0,-2,-5,-9,0,0,-16,12:10 - 11:6 - 11:2 - 0:0 - 0:0
16520571,2024-01-26 14:45:00,Mkrtchyan Andranik - Nikoghosyan Narek,1:3,11:6 - 9:11 - 8:11 - 9:11 - 0:0,1,3,Mkrtchyan Andranik,Nikoghosyan Narek,fiurst,Mkrtchyan Andranik - Nikoghosyan Narek,76,37,39,2,-2,17,20,19,20,0,-5,2,3,2,0,2,11:6 - 9:11 - 8:11 - 9:11 - 0:0
16520569,2024-01-26 14:35:00,Nazaryan Mushegh - Diaryan Aleksandr,3:0,3:11 - 4:11 - 3:11 - 0:0 - 0:0,0,3,Nazaryan Mushegh,Diaryan Aleksandr,fiurst,Diaryan Aleksandr - Nazaryan Mushegh,43,33,10,-23,23,14,15,14,0,0,-8,-7,-8,0,0,-23,11:3 - 11:4 - 11:3 - 0:0 - 0:0
16520563,2024-01-26 14:20:00,Mkrtchyan Andranik - Papyan Karen,1:3,12:10 - 9:11 - 8:11 - 7:11 - 0:0,1,3,Mkrtchyan Andranik,Papyan Karen,fiurst,Mkrtchyan Andranik - Papyan Karen,79,36,43,7,-7,22,20,19,18,0,-2,2,3,4,0,7,12:10 - 9:11 - 8:11 - 7:11 - 0:0
16520560,2024-01-26 14:05:00,Nikoghosyan Narek - Diaryan Aleksandr,3:1,5:11 - 11:6 - 7:11 - 5:11 - 0:0,1,3,Nikoghosyan Narek,Diaryan Aleksandr,fiurst,Diaryan Aleksandr - Nikoghosyan Narek,67,39,28,-11,11,16,17,18,16,0,-6,5,-4,-6,0,-11,11:5 - 6:11 - 11:7 - 11:5 - 0:0
16520556,2024-01-26 14:00:00,Nazaryan Mushegh - Mkrtchyan Andranik,3:0,7:11 - 8:11 - 7:11 - 0:0 - 0:0,0,3,Nazaryan Mushegh,Mkrtchyan Andranik,fiurst,Mkrtchyan Andranik - Nazaryan Mushegh,55,33,22,-11,11,18,19,18,0,0,-4,-3,-4,0,0,-11,11:7 - 11:8 - 11:7 - 0:0 - 0:0
16520550,2024-01-26 13:30:00,Papyan Karen - Nikoghosyan Narek,3:2,11:5 - 9:11 - 6:11 - 11:9 - 7:11,2,3,Papyan Karen,Nikoghosyan Narek,fiurst,Nikoghosyan Narek - Papyan Karen,91,47,44,-3,3,16,20,17,20,18,6,-2,-5,2,-4,-3,5:11 - 11:9 - 11:6 - 9:11 - 11:7
16520548,2024-01-26 13:25:00,Diaryan Aleksandr - Mkrtchyan Andranik,3:1,9:11 - 11:6 - 14:12 - 11:5 - 0:0,3,1,Diaryan Aleksandr,Mkrtchyan Andranik,fiurst,Diaryan Aleksandr - Mkrtchyan Andranik,79,45,34,-11,11,20,17,26,16,0,2,-5,-2,-6,0,-11,9:11 - 11:6 - 14:12 - 11:5 - 0:0
16520532,2024-01-26 13:00:00,Papyan Karen - Nazaryan Mushegh,0:3,11:9 - 11:8 - 13:11 - 0:0 - 0:0,3,0,Papyan Karen,Nazaryan Mushegh,fiurst,Nazaryan Mushegh - Papyan Karen,63,28,35,7,-7,20,19,24,0,0,2,3,2,0,0,7,9:11 - 8:11 - 11:13 - 0:0 - 0:0
16520526,2024-01-26 12:20:00,Nikoghosyan Narek - Mkrtchyan Andranik,2:3,9:11 - 11:9 - 13:15 - 15:13 - 11:6,3,2,Nikoghosyan Narek,Mkrtchyan Andranik,fiurst,Mkrtchyan Andranik - Nikoghosyan Narek,113,54,59,5,-5,20,20,28,28,17,-2,2,-2,2,5,5,11:9 - 9:11 - 15:13 - 13:15 - 6:11
16520522,2024-01-26 12:15:00,Papyan Karen - Diaryan Aleksandr,1:3,5:11 - 11:6 - 11:8 - 11:5 - 0:0,3,1,Papyan Karen,Diaryan Aleksandr,fiurst,Diaryan Aleksandr - Papyan Karen,68,30,38,8,-8,16,17,19,16,0,-6,5,3,6,0,8,11:5 - 6:11 - 8:11 - 5:11 - 0:0
16520518,2024-01-26 11:45:00,Nazaryan Mushegh - Nikoghosyan Narek,0:3,8:11 - 8:11 - 8:11 - 0:0 - 0:0,0,3,Nazaryan Mushegh,Nikoghosyan Narek,fiurst,Nazaryan Mushegh - Nikoghosyan Narek,57,24,33,9,-9,19,19,19,0,0,3,3,3,0,0,9,8:11 - 8:11 - 8:11 - 0:0 - 0:0
16520512,2024-01-26 11:40:00,Papyan Karen - Mkrtchyan Andranik,2:3,11:4 - 11:13 - 6:11 - 11:9 - 14:12,3,2,Papyan Karen,Mkrtchyan Andranik,fiurst,Mkrtchyan Andranik - Papyan Karen,102,49,53,4,-4,15,24,17,20,26,7,-2,-5,2,2,4,4:11 - 13:11 - 11:6 - 9:11 - 12:14
16520507,2024-01-26 11:20:00,Diaryan Aleksandr - Nazaryan Mushegh,3:0,11:6 - 11:2 - 11:5 - 0:0 - 0:0,3,0,Diaryan Aleksandr,Nazaryan Mushegh,fiurst,Diaryan Aleksandr - Nazaryan Mushegh,46,33,13,-20,20,17,13,16,0,0,-5,-9,-6,0,0,-20,11:6 - 11:2 - 11:5 - 0:0 - 0:0
16520501,2024-01-26 11:00:00,Nikoghosyan Narek - Papyan Karen,2:3,11:4 - 11:9 - 9:11 - 7:11 - 10:12,2,3,Nikoghosyan Narek,Papyan Karen,fiurst,Nikoghosyan Narek - Papyan Karen,95,48,47,-1,1,15,20,20,18,22,-7,-2,2,4,2,-1,11:4 - 11:9 - 9:11 - 7:11 - 10:12
16520486,2024-01-26 10:45:00,Mkrtchyan Andranik - Nazaryan Mushegh,3:2,11:7 - 9:11 - 11:7 - 9:11 - 11:6,3,2,Mkrtchyan Andranik,Nazaryan Mushegh,fiurst,Mkrtchyan Andranik - Nazaryan Mushegh,93,51,42,-9,9,18,20,18,20,17,-4,2,-4,2,-5,-9,11:7 - 9:11 - 11:7 - 9:11 - 11:6
16520482,2024-01-26 10:30:00,Diaryan Aleksandr - Nikoghosyan Narek,3:0,11:5 - 11:9 - 11:5 - 0:0 - 0:0,3,0,Diaryan Aleksandr,Nikoghosyan Narek,fiurst,Diaryan Aleksandr - Nikoghosyan Narek,52,33,19,-14,14,16,20,16,0,0,-6,-2,-6,0,0,-14,11:5 - 11:9 - 11:5 - 0:0 - 0:0
16520479,2024-01-26 10:15:00,Nazaryan Mushegh - Papyan Karen,1:3,5:11 - 11:9 - 8:11 - 8:11 - 0:0,1,3,Nazaryan Mushegh,Papyan Karen,fiurst,Nazaryan Mushegh - Papyan Karen,74,32,42,10,-10,16,20,19,19,0,6,-2,3,3,0,10,5:11 - 11:9 - 8:11 - 8:11 - 0:0
16520368,2024-01-26 10:00:00,Mkrtchyan Andranik - Diaryan Aleksandr,3:1,11:6 - 4:11 - 3:11 - 10:12 - 0:0,1,3,Mkrtchyan Andranik,Diaryan Aleksandr,fiurst,Diaryan Aleksandr - Mkrtchyan Andranik,68,40,28,-12,12,17,15,14,22,0,5,-7,-8,-2,0,-12,6:11 - 11:4 - 11:3 - 12:10 - 0:0
16507458,2024-01-25 17:45:00,Darbinyan Armen - Avakimyan Davit,3:0,6:11 - 8:11 - 5:11 - 0:0 - 0:0,0,3,Darbinyan Armen,Avakimyan Davit,fiurst,Avakimyan Davit - Darbinyan Armen,52,33,19,-14,14,17,19,16,0,0,-5,-3,-6,0,0,-14,11:6 - 11:8 - 11:5 - 0:0 - 0:0
16507457,2024-01-25 17:30:00,Gevorgyan Gegham - Miroyan Hakob,3:0,11:7 - 11:3 - 11:3 - 0:0 - 0:0,3,0,Gevorgyan Gegham,Miroyan Hakob,fiurst,Gevorgyan Gegham - Miroyan Hakob,46,33,13,-20,20,18,14,14,0,0,-4,-8,-8,0,0,-20,11:7 - 11:3 - 11:3 - 0:0 - 0:0
16507456,2024-01-25 17:15:00,Gevorgyan Hayk - Darbinyan Armen,0:3,11:5 - 11:6 - 11:4 - 0:0 - 0:0,3,0,Gevorgyan Hayk,Darbinyan Armen,fiurst,Darbinyan Armen - Gevorgyan Hayk,48,15,33,18,-18,16,17,15,0,0,6,5,7,0,0,18,5:11 - 6:11 - 4:11 - 0:0 - 0:0
16507453,2024-01-25 17:00:00,Gevorgyan Gegham - Avakimyan Davit,3:0,6:11 - 9:11 - 8:11 - 0:0 - 0:0,0,3,Gevorgyan Gegham,Avakimyan Davit,fiurst,Avakimyan Davit - Gevorgyan Gegham,56,33,23,-10,10,17,20,19,0,0,-5,-2,-3,0,0,-10,11:6 - 11:9 - 11:8 - 0:0 - 0:0
16507452,2024-01-25 16:45:00,Miroyan Hakob - Gevorgyan Hayk,3:0,4:11 - 5:11 - 6:11 - 0:0 - 0:0,0,3,Miroyan Hakob,Gevorgyan Hayk,fiurst,Gevorgyan Hayk - Miroyan Hakob,48,33,15,-18,18,15,16,17,0,0,-7,-6,-5,0,0,-18,11:4 - 11:5 - 11:6 - 0:0 - 0:0
16507444,2024-01-25 16:30:00,Darbinyan Armen - Gevorgyan Gegham,0:3,6:11 - 4:11 - 4:11 - 0:0 - 0:0,0,3,Darbinyan Armen,Gevorgyan Gegham,fiurst,Darbinyan Armen - Gevorgyan Gegham,47,14,33,19,-19,17,15,15,0,0,5,7,7,0,0,19,6:11 - 4:11 - 4:11 - 0:0 - 0:0
16507438,2024-01-25 16:20:00,Avakimyan Davit - Gevorgyan Hayk,0:3,4:11 - 5:11 - 5:11 - 0:0 - 0:0,0,3,Avakimyan Davit,Gevorgyan Hayk,fiurst,Avakimyan Davit - Gevorgyan Hayk,47,14,33,19,-19,15,16,16,0,0,7,6,6,0,0,19,4:11 - 5:11 - 5:11 - 0:0 - 0:0
16507436,2024-01-25 16:00:00,Miroyan Hakob - Darbinyan Armen,3:1,11:4 - 6:11 - 3:11 - 9:11 - 0:0,1,3,Miroyan Hakob,Darbinyan Armen,fiurst,Darbinyan Armen - Miroyan Hakob,66,37,29,-8,8,15,17,14,20,0,7,-5,-8,-2,0,-8,4:11 - 11:6 - 11:3 - 11:9 - 0:0
16507434,2024-01-25 15:45:00,Gevorgyan Hayk - Gevorgyan Gegham,2:3,11:6 - 9:11 - 9:11 - 11:5 - 11:8,3,2,Gevorgyan Hayk,Gevorgyan Gegham,fiurst,Gevorgyan Gegham - Gevorgyan Hayk,92,41,51,10,-10,17,20,20,16,19,5,-2,-2,6,3,10,6:11 - 11:9 - 11:9 - 5:11 - 8:11
16507433,2024-01-25 15:30:00,Avakimyan Davit - Miroyan Hakob,3:1,6:11 - 11:7 - 11:3 - 11:9 - 0:0,3,1,Avakimyan Davit,Miroyan Hakob,fiurst,Avakimyan Davit - Miroyan Hakob,69,39,30,-9,9,17,18,14,20,0,5,-4,-8,-2,0,-9,6:11 - 11:7 - 11:3 - 11:9 - 0:0
16507432,2024-01-25 15:20:00,Papyan Karen - Diaryan Aleksandr,3:1,10:12 - 13:11 - 10:12 - 3:11 - 0:0,1,3,Papyan Karen,Diaryan Aleksandr,fiurst,Diaryan Aleksandr - Papyan Karen,82,46,36,-10,10,22,24,22,14,0,-2,2,-2,-8,0,-10,12:10 - 11:13 - 12:10 - 11:3 - 0:0
16507430,2024-01-25 15:00:00,Mkrtchyan Andranik - Rafayelyan Edgar,1:3,7:11 - 15:13 - 9:11 - 4:11 - 0:0,1,3,Mkrtchyan Andranik,Rafayelyan Edgar,fiurst,Mkrtchyan Andranik - Rafayelyan Edgar,81,35,46,11,-11,18,28,20,15,0,4,-2,2,7,0,11,7:11 - 15:13 - 9:11 - 4:11 - 0:0
16507427,2024-01-25 14:50:00,Nikoghosyan Narek - Papyan Karen,2:3,11:8 - 8:11 - 11:7 - 8:11 - 7:11,2,3,Nikoghosyan Narek,Papyan Karen,fiurst,Nikoghosyan Narek - Papyan Karen,93,45,48,3,-3,19,19,18,19,18,-3,3,-4,3,4,3,11:8 - 8:11 - 11:7 - 8:11 - 7:11
16507423,2024-01-25 14:30:00,Diaryan Aleksandr - Mkrtchyan Andranik,3:2,11:6 - 11:5 - 8:11 - 9:11 - 11:4,3,2,Diaryan Aleksandr,Mkrtchyan Andranik,fiurst,Diaryan Aleksandr - Mkrtchyan Andranik,87,50,37,-13,13,17,16,19,20,15,-5,-6,3,2,-7,-13,11:6 - 11:5 - 8:11 - 9:11 - 11:4
16507392,2024-01-25 14:20:00,Nikoghosyan Narek - Rafayelyan Edgar,0:3,5:11 - 8:11 - 5:11 - 0:0 - 0:0,0,3,Nikoghosyan Narek,Rafayelyan Edgar,fiurst,Nikoghosyan Narek - Rafayelyan Edgar,51,18,33,15,-15,16,19,16,0,0,6,3,6,0,0,15,5:11 - 8:11 - 5:11 - 0:0 - 0:0
16507389,2024-01-25 14:00:00,Papyan Karen - Mkrtchyan Andranik,2:3,11:8 - 5:11 - 11:4 - 10:12 - 11:8,3,2,Papyan Karen,Mkrtchyan Andranik,fiurst,Mkrtchyan Andranik - Papyan Karen,91,43,48,5,-5,19,16,15,22,19,3,-6,7,-2,3,5,8:11 - 11:5 - 4:11 - 12:10 - 8:11
16507377,2024-01-25 13:45:00,Diaryan Aleksandr - Nikoghosyan Narek,3:1,11:8 - 6:11 - 11:7 - 11:8 - 0:0,3,1,Diaryan Aleksandr,Nikoghosyan Narek,fiurst,Diaryan Aleksandr - Nikoghosyan Narek,73,39,34,-5,5,19,17,18,19,0,-3,5,-4,-3,0,-5,11:8 - 6:11 - 11:7 - 11:8 - 0:0
16507370,2024-01-25 13:30:00,Rafayelyan Edgar - Papyan Karen,2:3,10:12 - 11:4 - 11:9 - 9:11 - 11:9,3,2,Rafayelyan Edgar,Papyan Karen,fiurst,Papyan Karen - Rafayelyan Edgar,97,45,52,7,-7,22,15,20,20,20,-2,7,2,-2,2,7,12:10 - 4:11 - 9:11 - 11:9 - 9:11
16507369,2024-01-25 13:15:00,Mkrtchyan Andranik - Nikoghosyan Narek,0:3,9:11 - 9:11 - 7:11 - 0:0 - 0:0,0,3,Mkrtchyan Andranik,Nikoghosyan Narek,fiurst,Mkrtchyan Andranik - Nikoghosyan Narek,58,25,33,8,-8,20,20,18,0,0,2,2,4,0,0,8,9:11 - 9:11 - 7:11 - 0:0 - 0:0
16507364,2024-01-25 13:00:00,Rafayelyan Edgar - Diaryan Aleksandr,0:3,11:8 - 11:7 - 11:6 - 0:0 - 0:0,3,0,Rafayelyan Edgar,Diaryan Aleksandr,fiurst,Diaryan Aleksandr - Rafayelyan Edgar,54,21,33,12,-12,19,18,17,0,0,3,4,5,0,0,12,8:11 - 7:11 - 6:11 - 0:0 - 0:0
16507362,2024-01-25 12:15:00,Papyan Karen - Nikoghosyan Narek,1:3,12:10 - 3:11 - 11:6 - 12:10 - 0:0,3,1,Papyan Karen,Nikoghosyan Narek,fiurst,Nikoghosyan Narek - Papyan Karen,75,37,38,1,-1,22,14,17,22,0,2,-8,5,2,0,1,10:12 - 11:3 - 6:11 - 10:12 - 0:0
16507359,2024-01-25 12:00:00,Rafayelyan Edgar - Mkrtchyan Andranik,1:3,8:11 - 11:3 - 11:4 - 11:9 - 0:0,3,1,Rafayelyan Edgar,Mkrtchyan Andranik,fiurst,Mkrtchyan Andranik - Rafayelyan Edgar,68,27,41,14,-14,19,14,15,20,0,-3,8,7,2,0,14,11:8 - 3:11 - 4:11 - 9:11 - 0:0
16507355,2024-01-25 11:50:00,Diaryan Aleksandr - Papyan Karen,3:0,11:5 - 11:8 - 12:10 - 0:0 - 0:0,3,0,Diaryan Aleksandr,Papyan Karen,fiurst,Diaryan Aleksandr - Papyan Karen,57,34,23,-11,11,16,19,22,0,0,-6,-3,-2,0,0,-11,11:5 - 11:8 - 12:10 - 0:0 - 0:0
16507353,2024-01-25 11:30:00,Rafayelyan Edgar - Nikoghosyan Narek,3:1,5:11 - 8:11 - 11:4 - 6:11 - 0:0,1,3,Rafayelyan Edgar,Nikoghosyan Narek,fiurst,Nikoghosyan Narek - Rafayelyan Edgar,67,37,30,-7,7,16,19,15,17,0,-6,-3,7,-5,0,-7,11:5 - 11:8 - 4:11 - 11:6 - 0:0
16507350,2024-01-25 11:15:00,Mkrtchyan Andranik - Diaryan Aleksandr,3:1,6:11 - 4:11 - 13:11 - 10:12 - 0:0,1,3,Mkrtchyan Andranik,Diaryan Aleksandr,fiurst,Diaryan Aleksandr - Mkrtchyan Andranik,78,45,33,-12,12,17,15,24,22,0,-5,-7,2,-2,0,-12,11:6 - 11:4 - 11:13 - 12:10 - 0:0
16507348,2024-01-25 11:00:00,Papyan Karen - Rafayelyan Edgar,1:3,11:8 - 10:12 - 9:11 - 7:11 - 0:0,1,3,Papyan Karen,Rafayelyan Edgar,fiurst,Papyan Karen - Rafayelyan Edgar,79,37,42,5,-5,19,22,20,18,0,-3,2,2,4,0,5,11:8 - 10:12 - 9:11 - 7:11 - 0:0
16507345,2024-01-25 10:45:00,Nikoghosyan Narek - Diaryan Aleksandr,0:3,11:9 - 12:10 - 12:10 - 0:0 - 0:0,3,0,Nikoghosyan Narek,Diaryan Aleksandr,fiurst,Diaryan Aleksandr - Nikoghosyan Narek,64,29,35,6,-6,20,22,22,0,0,2,2,2,0,0,6,9:11 - 10:12 - 10:12 - 0:0 - 0:0
16507337,2024-01-25 10:30:00,Mkrtchyan Andranik - Papyan Karen,1:3,11:6 - 3:11 - 7:11 - 9:11 - 0:0,1,3,Mkrtchyan Andranik,Papyan Karen,fiurst,Mkrtchyan Andranik - Papyan Karen,69,30,39,9,-9,17,14,18,20,0,-5,8,4,2,0,9,11:6 - 3:11 - 7:11 - 9:11 - 0:0
16507330,2024-01-25 10:15:00,Diaryan Aleksandr - Rafayelyan Edgar,1:3,6:11 - 6:11 - 11:1 - 9:11 - 0:0,1,3,Diaryan Aleksandr,Rafayelyan Edgar,fiurst,Diaryan Aleksandr - Rafayelyan Edgar,66,32,34,2,-2,17,17,12,20,0,5,5,-10,2,0,2,6:11 - 6:11 - 11:1 - 9:11 - 0:0
16507329,2024-01-25 10:00:00,Nikoghosyan Narek - Mkrtchyan Andranik,1:3,10:12 - 11:8 - 11:8 - 11:2 - 0:0,3,1,Nikoghosyan Narek,Mkrtchyan Andranik,fiurst,Mkrtchyan Andranik - Nikoghosyan Narek,73,30,43,13,-13,22,19,19,13,0,-2,3,3,9,0,13,12:10 - 8:11 - 8:11 - 2:11 - 0:0
16486751,2024-01-24 17:45:00,Darbinyan Armen - Gevorgyan Gegham,0:3,3:11 - 5:11 - 6:11 - 0:0 - 0:0,0,3,Darbinyan Armen,Gevorgyan Gegham,fiurst,Darbinyan Armen - Gevorgyan Gegham,47,14,33,19,-19,14,16,17,0,0,8,6,5,0,0,19,3:11 - 5:11 - 6:11 - 0:0 - 0:0
16486747,2024-01-24 17:30:00,Karakhanyan Mher - Gevorgyan Hayk,3:1,6:11 - 11:9 - 4:11 - 5:11 - 0:0,1,3,Karakhanyan Mher,Gevorgyan Hayk,fiurst,Gevorgyan Hayk - Karakhanyan Mher,68,42,26,-16,16,17,20,15,16,0,-5,2,-7,-6,0,-16,11:6 - 9:11 - 11:4 - 11:5 - 0:0
16486745,2024-01-24 17:15:00,Avakimyan Davit - Darbinyan Armen,3:0,11:3 - 11:8 - 11:3 - 0:0 - 0:0,3,0,Avakimyan Davit,Darbinyan Armen,fiurst,Avakimyan Davit - Darbinyan Armen,47,33,14,-19,19,14,19,14,0,0,-8,-3,-8,0,0,-19,11:3 - 11:8 - 11:3 - 0:0 - 0:0
16486743,2024-01-24 17:00:00,Karakhanyan Mher - Gevorgyan Gegham,3:0,6:11 - 6:11 - 7:11 - 0:0 - 0:0,0,3,Karakhanyan Mher,Gevorgyan Gegham,fiurst,Gevorgyan Gegham - Karakhanyan Mher,52,33,19,-14,14,17,17,18,0,0,-5,-5,-4,0,0,-14,11:6 - 11:6 - 11:7 - 0:0 - 0:0
16486741,2024-01-24 16:45:00,Gevorgyan Hayk - Avakimyan Davit,2:3,7:11 - 7:11 - 11:9 - 11:7 - 11:5,3,2,Gevorgyan Hayk,Avakimyan Davit,fiurst,Avakimyan Davit - Gevorgyan Hayk,90,43,47,4,-4,18,18,20,18,16,-4,-4,2,4,6,4,11:7 - 11:7 - 9:11 - 7:11 - 5:11
16486740,2024-01-24 16:30:00,Darbinyan Armen - Karakhanyan Mher,3:0,11:5 - 13:11 - 12:10 - 0:0 - 0:0,3,0,Darbinyan Armen,Karakhanyan Mher,fiurst,Darbinyan Armen - Karakhanyan Mher,62,36,26,-10,10,16,24,22,0,0,-6,-2,-2,0,0,-10,11:5 - 13:11 - 12:10 - 0:0 - 0:0
16486729,2024-01-24 16:15:00,Gevorgyan Gegham - Avakimyan Davit,3:1,4:11 - 11:8 - 6:11 - 9:11 - 0:0,1,3,Gevorgyan Gegham,Avakimyan Davit,fiurst,Avakimyan Davit - Gevorgyan Gegham,71,41,30,-11,11,15,19,17,20,0,-7,3,-5,-2,0,-11,11:4 - 8:11 - 11:6 - 11:9 - 0:0
16486724,2024-01-24 16:05:00,Gevorgyan Hayk - Darbinyan Armen,0:3,11:8 - 11:4 - 11:2 - 0:0 - 0:0,3,0,Gevorgyan Hayk,Darbinyan Armen,fiurst,Darbinyan Armen - Gevorgyan Hayk,47,14,33,19,-19,19,15,13,0,0,3,7,9,0,0,19,8:11 - 4:11 - 2:11 - 0:0 - 0:0
16486721,2024-01-24 15:45:00,Avakimyan Davit - Karakhanyan Mher,3:1,8:11 - 11:8 - 11:7 - 11:9 - 0:0,3,1,Avakimyan Davit,Karakhanyan Mher,fiurst,Avakimyan Davit - Karakhanyan Mher,76,41,35,-6,6,19,19,18,20,0,3,-3,-4,-2,0,-6,8:11 - 11:8 - 11:7 - 11:9 - 0:0
16486719,2024-01-24 15:30:00,Gevorgyan Gegham - Gevorgyan Hayk,0:3,9:11 - 7:11 - 4:11 - 0:0 - 0:0,0,3,Gevorgyan Gegham,Gevorgyan Hayk,fiurst,Gevorgyan Gegham - Gevorgyan Hayk,53,20,33,13,-13,20,18,15,0,0,2,4,7,0,0,13,9:11 - 7:11 - 4:11 - 0:0 - 0:0
16486716,2024-01-24 15:25:00,Rafayelyan Edgar - Arutyunov Ruben,0:3,11:8 - 11:9 - 11:7 - 0:0 - 0:0,3,0,Rafayelyan Edgar,Arutyunov Ruben,fiurst,Arutyunov Ruben - Rafayelyan Edgar,57,24,33,9,-9,19,20,18,0,0,3,2,4,0,0,9,8:11 - 9:11 - 7:11 - 0:0 - 0:0
16486715,2024-01-24 15:05:00,Nazaryan Mushegh - Nikoghosyan Narek,0:3,7:11 - 8:11 - 6:11 - 0:0 - 0:0,0,3,Nazaryan Mushegh,Nikoghosyan Narek,fiurst,Nazaryan Mushegh - Nikoghosyan Narek,54,21,33,12,-12,18,19,17,0,0,4,3,5,0,0,12,7:11 - 8:11 - 6:11 - 0:0 - 0:0
16486660,2024-01-24 14:50:00,Papyan Karen - Rafayelyan Edgar,2:3,11:5 - 11:9 - 7:11 - 8:11 - 8:11,2,3,Papyan Karen,Rafayelyan Edgar,fiurst,Papyan Karen - Rafayelyan Edgar,92,45,47,2,-2,16,20,18,19,19,-6,-2,4,3,3,2,11:5 - 11:9 - 7:11 - 8:11 - 8:11
16486657,2024-01-24 14:40:00,Arutyunov Ruben - Nazaryan Mushegh,1:3,6:11 - 11:13 - 11:5 - 9:11 - 0:0,1,3,Arutyunov Ruben,Nazaryan Mushegh,fiurst,Arutyunov Ruben - Nazaryan Mushegh,77,37,40,3,-3,17,24,16,20,0,5,2,-6,2,0,3,6:11 - 11:13 - 11:5 - 9:11 - 0:0
16486653,2024-01-24 14:15:00,Papyan Karen - Nikoghosyan Narek,3:2,4:11 - 3:11 - 11:9 - 11:9 - 5:11,2,3,Papyan Karen,Nikoghosyan Narek,fiurst,Nikoghosyan Narek - Papyan Karen,85,51,34,-17,17,15,14,20,20,16,-7,-8,2,2,-6,-17,11:4 - 11:3 - 9:11 - 9:11 - 11:5
16486649,2024-01-24 14:05:00,Rafayelyan Edgar - Nazaryan Mushegh,1:3,11:8 - 8:11 - 11:8 - 11:7 - 0:0,3,1,Rafayelyan Edgar,Nazaryan Mushegh,fiurst,Nazaryan Mushegh - Rafayelyan Edgar,75,34,41,7,-7,19,19,19,18,0,3,-3,3,4,0,7,8:11 - 11:8 - 8:11 - 7:11 - 0:0
16486647,2024-01-24 13:45:00,Arutyunov Ruben - Papyan Karen,0:3,9:11 - 10:12 - 11:13 - 0:0 - 0:0,0,3,Arutyunov Ruben,Papyan Karen,fiurst,Arutyunov Ruben - Papyan Karen,66,30,36,6,-6,20,22,24,0,0,2,2,2,0,0,6,9:11 - 10:12 - 11:13 - 0:0 - 0:0
16486645,2024-01-24 13:30:00,Nikoghosyan Narek - Rafayelyan Edgar,3:2,5:11 - 11:6 - 10:12 - 11:8 - 11:7,3,2,Nikoghosyan Narek,Rafayelyan Edgar,fiurst,Nikoghosyan Narek - Rafayelyan Edgar,92,48,44,-4,4,16,17,22,19,18,6,-5,2,-3,-4,-4,5:11 - 11:6 - 10:12 - 11:8 - 11:7
16486643,2024-01-24 13:15:00,Nazaryan Mushegh - Papyan Karen,2:3,9:11 - 11:8 - 6:11 - 11:5 - 4:11,2,3,Nazaryan Mushegh,Papyan Karen,fiurst,Nazaryan Mushegh - Papyan Karen,87,41,46,5,-5,20,19,17,16,15,2,-3,5,-6,7,5,9:11 - 11:8 - 6:11 - 11:5 - 4:11
16486641,2024-01-24 13:00:00,Nikoghosyan Narek - Arutyunov Ruben,1:3,11:4 - 4:11 - 12:10 - 11:3 - 0:0,3,1,Nikoghosyan Narek,Arutyunov Ruben,fiurst,Arutyunov Ruben - Nikoghosyan Narek,66,28,38,10,-10,15,15,22,14,0,7,-7,2,8,0,10,4:11 - 11:4 - 10:12 - 3:11 - 0:0
16486630,2024-01-24 12:20:00,Rafayelyan Edgar - Papyan Karen,1:3,9:11 - 11:9 - 11:9 - 11:2 - 0:0,3,1,Rafayelyan Edgar,Papyan Karen,fiurst,Papyan Karen - Rafayelyan Edgar,73,31,42,11,-11,20,20,20,13,0,-2,2,2,9,0,11,11:9 - 9:11 - 9:11 - 2:11 - 0:0
16486629,2024-01-24 12:15:00,Nikoghosyan Narek - Nazaryan Mushegh,0:3,11:5 - 11:5 - 14:12 - 0:0 - 0:0,3,0,Nikoghosyan Narek,Nazaryan Mushegh,fiurst,Nazaryan Mushegh - Nikoghosyan Narek,58,22,36,14,-14,16,16,26,0,0,6,6,2,0,0,14,5:11 - 5:11 - 12:14 - 0:0 - 0:0
16486627,2024-01-24 12:05:00,Arutyunov Ruben - Rafayelyan Edgar,0:3,9:11 - 6:11 - 7:11 - 0:0 - 0:0,0,3,Arutyunov Ruben,Rafayelyan Edgar,fiurst,Arutyunov Ruben - Rafayelyan Edgar,55,22,33,11,-11,20,17,18,0,0,2,5,4,0,0,11,9:11 - 6:11 - 7:11 - 0:0 - 0:0
16486626,2024-01-24 11:35:00,Nikoghosyan Narek - Papyan Karen,3:2,11:9 - 11:6 - 9:11 - 10:12 - 11:9,3,2,Nikoghosyan Narek,Papyan Karen,fiurst,Nikoghosyan Narek - Papyan Karen,99,52,47,-5,5,20,17,20,22,20,-2,-5,2,2,-2,-5,11:9 - 11:6 - 9:11 - 10:12 - 11:9
16486624,2024-01-24 11:30:00,Nazaryan Mushegh - Arutyunov Ruben,2:3,11:2 - 9:11 - 11:2 - 10:12 - 11:6,3,2,Nazaryan Mushegh,Arutyunov Ruben,fiurst,Arutyunov Ruben - Nazaryan Mushegh,85,33,52,19,-19,13,20,13,22,17,9,-2,9,-2,5,19,2:11 - 11:9 - 2:11 - 12:10 - 6:11
16486623,2024-01-24 11:00:00,Rafayelyan Edgar - Nikoghosyan Narek,0:3,15:13 - 11:6 - 11:3 - 0:0 - 0:0,3,0,Rafayelyan Edgar,Nikoghosyan Narek,fiurst,Nikoghosyan Narek - Rafayelyan Edgar,59,22,37,15,-15,28,17,14,0,0,2,5,8,0,0,15,13:15 - 6:11 - 3:11 - 0:0 - 0:0
16486619,2024-01-24 10:50:00,Papyan Karen - Arutyunov Ruben,2:3,11:8 - 11:7 - 9:11 - 10:12 - 11:9,3,2,Papyan Karen,Arutyunov Ruben,fiurst,Arutyunov Ruben - Papyan Karen,99,47,52,5,-5,19,18,20,22,20,3,4,-2,-2,2,5,8:11 - 7:11 - 11:9 - 12:10 - 9:11
16486618,2024-01-24 10:30:00,Nazaryan Mushegh - Rafayelyan Edgar,2:3,11:9 - 7:11 - 6:11 - 11:8 - 8:11,2,3,Nazaryan Mushegh,Rafayelyan Edgar,fiurst,Nazaryan Mushegh - Rafayelyan Edgar,93,43,50,7,-7,20,18,17,19,19,-2,4,5,-3,3,7,11:9 - 7:11 - 6:11 - 11:8 - 8:11
16486606,2024-01-24 10:15:00,Arutyunov Ruben - Nikoghosyan Narek,2:3,6:11 - 8:11 - 11:6 - 11:5 - 3:11,2,3,Arutyunov Ruben,Nikoghosyan Narek,fiurst,Arutyunov Ruben - Nikoghosyan Narek,83,39,44,5,-5,17,19,17,16,14,5,3,-5,-6,8,5,6:11 - 8:11 - 11:6 - 11:5 - 3:11
16486605,2024-01-24 10:00:00,Papyan Karen - Nazaryan Mushegh,1:3,11:9 - 11:13 - 11:6 - 11:8 - 0:0,3,1,Papyan Karen,Nazaryan Mushegh,fiurst,Nazaryan Mushegh - Papyan Karen,80,36,44,8,-8,20,24,17,19,0,2,-2,5,3,0,8,9:11 - 13:11 - 6:11 - 8:11 - 0:0
16462427,2024-01-23 17:45:00,Darbinyan Armen - Karakhanyan Mher,0:3,4:11 - 7:11 - 5:11 - 0:0 - 0:0,0,3,Darbinyan Armen,Karakhanyan Mher,fiurst,Darbinyan Armen - Karakhanyan Mher,49,16,33,17,-17,15,18,16,0,0,7,4,6,0,0,17,4:11 - 7:11 - 5:11 - 0:0 - 0:0
16462422,2024-01-23 17:30:00,Avakimyan Davit - Grigoryan Erik,2:3,9:11 - 11:8 - 11:7 - 10:12 - 7:11,2,3,Avakimyan Davit,Grigoryan Erik,fiurst,Avakimyan Davit - Grigoryan Erik,97,48,49,1,-1,20,19,18,22,18,2,-3,-4,2,4,1,9:11 - 11:8 - 11:7 - 10:12 - 7:11
16462417,2024-01-23 17:15:00,Gevorgyan Hayk - Darbinyan Armen,0:3,11:4 - 11:8 - 11:2 - 0:0 - 0:0,3,0,Gevorgyan Hayk,Darbinyan Armen,fiurst,Darbinyan Armen - Gevorgyan Hayk,47,14,33,19,-19,15,19,13,0,0,7,3,9,0,0,19,4:11 - 8:11 - 2:11 - 0:0 - 0:0
16462412,2024-01-23 17:00:00,Avakimyan Davit - Karakhanyan Mher,3:0,11:7 - 13:11 - 11:8 - 0:0 - 0:0,3,0,Avakimyan Davit,Karakhanyan Mher,fiurst,Avakimyan Davit - Karakhanyan Mher,61,35,26,-9,9,18,24,19,0,0,-4,-2,-3,0,0,-9,11:7 - 13:11 - 11:8 - 0:0 - 0:0
16462406,2024-01-23 16:45:00,Grigoryan Erik - Gevorgyan Hayk,3:0,7:11 - 8:11 - 5:11 - 0:0 - 0:0,0,3,Grigoryan Erik,Gevorgyan Hayk,fiurst,Gevorgyan Hayk - Grigoryan Erik,53,33,20,-13,13,18,19,16,0,0,-4,-3,-6,0,0,-13,11:7 - 11:8 - 11:5 - 0:0 - 0:0
16462404,2024-01-23 16:30:00,Darbinyan Armen - Avakimyan Davit,3:0,7:11 - 6:11 - 3:11 - 0:0 - 0:0,0,3,Darbinyan Armen,Avakimyan Davit,fiurst,Avakimyan Davit - Darbinyan Armen,49,33,16,-17,17,18,17,14,0,0,-4,-5,-8,0,0,-17,11:7 - 11:6 - 11:3 - 0:0 - 0:0
16462392,2024-01-23 16:15:00,Karakhanyan Mher - Gevorgyan Hayk,3:0,8:11 - 9:11 - 2:11 - 0:0 - 0:0,0,3,Karakhanyan Mher,Gevorgyan Hayk,fiurst,Gevorgyan Hayk - Karakhanyan Mher,52,33,19,-14,14,19,20,13,0,0,-3,-2,-9,0,0,-14,11:8 - 11:9 - 11:2 - 0:0 - 0:0
16462391,2024-01-23 16:00:00,Grigoryan Erik - Darbinyan Armen,0:3,11:5 - 12:10 - 11:6 - 0:0 - 0:0,3,0,Grigoryan Erik,Darbinyan Armen,fiurst,Darbinyan Armen - Grigoryan Erik,55,21,34,13,-13,16,22,17,0,0,6,2,5,0,0,13,5:11 - 10:12 - 6:11 - 0:0 - 0:0
16462389,2024-01-23 15:45:00,Gevorgyan Hayk - Avakimyan Davit,3:0,9:11 - 9:11 - 8:11 - 0:0 - 0:0,0,3,Gevorgyan Hayk,Avakimyan Davit,fiurst,Avakimyan Davit - Gevorgyan Hayk,59,33,26,-7,7,20,20,19,0,0,-2,-2,-3,0,0,-7,11:9 - 11:9 - 11:8 - 0:0 - 0:0
16462387,2024-01-23 15:30:00,Karakhanyan Mher - Grigoryan Erik,3:0,6:11 - 9:11 - 8:11 - 0:0 - 0:0,0,3,Karakhanyan Mher,Grigoryan Erik,fiurst,Grigoryan Erik - Karakhanyan Mher,56,33,23,-10,10,17,20,19,0,0,-5,-2,-3,0,0,-10,11:6 - 11:9 - 11:8 - 0:0 - 0:0
16462381,2024-01-23 15:20:00,Nikoghosyan Narek - Mkrtchyan Andranik,2:3,11:4 - 11:4 - 9:11 - 8:11 - 11:9,3,2,Nikoghosyan Narek,Mkrtchyan Andranik,fiurst,Mkrtchyan Andranik - Nikoghosyan Narek,89,39,50,11,-11,15,15,20,19,20,7,7,-2,-3,2,11,4:11 - 4:11 - 11:9 - 11:8 - 9:11
16462379,2024-01-23 15:10:00,Arutyunov Ruben - Diaryan Aleksandr,0:3,6:11 - 5:11 - 4:11 - 0:0 - 0:0,0,3,Arutyunov Ruben,Diaryan Aleksandr,fiurst,Arutyunov Ruben - Diaryan Aleksandr,48,15,33,18,-18,17,16,15,0,0,5,6,7,0,0,18,6:11 - 5:11 - 4:11 - 0:0 - 0:0
16462375,2024-01-23 14:50:00,Nazaryan Mushegh - Nikoghosyan Narek,1:3,9:11 - 11:5 - 6:11 - 4:11 - 0:0,1,3,Nazaryan Mushegh,Nikoghosyan Narek,fiurst,Nazaryan Mushegh - Nikoghosyan Narek,68,30,38,8,-8,20,16,17,15,0,2,-6,5,7,0,8,9:11 - 11:5 - 6:11 - 4:11 - 0:0
16462363,2024-01-23 14:30:00,Mkrtchyan Andranik - Arutyunov Ruben,2:3,10:12 - 11:9 - 11:7 - 6:11 - 11:6,3,2,Mkrtchyan Andranik,Arutyunov Ruben,fiurst,Arutyunov Ruben - Mkrtchyan Andranik,94,45,49,4,-4,22,20,18,17,17,-2,2,4,-5,5,4,12:10 - 9:11 - 7:11 - 11:6 - 6:11
16462361,2024-01-23 14:25:00,Nazaryan Mushegh - Diaryan Aleksandr,0:3,11:7 - 11:6 - 11:6 - 0:0 - 0:0,3,0,Nazaryan Mushegh,Diaryan Aleksandr,fiurst,Diaryan Aleksandr - Nazaryan Mushegh,52,19,33,14,-14,18,17,17,0,0,4,5,5,0,0,14,7:11 - 6:11 - 6:11 - 0:0 - 0:0
16462347,2024-01-23 14:00:00,Nikoghosyan Narek - Arutyunov Ruben,1:3,11:4 - 11:6 - 9:11 - 11:1 - 0:0,3,1,Nikoghosyan Narek,Arutyunov Ruben,fiurst,Arutyunov Ruben - Nikoghosyan Narek,64,22,42,20,-20,15,17,20,12,0,7,5,-2,10,0,20,4:11 - 6:11 - 11:9 - 1:11 - 0:0
16462344,2024-01-23 13:50:00,Mkrtchyan Andranik - Nazaryan Mushegh,2:3,11:8 - 6:11 - 2:11 - 11:5 - 9:11,2,3,Mkrtchyan Andranik,Nazaryan Mushegh,fiurst,Mkrtchyan Andranik - Nazaryan Mushegh,85,39,46,7,-7,19,17,13,16,20,-3,5,9,-6,2,7,11:8 - 6:11 - 2:11 - 11:5 - 9:11
16462342,2024-01-23 13:30:00,Diaryan Aleksandr - Nikoghosyan Narek,3:2,8:11 - 11:4 - 7:11 - 11:5 - 11:3,3,2,Diaryan Aleksandr,Nikoghosyan Narek,fiurst,Diaryan Aleksandr - Nikoghosyan Narek,82,48,34,-14,14,19,15,18,16,14,3,-7,4,-6,-8,-14,8:11 - 11:4 - 7:11 - 11:5 - 11:3
16462340,2024-01-23 13:15:00,Arutyunov Ruben - Nazaryan Mushegh,2:3,11:8 - 3:11 - 10:12 - 11:9 - 9:11,2,3,Arutyunov Ruben,Nazaryan Mushegh,fiurst,Arutyunov Ruben - Nazaryan Mushegh,95,44,51,7,-7,19,14,22,20,20,-3,8,2,-2,2,7,11:8 - 3:11 - 10:12 - 11:9 - 9:11
16462335,2024-01-23 13:00:00,Diaryan Aleksandr - Mkrtchyan Andranik,3:0,11:6 - 11:9 - 11:6 - 0:0 - 0:0,3,0,Diaryan Aleksandr,Mkrtchyan Andranik,fiurst,Diaryan Aleksandr - Mkrtchyan Andranik,54,33,21,-12,12,17,20,17,0,0,-5,-2,-5,0,0,-12,11:6 - 11:9 - 11:6 - 0:0 - 0:0
16462319,2024-01-23 12:15:00,Nikoghosyan Narek - Nazaryan Mushegh,1:3,11:6 - 11:9 - 7:11 - 11:7 - 0:0,3,1,Nikoghosyan Narek,Nazaryan Mushegh,fiurst,Nazaryan Mushegh - Nikoghosyan Narek,73,33,40,7,-7,17,20,18,18,0,5,2,-4,4,0,7,6:11 - 9:11 - 11:7 - 7:11 - 0:0
16462315,2024-01-23 12:10:00,Diaryan Aleksandr - Arutyunov Ruben,1:3,11:5 - 8:11 - 11:4 - 11:2 - 0:0,3,1,Diaryan Aleksandr,Arutyunov Ruben,fiurst,Arutyunov Ruben - Diaryan Aleksandr,63,22,41,19,-19,16,19,15,13,0,6,-3,7,9,0,19,5:11 - 11:8 - 4:11 - 2:11 - 0:0
16462311,2024-01-23 11:45:00,Mkrtchyan Andranik - Nikoghosyan Narek,0:3,6:11 - 3:11 - 7:11 - 0:0 - 0:0,0,3,Mkrtchyan Andranik,Nikoghosyan Narek,fiurst,Mkrtchyan Andranik - Nikoghosyan Narek,49,16,33,17,-17,17,14,18,0,0,5,8,4,0,0,17,6:11 - 3:11 - 7:11 - 0:0 - 0:0
16462308,2024-01-23 11:35:00,Diaryan Aleksandr - Nazaryan Mushegh,3:1,11:8 - 11:5 - 9:11 - 11:5 - 0:0,3,1,Diaryan Aleksandr,Nazaryan Mushegh,fiurst,Diaryan Aleksandr - Nazaryan Mushegh,71,42,29,-13,13,19,16,20,16,0,-3,-6,2,-6,0,-13,11:8 - 11:5 - 9:11 - 11:5 - 0:0
16462306,2024-01-23 11:20:00,Arutyunov Ruben - Mkrtchyan Andranik,3:0,11:8 - 11:8 - 11:9 - 0:0 - 0:0,3,0,Arutyunov Ruben,Mkrtchyan Andranik,fiurst,Arutyunov Ruben - Mkrtchyan Andranik,58,33,25,-8,8,19,19,20,0,0,-3,-3,-2,0,0,-8,11:8 - 11:8 - 11:9 - 0:0 - 0:0
16462303,2024-01-23 11:00:00,Nikoghosyan Narek - Diaryan Aleksandr,3:1,5:11 - 7:11 - 11:9 - 8:11 - 0:0,1,3,Nikoghosyan Narek,Diaryan Aleksandr,fiurst,Diaryan Aleksandr - Nikoghosyan Narek,73,42,31,-11,11,16,18,20,19,0,-6,-4,2,-3,0,-11,11:5 - 11:7 - 9:11 - 11:8 - 0:0
16462292,2024-01-23 10:45:00,Nazaryan Mushegh - Mkrtchyan Andranik,1:3,9:11 - 15:13 - 11:6 - 11:9 - 0:0,3,1,Nazaryan Mushegh,Mkrtchyan Andranik,fiurst,Mkrtchyan Andranik - Nazaryan Mushegh,85,39,46,7,-7,20,28,17,20,0,-2,2,5,2,0,7,11:9 - 13:15 - 6:11 - 9:11 - 0:0
16462284,2024-01-23 10:30:00,Arutyunov Ruben - Nikoghosyan Narek,1:3,11:5 - 10:12 - 10:12 - 4:11 - 0:0,1,3,Arutyunov Ruben,Nikoghosyan Narek,fiurst,Arutyunov Ruben - Nikoghosyan Narek,75,35,40,5,-5,16,22,22,15,0,-6,2,2,7,0,5,11:5 - 10:12 - 10:12 - 4:11 - 0:0
16462280,2024-01-23 10:15:00,Mkrtchyan Andranik - Diaryan Aleksandr,3:0,7:11 - 7:11 - 9:11 - 0:0 - 0:0,0,3,Mkrtchyan Andranik,Diaryan Aleksandr,fiurst,Diaryan Aleksandr - Mkrtchyan Andranik,56,33,23,-10,10,18,18,20,0,0,-4,-4,-2,0,0,-10,11:7 - 11:7 - 11:9 - 0:0 - 0:0
16462277,2024-01-23 10:00:00,Nazaryan Mushegh - Arutyunov Ruben,0:3,11:7 - 11:6 - 12:10 - 0:0 - 0:0,3,0,Nazaryan Mushegh,Arutyunov Ruben,fiurst,Arutyunov Ruben - Nazaryan Mushegh,57,23,34,11,-11,18,17,22,0,0,4,5,2,0,0,11,7:11 - 6:11 - 10:12 - 0:0 - 0:0
16443727,2024-01-22 17:45:00,Darbinyan Armen - Gevorgyan Hayk,0:3,4:11 - 3:11 - 9:11 - 0:0 - 0:0,0,3,Darbinyan Armen,Gevorgyan Hayk,fiurst,Darbinyan Armen - Gevorgyan Hayk,49,16,33,17,-17,15,14,20,0,0,7,8,2,0,0,17,4:11 - 3:11 - 9:11 - 0:0 - 0:0
16443687,2024-01-22 17:30:00,Gevorgyan Gegham - Karakhanyan Mher,1:3,10:12 - 11:5 - 11:13 - 6:11 - 0:0,1,3,Gevorgyan Gegham,Karakhanyan Mher,fiurst,Gevorgyan Gegham - Karakhanyan Mher,79,38,41,3,-3,22,16,24,17,0,2,-6,2,5,0,3,10:12 - 11:5 - 11:13 - 6:11 - 0:0
16443675,2024-01-22 17:15:00,Grigoryan Erik - Darbinyan Armen,1:3,6:11 - 11:5 - 16:14 - 11:9 - 0:0,3,1,Grigoryan Erik,Darbinyan Armen,fiurst,Darbinyan Armen - Grigoryan Erik,83,39,44,5,-5,17,16,30,20,0,-5,6,2,2,0,5,11:6 - 5:11 - 14:16 - 9:11 - 0:0
16443673,2024-01-22 17:00:00,Gevorgyan Gegham - Gevorgyan Hayk,1:3,11:8 - 8:11 - 8:11 - 9:11 - 0:0,1,3,Gevorgyan Gegham,Gevorgyan Hayk,fiurst,Gevorgyan Gegham - Gevorgyan Hayk,77,36,41,5,-5,19,19,19,20,0,-3,3,3,2,0,5,11:8 - 8:11 - 8:11 - 9:11 - 0:0
16443669,2024-01-22 16:45:00,Karakhanyan Mher - Grigoryan Erik,3:0,6:11 - 10:12 - 6:11 - 0:0 - 0:0,0,3,Karakhanyan Mher,Grigoryan Erik,fiurst,Grigoryan Erik - Karakhanyan Mher,56,34,22,-12,12,17,22,17,0,0,-5,-2,-5,0,0,-12,11:6 - 12:10 - 11:6 - 0:0 - 0:0
16443644,2024-01-22 16:30:00,Darbinyan Armen - Gevorgyan Gegham,0:3,2:11 - 5:11 - 4:11 - 0:0 - 0:0,0,3,Darbinyan Armen,Gevorgyan Gegham,fiurst,Darbinyan Armen - Gevorgyan Gegham,44,11,33,22,-22,13,16,15,0,0,9,6,7,0,0,22,2:11 - 5:11 - 4:11 - 0:0 - 0:0
16443641,2024-01-22 16:15:00,Gevorgyan Hayk - Grigoryan Erik,3:0,11:8 - 11:7 - 11:6 - 0:0 - 0:0,3,0,Gevorgyan Hayk,Grigoryan Erik,fiurst,Gevorgyan Hayk - Grigoryan Erik,54,33,21,-12,12,19,18,17,0,0,-3,-4,-5,0,0,-12,11:8 - 11:7 - 11:6 - 0:0 - 0:0
16443639,2024-01-22 16:05:00,Karakhanyan Mher - Darbinyan Armen,0:3,11:8 - 11:9 - 11:6 - 0:0 - 0:0,3,0,Karakhanyan Mher,Darbinyan Armen,fiurst,Darbinyan Armen - Karakhanyan Mher,56,23,33,10,-10,19,20,17,0,0,3,2,5,0,0,10,8:11 - 9:11 - 6:11 - 0:0 - 0:0
16443633,2024-01-22 15:55:00,Gevorgyan Hayk - Karakhanyan Mher,3:0,11:9 - 11:8 - 11:3 - 0:0 - 0:0,3,0,Gevorgyan Hayk,Karakhanyan Mher,fiurst,Gevorgyan Hayk - Karakhanyan Mher,53,33,20,-13,13,20,19,14,0,0,-2,-3,-8,0,0,-13,11:9 - 11:8 - 11:3 - 0:0 - 0:0
16443636,2024-01-22 15:45:00,Grigoryan Erik - Gevorgyan Gegham,3:1,11:13 - 11:6 - 6:11 - 17:19 - 0:0,1,3,Grigoryan Erik,Gevorgyan Gegham,fiurst,Gevorgyan Gegham - Grigoryan Erik,94,49,45,-4,4,24,17,17,36,0,-2,5,-5,-2,0,-4,13:11 - 6:11 - 11:6 - 19:17 - 0:0
16443626,2024-01-22 15:25:00,Arutyunov Ruben - Mkrtchyan Andranik,3:1,17:15 - 13:15 - 11:9 - 11:7 - 0:0,3,1,Arutyunov Ruben,Mkrtchyan Andranik,fiurst,Arutyunov Ruben - Mkrtchyan Andranik,98,52,46,-6,6,32,28,20,18,0,-2,2,-2,-4,0,-6,17:15 - 13:15 - 11:9 - 11:7 - 0:0
16443630,2024-01-22 15:15:00,Nazaryan Mushegh - Diaryan Aleksandr,3:0,7:11 - 7:11 - 6:11 - 0:0 - 0:0,0,3,Nazaryan Mushegh,Diaryan Aleksandr,fiurst,Diaryan Aleksandr - Nazaryan Mushegh,53,33,20,-13,13,18,18,17,0,0,-4,-4,-5,0,0,-13,11:7 - 11:7 - 11:6 - 0:0 - 0:0
16443613,2024-01-22 14:50:00,Rafayelyan Edgar - Nazaryan Mushegh,2:3,11:7 - 8:11 - 11:5 - 7:11 - 11:4,3,2,Rafayelyan Edgar,Nazaryan Mushegh,fiurst,Nazaryan Mushegh - Rafayelyan Edgar,86,38,48,10,-10,18,19,16,18,15,4,-3,6,-4,7,10,7:11 - 11:8 - 5:11 - 11:7 - 4:11
16443611,2024-01-22 14:45:00,Diaryan Aleksandr - Arutyunov Ruben,2:3,13:11 - 11:8 - 11:13 - 3:11 - 11:9,3,2,Diaryan Aleksandr,Arutyunov Ruben,fiurst,Arutyunov Ruben - Diaryan Aleksandr,101,52,49,-3,3,24,19,24,14,20,2,3,-2,-8,2,-3,11:13 - 8:11 - 13:11 - 11:3 - 9:11
16443593,2024-01-22 14:25:00,Rafayelyan Edgar - Mkrtchyan Andranik,0:3,11:5 - 11:7 - 12:10 - 0:0 - 0:0,3,0,Rafayelyan Edgar,Mkrtchyan Andranik,fiurst,Mkrtchyan Andranik - Rafayelyan Edgar,56,22,34,12,-12,16,18,22,0,0,6,4,2,0,0,12,5:11 - 7:11 - 10:12 - 0:0 - 0:0
16443579,2024-01-22 14:20:00,Nazaryan Mushegh - Arutyunov Ruben,1:3,11:5 - 7:11 - 11:4 - 11:7 - 0:0,3,1,Nazaryan Mushegh,Arutyunov Ruben,fiurst,Arutyunov Ruben - Nazaryan Mushegh,67,27,40,13,-13,16,18,15,18,0,6,-4,7,4,0,13,5:11 - 11:7 - 4:11 - 7:11 - 0:0
16443577,2024-01-22 13:45:00,Diaryan Aleksandr - Rafayelyan Edgar,0:3,7:11 - 7:11 - 10:12 - 0:0 - 0:0,0,3,Diaryan Aleksandr,Rafayelyan Edgar,fiurst,Diaryan Aleksandr - Rafayelyan Edgar,58,24,34,10,-10,18,18,22,0,0,4,4,2,0,0,10,7:11 - 7:11 - 10:12 - 0:0 - 0:0
16443576,2024-01-22 13:40:00,Mkrtchyan Andranik - Nazaryan Mushegh,2:3,6:11 - 11:7 - 11:5 - 9:11 - 14:16,2,3,Mkrtchyan Andranik,Nazaryan Mushegh,fiurst,Mkrtchyan Andranik - Nazaryan Mushegh,101,51,50,-1,1,17,18,16,20,30,5,-4,-6,2,2,-1,6:11 - 11:7 - 11:5 - 9:11 - 14:16
16443565,2024-01-22 13:20:00,Arutyunov Ruben - Rafayelyan Edgar,0:3,9:11 - 6:11 - 4:11 - 0:0 - 0:0,0,3,Arutyunov Ruben,Rafayelyan Edgar,fiurst,Arutyunov Ruben - Rafayelyan Edgar,52,19,33,14,-14,20,17,15,0,0,2,5,7,0,0,14,9:11 - 6:11 - 4:11 - 0:0 - 0:0
16443560,2024-01-22 13:05:00,Mkrtchyan Andranik - Diaryan Aleksandr,3:2,4:11 - 11:9 - 11:8 - 5:11 - 5:11,2,3,Mkrtchyan Andranik,Diaryan Aleksandr,fiurst,Diaryan Aleksandr - Mkrtchyan Andranik,86,50,36,-14,14,15,20,19,16,16,-7,2,3,-6,-6,-14,11:4 - 9:11 - 8:11 - 11:5 - 11:5
16443555,2024-01-22 12:15:00,Nazaryan Mushegh - Rafayelyan Edgar,0:3,3:11 - 1:11 - 8:11 - 0:0 - 0:0,0,3,Nazaryan Mushegh,Rafayelyan Edgar,fiurst,Nazaryan Mushegh - Rafayelyan Edgar,45,12,33,21,-21,14,12,19,0,0,8,10,3,0,0,21,3:11 - 1:11 - 8:11 - 0:0 - 0:0
16443551,2024-01-22 12:05:00,Mkrtchyan Andranik - Arutyunov Ruben,3:1,4:11 - 11:7 - 14:16 - 8:11 - 0:0,1,3,Mkrtchyan Andranik,Arutyunov Ruben,fiurst,Arutyunov Ruben - Mkrtchyan Andranik,82,45,37,-8,8,15,18,30,19,0,-7,4,-2,-3,0,-8,11:4 - 7:11 - 16:14 - 11:8 - 0:0
16443549,2024-01-22 11:45:00,Diaryan Aleksandr - Nazaryan Mushegh,3:1,11:6 - 8:11 - 11:6 - 11:5 - 0:0,3,1,Diaryan Aleksandr,Nazaryan Mushegh,fiurst,Diaryan Aleksandr - Nazaryan Mushegh,69,41,28,-13,13,17,19,17,16,0,-5,3,-5,-6,0,-13,11:6 - 8:11 - 11:6 - 11:5 - 0:0
16443545,2024-01-22 11:40:00,Mkrtchyan Andranik - Rafayelyan Edgar,0:3,7:11 - 6:11 - 9:11 - 0:0 - 0:0,0,3,Mkrtchyan Andranik,Rafayelyan Edgar,fiurst,Mkrtchyan Andranik - Rafayelyan Edgar,55,22,33,11,-11,18,17,20,0,0,4,5,2,0,0,11,7:11 - 6:11 - 9:11 - 0:0 - 0:0
16443535,2024-01-22 11:15:00,Arutyunov Ruben - Diaryan Aleksandr,0:3,9:11 - 8:11 - 3:11 - 0:0 - 0:0,0,3,Arutyunov Ruben,Diaryan Aleksandr,fiurst,Arutyunov Ruben - Diaryan Aleksandr,53,20,33,13,-13,20,19,14,0,0,2,3,8,0,0,13,9:11 - 8:11 - 3:11 - 0:0 - 0:0
16443529,2024-01-22 11:05:00,Nazaryan Mushegh - Mkrtchyan Andranik,2:3,12:10 - 11:7 - 4:11 - 9:11 - 11:9,3,2,Nazaryan Mushegh,Mkrtchyan Andranik,fiurst,Mkrtchyan Andranik - Nazaryan Mushegh,95,48,47,-1,1,22,18,15,20,20,2,4,-7,-2,2,-1,10:12 - 7:11 - 11:4 - 11:9 - 9:11
16443505,2024-01-22 10:45:00,Arutyunov Ruben - Nazaryan Mushegh,1:3,11:7 - 9:11 - 7:11 - 8:11 - 0:0,1,3,Arutyunov Ruben,Nazaryan Mushegh,fiurst,Arutyunov Ruben - Nazaryan Mushegh,75,35,40,5,-5,18,20,18,19,0,-4,2,4,3,0,5,11:7 - 9:11 - 7:11 - 8:11 - 0:0
16443520,2024-01-22 10:45:00,Rafayelyan Edgar - Diaryan Aleksandr,3:0,12:14 - 8:11 - 2:11 - 0:0 - 0:0,0,3,Rafayelyan Edgar,Diaryan Aleksandr,fiurst,Diaryan Aleksandr - Rafayelyan Edgar,58,36,22,-14,14,26,19,13,0,0,-2,-3,-9,0,0,-14,14:12 - 11:8 - 11:2 - 0:0 - 0:0
16443499,2024-01-22 10:15:00,Rafayelyan Edgar - Arutyunov Ruben,1:3,13:11 - 11:8 - 5:11 - 11:6 - 0:0,3,1,Rafayelyan Edgar,Arutyunov Ruben,fiurst,Arutyunov Ruben - Rafayelyan Edgar,76,36,40,4,-4,24,19,16,17,0,2,3,-6,5,0,4,11:13 - 8:11 - 11:5 - 6:11 - 0:0
16443502,2024-01-22 10:15:00,Diaryan Aleksandr - Mkrtchyan Andranik,3:0,11:5 - 11:4 - 11:1 - 0:0 - 0:0,3,0,Diaryan Aleksandr,Mkrtchyan Andranik,fiurst,Diaryan Aleksandr - Mkrtchyan Andranik,43,33,10,-23,23,16,15,12,0,0,-6,-7,-10,0,0,-23,11:5 - 11:4 - 11:1 - 0:0 - 0:0
16424209,2024-01-21 17:45:00,Gevorgyan Hayk - Avakimyan Davit,1:3,7:11 - 11:4 - 12:10 - 11:5 - 0:0,3,1,Gevorgyan Hayk,Avakimyan Davit,fiurst,Avakimyan Davit - Gevorgyan Hayk,71,30,41,11,-11,18,15,22,16,0,-4,7,2,6,0,11,11:7 - 4:11 - 10:12 - 5:11 - 0:0
16424205,2024-01-21 17:35:00,Karakhanyan Mher - Grigoryan Erik,3:0,6:11 - 10:12 - 9:11 - 0:0 - 0:0,0,3,Karakhanyan Mher,Grigoryan Erik,fiurst,Grigoryan Erik - Karakhanyan Mher,59,34,25,-9,9,17,22,20,0,0,-5,-2,-2,0,0,-9,11:6 - 12:10 - 11:9 - 0:0 - 0:0
16424204,2024-01-21 17:15:00,Gevorgyan Gegham - Gevorgyan Hayk,0:3,4:11 - 8:11 - 4:11 - 0:0 - 0:0,0,3,Gevorgyan Gegham,Gevorgyan Hayk,fiurst,Gevorgyan Gegham - Gevorgyan Hayk,49,16,33,17,-17,15,19,15,0,0,7,3,7,0,0,17,4:11 - 8:11 - 4:11 - 0:0 - 0:0
16424199,2024-01-21 17:00:00,Karakhanyan Mher - Avakimyan Davit,3:0,9:11 - 13:15 - 11:13 - 0:0 - 0:0,0,3,Karakhanyan Mher,Avakimyan Davit,fiurst,Avakimyan Davit - Karakhanyan Mher,72,39,33,-6,6,20,28,24,0,0,-2,-2,-2,0,0,-6,11:9 - 15:13 - 13:11 - 0:0 - 0:0
16424197,2024-01-21 16:45:00,Grigoryan Erik - Gevorgyan Gegham,3:0,7:11 - 1:11 - 7:11 - 0:0 - 0:0,0,3,Grigoryan Erik,Gevorgyan Gegham,fiurst,Gevorgyan Gegham - Grigoryan Erik,48,33,15,-18,18,18,12,18,0,0,-4,-10,-4,0,0,-18,11:7 - 11:1 - 11:7 - 0:0 - 0:0
16424192,2024-01-21 16:30:00,Gevorgyan Hayk - Karakhanyan Mher,3:0,11:4 - 12:10 - 11:7 - 0:0 - 0:0,3,0,Gevorgyan Hayk,Karakhanyan Mher,fiurst,Gevorgyan Hayk - Karakhanyan Mher,55,34,21,-13,13,15,22,18,0,0,-7,-2,-4,0,0,-13,11:4 - 12:10 - 11:7 - 0:0 - 0:0
16424184,2024-01-21 16:15:00,Avakimyan Davit - Gevorgyan Gegham,3:0,11:8 - 11:8 - 11:3 - 0:0 - 0:0,3,0,Avakimyan Davit,Gevorgyan Gegham,fiurst,Avakimyan Davit - Gevorgyan Gegham,52,33,19,-14,14,19,19,14,0,0,-3,-3,-8,0,0,-14,11:8 - 11:8 - 11:3 - 0:0 - 0:0
16424183,2024-01-21 16:00:00,Grigoryan Erik - Gevorgyan Hayk,3:1,4:11 - 6:11 - 17:15 - 4:11 - 0:0,1,3,Grigoryan Erik,Gevorgyan Hayk,fiurst,Gevorgyan Hayk - Grigoryan Erik,79,48,31,-17,17,15,17,32,15,0,-7,-5,2,-7,0,-17,11:4 - 11:6 - 15:17 - 11:4 - 0:0
16424181,2024-01-21 15:45:00,Gevorgyan Gegham - Karakhanyan Mher,3:1,11:9 - 11:6 - 8:11 - 11:6 - 0:0,3,1,Gevorgyan Gegham,Karakhanyan Mher,fiurst,Gevorgyan Gegham - Karakhanyan Mher,73,41,32,-9,9,20,17,19,17,0,-2,-5,3,-5,0,-9,11:9 - 11:6 - 8:11 - 11:6 - 0:0
16424176,2024-01-21 15:30:00,Avakimyan Davit - Grigoryan Erik,3:0,11:6 - 11:8 - 11:5 - 0:0 - 0:0,3,0,Avakimyan Davit,Grigoryan Erik,fiurst,Avakimyan Davit - Grigoryan Erik,52,33,19,-14,14,17,19,16,0,0,-5,-3,-6,0,0,-14,11:6 - 11:8 - 11:5 - 0:0 - 0:0
16424153,2024-01-21 15:25:00,Nikoghosyan Narek - Rafayelyan Edgar,0:3,9:11 - 6:11 - 11:13 - 0:0 - 0:0,0,3,Nikoghosyan Narek,Rafayelyan Edgar,fiurst,Nikoghosyan Narek - Rafayelyan Edgar,61,26,35,9,-9,20,17,24,0,0,2,5,2,0,0,9,9:11 - 6:11 - 11:13 - 0:0 - 0:0
16424150,2024-01-21 15:00:00,Papyan Karen - Nazaryan Mushegh,0:3,13:11 - 11:8 - 11:8 - 0:0 - 0:0,3,0,Papyan Karen,Nazaryan Mushegh,fiurst,Nazaryan Mushegh - Papyan Karen,62,27,35,8,-8,24,19,19,0,0,2,3,3,0,0,8,11:13 - 8:11 - 8:11 - 0:0 - 0:0
16424147,2024-01-21 14:50:00,Diaryan Aleksandr - Nikoghosyan Narek,3:2,11:9 - 11:7 - 6:11 - 9:11 - 11:4,3,2,Diaryan Aleksandr,Nikoghosyan Narek,fiurst,Diaryan Aleksandr - Nikoghosyan Narek,90,48,42,-6,6,20,18,17,20,15,-2,-4,5,2,-7,-6,11:9 - 11:7 - 6:11 - 9:11 - 11:4
16424142,2024-01-21 14:40:00,Rafayelyan Edgar - Papyan Karen,3:1,8:11 - 7:11 - 11:3 - 9:11 - 0:0,1,3,Rafayelyan Edgar,Papyan Karen,fiurst,Papyan Karen - Rafayelyan Edgar,71,36,35,-1,1,19,18,14,20,0,-3,-4,8,-2,0,-1,11:8 - 11:7 - 3:11 - 11:9 - 0:0
16424139,2024-01-21 14:15:00,Diaryan Aleksandr - Nazaryan Mushegh,3:0,11:5 - 11:5 - 11:7 - 0:0 - 0:0,3,0,Diaryan Aleksandr,Nazaryan Mushegh,fiurst,Diaryan Aleksandr - Nazaryan Mushegh,50,33,17,-16,16,16,16,18,0,0,-6,-6,-4,0,0,-16,11:5 - 11:5 - 11:7 - 0:0 - 0:0
16424134,2024-01-21 14:00:00,Nikoghosyan Narek - Papyan Karen,3:1,16:14 - 11:9 - 3:11 - 15:13 - 0:0,3,1,Nikoghosyan Narek,Papyan Karen,fiurst,Nikoghosyan Narek - Papyan Karen,92,45,47,2,-2,30,20,14,28,0,-2,-2,8,-2,0,2,16:14 - 11:9 - 3:11 - 15:13 - 0:0
16424124,2024-01-21 13:45:00,Rafayelyan Edgar - Diaryan Aleksandr,0:3,11:7 - 11:7 - 11:8 - 0:0 - 0:0,3,0,Rafayelyan Edgar,Diaryan Aleksandr,fiurst,Diaryan Aleksandr - Rafayelyan Edgar,55,22,33,11,-11,18,18,19,0,0,4,4,3,0,0,11,7:11 - 7:11 - 8:11 - 0:0 - 0:0
16424116,2024-01-21 13:30:00,Nazaryan Mushegh - Nikoghosyan Narek,1:3,9:11 - 11:7 - 9:11 - 5:11 - 0:0,1,3,Nazaryan Mushegh,Nikoghosyan Narek,fiurst,Nazaryan Mushegh - Nikoghosyan Narek,74,34,40,6,-6,20,18,20,16,0,2,-4,2,6,0,6,9:11 - 11:7 - 9:11 - 5:11 - 0:0
16424114,2024-01-21 13:15:00,Papyan Karen - Diaryan Aleksandr,2:3,11:7 - 11:8 - 10:12 - 8:11 - 11:7,3,2,Papyan Karen,Diaryan Aleksandr,fiurst,Diaryan Aleksandr - Papyan Karen,96,45,51,6,-6,18,19,22,19,18,4,3,-2,-3,4,6,7:11 - 8:11 - 12:10 - 11:8 - 7:11
16424112,2024-01-21 13:00:00,Nazaryan Mushegh - Rafayelyan Edgar,1:3,4:11 - 11:7 - 4:11 - 6:11 - 0:0,1,3,Nazaryan Mushegh,Rafayelyan Edgar,fiurst,Nazaryan Mushegh - Rafayelyan Edgar,65,25,40,15,-15,15,18,15,17,0,7,-4,7,5,0,15,4:11 - 11:7 - 4:11 - 6:11 - 0:0
16424109,2024-01-21 12:15:00,Nikoghosyan Narek - Diaryan Aleksandr,0:3,11:5 - 13:11 - 11:3 - 0:0 - 0:0,3,0,Nikoghosyan Narek,Diaryan Aleksandr,fiurst,Diaryan Aleksandr - Nikoghosyan Narek,54,19,35,16,-16,16,24,14,0,0,6,2,8,0,0,16,5:11 - 11:13 - 3:11 - 0:0 - 0:0
16424106,2024-01-21 12:00:00,Nazaryan Mushegh - Papyan Karen,2:3,11:3 - 13:15 - 3:11 - 11:3 - 7:11,2,3,Nazaryan Mushegh,Papyan Karen,fiurst,Nazaryan Mushegh - Papyan Karen,88,45,43,-2,2,14,28,14,14,18,-8,2,8,-8,4,-2,11:3 - 13:15 - 3:11 - 11:3 - 7:11
16424101,2024-01-21 11:50:00,Rafayelyan Edgar - Nikoghosyan Narek,1:3,5:11 - 11:6 - 12:10 - 11:8 - 0:0,3,1,Rafayelyan Edgar,Nikoghosyan Narek,fiurst,Nikoghosyan Narek - Rafayelyan Edgar,74,35,39,4,-4,16,17,22,19,0,-6,5,2,3,0,4,11:5 - 6:11 - 10:12 - 8:11 - 0:0
16424097,2024-01-21 11:35:00,Nazaryan Mushegh - Diaryan Aleksandr,3:0,6:11 - 7:11 - 8:11 - 0:0 - 0:0,0,3,Nazaryan Mushegh,Diaryan Aleksandr,fiurst,Diaryan Aleksandr - Nazaryan Mushegh,54,33,21,-12,12,17,18,19,0,0,-5,-4,-3,0,0,-12,11:6 - 11:7 - 11:8 - 0:0 - 0:0
16424095,2024-01-21 11:25:00,Papyan Karen - Rafayelyan Edgar,0:3,3:11 - 8:11 - 5:11 - 0:0 - 0:0,0,3,Papyan Karen,Rafayelyan Edgar,fiurst,Papyan Karen - Rafayelyan Edgar,49,16,33,17,-17,14,19,16,0,0,8,3,6,0,0,17,3:11 - 8:11 - 5:11 - 0:0 - 0:0
16424077,2024-01-21 11:05:00,Nikoghosyan Narek - Nazaryan Mushegh,1:3,10:12 - 11:6 - 11:4 - 11:9 - 0:0,3,1,Nikoghosyan Narek,Nazaryan Mushegh,fiurst,Nazaryan Mushegh - Nikoghosyan Narek,74,31,43,12,-12,22,17,15,20,0,-2,5,7,2,0,12,12:10 - 6:11 - 4:11 - 9:11 - 0:0
16424074,2024-01-21 10:45:00,Diaryan Aleksandr - Rafayelyan Edgar,2:3,14:16 - 11:4 - 11:8 - 8:11 - 9:11,2,3,Diaryan Aleksandr,Rafayelyan Edgar,fiurst,Diaryan Aleksandr - Rafayelyan Edgar,103,53,50,-3,3,30,15,19,19,20,2,-7,-3,3,2,-3,14:16 - 11:4 - 11:8 - 8:11 - 9:11
16424072,2024-01-21 10:30:00,Papyan Karen - Nikoghosyan Narek,0:3,11:9 - 11:6 - 13:11 - 0:0 - 0:0,3,0,Papyan Karen,Nikoghosyan Narek,fiurst,Nikoghosyan Narek - Papyan Karen,61,26,35,9,-9,20,17,24,0,0,2,5,2,0,0,9,9:11 - 6:11 - 11:13 - 0:0 - 0:0
16424071,2024-01-21 10:15:00,Rafayelyan Edgar - Nazaryan Mushegh,0:3,11:4 - 11:4 - 11:6 - 0:0 - 0:0,3,0,Rafayelyan Edgar,Nazaryan Mushegh,fiurst,Nazaryan Mushegh - Rafayelyan Edgar,47,14,33,19,-19,15,15,17,0,0,7,7,5,0,0,19,4:11 - 4:11 - 6:11 - 0:0 - 0:0
16424068,2024-01-21 10:00:00,Diaryan Aleksandr - Papyan Karen,3:0,11:7 - 11:8 - 11:6 - 0:0 - 0:0,3,0,Diaryan Aleksandr,Papyan Karen,fiurst,Diaryan Aleksandr - Papyan Karen,54,33,21,-12,12,18,19,17,0,0,-4,-3,-5,0,0,-12,11:7 - 11:8 - 11:6 - 0:0 - 0:0
16405421,2024-01-20 17:45:00,Darbinyan Armen - Grigoryan Erik,3:2,11:7 - 10:12 - 7:11 - 11:8 - 14:12,3,2,Darbinyan Armen,Grigoryan Erik,fiurst,Darbinyan Armen - Grigoryan Erik,103,53,50,-3,3,18,22,18,19,26,-4,2,4,-3,-2,-3,11:7 - 10:12 - 7:11 - 11:8 - 14:12
16405413,2024-01-20 17:30:00,Gevorgyan Hayk - Avakimyan Davit,2:3,11:13 - 11:13 - 11:8 - 11:3 - 11:8,3,2,Gevorgyan Hayk,Avakimyan Davit,fiurst,Avakimyan Davit - Gevorgyan Hayk,100,45,55,10,-10,24,24,19,14,19,-2,-2,3,8,3,10,13:11 - 13:11 - 8:11 - 3:11 - 8:11
16405397,2024-01-20 17:15:00,Karakhanyan Mher - Darbinyan Armen,3:1,11:6 - 6:11 - 9:11 - 7:11 - 0:0,1,3,Karakhanyan Mher,Darbinyan Armen,fiurst,Darbinyan Armen - Karakhanyan Mher,72,39,33,-6,6,17,17,20,18,0,5,-5,-2,-4,0,-6,6:11 - 11:6 - 11:9 - 11:7 - 0:0
16405394,2024-01-20 17:00:00,Gevorgyan Hayk - Grigoryan Erik,3:0,11:3 - 11:9 - 11:6 - 0:0 - 0:0,3,0,Gevorgyan Hayk,Grigoryan Erik,fiurst,Gevorgyan Hayk - Grigoryan Erik,51,33,18,-15,15,14,20,17,0,0,-8,-2,-5,0,0,-15,11:3 - 11:9 - 11:6 - 0:0 - 0:0
16405393,2024-01-20 16:45:00,Avakimyan Davit - Karakhanyan Mher,3:0,11:6 - 11:8 - 11:7 - 0:0 - 0:0,3,0,Avakimyan Davit,Karakhanyan Mher,fiurst,Avakimyan Davit - Karakhanyan Mher,54,33,21,-12,12,17,19,18,0,0,-5,-3,-4,0,0,-12,11:6 - 11:8 - 11:7 - 0:0 - 0:0
16405391,2024-01-20 16:30:00,Darbinyan Armen - Gevorgyan Hayk,0:3,4:11 - 3:11 - 7:11 - 0:0 - 0:0,0,3,Darbinyan Armen,Gevorgyan Hayk,fiurst,Darbinyan Armen - Gevorgyan Hayk,47,14,33,19,-19,15,14,18,0,0,7,8,4,0,0,19,4:11 - 3:11 - 7:11 - 0:0 - 0:0
16405390,2024-01-20 16:15:00,Grigoryan Erik - Karakhanyan Mher,3:1,3:11 - 11:6 - 11:4 - 13:11 - 0:0,3,1,Grigoryan Erik,Karakhanyan Mher,fiurst,Grigoryan Erik - Karakhanyan Mher,70,38,32,-6,6,14,17,15,24,0,8,-5,-7,-2,0,-6,3:11 - 11:6 - 11:4 - 13:11 - 0:0
16405383,2024-01-20 16:00:00,Avakimyan Davit - Darbinyan Armen,3:0,11:7 - 11:8 - 11:4 - 0:0 - 0:0,3,0,Avakimyan Davit,Darbinyan Armen,fiurst,Avakimyan Davit - Darbinyan Armen,52,33,19,-14,14,18,19,15,0,0,-4,-3,-7,0,0,-14,11:7 - 11:8 - 11:4 - 0:0 - 0:0
16405382,2024-01-20 15:45:00,Karakhanyan Mher - Gevorgyan Hayk,3:0,11:13 - 6:11 - 13:15 - 0:0 - 0:0,0,3,Karakhanyan Mher,Gevorgyan Hayk,fiurst,Gevorgyan Hayk - Karakhanyan Mher,69,39,30,-9,9,24,17,28,0,0,-2,-5,-2,0,0,-9,13:11 - 11:6 - 15:13 - 0:0 - 0:0
16405380,2024-01-20 15:30:00,Grigoryan Erik - Avakimyan Davit,3:1,9:11 - 6:11 - 11:5 - 6:11 - 0:0,1,3,Grigoryan Erik,Avakimyan Davit,fiurst,Avakimyan Davit - Grigoryan Erik,70,38,32,-6,6,20,17,16,17,0,-2,-5,6,-5,0,-6,11:9 - 11:6 - 5:11 - 11:6 - 0:0
16405367,2024-01-20 15:15:00,Arutyunov Ruben - Mkrtchyan Andranik,1:3,12:10 - 6:11 - 9:11 - 12:14 - 0:0,1,3,Arutyunov Ruben,Mkrtchyan Andranik,fiurst,Arutyunov Ruben - Mkrtchyan Andranik,85,39,46,7,-7,22,17,20,26,0,-2,5,2,2,0,7,12:10 - 6:11 - 9:11 - 12:14 - 0:0
16405365,2024-01-20 15:05:00,Papyan Karen - Rafayelyan Edgar,1:3,5:11 - 8:11 - 11:4 - 8:11 - 0:0,1,3,Papyan Karen,Rafayelyan Edgar,fiurst,Papyan Karen - Rafayelyan Edgar,69,32,37,5,-5,16,19,15,19,0,6,3,-7,3,0,5,5:11 - 8:11 - 11:4 - 8:11 - 0:0
16405361,2024-01-20 14:55:00,Nikoghosyan Narek - Arutyunov Ruben,0:3,11:4 - 11:7 - 11:5 - 0:0 - 0:0,3,0,Nikoghosyan Narek,Arutyunov Ruben,fiurst,Arutyunov Ruben - Nikoghosyan Narek,49,16,33,17,-17,15,18,16,0,0,7,4,6,0,0,17,4:11 - 7:11 - 5:11 - 0:0 - 0:0
16405358,2024-01-20 14:30:00,Mkrtchyan Andranik - Papyan Karen,1:3,7:11 - 10:12 - 11:8 - 10:12 - 0:0,1,3,Mkrtchyan Andranik,Papyan Karen,fiurst,Mkrtchyan Andranik - Papyan Karen,81,38,43,5,-5,18,22,19,22,0,4,2,-3,2,0,5,7:11 - 10:12 - 11:8 - 10:12 - 0:0
16405356,2024-01-20 14:15:00,Nikoghosyan Narek - Rafayelyan Edgar,3:1,11:8 - 11:9 - 7:11 - 11:4 - 0:0,3,1,Nikoghosyan Narek,Rafayelyan Edgar,fiurst,Nikoghosyan Narek - Rafayelyan Edgar,72,40,32,-8,8,19,20,18,15,0,-3,-2,4,-7,0,-8,11:8 - 11:9 - 7:11 - 11:4 - 0:0
16405353,2024-01-20 14:05:00,Arutyunov Ruben - Papyan Karen,0:3,1:11 - 7:11 - 10:12 - 0:0 - 0:0,0,3,Arutyunov Ruben,Papyan Karen,fiurst,Arutyunov Ruben - Papyan Karen,52,18,34,16,-16,12,18,22,0,0,10,4,2,0,0,16,1:11 - 7:11 - 10:12 - 0:0 - 0:0
16405350,2024-01-20 13:50:00,Mkrtchyan Andranik - Nikoghosyan Narek,0:3,4:11 - 7:11 - 4:11 - 0:0 - 0:0,0,3,Mkrtchyan Andranik,Nikoghosyan Narek,fiurst,Mkrtchyan Andranik - Nikoghosyan Narek,48,15,33,18,-18,15,18,15,0,0,7,4,7,0,0,18,4:11 - 7:11 - 4:11 - 0:0 - 0:0
16405337,2024-01-20 13:30:00,Rafayelyan Edgar - Arutyunov Ruben,2:3,6:11 - 11:5 - 11:3 - 9:11 - 13:11,3,2,Rafayelyan Edgar,Arutyunov Ruben,fiurst,Arutyunov Ruben - Rafayelyan Edgar,91,41,50,9,-9,17,16,14,20,24,-5,6,8,-2,2,9,11:6 - 5:11 - 3:11 - 11:9 - 11:13
16405335,2024-01-20 13:15:00,Papyan Karen - Nikoghosyan Narek,3:1,8:11 - 11:8 - 9:11 - 9:11 - 0:0,1,3,Papyan Karen,Nikoghosyan Narek,fiurst,Nikoghosyan Narek - Papyan Karen,78,41,37,-4,4,19,19,20,20,0,-3,3,-2,-2,0,-4,11:8 - 8:11 - 11:9 - 11:9 - 0:0
16405334,2024-01-20 13:00:00,Rafayelyan Edgar - Mkrtchyan Andranik,0:3,11:9 - 11:7 - 11:5 - 0:0 - 0:0,3,0,Rafayelyan Edgar,Mkrtchyan Andranik,fiurst,Mkrtchyan Andranik - Rafayelyan Edgar,54,21,33,12,-12,20,18,16,0,0,2,4,6,0,0,12,9:11 - 7:11 - 5:11 - 0:0 - 0:0
16405331,2024-01-20 12:25:00,Arutyunov Ruben - Nikoghosyan Narek,1:3,2:11 - 11:5 - 5:11 - 7:11 - 0:0,1,3,Arutyunov Ruben,Nikoghosyan Narek,fiurst,Arutyunov Ruben - Nikoghosyan Narek,63,25,38,13,-13,13,16,16,18,0,9,-6,6,4,0,13,2:11 - 11:5 - 5:11 - 7:11 - 0:0
16405329,2024-01-20 12:10:00,Rafayelyan Edgar - Papyan Karen,3:1,10:12 - 10:12 - 11:5 - 5:11 - 0:0,1,3,Rafayelyan Edgar,Papyan Karen,fiurst,Papyan Karen - Rafayelyan Edgar,76,40,36,-4,4,22,22,16,16,0,-2,-2,6,-6,0,-4,12:10 - 12:10 - 5:11 - 11:5 - 0:0
16405328,2024-01-20 11:50:00,Mkrtchyan Andranik - Arutyunov Ruben,3:0,14:16 - 10:12 - 9:11 - 0:0 - 0:0,0,3,Mkrtchyan Andranik,Arutyunov Ruben,fiurst,Arutyunov Ruben - Mkrtchyan Andranik,72,39,33,-6,6,30,22,20,0,0,-2,-2,-2,0,0,-6,16:14 - 12:10 - 11:9 - 0:0 - 0:0
16405323,2024-01-20 11:40:00,Rafayelyan Edgar - Nikoghosyan Narek,3:2,9:11 - 11:5 - 11:7 - 8:11 - 4:11,2,3,Rafayelyan Edgar,Nikoghosyan Narek,fiurst,Nikoghosyan Narek - Rafayelyan Edgar,88,45,43,-2,2,20,16,18,19,15,-2,6,4,-3,-7,-2,11:9 - 5:11 - 7:11 - 11:8 - 11:4
16405314,2024-01-20 11:20:00,Papyan Karen - Mkrtchyan Andranik,0:3,11:5 - 11:7 - 11:8 - 0:0 - 0:0,3,0,Papyan Karen,Mkrtchyan Andranik,fiurst,Mkrtchyan Andranik - Papyan Karen,53,20,33,13,-13,16,18,19,0,0,6,4,3,0,0,13,5:11 - 7:11 - 8:11 - 0:0 - 0:0
16405312,2024-01-20 11:10:00,Arutyunov Ruben - Rafayelyan Edgar,1:3,12:10 - 6:11 - 2:11 - 12:14 - 0:0,1,3,Arutyunov Ruben,Rafayelyan Edgar,fiurst,Arutyunov Ruben - Rafayelyan Edgar,78,32,46,14,-14,22,17,13,26,0,-2,5,9,2,0,14,12:10 - 6:11 - 2:11 - 12:14 - 0:0
16405309,2024-01-20 10:45:00,Nikoghosyan Narek - Mkrtchyan Andranik,1:3,8:11 - 11:3 - 11:6 - 11:7 - 0:0,3,1,Nikoghosyan Narek,Mkrtchyan Andranik,fiurst,Mkrtchyan Andranik - Nikoghosyan Narek,68,27,41,14,-14,19,14,17,18,0,-3,8,5,4,0,14,11:8 - 3:11 - 6:11 - 7:11 - 0:0
16405305,2024-01-20 10:35:00,Papyan Karen - Arutyunov Ruben,2:3,5:11 - 5:11 - 11:9 - 11:7 - 12:10,3,2,Papyan Karen,Arutyunov Ruben,fiurst,Arutyunov Ruben - Papyan Karen,92,48,44,-4,4,16,16,20,18,22,-6,-6,2,4,2,-4,11:5 - 11:5 - 9:11 - 7:11 - 10:12
16405301,2024-01-20 10:15:00,Mkrtchyan Andranik - Rafayelyan Edgar,0:3,2:11 - 9:11 - 5:11 - 0:0 - 0:0,0,3,Mkrtchyan Andranik,Rafayelyan Edgar,fiurst,Mkrtchyan Andranik - Rafayelyan Edgar,49,16,33,17,-17,13,20,16,0,0,9,2,6,0,0,17,2:11 - 9:11 - 5:11 - 0:0 - 0:0
16405298,2024-01-20 10:00:00,Nikoghosyan Narek - Papyan Karen,3:1,6:11 - 11:8 - 11:7 - 11:9 - 0:0,3,1,Nikoghosyan Narek,Papyan Karen,fiurst,Nikoghosyan Narek - Papyan Karen,74,39,35,-4,4,17,19,18,20,0,5,-3,-4,-2,0,-4,6:11 - 11:8 - 11:7 - 11:9 - 0:0
16387642,2024-01-19 17:45:00,Grigoryan Erik - Karakhanyan Mher,1:3,11:13 - 11:4 - 8:11 - 7:11 - 0:0,1,3,Grigoryan Erik,Karakhanyan Mher,fiurst,Grigoryan Erik - Karakhanyan Mher,76,37,39,2,-2,24,15,19,18,0,2,-7,3,4,0,2,11:13 - 11:4 - 8:11 - 7:11 - 0:0
16387638,2024-01-19 17:30:00,Darbinyan Armen - Avakimyan Davit,3:1,11:9 - 8:11 - 9:11 - 8:11 - 0:0,1,3,Darbinyan Armen,Avakimyan Davit,fiurst,Avakimyan Davit - Darbinyan Armen,78,42,36,-6,6,20,19,20,19,0,2,-3,-2,-3,0,-6,9:11 - 11:8 - 11:9 - 11:8 - 0:0
16387636,2024-01-19 17:15:00,Gevorgyan Hayk - Grigoryan Erik,3:0,11:3 - 11:7 - 11:7 - 0:0 - 0:0,3,0,Gevorgyan Hayk,Grigoryan Erik,fiurst,Gevorgyan Hayk - Grigoryan Erik,50,33,17,-16,16,14,18,18,0,0,-8,-4,-4,0,0,-16,11:3 - 11:7 - 11:7 - 0:0 - 0:0
16387632,2024-01-19 17:00:00,Darbinyan Armen - Karakhanyan Mher,0:3,5:11 - 6:11 - 4:11 - 0:0 - 0:0,0,3,Darbinyan Armen,Karakhanyan Mher,fiurst,Darbinyan Armen - Karakhanyan Mher,48,15,33,18,-18,16,17,15,0,0,6,5,7,0,0,18,5:11 - 6:11 - 4:11 - 0:0 - 0:0
16387619,2024-01-19 16:45:00,Avakimyan Davit - Gevorgyan Hayk,0:3,6:11 - 4:11 - 5:11 - 0:0 - 0:0,0,3,Avakimyan Davit,Gevorgyan Hayk,fiurst,Avakimyan Davit - Gevorgyan Hayk,48,15,33,18,-18,17,15,16,0,0,5,7,6,0,0,18,6:11 - 4:11 - 5:11 - 0:0 - 0:0
16387607,2024-01-19 16:30:00,Grigoryan Erik - Darbinyan Armen,0:3,11:4 - 11:3 - 11:4 - 0:0 - 0:0,3,0,Grigoryan Erik,Darbinyan Armen,fiurst,Darbinyan Armen - Grigoryan Erik,44,11,33,22,-22,15,14,15,0,0,7,8,7,0,0,22,4:11 - 3:11 - 4:11 - 0:0 - 0:0
16387605,2024-01-19 16:15:00,Karakhanyan Mher - Gevorgyan Hayk,3:0,5:11 - 9:11 - 8:11 - 0:0 - 0:0,0,3,Karakhanyan Mher,Gevorgyan Hayk,fiurst,Gevorgyan Hayk - Karakhanyan Mher,55,33,22,-11,11,16,20,19,0,0,-6,-2,-3,0,0,-11,11:5 - 11:9 - 11:8 - 0:0 - 0:0
16387603,2024-01-19 16:00:00,Avakimyan Davit - Grigoryan Erik,1:3,11:6 - 11:13 - 9:11 - 7:11 - 0:0,1,3,Avakimyan Davit,Grigoryan Erik,fiurst,Avakimyan Davit - Grigoryan Erik,79,38,41,3,-3,17,24,20,18,0,-5,2,2,4,0,3,11:6 - 11:13 - 9:11 - 7:11 - 0:0
16387602,2024-01-19 15:45:00,Gevorgyan Hayk - Darbinyan Armen,0:3,11:4 - 11:1 - 11:9 - 0:0 - 0:0,3,0,Gevorgyan Hayk,Darbinyan Armen,fiurst,Darbinyan Armen - Gevorgyan Hayk,47,14,33,19,-19,15,12,20,0,0,7,10,2,0,0,19,4:11 - 1:11 - 9:11 - 0:0 - 0:0
16387598,2024-01-19 15:30:00,Karakhanyan Mher - Avakimyan Davit,1:3,11:9 - 8:11 - 12:10 - 11:9 - 0:0,3,1,Karakhanyan Mher,Avakimyan Davit,fiurst,Avakimyan Davit - Karakhanyan Mher,81,39,42,3,-3,20,19,22,20,0,2,-3,2,2,0,3,9:11 - 11:8 - 10:12 - 9:11 - 0:0
16387596,2024-01-19 15:15:00,Nazaryan Mushegh - Papyan Karen,0:3,5:11 - 7:11 - 6:11 - 0:0 - 0:0,0,3,Nazaryan Mushegh,Papyan Karen,fiurst,Nazaryan Mushegh - Papyan Karen,51,18,33,15,-15,16,18,17,0,0,6,4,5,0,0,15,5:11 - 7:11 - 6:11 - 0:0 - 0:0
16387595,2024-01-19 15:05:00,Diaryan Aleksandr - Nikoghosyan Narek,3:1,11:7 - 11:9 - 5:11 - 11:2 - 0:0,3,1,Diaryan Aleksandr,Nikoghosyan Narek,fiurst,Diaryan Aleksandr - Nikoghosyan Narek,67,38,29,-9,9,18,20,16,13,0,-4,-2,6,-9,0,-9,11:7 - 11:9 - 5:11 - 11:2 - 0:0
16387593,2024-01-19 14:45:00,Arutyunov Ruben - Nazaryan Mushegh,0:3,4:11 - 5:11 - 9:11 - 0:0 - 0:0,0,3,Arutyunov Ruben,Nazaryan Mushegh,fiurst,Arutyunov Ruben - Nazaryan Mushegh,51,18,33,15,-15,15,16,20,0,0,7,6,2,0,0,15,4:11 - 5:11 - 9:11 - 0:0 - 0:0
16387582,2024-01-19 14:30:00,Papyan Karen - Diaryan Aleksandr,3:0,7:11 - 9:11 - 9:11 - 0:0 - 0:0,0,3,Papyan Karen,Diaryan Aleksandr,fiurst,Diaryan Aleksandr - Papyan Karen,58,33,25,-8,8,18,20,20,0,0,-4,-2,-2,0,0,-8,11:7 - 11:9 - 11:9 - 0:0 - 0:0
16387581,2024-01-19 14:15:00,Arutyunov Ruben - Nikoghosyan Narek,0:3,5:11 - 3:11 - 8:11 - 0:0 - 0:0,0,3,Arutyunov Ruben,Nikoghosyan Narek,fiurst,Arutyunov Ruben - Nikoghosyan Narek,49,16,33,17,-17,16,14,19,0,0,6,8,3,0,0,17,5:11 - 3:11 - 8:11 - 0:0 - 0:0
16387577,2024-01-19 14:00:00,Nazaryan Mushegh - Diaryan Aleksandr,3:0,7:11 - 4:11 - 5:11 - 0:0 - 0:0,0,3,Nazaryan Mushegh,Diaryan Aleksandr,fiurst,Diaryan Aleksandr - Nazaryan Mushegh,49,33,16,-17,17,18,15,16,0,0,-4,-7,-6,0,0,-17,11:7 - 11:4 - 11:5 - 0:0 - 0:0
16387576,2024-01-19 13:45:00,Papyan Karen - Arutyunov Ruben,0:3,11:4 - 11:3 - 11:5 - 0:0 - 0:0,3,0,Papyan Karen,Arutyunov Ruben,fiurst,Arutyunov Ruben - Papyan Karen,45,12,33,21,-21,15,14,16,0,0,7,8,6,0,0,21,4:11 - 3:11 - 5:11 - 0:0 - 0:0
16387574,2024-01-19 13:30:00,Nikoghosyan Narek - Nazaryan Mushegh,1:3,11:1 - 11:6 - 9:11 - 11:4 - 0:0,3,1,Nikoghosyan Narek,Nazaryan Mushegh,fiurst,Nazaryan Mushegh - Nikoghosyan Narek,64,22,42,20,-20,12,17,20,15,0,10,5,-2,7,0,20,1:11 - 6:11 - 11:9 - 4:11 - 0:0
16387573,2024-01-19 13:15:00,Diaryan Aleksandr - Arutyunov Ruben,0:3,11:5 - 11:5 - 11:5 - 0:0 - 0:0,3,0,Diaryan Aleksandr,Arutyunov Ruben,fiurst,Arutyunov Ruben - Diaryan Aleksandr,48,15,33,18,-18,16,16,16,0,0,6,6,6,0,0,18,5:11 - 5:11 - 5:11 - 0:0 - 0:0
16387572,2024-01-19 13:00:00,Nikoghosyan Narek - Papyan Karen,3:0,12:10 - 11:9 - 11:6 - 0:0 - 0:0,3,0,Nikoghosyan Narek,Papyan Karen,fiurst,Nikoghosyan Narek - Papyan Karen,59,34,25,-9,9,22,20,17,0,0,-2,-2,-5,0,0,-9,12:10 - 11:9 - 11:6 - 0:0 - 0:0
16387559,2024-01-19 12:25:00,Nazaryan Mushegh - Arutyunov Ruben,2:3,14:12 - 10:12 - 11:6 - 6:11 - 11:7,3,2,Nazaryan Mushegh,Arutyunov Ruben,fiurst,Arutyunov Ruben - Nazaryan Mushegh,100,48,52,4,-4,26,22,17,17,18,2,-2,5,-5,4,4,12:14 - 12:10 - 6:11 - 11:6 - 7:11
16387558,2024-01-19 12:15:00,Nikoghosyan Narek - Diaryan Aleksandr,3:0,11:13 - 5:11 - 8:11 - 0:0 - 0:0,0,3,Nikoghosyan Narek,Diaryan Aleksandr,fiurst,Diaryan Aleksandr - Nikoghosyan Narek,59,35,24,-11,11,24,16,19,0,0,-2,-6,-3,0,0,-11,13:11 - 11:5 - 11:8 - 0:0 - 0:0
16387557,2024-01-19 12:00:00,Papyan Karen - Nazaryan Mushegh,3:1,11:8 - 9:11 - 9:11 - 9:11 - 0:0,1,3,Papyan Karen,Nazaryan Mushegh,fiurst,Nazaryan Mushegh - Papyan Karen,79,41,38,-3,3,19,20,20,20,0,3,-2,-2,-2,0,-3,8:11 - 11:9 - 11:9 - 11:9 - 0:0
16387554,2024-01-19 11:40:00,Nikoghosyan Narek - Arutyunov Ruben,2:3,11:4 - 10:12 - 11:5 - 7:11 - 11:8,3,2,Nikoghosyan Narek,Arutyunov Ruben,fiurst,Arutyunov Ruben - Nikoghosyan Narek,90,40,50,10,-10,15,22,16,18,19,7,-2,6,-4,3,10,4:11 - 12:10 - 5:11 - 11:7 - 8:11
16387530,2024-01-19 11:25:00,Diaryan Aleksandr - Papyan Karen,2:3,11:13 - 7:11 - 11:2 - 11:7 - 4:11,2,3,Diaryan Aleksandr,Papyan Karen,fiurst,Diaryan Aleksandr - Papyan Karen,88,44,44,0,0,24,18,13,18,15,2,4,-9,-4,7,0,11:13 - 7:11 - 11:2 - 11:7 - 4:11
16387529,2024-01-19 11:00:00,Nazaryan Mushegh - Nikoghosyan Narek,3:1,12:10 - 5:11 - 11:9 - 11:4 - 0:0,3,1,Nazaryan Mushegh,Nikoghosyan Narek,fiurst,Nazaryan Mushegh - Nikoghosyan Narek,73,39,34,-5,5,22,16,20,15,0,-2,6,-2,-7,0,-5,12:10 - 5:11 - 11:9 - 11:4 - 0:0
16387527,2024-01-19 10:55:00,Arutyunov Ruben - Papyan Karen,1:3,9:11 - 12:10 - 8:11 - 10:12 - 0:0,1,3,Arutyunov Ruben,Papyan Karen,fiurst,Arutyunov Ruben - Papyan Karen,83,39,44,5,-5,20,22,19,22,0,2,-2,3,2,0,5,9:11 - 12:10 - 8:11 - 10:12 - 0:0
16387525,2024-01-19 10:30:00,Diaryan Aleksandr - Nazaryan Mushegh,3:0,11:5 - 11:6 - 11:4 - 0:0 - 0:0,3,0,Diaryan Aleksandr,Nazaryan Mushegh,fiurst,Diaryan Aleksandr - Nazaryan Mushegh,48,33,15,-18,18,16,17,15,0,0,-6,-5,-7,0,0,-18,11:5 - 11:6 - 11:4 - 0:0 - 0:0
16387523,2024-01-19 10:15:00,Papyan Karen - Nikoghosyan Narek,2:3,5:11 - 8:11 - 11:8 - 11:9 - 13:11,3,2,Papyan Karen,Nikoghosyan Narek,fiurst,Nikoghosyan Narek - Papyan Karen,98,50,48,-2,2,16,19,19,20,24,-6,-3,3,2,2,-2,11:5 - 11:8 - 8:11 - 9:11 - 11:13
16387512,2024-01-19 10:00:00,Arutyunov Ruben - Diaryan Aleksandr,0:3,4:11 - 6:11 - 7:11 - 0:0 - 0:0,0,3,Arutyunov Ruben,Diaryan Aleksandr,fiurst,Arutyunov Ruben - Diaryan Aleksandr,50,17,33,16,-16,15,17,18,0,0,7,5,4,0,0,16,4:11 - 6:11 - 7:11 - 0:0 - 0:0
16366538,2024-01-18 17:50:00,Avakimyan Davit - Gevorgyan Gegham,1:3,13:11 - 5:11 - 14:16 - 7:11 - 0:0,1,3,Avakimyan Davit,Gevorgyan Gegham,fiurst,Avakimyan Davit - Gevorgyan Gegham,88,39,49,10,-10,24,16,30,18,0,-2,6,2,4,0,10,13:11 - 5:11 - 14:16 - 7:11 - 0:0
16366536,2024-01-18 17:30:00,Darbinyan Armen - Grigoryan Erik,0:3,7:11 - 8:11 - 4:11 - 0:0 - 0:0,0,3,Darbinyan Armen,Grigoryan Erik,fiurst,Darbinyan Armen - Grigoryan Erik,52,19,33,14,-14,18,19,15,0,0,4,3,7,0,0,14,7:11 - 8:11 - 4:11 - 0:0 - 0:0
16366534,2024-01-18 17:15:00,Karakhanyan Mher - Avakimyan Davit,3:0,5:11 - 2:11 - 10:12 - 0:0 - 0:0,0,3,Karakhanyan Mher,Avakimyan Davit,fiurst,Avakimyan Davit - Karakhanyan Mher,51,34,17,-17,17,16,13,22,0,0,-6,-9,-2,0,0,-17,11:5 - 11:2 - 12:10 - 0:0 - 0:0
16366533,2024-01-18 17:05:00,Darbinyan Armen - Gevorgyan Gegham,0:3,4:11 - 4:11 - 6:11 - 0:0 - 0:0,0,3,Darbinyan Armen,Gevorgyan Gegham,fiurst,Darbinyan Armen - Gevorgyan Gegham,47,14,33,19,-19,15,15,17,0,0,7,7,5,0,0,19,4:11 - 4:11 - 6:11 - 0:0 - 0:0
16366496,2024-01-18 16:45:00,Karakhanyan Mher - Darbinyan Armen,1:3,11:5 - 11:7 - 8:11 - 11:6 - 0:0,3,1,Karakhanyan Mher,Darbinyan Armen,fiurst,Darbinyan Armen - Karakhanyan Mher,70,29,41,12,-12,16,18,19,17,0,6,4,-3,5,0,12,5:11 - 7:11 - 11:8 - 6:11 - 0:0
16366501,2024-01-18 16:45:00,Gevorgyan Gegham - Karakhanyan Mher,3:0,11:8 - 11:3 - 11:8 - 0:0 - 0:0,3,0,Gevorgyan Gegham,Karakhanyan Mher,fiurst,Gevorgyan Gegham - Karakhanyan Mher,52,33,19,-14,14,19,14,19,0,0,-3,-8,-3,0,0,-14,11:8 - 11:3 - 11:8 - 0:0 - 0:0
16366505,2024-01-18 16:30:00,Avakimyan Davit - Darbinyan Armen,3:1,11:8 - 8:11 - 11:9 - 11:6 - 0:0,3,1,Avakimyan Davit,Darbinyan Armen,fiurst,Avakimyan Davit - Darbinyan Armen,75,41,34,-7,7,19,19,20,17,0,-3,3,-2,-5,0,-7,11:8 - 8:11 - 11:9 - 11:6 - 0:0
16366531,2024-01-18 16:20:00,Grigoryan Erik - Karakhanyan Mher,3:1,9:11 - 11:9 - 11:8 - 11:8 - 0:0,3,1,Grigoryan Erik,Karakhanyan Mher,fiurst,Grigoryan Erik - Karakhanyan Mher,78,42,36,-6,6,20,20,19,19,0,2,-2,-3,-3,0,-6,9:11 - 11:9 - 11:8 - 11:8 - 0:0
16366499,2024-01-18 16:00:00,Grigoryan Erik - Avakimyan Davit,3:0,7:11 - 7:11 - 4:11 - 0:0 - 0:0,0,3,Grigoryan Erik,Avakimyan Davit,fiurst,Avakimyan Davit - Grigoryan Erik,51,33,18,-15,15,18,18,15,0,0,-4,-4,-7,0,0,-15,11:7 - 11:7 - 11:4 - 0:0 - 0:0
16366495,2024-01-18 15:30:00,Gevorgyan Gegham - Grigoryan Erik,3:0,11:7 - 11:8 - 11:6 - 0:0 - 0:0,3,0,Gevorgyan Gegham,Grigoryan Erik,fiurst,Gevorgyan Gegham - Grigoryan Erik,54,33,21,-12,12,18,19,17,0,0,-4,-3,-5,0,0,-12,11:7 - 11:8 - 11:6 - 0:0 - 0:0
16366494,2024-01-18 15:20:00,Diaryan Aleksandr - Gevorgyan Hayk,3:0,11:9 - 11:4 - 11:7 - 0:0 - 0:0,3,0,Diaryan Aleksandr,Gevorgyan Hayk,fiurst,Diaryan Aleksandr - Gevorgyan Hayk,53,33,20,-13,13,20,15,18,0,0,-2,-7,-4,0,0,-13,11:9 - 11:4 - 11:7 - 0:0 - 0:0
16366488,2024-01-18 15:00:00,Nikoghosyan Narek - Arutyunov Ruben,0:3,13:11 - 11:7 - 11:7 - 0:0 - 0:0,3,0,Nikoghosyan Narek,Arutyunov Ruben,fiurst,Arutyunov Ruben - Nikoghosyan Narek,60,25,35,10,-10,24,18,18,0,0,2,4,4,0,0,10,11:13 - 7:11 - 7:11 - 0:0 - 0:0
16366485,2024-01-18 14:45:00,Rafayelyan Edgar - Diaryan Aleksandr,1:3,11:7 - 9:11 - 11:9 - 11:6 - 0:0,3,1,Rafayelyan Edgar,Diaryan Aleksandr,fiurst,Diaryan Aleksandr - Rafayelyan Edgar,75,33,42,9,-9,18,20,20,17,0,4,-2,2,5,0,9,7:11 - 11:9 - 9:11 - 6:11 - 0:0
16366484,2024-01-18 14:30:00,Gevorgyan Hayk - Nikoghosyan Narek,0:3,8:11 - 6:11 - 2:11 - 0:0 - 0:0,0,3,Gevorgyan Hayk,Nikoghosyan Narek,fiurst,Gevorgyan Hayk - Nikoghosyan Narek,49,16,33,17,-17,19,17,13,0,0,3,5,9,0,0,17,8:11 - 6:11 - 2:11 - 0:0 - 0:0
16366481,2024-01-18 14:15:00,Rafayelyan Edgar - Arutyunov Ruben,0:3,11:3 - 11:2 - 14:12 - 0:0 - 0:0,3,0,Rafayelyan Edgar,Arutyunov Ruben,fiurst,Arutyunov Ruben - Rafayelyan Edgar,53,17,36,19,-19,14,13,26,0,0,8,9,2,0,0,19,3:11 - 2:11 - 12:14 - 0:0 - 0:0
16366478,2024-01-18 14:00:00,Diaryan Aleksandr - Nikoghosyan Narek,0:3,9:11 - 7:11 - 8:11 - 0:0 - 0:0,0,3,Diaryan Aleksandr,Nikoghosyan Narek,fiurst,Diaryan Aleksandr - Nikoghosyan Narek,57,24,33,9,-9,20,18,19,0,0,2,4,3,0,0,9,9:11 - 7:11 - 8:11 - 0:0 - 0:0
16366476,2024-01-18 13:45:00,Gevorgyan Hayk - Rafayelyan Edgar,1:3,9:11 - 9:11 - 11:9 - 9:11 - 0:0,1,3,Gevorgyan Hayk,Rafayelyan Edgar,fiurst,Gevorgyan Hayk - Rafayelyan Edgar,80,38,42,4,-4,20,20,20,20,0,2,2,-2,2,0,4,9:11 - 9:11 - 11:9 - 9:11 - 0:0
16366473,2024-01-18 13:35:00,Arutyunov Ruben - Diaryan Aleksandr,1:3,11:9 - 8:11 - 4:11 - 6:11 - 0:0,1,3,Arutyunov Ruben,Diaryan Aleksandr,fiurst,Arutyunov Ruben - Diaryan Aleksandr,71,29,42,13,-13,20,19,15,17,0,-2,3,7,5,0,13,11:9 - 8:11 - 4:11 - 6:11 - 0:0
16366467,2024-01-18 13:15:00,Nikoghosyan Narek - Rafayelyan Edgar,0:3,7:11 - 6:11 - 8:11 - 0:0 - 0:0,0,3,Nikoghosyan Narek,Rafayelyan Edgar,fiurst,Nikoghosyan Narek - Rafayelyan Edgar,54,21,33,12,-12,18,17,19,0,0,4,5,3,0,0,12,7:11 - 6:11 - 8:11 - 0:0 - 0:0
16366457,2024-01-18 13:00:00,Arutyunov Ruben - Gevorgyan Hayk,3:2,10:12 - 11:6 - 8:11 - 11:7 - 11:7,3,2,Arutyunov Ruben,Gevorgyan Hayk,fiurst,Arutyunov Ruben - Gevorgyan Hayk,94,51,43,-8,8,22,17,19,18,18,2,-5,3,-4,-4,-8,10:12 - 11:6 - 8:11 - 11:7 - 11:7
16366455,2024-01-18 12:15:00,Diaryan Aleksandr - Rafayelyan Edgar,3:1,11:9 - 8:11 - 11:7 - 11:4 - 0:0,3,1,Diaryan Aleksandr,Rafayelyan Edgar,fiurst,Diaryan Aleksandr - Rafayelyan Edgar,72,41,31,-10,10,20,19,18,15,0,-2,3,-4,-7,0,-10,11:9 - 8:11 - 11:7 - 11:4 - 0:0
16366453,2024-01-18 12:00:00,Arutyunov Ruben - Nikoghosyan Narek,1:3,2:11 - 11:3 - 6:11 - 9:11 - 0:0,1,3,Arutyunov Ruben,Nikoghosyan Narek,fiurst,Arutyunov Ruben - Nikoghosyan Narek,64,28,36,8,-8,13,14,17,20,0,9,-8,5,2,0,8,2:11 - 11:3 - 6:11 - 9:11 - 0:0
16366448,2024-01-18 11:45:00,Gevorgyan Hayk - Diaryan Aleksandr,3:0,10:12 - 8:11 - 8:11 - 0:0 - 0:0,0,3,Gevorgyan Hayk,Diaryan Aleksandr,fiurst,Diaryan Aleksandr - Gevorgyan Hayk,60,34,26,-8,8,22,19,19,0,0,-2,-3,-3,0,0,-8,12:10 - 11:8 - 11:8 - 0:0 - 0:0
16366440,2024-01-18 11:30:00,Arutyunov Ruben - Rafayelyan Edgar,0:3,5:11 - 4:11 - 3:11 - 0:0 - 0:0,0,3,Arutyunov Ruben,Rafayelyan Edgar,fiurst,Arutyunov Ruben - Rafayelyan Edgar,45,12,33,21,-21,16,15,14,0,0,6,7,8,0,0,21,5:11 - 4:11 - 3:11 - 0:0 - 0:0
16366437,2024-01-18 11:15:00,Nikoghosyan Narek - Gevorgyan Hayk,3:0,7:11 - 8:11 - 8:11 - 0:0 - 0:0,0,3,Nikoghosyan Narek,Gevorgyan Hayk,fiurst,Gevorgyan Hayk - Nikoghosyan Narek,56,33,23,-10,10,18,19,19,0,0,-4,-3,-3,0,0,-10,11:7 - 11:8 - 11:8 - 0:0 - 0:0
16366422,2024-01-18 11:05:00,Diaryan Aleksandr - Arutyunov Ruben,0:3,11:4 - 11:3 - 11:4 - 0:0 - 0:0,3,0,Diaryan Aleksandr,Arutyunov Ruben,fiurst,Arutyunov Ruben - Diaryan Aleksandr,44,11,33,22,-22,15,14,15,0,0,7,8,7,0,0,22,4:11 - 3:11 - 4:11 - 0:0 - 0:0
16366417,2024-01-18 10:45:00,Nikoghosyan Narek - Diaryan Aleksandr,3:0,7:11 - 9:11 - 5:11 - 0:0 - 0:0,0,3,Nikoghosyan Narek,Diaryan Aleksandr,fiurst,Diaryan Aleksandr - Nikoghosyan Narek,54,33,21,-12,12,18,20,16,0,0,-4,-2,-6,0,0,-12,11:7 - 11:9 - 11:5 - 0:0 - 0:0
16366421,2024-01-18 10:45:00,Rafayelyan Edgar - Gevorgyan Hayk,0:3,11:9 - 11:9 - 11:8 - 0:0 - 0:0,3,0,Rafayelyan Edgar,Gevorgyan Hayk,fiurst,Gevorgyan Hayk - Rafayelyan Edgar,59,26,33,7,-7,20,20,19,0,0,2,2,3,0,0,7,9:11 - 9:11 - 8:11 - 0:0 - 0:0
16366413,2024-01-18 10:15:00,Gevorgyan Hayk - Arutyunov Ruben,3:1,5:11 - 4:11 - 12:10 - 4:11 - 0:0,1,3,Gevorgyan Hayk,Arutyunov Ruben,fiurst,Arutyunov Ruben - Gevorgyan Hayk,68,43,25,-18,18,16,15,22,15,0,-6,-7,2,-7,0,-18,11:5 - 11:4 - 10:12 - 11:4 - 0:0
16366406,2024-01-18 10:00:00,Rafayelyan Edgar - Nikoghosyan Narek,2:3,8:11 - 9:11 - 11:8 - 11:6 - 13:11,3,2,Rafayelyan Edgar,Nikoghosyan Narek,fiurst,Nikoghosyan Narek - Rafayelyan Edgar,99,47,52,5,-5,19,20,19,17,24,-3,-2,3,5,2,5,11:8 - 11:9 - 8:11 - 6:11 - 11:13
16347864,2024-01-17 17:45:00,Darbinyan Armen - Avakimyan Davit,3:0,5:11 - 8:11 - 2:11 - 0:0 - 0:0,0,3,Darbinyan Armen,Avakimyan Davit,fiurst,Avakimyan Davit - Darbinyan Armen,48,33,15,-18,18,16,19,13,0,0,-6,-3,-9,0,0,-18,11:5 - 11:8 - 11:2 - 0:0 - 0:0
16347852,2024-01-17 17:30:00,Karakhanyan Mher - Gevorgyan Gegham,3:1,12:10 - 6:11 - 8:11 - 8:11 - 0:0,1,3,Karakhanyan Mher,Gevorgyan Gegham,fiurst,Gevorgyan Gegham - Karakhanyan Mher,77,43,34,-9,9,22,17,19,19,0,2,-5,-3,-3,0,-9,10:12 - 11:6 - 11:8 - 11:8 - 0:0
16347850,2024-01-17 17:20:00,Grigoryan Erik - Darbinyan Armen,0:3,11:2 - 11:6 - 11:1 - 0:0 - 0:0,3,0,Grigoryan Erik,Darbinyan Armen,fiurst,Darbinyan Armen - Grigoryan Erik,42,9,33,24,-24,13,17,12,0,0,9,5,10,0,0,24,2:11 - 6:11 - 1:11 - 0:0 - 0:0
16347847,2024-01-17 17:00:00,Karakhanyan Mher - Avakimyan Davit,3:1,11:9 - 7:11 - 9:11 - 9:11 - 0:0,1,3,Karakhanyan Mher,Avakimyan Davit,fiurst,Avakimyan Davit - Karakhanyan Mher,78,42,36,-6,6,20,18,20,20,0,2,-4,-2,-2,0,-6,9:11 - 11:7 - 11:9 - 11:9 - 0:0
16347845,2024-01-17 16:50:00,Gevorgyan Gegham - Grigoryan Erik,2:3,11:4 - 11:6 - 10:12 - 7:11 - 11:13,2,3,Gevorgyan Gegham,Grigoryan Erik,fiurst,Gevorgyan Gegham - Grigoryan Erik,96,50,46,-4,4,15,17,22,18,24,-7,-5,2,4,2,-4,11:4 - 11:6 - 10:12 - 7:11 - 11:13
16347844,2024-01-17 16:40:00,Darbinyan Armen - Karakhanyan Mher,0:3,6:11 - 8:11 - 7:11 - 0:0 - 0:0,0,3,Darbinyan Armen,Karakhanyan Mher,fiurst,Darbinyan Armen - Karakhanyan Mher,54,21,33,12,-12,17,19,18,0,0,5,3,4,0,0,12,6:11 - 8:11 - 7:11 - 0:0 - 0:0
16347838,2024-01-17 16:15:00,Gevorgyan Gegham - Darbinyan Armen,0:3,11:5 - 11:4 - 11:3 - 0:0 - 0:0,3,0,Gevorgyan Gegham,Darbinyan Armen,fiurst,Darbinyan Armen - Gevorgyan Gegham,45,12,33,21,-21,16,15,14,0,0,6,7,8,0,0,21,5:11 - 4:11 - 3:11 - 0:0 - 0:0
16347842,2024-01-17 16:15:00,Avakimyan Davit - Grigoryan Erik,3:2,11:6 - 11:9 - 10:12 - 10:12 - 11:8,3,2,Avakimyan Davit,Grigoryan Erik,fiurst,Avakimyan Davit - Grigoryan Erik,100,53,47,-6,6,17,20,22,22,19,-5,-2,2,2,-3,-6,11:6 - 11:9 - 10:12 - 10:12 - 11:8
16347834,2024-01-17 15:45:00,Grigoryan Erik - Karakhanyan Mher,3:0,11:5 - 11:5 - 11:9 - 0:0 - 0:0,3,0,Grigoryan Erik,Karakhanyan Mher,fiurst,Grigoryan Erik - Karakhanyan Mher,52,33,19,-14,14,16,16,20,0,0,-6,-6,-2,0,0,-14,11:5 - 11:5 - 11:9 - 0:0 - 0:0
16347833,2024-01-17 15:30:00,Avakimyan Davit - Gevorgyan Gegham,3:0,11:6 - 12:10 - 11:8 - 0:0 - 0:0,3,0,Avakimyan Davit,Gevorgyan Gegham,fiurst,Avakimyan Davit - Gevorgyan Gegham,58,34,24,-10,10,17,22,19,0,0,-5,-2,-3,0,0,-10,11:6 - 12:10 - 11:8 - 0:0 - 0:0
16347821,2024-01-17 15:20:00,Nazaryan Mushegh - Nikoghosyan Narek,0:3,8:11 - 9:11 - 5:11 - 0:0 - 0:0,0,3,Nazaryan Mushegh,Nikoghosyan Narek,fiurst,Nazaryan Mushegh - Nikoghosyan Narek,55,22,33,11,-11,19,20,16,0,0,3,2,6,0,0,11,8:11 - 9:11 - 5:11 - 0:0 - 0:0
16347818,2024-01-17 15:00:00,Rafayelyan Edgar - Arutyunov Ruben,0:3,11:9 - 11:8 - 14:12 - 0:0 - 0:0,3,0,Rafayelyan Edgar,Arutyunov Ruben,fiurst,Arutyunov Ruben - Rafayelyan Edgar,65,29,36,7,-7,20,19,26,0,0,2,3,2,0,0,7,9:11 - 8:11 - 12:14 - 0:0 - 0:0
16347816,2024-01-17 14:45:00,Papyan Karen - Nazaryan Mushegh,0:3,11:8 - 11:9 - 11:3 - 0:0 - 0:0,3,0,Papyan Karen,Nazaryan Mushegh,fiurst,Nazaryan Mushegh - Papyan Karen,53,20,33,13,-13,19,20,14,0,0,3,2,8,0,0,13,8:11 - 9:11 - 3:11 - 0:0 - 0:0
16347814,2024-01-17 14:30:00,Nikoghosyan Narek - Rafayelyan Edgar,1:3,9:11 - 11:7 - 4:11 - 13:15 - 0:0,1,3,Nikoghosyan Narek,Rafayelyan Edgar,fiurst,Nikoghosyan Narek - Rafayelyan Edgar,81,37,44,7,-7,20,18,15,28,0,2,-4,7,2,0,7,9:11 - 11:7 - 4:11 - 13:15 - 0:0
16347812,2024-01-17 14:25:00,Arutyunov Ruben - Nikoghosyan Narek,0:0,0:0 - 0:0 - 0:0 - 0:0 - 0:0,0,0,Arutyunov Ruben,Nikoghosyan Narek,fiurst,Arutyunov Ruben - Nikoghosyan Narek,0,0,0,0,0,0,0,0,0,0,0,0,0,0,0,0,0:0 - 0:0 - 0:0 - 0:0 - 0:0
16370116,2024-01-17 14:25:00,Papyan Karen - Arutyunov Ruben,0:3,11:4 - 11:5 - 12:10 - 0:0 - 0:0,3,0,Papyan Karen,Arutyunov Ruben,fiurst,Arutyunov Ruben - Papyan Karen,53,19,34,15,-15,15,16,22,0,0,7,6,2,0,0,15,4:11 - 5:11 - 10:12 - 0:0 - 0:0
16347810,2024-01-17 14:00:00,Nazaryan Mushegh - Rafayelyan Edgar,0:3,5:11 - 6:11 - 8:11 - 0:0 - 0:0,0,3,Nazaryan Mushegh,Rafayelyan Edgar,fiurst,Nazaryan Mushegh - Rafayelyan Edgar,52,19,33,14,-14,16,17,19,0,0,6,5,3,0,0,14,5:11 - 6:11 - 8:11 - 0:0 - 0:0
16347808,2024-01-17 13:55:00,Nikoghosyan Narek - Papyan Karen,1:3,12:10 - 8:11 - 7:11 - 8:11 - 0:0,1,3,Nikoghosyan Narek,Papyan Karen,fiurst,Nikoghosyan Narek - Papyan Karen,78,35,43,8,-8,22,19,18,19,0,-2,3,4,3,0,8,12:10 - 8:11 - 7:11 - 8:11 - 0:0
16347798,2024-01-17 13:30:00,Arutyunov Ruben - Nazaryan Mushegh,2:3,11:9 - 4:11 - 4:11 - 11:5 - 4:11,2,3,Arutyunov Ruben,Nazaryan Mushegh,fiurst,Arutyunov Ruben - Nazaryan Mushegh,81,34,47,13,-13,20,15,15,16,15,-2,7,7,-6,7,13,11:9 - 4:11 - 4:11 - 11:5 - 4:11
16347796,2024-01-17 13:15:00,Rafayelyan Edgar - Papyan Karen,2:3,11:5 - 14:12 - 8:11 - 8:11 - 11:8,3,2,Rafayelyan Edgar,Papyan Karen,fiurst,Papyan Karen - Rafayelyan Edgar,99,47,52,5,-5,16,26,19,19,19,6,2,-3,-3,3,5,5:11 - 12:14 - 11:8 - 11:8 - 8:11
16347792,2024-01-17 13:00:00,Arutyunov Ruben - Nikoghosyan Narek,0:3,11:13 - 6:11 - 9:11 - 0:0 - 0:0,0,3,Arutyunov Ruben,Nikoghosyan Narek,fiurst,Arutyunov Ruben - Nikoghosyan Narek,61,26,35,9,-9,24,17,20,0,0,2,5,2,0,0,9,11:13 - 6:11 - 9:11 - 0:0 - 0:0
16347778,2024-01-17 12:15:00,Nazaryan Mushegh - Papyan Karen,1:3,12:10 - 11:13 - 9:11 - 5:11 - 0:0,1,3,Nazaryan Mushegh,Papyan Karen,fiurst,Nazaryan Mushegh - Papyan Karen,82,37,45,8,-8,22,24,20,16,0,-2,2,2,6,0,8,12:10 - 11:13 - 9:11 - 5:11 - 0:0
16347763,2024-01-17 12:10:00,Arutyunov Ruben - Rafayelyan Edgar,3:2,4:11 - 11:9 - 6:11 - 11:9 - 11:6,3,2,Arutyunov Ruben,Rafayelyan Edgar,fiurst,Arutyunov Ruben - Rafayelyan Edgar,89,43,46,3,-3,15,20,17,20,17,7,-2,5,-2,-5,3,4:11 - 11:9 - 6:11 - 11:9 - 11:6
16347759,2024-01-17 11:45:00,Nikoghosyan Narek - Nazaryan Mushegh,0:3,11:7 - 11:7 - 11:7 - 0:0 - 0:0,3,0,Nikoghosyan Narek,Nazaryan Mushegh,fiurst,Nazaryan Mushegh - Nikoghosyan Narek,54,21,33,12,-12,18,18,18,0,0,4,4,4,0,0,12,7:11 - 7:11 - 7:11 - 0:0 - 0:0
16347757,2024-01-17 11:30:00,Arutyunov Ruben - Papyan Karen,2:3,11:9 - 11:6 - 7:11 - 7:11 - 9:11,2,3,Arutyunov Ruben,Papyan Karen,fiurst,Arutyunov Ruben - Papyan Karen,93,45,48,3,-3,20,17,18,18,20,-2,-5,4,4,2,3,11:9 - 11:6 - 7:11 - 7:11 - 9:11
16347755,2024-01-17 11:25:00,Rafayelyan Edgar - Nikoghosyan Narek,0:3,11:9 - 11:4 - 11:2 - 0:0 - 0:0,3,0,Rafayelyan Edgar,Nikoghosyan Narek,fiurst,Nikoghosyan Narek - Rafayelyan Edgar,48,15,33,18,-18,20,15,13,0,0,2,7,9,0,0,18,9:11 - 4:11 - 2:11 - 0:0 - 0:0
16347750,2024-01-17 11:00:00,Nazaryan Mushegh - Arutyunov Ruben,0:3,11:6 - 11:8 - 11:5 - 0:0 - 0:0,3,0,Nazaryan Mushegh,Arutyunov Ruben,fiurst,Arutyunov Ruben - Nazaryan Mushegh,52,19,33,14,-14,17,19,16,0,0,5,3,6,0,0,14,6:11 - 8:11 - 5:11 - 0:0 - 0:0
16347742,2024-01-17 10:45:00,Papyan Karen - Nikoghosyan Narek,1:3,13:11 - 9:11 - 11:8 - 11:7 - 0:0,3,1,Papyan Karen,Nikoghosyan Narek,fiurst,Nikoghosyan Narek - Papyan Karen,81,37,44,7,-7,24,20,19,18,0,2,-2,3,4,0,7,11:13 - 11:9 - 8:11 - 7:11 - 0:0
16347741,2024-01-17 10:35:00,Rafayelyan Edgar - Nazaryan Mushegh,0:3,11:8 - 11:4 - 11:5 - 0:0 - 0:0,3,0,Rafayelyan Edgar,Nazaryan Mushegh,fiurst,Nazaryan Mushegh - Rafayelyan Edgar,50,17,33,16,-16,19,15,16,0,0,3,7,6,0,0,16,8:11 - 4:11 - 5:11 - 0:0 - 0:0
16347738,2024-01-17 10:15:00,Nikoghosyan Narek - Arutyunov Ruben,0:3,11:3 - 15:13 - 11:8 - 0:0 - 0:0,3,0,Nikoghosyan Narek,Arutyunov Ruben,fiurst,Arutyunov Ruben - Nikoghosyan Narek,61,24,37,13,-13,14,28,19,0,0,8,2,3,0,0,13,3:11 - 13:15 - 8:11 - 0:0 - 0:0
16347735,2024-01-17 10:00:00,Papyan Karen - Rafayelyan Edgar,2:3,12:10 - 13:11 - 10:12 - 8:11 - 9:11,2,3,Papyan Karen,Rafayelyan Edgar,fiurst,Papyan Karen - Rafayelyan Edgar,107,52,55,3,-3,22,24,22,19,20,-2,-2,2,3,2,3,12:10 - 13:11 - 10:12 - 8:11 - 9:11
16329939,2024-01-16 17:45:00,Darbinyan Armen - Karakhanyan Mher,0:3,3:11 - 8:11 - 5:11 - 0:0 - 0:0,0,3,Darbinyan Armen,Karakhanyan Mher,fiurst,Darbinyan Armen - Karakhanyan Mher,49,16,33,17,-17,14,19,16,0,0,8,3,6,0,0,17,3:11 - 8:11 - 5:11 - 0:0 - 0:0
16329936,2024-01-16 17:30:00,Babakhanyan Artak - Gevorgyan Gegham,0:3,3:11 - 6:11 - 8:11 - 0:0 - 0:0,0,3,Babakhanyan Artak,Gevorgyan Gegham,fiurst,Babakhanyan Artak - Gevorgyan Gegham,50,17,33,16,-16,14,17,19,0,0,8,5,3,0,0,16,3:11 - 6:11 - 8:11 - 0:0 - 0:0
16329923,2024-01-16 17:15:00,Avakimyan Davit - Darbinyan Armen,3:1,8:11 - 11:3 - 11:7 - 11:6 - 0:0,3,1,Avakimyan Davit,Darbinyan Armen,fiurst,Avakimyan Davit - Darbinyan Armen,68,41,27,-14,14,19,14,18,17,0,3,-8,-4,-5,0,-14,8:11 - 11:3 - 11:7 - 11:6 - 0:0
16329915,2024-01-16 17:00:00,Babakhanyan Artak - Karakhanyan Mher,3:2,11:9 - 7:11 - 11:9 - 9:11 - 11:4,3,2,Babakhanyan Artak,Karakhanyan Mher,fiurst,Babakhanyan Artak - Karakhanyan Mher,93,49,44,-5,5,20,18,20,20,15,-2,4,-2,2,-7,-5,11:9 - 7:11 - 11:9 - 9:11 - 11:4
16329910,2024-01-16 16:45:00,Gevorgyan Gegham - Avakimyan Davit,3:0,7:11 - 10:12 - 8:11 - 0:0 - 0:0,0,3,Gevorgyan Gegham,Avakimyan Davit,fiurst,Avakimyan Davit - Gevorgyan Gegham,59,34,25,-9,9,18,22,19,0,0,-4,-2,-3,0,0,-9,11:7 - 12:10 - 11:8 - 0:0 - 0:0
16329908,2024-01-16 16:30:00,Darbinyan Armen - Babakhanyan Artak,3:0,9:11 - 8:11 - 4:11 - 0:0 - 0:0,0,3,Darbinyan Armen,Babakhanyan Artak,fiurst,Babakhanyan Artak - Darbinyan Armen,54,33,21,-12,12,20,19,15,0,0,-2,-3,-7,0,0,-12,11:9 - 11:8 - 11:4 - 0:0 - 0:0
16329905,2024-01-16 16:15:00,Karakhanyan Mher - Avakimyan Davit,3:0,7:11 - 9:11 - 10:12 - 0:0 - 0:0,0,3,Karakhanyan Mher,Avakimyan Davit,fiurst,Avakimyan Davit - Karakhanyan Mher,60,34,26,-8,8,18,20,22,0,0,-4,-2,-2,0,0,-8,11:7 - 11:9 - 12:10 - 0:0 - 0:0
16329903,2024-01-16 16:00:00,Gevorgyan Gegham - Darbinyan Armen,0:3,11:5 - 11:5 - 11:4 - 0:0 - 0:0,3,0,Gevorgyan Gegham,Darbinyan Armen,fiurst,Darbinyan Armen - Gevorgyan Gegham,47,14,33,19,-19,16,16,15,0,0,6,6,7,0,0,19,5:11 - 5:11 - 4:11 - 0:0 - 0:0
16329898,2024-01-16 15:45:00,Avakimyan Davit - Babakhanyan Artak,3:0,11:7 - 11:9 - 11:6 - 0:0 - 0:0,3,0,Avakimyan Davit,Babakhanyan Artak,fiurst,Avakimyan Davit - Babakhanyan Artak,55,33,22,-11,11,18,20,17,0,0,-4,-2,-5,0,0,-11,11:7 - 11:9 - 11:6 - 0:0 - 0:0
16329896,2024-01-16 15:30:00,Karakhanyan Mher - Gevorgyan Gegham,3:1,9:11 - 7:11 - 11:5 - 2:11 - 0:0,1,3,Karakhanyan Mher,Gevorgyan Gegham,fiurst,Gevorgyan Gegham - Karakhanyan Mher,67,38,29,-9,9,20,18,16,13,0,-2,-4,6,-9,0,-9,11:9 - 11:7 - 5:11 - 11:2 - 0:0
16329894,2024-01-16 15:15:00,Papyan Karen - Arutyunov Ruben,1:3,11:8 - 11:2 - 7:11 - 11:4 - 0:0,3,1,Papyan Karen,Arutyunov Ruben,fiurst,Arutyunov Ruben - Papyan Karen,65,25,40,15,-15,19,13,18,15,0,3,9,-4,7,0,15,8:11 - 2:11 - 11:7 - 4:11 - 0:0
16329893,2024-01-16 15:10:00,Nikoghosyan Narek - Diaryan Aleksandr,0:3,11:9 - 11:2 - 11:8 - 0:0 - 0:0,3,0,Nikoghosyan Narek,Diaryan Aleksandr,fiurst,Diaryan Aleksandr - Nikoghosyan Narek,52,19,33,14,-14,20,13,19,0,0,2,9,3,0,0,14,9:11 - 2:11 - 8:11 - 0:0 - 0:0
16329891,2024-01-16 14:45:00,Nazaryan Mushegh - Papyan Karen,3:1,14:12 - 1:11 - 11:9 - 11:9 - 0:0,3,1,Nazaryan Mushegh,Papyan Karen,fiurst,Nazaryan Mushegh - Papyan Karen,78,37,41,4,-4,26,12,20,20,0,-2,10,-2,-2,0,4,14:12 - 1:11 - 11:9 - 11:9 - 0:0
16329890,2024-01-16 14:40:00,Arutyunov Ruben - Nikoghosyan Narek,3:2,6:11 - 0:11 - 11:9 - 11:9 - 11:5,3,2,Arutyunov Ruben,Nikoghosyan Narek,fiurst,Arutyunov Ruben - Nikoghosyan Narek,84,39,45,6,-6,17,11,20,20,16,5,11,-2,-2,-6,6,6:11 - 0:11 - 11:9 - 11:9 - 11:5
16329888,2024-01-16 14:15:00,Nazaryan Mushegh - Diaryan Aleksandr,3:0,4:11 - 5:11 - 3:11 - 0:0 - 0:0,0,3,Nazaryan Mushegh,Diaryan Aleksandr,fiurst,Diaryan Aleksandr - Nazaryan Mushegh,45,33,12,-21,21,15,16,14,0,0,-7,-6,-8,0,0,-21,11:4 - 11:5 - 11:3 - 0:0 - 0:0
16329876,2024-01-16 14:00:00,Papyan Karen - Nikoghosyan Narek,1:3,11:9 - 8:11 - 11:8 - 11:5 - 0:0,3,1,Papyan Karen,Nikoghosyan Narek,fiurst,Nikoghosyan Narek - Papyan Karen,74,33,41,8,-8,20,19,19,16,0,2,-3,3,6,0,8,9:11 - 11:8 - 8:11 - 5:11 - 0:0
16329872,2024-01-16 13:45:00,Arutyunov Ruben - Nazaryan Mushegh,3:1,9:11 - 11:8 - 11:7 - 11:5 - 0:0,3,1,Arutyunov Ruben,Nazaryan Mushegh,fiurst,Arutyunov Ruben - Nazaryan Mushegh,73,42,31,-11,11,20,19,18,16,0,2,-3,-4,-6,0,-11,9:11 - 11:8 - 11:7 - 11:5 - 0:0
16329870,2024-01-16 13:30:00,Diaryan Aleksandr - Papyan Karen,1:3,9:11 - 6:11 - 11:3 - 6:11 - 0:0,1,3,Diaryan Aleksandr,Papyan Karen,fiurst,Diaryan Aleksandr - Papyan Karen,68,32,36,4,-4,20,17,14,17,0,2,5,-8,5,0,4,9:11 - 6:11 - 11:3 - 6:11 - 0:0
16329868,2024-01-16 13:15:00,Nikoghosyan Narek - Nazaryan Mushegh,0:3,11:9 - 12:10 - 11:7 - 0:0 - 0:0,3,0,Nikoghosyan Narek,Nazaryan Mushegh,fiurst,Nazaryan Mushegh - Nikoghosyan Narek,60,26,34,8,-8,20,22,18,0,0,2,2,4,0,0,8,9:11 - 10:12 - 7:11 - 0:0 - 0:0
16329866,2024-01-16 13:00:00,Diaryan Aleksandr - Arutyunov Ruben,0:3,11:2 - 14:12 - 11:7 - 0:0 - 0:0,3,0,Diaryan Aleksandr,Arutyunov Ruben,fiurst,Arutyunov Ruben - Diaryan Aleksandr,57,21,36,15,-15,13,26,18,0,0,9,2,4,0,0,15,2:11 - 12:14 - 7:11 - 0:0 - 0:0
16329842,2024-01-16 12:15:00,Papyan Karen - Nazaryan Mushegh,1:3,11:13 - 12:10 - 11:2 - 11:7 - 0:0,3,1,Papyan Karen,Nazaryan Mushegh,fiurst,Nazaryan Mushegh - Papyan Karen,77,32,45,13,-13,24,22,13,18,0,-2,2,9,4,0,13,13:11 - 10:12 - 2:11 - 7:11 - 0:0
16329835,2024-01-16 12:05:00,Diaryan Aleksandr - Nikoghosyan Narek,3:0,11:6 - 11:7 - 11:3 - 0:0 - 0:0,3,0,Diaryan Aleksandr,Nikoghosyan Narek,fiurst,Diaryan Aleksandr - Nikoghosyan Narek,49,33,16,-17,17,17,18,14,0,0,-5,-4,-8,0,0,-17,11:6 - 11:7 - 11:3 - 0:0 - 0:0
16329834,2024-01-16 11:45:00,Arutyunov Ruben - Papyan Karen,1:3,15:13 - 7:11 - 7:11 - 3:11 - 0:0,1,3,Arutyunov Ruben,Papyan Karen,fiurst,Arutyunov Ruben - Papyan Karen,78,32,46,14,-14,28,18,18,14,0,-2,4,4,8,0,14,15:13 - 7:11 - 7:11 - 3:11 - 0:0
16329832,2024-01-16 11:35:00,Diaryan Aleksandr - Nazaryan Mushegh,3:1,11:9 - 11:5 - 8:11 - 11:4 - 0:0,3,1,Diaryan Aleksandr,Nazaryan Mushegh,fiurst,Diaryan Aleksandr - Nazaryan Mushegh,70,41,29,-12,12,20,16,19,15,0,-2,-6,3,-7,0,-12,11:9 - 11:5 - 8:11 - 11:4 - 0:0
16329830,2024-01-16 11:15:00,Nikoghosyan Narek - Arutyunov Ruben,0:3,11:5 - 11:9 - 12:10 - 0:0 - 0:0,3,0,Nikoghosyan Narek,Arutyunov Ruben,fiurst,Arutyunov Ruben - Nikoghosyan Narek,58,24,34,10,-10,16,20,22,0,0,6,2,2,0,0,10,5:11 - 9:11 - 10:12 - 0:0 - 0:0
16329827,2024-01-16 11:10:00,Papyan Karen - Diaryan Aleksandr,2:3,11:5 - 9:11 - 7:11 - 11:5 - 11:8,3,2,Papyan Karen,Diaryan Aleksandr,fiurst,Diaryan Aleksandr - Papyan Karen,89,40,49,9,-9,16,20,18,16,19,6,-2,-4,6,3,9,5:11 - 11:9 - 11:7 - 5:11 - 8:11
16329814,2024-01-16 10:45:00,Nazaryan Mushegh - Arutyunov Ruben,3:0,4:11 - 9:11 - 4:11 - 0:0 - 0:0,0,3,Nazaryan Mushegh,Arutyunov Ruben,fiurst,Arutyunov Ruben - Nazaryan Mushegh,50,33,17,-16,16,15,20,15,0,0,-7,-2,-7,0,0,-16,11:4 - 11:9 - 11:4 - 0:0 - 0:0
16329812,2024-01-16 10:30:00,Nikoghosyan Narek - Papyan Karen,2:3,8:11 - 9:11 - 11:8 - 11:4 - 6:11,2,3,Nikoghosyan Narek,Papyan Karen,fiurst,Nikoghosyan Narek - Papyan Karen,90,45,45,0,0,19,20,19,15,17,3,2,-3,-7,5,0,8:11 - 9:11 - 11:8 - 11:4 - 6:11
16329807,2024-01-16 10:15:00,Arutyunov Ruben - Diaryan Aleksandr,0:3,3:11 - 10:12 - 2:11 - 0:0 - 0:0,0,3,Arutyunov Ruben,Diaryan Aleksandr,fiurst,Arutyunov Ruben - Diaryan Aleksandr,49,15,34,19,-19,14,22,13,0,0,8,2,9,0,0,19,3:11 - 10:12 - 2:11 - 0:0 - 0:0
16329806,2024-01-16 10:00:00,Nazaryan Mushegh - Nikoghosyan Narek,1:3,9:11 - 3:11 - 11:4 - 8:11 - 0:0,1,3,Nazaryan Mushegh,Nikoghosyan Narek,fiurst,Nazaryan Mushegh - Nikoghosyan Narek,68,31,37,6,-6,20,14,15,19,0,2,8,-7,3,0,6,9:11 - 3:11 - 11:4 - 8:11 - 0:0
16311497,2024-01-15 17:45:00,Darbinyan Armen - Gevorgyan Gegham,0:3,7:11 - 7:11 - 2:11 - 0:0 - 0:0,0,3,Darbinyan Armen,Gevorgyan Gegham,fiurst,Darbinyan Armen - Gevorgyan Gegham,49,16,33,17,-17,18,18,13,0,0,4,4,9,0,0,17,7:11 - 7:11 - 2:11 - 0:0 - 0:0
16311492,2024-01-15 17:30:00,Karakhanyan Mher - Avakimyan Davit,2:3,9:11 - 12:10 - 11:8 - 7:11 - 11:7,3,2,Karakhanyan Mher,Avakimyan Davit,fiurst,Avakimyan Davit - Karakhanyan Mher,97,47,50,3,-3,20,22,19,18,18,-2,2,3,-4,4,3,11:9 - 10:12 - 8:11 - 11:7 - 7:11
16311439,2024-01-15 17:15:00,Miroyan Hakob - Darbinyan Armen,2:1,9:11 - 11:7 - 6:11 - 0:0 - 0:0,1,2,Miroyan Hakob,Darbinyan Armen,fiurst,Darbinyan Armen - Miroyan Hakob,55,29,26,-3,3,20,18,17,0,0,-2,4,-5,0,0,-3,11:9 - 7:11 - 11:6 - 0:0 - 0:0
16311437,2024-01-15 17:00:00,Karakhanyan Mher - Gevorgyan Gegham,3:2,11:9 - 6:11 - 7:11 - 12:10 - 9:11,2,3,Karakhanyan Mher,Gevorgyan Gegham,fiurst,Gevorgyan Gegham - Karakhanyan Mher,97,52,45,-7,7,20,17,18,22,20,2,-5,-4,2,-2,-7,9:11 - 11:6 - 11:7 - 10:12 - 11:9
16311434,2024-01-15 16:45:00,Avakimyan Davit - Miroyan Hakob,3:1,8:11 - 11:9 - 11:7 - 11:6 - 0:0,3,1,Avakimyan Davit,Miroyan Hakob,fiurst,Avakimyan Davit - Miroyan Hakob,74,41,33,-8,8,19,20,18,17,0,3,-2,-4,-5,0,-8,8:11 - 11:9 - 11:7 - 11:6 - 0:0
16311432,2024-01-15 16:30:00,Darbinyan Armen - Karakhanyan Mher,3:2,11:9 - 7:11 - 11:8 - 6:11 - 11:8,3,2,Darbinyan Armen,Karakhanyan Mher,fiurst,Darbinyan Armen - Karakhanyan Mher,93,46,47,1,-1,20,18,19,17,19,-2,4,-3,5,-3,1,11:9 - 7:11 - 11:8 - 6:11 - 11:8
16311429,2024-01-15 16:15:00,Gevorgyan Gegham - Miroyan Hakob,3:1,11:6 - 7:11 - 11:7 - 11:4 - 0:0,3,1,Gevorgyan Gegham,Miroyan Hakob,fiurst,Gevorgyan Gegham - Miroyan Hakob,68,40,28,-12,12,17,18,18,15,0,-5,4,-4,-7,0,-12,11:6 - 7:11 - 11:7 - 11:4 - 0:0
16311428,2024-01-15 16:00:00,Avakimyan Davit - Darbinyan Armen,3:2,14:16 - 11:13 - 11:1 - 11:7 - 11:9,3,2,Avakimyan Davit,Darbinyan Armen,fiurst,Avakimyan Davit - Darbinyan Armen,104,58,46,-12,12,30,24,12,18,20,2,2,-10,-4,-2,-12,14:16 - 11:13 - 11:1 - 11:7 - 11:9
16311415,2024-01-15 15:45:00,Miroyan Hakob - Karakhanyan Mher,3:1,11:13 - 11:8 - 7:11 - 8:11 - 0:0,1,3,Miroyan Hakob,Karakhanyan Mher,fiurst,Karakhanyan Mher - Miroyan Hakob,80,43,37,-6,6,24,19,18,19,0,-2,3,-4,-3,0,-6,13:11 - 8:11 - 11:7 - 11:8 - 0:0
16311414,2024-01-15 15:30:00,Gevorgyan Gegham - Avakimyan Davit,2:3,8:11 - 11:9 - 8:11 - 12:10 - 15:13,3,2,Gevorgyan Gegham,Avakimyan Davit,fiurst,Avakimyan Davit - Gevorgyan Gegham,108,54,54,0,0,19,20,19,22,28,-3,2,-3,2,2,0,11:8 - 9:11 - 11:8 - 10:12 - 13:15
16311410,2024-01-15 15:15:00,Diaryan Aleksandr - Rafayelyan Edgar,1:3,11:7 - 13:15 - 5:11 - 5:11 - 0:0,1,3,Diaryan Aleksandr,Rafayelyan Edgar,fiurst,Diaryan Aleksandr - Rafayelyan Edgar,78,34,44,10,-10,18,28,16,16,0,-4,2,6,6,0,10,11:7 - 13:15 - 5:11 - 5:11 - 0:0
16311389,2024-01-15 15:05:00,Gevorgyan Hayk - Papyan Karen,3:1,11:8 - 9:11 - 11:6 - 11:8 - 0:0,3,1,Gevorgyan Hayk,Papyan Karen,fiurst,Gevorgyan Hayk - Papyan Karen,75,42,33,-9,9,19,20,17,19,0,-3,2,-5,-3,0,-9,11:8 - 9:11 - 11:6 - 11:8 - 0:0
16311382,2024-01-15 14:45:00,Arutyunov Ruben - Diaryan Aleksandr,0:3,7:11 - 5:11 - 7:11 - 0:0 - 0:0,0,3,Arutyunov Ruben,Diaryan Aleksandr,fiurst,Arutyunov Ruben - Diaryan Aleksandr,52,19,33,14,-14,18,16,18,0,0,4,6,4,0,0,14,7:11 - 5:11 - 7:11 - 0:0 - 0:0
16311362,2024-01-15 14:30:00,Rafayelyan Edgar - Gevorgyan Hayk,1:3,6:11 - 11:4 - 11:9 - 12:10 - 0:0,3,1,Rafayelyan Edgar,Gevorgyan Hayk,fiurst,Gevorgyan Hayk - Rafayelyan Edgar,74,34,40,6,-6,17,15,20,22,0,-5,7,2,2,0,6,11:6 - 4:11 - 9:11 - 10:12 - 0:0
16311358,2024-01-15 14:15:00,Arutyunov Ruben - Papyan Karen,0:3,5:11 - 6:11 - 6:11 - 0:0 - 0:0,0,3,Arutyunov Ruben,Papyan Karen,fiurst,Arutyunov Ruben - Papyan Karen,50,17,33,16,-16,16,17,17,0,0,6,5,5,0,0,16,5:11 - 6:11 - 6:11 - 0:0 - 0:0
16311355,2024-01-15 14:00:00,Diaryan Aleksandr - Gevorgyan Hayk,3:1,11:4 - 11:8 - 8:11 - 11:4 - 0:0,3,1,Diaryan Aleksandr,Gevorgyan Hayk,fiurst,Diaryan Aleksandr - Gevorgyan Hayk,68,41,27,-14,14,15,19,19,15,0,-7,-3,3,-7,0,-14,11:4 - 11:8 - 8:11 - 11:4 - 0:0
16311352,2024-01-15 13:45:00,Rafayelyan Edgar - Arutyunov Ruben,1:3,6:11 - 11:7 - 11:7 - 11:4 - 0:0,3,1,Rafayelyan Edgar,Arutyunov Ruben,fiurst,Arutyunov Ruben - Rafayelyan Edgar,68,29,39,10,-10,17,18,18,15,0,-5,4,4,7,0,10,11:6 - 7:11 - 7:11 - 4:11 - 0:0
16311350,2024-01-15 13:30:00,Papyan Karen - Diaryan Aleksandr,3:1,11:9 - 10:12 - 4:11 - 2:11 - 0:0,1,3,Papyan Karen,Diaryan Aleksandr,fiurst,Diaryan Aleksandr - Papyan Karen,70,43,27,-16,16,20,22,15,13,0,2,-2,-7,-9,0,-16,9:11 - 12:10 - 11:4 - 11:2 - 0:0
16311347,2024-01-15 13:15:00,Gevorgyan Hayk - Arutyunov Ruben,3:1,11:7 - 8:11 - 9:11 - 9:11 - 0:0,1,3,Gevorgyan Hayk,Arutyunov Ruben,fiurst,Arutyunov Ruben - Gevorgyan Hayk,77,40,37,-3,3,18,19,20,20,0,4,-3,-2,-2,0,-3,7:11 - 11:8 - 11:9 - 11:9 - 0:0
16311345,2024-01-15 13:00:00,Papyan Karen - Rafayelyan Edgar,3:1,11:5 - 11:4 - 5:11 - 11:7 - 0:0,3,1,Papyan Karen,Rafayelyan Edgar,fiurst,Papyan Karen - Rafayelyan Edgar,65,38,27,-11,11,16,15,16,18,0,-6,-7,6,-4,0,-11,11:5 - 11:4 - 5:11 - 11:7 - 0:0
16311334,2024-01-15 12:15:00,Diaryan Aleksandr - Arutyunov Ruben,0:3,11:6 - 11:2 - 11:4 - 0:0 - 0:0,3,0,Diaryan Aleksandr,Arutyunov Ruben,fiurst,Arutyunov Ruben - Diaryan Aleksandr,45,12,33,21,-21,17,13,15,0,0,5,9,7,0,0,21,6:11 - 2:11 - 4:11 - 0:0 - 0:0
16311332,2024-01-15 12:05:00,Papyan Karen - Gevorgyan Hayk,3:2,7:11 - 11:3 - 11:6 - 5:11 - 5:11,2,3,Papyan Karen,Gevorgyan Hayk,fiurst,Gevorgyan Hayk - Papyan Karen,81,42,39,-3,3,18,14,17,16,16,-4,8,5,-6,-6,-3,11:7 - 3:11 - 6:11 - 11:5 - 11:5
16311329,2024-01-15 11:45:00,Rafayelyan Edgar - Diaryan Aleksandr,3:0,8:11 - 9:11 - 7:11 - 0:0 - 0:0,0,3,Rafayelyan Edgar,Diaryan Aleksandr,fiurst,Diaryan Aleksandr - Rafayelyan Edgar,57,33,24,-9,9,19,20,18,0,0,-3,-2,-4,0,0,-9,11:8 - 11:9 - 11:7 - 0:0 - 0:0
16311313,2024-01-15 11:30:00,Papyan Karen - Arutyunov Ruben,3:2,9:11 - 14:12 - 7:11 - 11:2 - 10:12,2,3,Papyan Karen,Arutyunov Ruben,fiurst,Arutyunov Ruben - Papyan Karen,99,48,51,3,-3,20,26,18,13,22,-2,2,-4,9,-2,3,11:9 - 12:14 - 11:7 - 2:11 - 12:10
16311312,2024-01-15 11:15:00,Gevorgyan Hayk - Rafayelyan Edgar,0:3,8:11 - 4:11 - 6:11 - 0:0 - 0:0,0,3,Gevorgyan Hayk,Rafayelyan Edgar,fiurst,Gevorgyan Hayk - Rafayelyan Edgar,51,18,33,15,-15,19,15,17,0,0,3,7,5,0,0,15,8:11 - 4:11 - 6:11 - 0:0 - 0:0
16311298,2024-01-15 11:00:00,Diaryan Aleksandr - Papyan Karen,3:1,10:12 - 11:6 - 11:5 - 11:5 - 0:0,3,1,Diaryan Aleksandr,Papyan Karen,fiurst,Diaryan Aleksandr - Papyan Karen,71,43,28,-15,15,22,17,16,16,0,2,-5,-6,-6,0,-15,10:12 - 11:6 - 11:5 - 11:5 - 0:0
16311294,2024-01-15 10:45:00,Arutyunov Ruben - Rafayelyan Edgar,0:3,6:11 - 12:14 - 8:11 - 0:0 - 0:0,0,3,Arutyunov Ruben,Rafayelyan Edgar,fiurst,Arutyunov Ruben - Rafayelyan Edgar,62,26,36,10,-10,17,26,19,0,0,5,2,3,0,0,10,6:11 - 12:14 - 8:11 - 0:0 - 0:0
16311291,2024-01-15 10:30:00,Gevorgyan Hayk - Diaryan Aleksandr,3:0,7:11 - 3:11 - 4:11 - 0:0 - 0:0,0,3,Gevorgyan Hayk,Diaryan Aleksandr,fiurst,Diaryan Aleksandr - Gevorgyan Hayk,47,33,14,-19,19,18,14,15,0,0,-4,-8,-7,0,0,-19,11:7 - 11:3 - 11:4 - 0:0 - 0:0
16311289,2024-01-15 10:15:00,Rafayelyan Edgar - Papyan Karen,1:3,12:14 - 11:8 - 11:3 - 11:5 - 0:0,3,1,Rafayelyan Edgar,Papyan Karen,fiurst,Papyan Karen - Rafayelyan Edgar,75,30,45,15,-15,26,19,14,16,0,-2,3,8,6,0,15,14:12 - 8:11 - 3:11 - 5:11 - 0:0
16311287,2024-01-15 10:00:00,Arutyunov Ruben - Gevorgyan Hayk,3:1,11:5 - 11:7 - 7:11 - 11:4 - 0:0,3,1,Arutyunov Ruben,Gevorgyan Hayk,fiurst,Arutyunov Ruben - Gevorgyan Hayk,67,40,27,-13,13,16,18,18,15,0,-6,-4,4,-7,0,-13,11:5 - 11:7 - 7:11 - 11:4 - 0:0
16292746,2024-01-14 17:45:00,Karakhanyan Mher - Miroyan Hakob,0:3,4:11 - 7:11 - 7:11 - 0:0 - 0:0,0,3,Karakhanyan Mher,Miroyan Hakob,fiurst,Karakhanyan Mher - Miroyan Hakob,51,18,33,15,-15,15,18,18,0,0,7,4,4,0,0,15,4:11 - 7:11 - 7:11 - 0:0 - 0:0
16292731,2024-01-14 17:35:00,Gevorgyan Gegham - Darbinyan Armen,0:3,11:7 - 11:1 - 11:5 - 0:0 - 0:0,3,0,Gevorgyan Gegham,Darbinyan Armen,fiurst,Darbinyan Armen - Gevorgyan Gegham,46,13,33,20,-20,18,12,16,0,0,4,10,6,0,0,20,7:11 - 1:11 - 5:11 - 0:0 - 0:0
16292726,2024-01-14 17:15:00,Avakimyan Davit - Karakhanyan Mher,3:0,11:8 - 11:7 - 11:8 - 0:0 - 0:0,3,0,Avakimyan Davit,Karakhanyan Mher,fiurst,Avakimyan Davit - Karakhanyan Mher,56,33,23,-10,10,19,18,19,0,0,-3,-4,-3,0,0,-10,11:8 - 11:7 - 11:8 - 0:0 - 0:0
16292721,2024-01-14 17:00:00,Gevorgyan Gegham - Miroyan Hakob,1:3,10:12 - 11:5 - 8:11 - 11:13 - 0:0,1,3,Gevorgyan Gegham,Miroyan Hakob,fiurst,Gevorgyan Gegham - Miroyan Hakob,81,40,41,1,-1,22,16,19,24,0,2,-6,3,2,0,1,10:12 - 11:5 - 8:11 - 11:13 - 0:0
16292719,2024-01-14 16:45:00,Darbinyan Armen - Avakimyan Davit,3:0,4:11 - 3:11 - 5:11 - 0:0 - 0:0,0,3,Darbinyan Armen,Avakimyan Davit,fiurst,Avakimyan Davit - Darbinyan Armen,45,33,12,-21,21,15,14,16,0,0,-7,-8,-6,0,0,-21,11:4 - 11:3 - 11:5 - 0:0 - 0:0
16292714,2024-01-14 16:30:00,Karakhanyan Mher - Gevorgyan Gegham,3:0,7:11 - 7:11 - 7:11 - 0:0 - 0:0,0,3,Karakhanyan Mher,Gevorgyan Gegham,fiurst,Gevorgyan Gegham - Karakhanyan Mher,54,33,21,-12,12,18,18,18,0,0,-4,-4,-4,0,0,-12,11:7 - 11:7 - 11:7 - 0:0 - 0:0
16292712,2024-01-14 16:15:00,Miroyan Hakob - Avakimyan Davit,3:0,10:12 - 2:11 - 9:11 - 0:0 - 0:0,0,3,Miroyan Hakob,Avakimyan Davit,fiurst,Avakimyan Davit - Miroyan Hakob,55,34,21,-13,13,22,13,20,0,0,-2,-9,-2,0,0,-13,12:10 - 11:2 - 11:9 - 0:0 - 0:0
16292711,2024-01-14 16:00:00,Darbinyan Armen - Karakhanyan Mher,1:3,11:8 - 8:11 - 5:11 - 9:11 - 0:0,1,3,Darbinyan Armen,Karakhanyan Mher,fiurst,Darbinyan Armen - Karakhanyan Mher,74,33,41,8,-8,19,19,16,20,0,-3,3,6,2,0,8,11:8 - 8:11 - 5:11 - 9:11 - 0:0
16292710,2024-01-14 15:45:00,Avakimyan Davit - Gevorgyan Gegham,3:2,11:5 - 11:1 - 9:11 - 10:12 - 13:11,3,2,Avakimyan Davit,Gevorgyan Gegham,fiurst,Avakimyan Davit - Gevorgyan Gegham,94,54,40,-14,14,16,12,20,22,24,-6,-10,2,2,-2,-14,11:5 - 11:1 - 9:11 - 10:12 - 13:11
16292696,2024-01-14 15:30:00,Miroyan Hakob - Darbinyan Armen,0:3,11:8 - 14:12 - 11:4 - 0:0 - 0:0,3,0,Miroyan Hakob,Darbinyan Armen,fiurst,Darbinyan Armen - Miroyan Hakob,60,24,36,12,-12,19,26,15,0,0,3,2,7,0,0,12,8:11 - 12:14 - 4:11 - 0:0 - 0:0
16292693,2024-01-14 15:25:00,Papyan Karen - Gevorgyan Hayk,1:3,11:7 - 11:7 - 11:13 - 11:6 - 0:0,3,1,Papyan Karen,Gevorgyan Hayk,fiurst,Gevorgyan Hayk - Papyan Karen,77,33,44,11,-11,18,18,24,17,0,4,4,-2,5,0,11,7:11 - 7:11 - 13:11 - 6:11 - 0:0
16292681,2024-01-14 15:00:00,Diaryan Aleksandr - Papyan Karen,3:1,11:7 - 8:11 - 11:4 - 11:9 - 0:0,3,1,Diaryan Aleksandr,Papyan Karen,fiurst,Diaryan Aleksandr - Papyan Karen,72,41,31,-10,10,18,19,15,20,0,-4,3,-7,-2,0,-10,11:7 - 8:11 - 11:4 - 11:9 - 0:0
16292687,2024-01-14 15:00:00,Rafayelyan Edgar - Nikoghosyan Narek,3:1,8:11 - 11:9 - 10:12 - 8:11 - 0:0,1,3,Rafayelyan Edgar,Nikoghosyan Narek,fiurst,Nikoghosyan Narek - Rafayelyan Edgar,80,43,37,-6,6,19,20,22,19,0,-3,2,-2,-3,0,-6,11:8 - 9:11 - 12:10 - 11:8 - 0:0
16292676,2024-01-14 14:45:00,Gevorgyan Hayk - Rafayelyan Edgar,0:3,8:11 - 4:11 - 6:11 - 0:0 - 0:0,0,3,Gevorgyan Hayk,Rafayelyan Edgar,fiurst,Gevorgyan Hayk - Rafayelyan Edgar,51,18,33,15,-15,19,15,17,0,0,3,7,5,0,0,15,8:11 - 4:11 - 6:11 - 0:0 - 0:0
16292670,2024-01-14 14:30:00,Diaryan Aleksandr - Nikoghosyan Narek,3:0,11:8 - 11:5 - 12:10 - 0:0 - 0:0,3,0,Diaryan Aleksandr,Nikoghosyan Narek,fiurst,Diaryan Aleksandr - Nikoghosyan Narek,57,34,23,-11,11,19,16,22,0,0,-3,-6,-2,0,0,-11,11:8 - 11:5 - 12:10 - 0:0 - 0:0
16292666,2024-01-14 14:15:00,Papyan Karen - Rafayelyan Edgar,1:3,11:9 - 9:11 - 3:11 - 8:11 - 0:0,1,3,Papyan Karen,Rafayelyan Edgar,fiurst,Papyan Karen - Rafayelyan Edgar,73,31,42,11,-11,20,20,14,19,0,-2,2,8,3,0,11,11:9 - 9:11 - 3:11 - 8:11 - 0:0
16292664,2024-01-14 13:45:00,Gevorgyan Hayk - Diaryan Aleksandr,3:2,11:9 - 5:11 - 22:20 - 4:11 - 5:11,2,3,Gevorgyan Hayk,Diaryan Aleksandr,fiurst,Diaryan Aleksandr - Gevorgyan Hayk,109,62,47,-15,15,20,16,42,15,16,2,-6,2,-7,-6,-15,9:11 - 11:5 - 20:22 - 11:4 - 11:5
16292662,2024-01-14 13:35:00,Nikoghosyan Narek - Papyan Karen,3:1,11:8 - 11:8 - 10:12 - 11:5 - 0:0,3,1,Nikoghosyan Narek,Papyan Karen,fiurst,Nikoghosyan Narek - Papyan Karen,76,43,33,-10,10,19,19,22,16,0,-3,-3,2,-6,0,-10,11:8 - 11:8 - 10:12 - 11:5 - 0:0
16292657,2024-01-14 13:15:00,Rafayelyan Edgar - Diaryan Aleksandr,2:3,4:11 - 8:11 - 11:7 - 11:7 - 11:4,3,2,Rafayelyan Edgar,Diaryan Aleksandr,fiurst,Diaryan Aleksandr - Rafayelyan Edgar,85,40,45,5,-5,15,19,18,18,15,-7,-3,4,4,7,5,11:4 - 11:8 - 7:11 - 7:11 - 4:11
16292653,2024-01-14 13:00:00,Nikoghosyan Narek - Gevorgyan Hayk,0:3,11:5 - 13:11 - 13:11 - 0:0 - 0:0,3,0,Nikoghosyan Narek,Gevorgyan Hayk,fiurst,Gevorgyan Hayk - Nikoghosyan Narek,64,27,37,10,-10,16,24,24,0,0,6,2,2,0,0,10,5:11 - 11:13 - 11:13 - 0:0 - 0:0
16292632,2024-01-14 12:20:00,Papyan Karen - Diaryan Aleksandr,3:1,11:6 - 5:11 - 1:11 - 4:11 - 0:0,1,3,Papyan Karen,Diaryan Aleksandr,fiurst,Diaryan Aleksandr - Papyan Karen,60,39,21,-18,18,17,16,12,15,0,5,-6,-10,-7,0,-18,6:11 - 11:5 - 11:1 - 11:4 - 0:0
16292628,2024-01-14 12:10:00,Nikoghosyan Narek - Rafayelyan Edgar,2:3,13:11 - 8:11 - 3:11 - 11:9 - 7:11,2,3,Nikoghosyan Narek,Rafayelyan Edgar,fiurst,Nikoghosyan Narek - Rafayelyan Edgar,95,42,53,11,-11,24,19,14,20,18,-2,3,8,-2,4,11,13:11 - 8:11 - 3:11 - 11:9 - 7:11
16292620,2024-01-14 11:45:00,Gevorgyan Hayk - Papyan Karen,2:3,11:7 - 11:2 - 9:11 - 8:11 - 5:11,2,3,Gevorgyan Hayk,Papyan Karen,fiurst,Gevorgyan Hayk - Papyan Karen,86,44,42,-2,2,18,13,20,19,16,-4,-9,2,3,6,-2,11:7 - 11:2 - 9:11 - 8:11 - 5:11
16292594,2024-01-14 11:40:00,Nikoghosyan Narek - Diaryan Aleksandr,1:3,7:11 - 11:6 - 11:6 - 11:3 - 0:0,3,1,Nikoghosyan Narek,Diaryan Aleksandr,fiurst,Diaryan Aleksandr - Nikoghosyan Narek,66,26,40,14,-14,18,17,17,14,0,-4,5,5,8,0,14,11:7 - 6:11 - 6:11 - 3:11 - 0:0
16292588,2024-01-14 11:15:00,Rafayelyan Edgar - Gevorgyan Hayk,0:3,11:4 - 11:4 - 11:8 - 0:0 - 0:0,3,0,Rafayelyan Edgar,Gevorgyan Hayk,fiurst,Gevorgyan Hayk - Rafayelyan Edgar,49,16,33,17,-17,15,15,19,0,0,7,7,3,0,0,17,4:11 - 4:11 - 8:11 - 0:0 - 0:0
16292585,2024-01-14 11:00:00,Papyan Karen - Nikoghosyan Narek,1:3,11:5 - 9:11 - 15:13 - 11:6 - 0:0,3,1,Papyan Karen,Nikoghosyan Narek,fiurst,Nikoghosyan Narek - Papyan Karen,81,35,46,11,-11,16,20,28,17,0,6,-2,2,5,0,11,5:11 - 11:9 - 13:15 - 6:11 - 0:0
16292575,2024-01-14 10:45:00,Diaryan Aleksandr - Gevorgyan Hayk,3:0,12:10 - 11:8 - 11:6 - 0:0 - 0:0,3,0,Diaryan Aleksandr,Gevorgyan Hayk,fiurst,Diaryan Aleksandr - Gevorgyan Hayk,58,34,24,-10,10,22,19,17,0,0,-2,-3,-5,0,0,-10,12:10 - 11:8 - 11:6 - 0:0 - 0:0
16292566,2024-01-14 10:35:00,Rafayelyan Edgar - Papyan Karen,1:3,9:11 - 11:8 - 11:4 - 11:7 - 0:0,3,1,Rafayelyan Edgar,Papyan Karen,fiurst,Papyan Karen - Rafayelyan Edgar,72,30,42,12,-12,20,19,15,18,0,-2,3,7,4,0,12,11:9 - 8:11 - 4:11 - 7:11 - 0:0
16292560,2024-01-14 10:15:00,Gevorgyan Hayk - Nikoghosyan Narek,0:3,6:11 - 3:11 - 5:11 - 0:0 - 0:0,0,3,Gevorgyan Hayk,Nikoghosyan Narek,fiurst,Gevorgyan Hayk - Nikoghosyan Narek,47,14,33,19,-19,17,14,16,0,0,5,8,6,0,0,19,6:11 - 3:11 - 5:11 - 0:0 - 0:0
16292540,2024-01-14 10:00:00,Diaryan Aleksandr - Rafayelyan Edgar,2:3,5:11 - 8:11 - 11:9 - 12:10 - 9:11,2,3,Diaryan Aleksandr,Rafayelyan Edgar,fiurst,Diaryan Aleksandr - Rafayelyan Edgar,97,45,52,7,-7,16,19,20,22,20,6,3,-2,-2,2,7,5:11 - 8:11 - 11:9 - 12:10 - 9:11
16285742,2024-01-13 17:45:00,Miroyan Hakob - Gevorgyan Hayk,3:0,8:11 - 3:11 - 3:11 - 0:0 - 0:0,0,3,Miroyan Hakob,Gevorgyan Hayk,fiurst,Gevorgyan Hayk - Miroyan Hakob,47,33,14,-19,19,19,14,14,0,0,-3,-8,-8,0,0,-19,11:8 - 11:3 - 11:3 - 0:0 - 0:0
16285739,2024-01-13 17:30:00,Karakhanyan Mher - Darbinyan Armen,1:3,12:10 - 14:12 - 8:11 - 11:3 - 0:0,3,1,Karakhanyan Mher,Darbinyan Armen,fiurst,Darbinyan Armen - Karakhanyan Mher,81,36,45,9,-9,22,26,19,14,0,2,2,-3,8,0,9,10:12 - 12:14 - 11:8 - 3:11 - 0:0
16285737,2024-01-13 17:15:00,Gevorgyan Gegham - Miroyan Hakob,3:0,11:3 - 13:11 - 11:3 - 0:0 - 0:0,3,0,Gevorgyan Gegham,Miroyan Hakob,fiurst,Gevorgyan Gegham - Miroyan Hakob,52,35,17,-18,18,14,24,14,0,0,-8,-2,-8,0,0,-18,11:3 - 13:11 - 11:3 - 0:0 - 0:0
16285734,2024-01-13 17:00:00,Karakhanyan Mher - Gevorgyan Hayk,3:1,11:7 - 5:11 - 7:11 - 6:11 - 0:0,1,3,Karakhanyan Mher,Gevorgyan Hayk,fiurst,Gevorgyan Hayk - Karakhanyan Mher,69,40,29,-11,11,18,16,18,17,0,4,-6,-4,-5,0,-11,7:11 - 11:5 - 11:7 - 11:6 - 0:0
16285731,2024-01-13 16:50:00,Darbinyan Armen - Gevorgyan Gegham,0:3,1:11 - 6:11 - 8:11 - 0:0 - 0:0,0,3,Darbinyan Armen,Gevorgyan Gegham,fiurst,Darbinyan Armen - Gevorgyan Gegham,48,15,33,18,-18,12,17,19,0,0,10,5,3,0,0,18,1:11 - 6:11 - 8:11 - 0:0 - 0:0
16285729,2024-01-13 16:40:00,Miroyan Hakob - Karakhanyan Mher,3:1,11:7 - 8:11 - 4:11 - 5:11 - 0:0,1,3,Miroyan Hakob,Karakhanyan Mher,fiurst,Karakhanyan Mher - Miroyan Hakob,68,40,28,-12,12,18,19,15,16,0,4,-3,-7,-6,0,-12,7:11 - 11:8 - 11:4 - 11:5 - 0:0
16285710,2024-01-13 16:25:00,Gevorgyan Hayk - Gevorgyan Gegham,1:3,7:11 - 11:6 - 11:8 - 11:6 - 0:0,3,1,Gevorgyan Hayk,Gevorgyan Gegham,fiurst,Gevorgyan Gegham - Gevorgyan Hayk,71,31,40,9,-9,18,17,19,17,0,-4,5,3,5,0,9,11:7 - 6:11 - 8:11 - 6:11 - 0:0
16285709,2024-01-13 16:05:00,Darbinyan Armen - Miroyan Hakob,3:2,11:13 - 11:9 - 6:11 - 11:3 - 11:5,3,2,Darbinyan Armen,Miroyan Hakob,fiurst,Darbinyan Armen - Miroyan Hakob,91,50,41,-9,9,24,20,17,14,16,2,-2,5,-8,-6,-9,11:13 - 11:9 - 6:11 - 11:3 - 11:5
16285700,2024-01-13 15:50:00,Gevorgyan Gegham - Karakhanyan Mher,3:0,11:6 - 11:8 - 14:12 - 0:0 - 0:0,3,0,Gevorgyan Gegham,Karakhanyan Mher,fiurst,Gevorgyan Gegham - Karakhanyan Mher,62,36,26,-10,10,17,19,26,0,0,-5,-3,-2,0,0,-10,11:6 - 11:8 - 14:12 - 0:0 - 0:0
16285685,2024-01-13 15:30:00,Gevorgyan Hayk - Darbinyan Armen,0:3,11:3 - 11:5 - 11:8 - 0:0 - 0:0,3,0,Gevorgyan Hayk,Darbinyan Armen,fiurst,Darbinyan Armen - Gevorgyan Hayk,49,16,33,17,-17,14,16,19,0,0,8,6,3,0,0,17,3:11 - 5:11 - 8:11 - 0:0 - 0:0
16285683,2024-01-13 15:25:00,Miroyan Hakob - Gevorgyan Gegham,2:3,9:11 - 11:5 - 12:10 - 4:11 - 11:7,3,2,Miroyan Hakob,Gevorgyan Gegham,fiurst,Gevorgyan Gegham - Miroyan Hakob,91,44,47,3,-3,20,16,22,15,18,-2,6,2,-7,4,3,11:9 - 5:11 - 10:12 - 11:4 - 7:11
16285662,2024-01-13 15:00:00,Papyan Karen - Diaryan Aleksandr,3:0,5:11 - 6:11 - 9:11 - 0:0 - 0:0,0,3,Papyan Karen,Diaryan Aleksandr,fiurst,Diaryan Aleksandr - Papyan Karen,53,33,20,-13,13,16,17,20,0,0,-6,-5,-2,0,0,-13,11:5 - 11:6 - 11:9 - 0:0 - 0:0
16285655,2024-01-13 14:55:00,Nikoghosyan Narek - Rafayelyan Edgar,2:3,11:3 - 6:11 - 7:11 - 11:8 - 5:11,2,3,Nikoghosyan Narek,Rafayelyan Edgar,fiurst,Nikoghosyan Narek - Rafayelyan Edgar,84,40,44,4,-4,14,17,18,19,16,-8,5,4,-3,6,4,11:3 - 6:11 - 7:11 - 11:8 - 5:11
16285642,2024-01-13 14:15:00,Nikoghosyan Narek - Diaryan Aleksandr,2:3,11:6 - 10:12 - 12:10 - 7:11 - 11:4,3,2,Nikoghosyan Narek,Diaryan Aleksandr,fiurst,Diaryan Aleksandr - Nikoghosyan Narek,94,43,51,8,-8,17,22,22,18,15,5,-2,2,-4,7,8,6:11 - 12:10 - 10:12 - 11:7 - 4:11
16285639,2024-01-13 14:00:00,Rafayelyan Edgar - Papyan Karen,0:3,11:6 - 11:2 - 11:6 - 0:0 - 0:0,3,0,Rafayelyan Edgar,Papyan Karen,fiurst,Papyan Karen - Rafayelyan Edgar,47,14,33,19,-19,17,13,17,0,0,5,9,5,0,0,19,6:11 - 2:11 - 6:11 - 0:0 - 0:0
16285608,2024-01-13 13:30:00,Diaryan Aleksandr - Rafayelyan Edgar,3:0,11:8 - 11:6 - 11:6 - 0:0 - 0:0,3,0,Diaryan Aleksandr,Rafayelyan Edgar,fiurst,Diaryan Aleksandr - Rafayelyan Edgar,53,33,20,-13,13,19,17,17,0,0,-3,-5,-5,0,0,-13,11:8 - 11:6 - 11:6 - 0:0 - 0:0
16285580,2024-01-13 13:15:00,Papyan Karen - Nikoghosyan Narek,3:2,6:11 - 11:5 - 13:11 - 9:11 - 2:11,2,3,Papyan Karen,Nikoghosyan Narek,fiurst,Nikoghosyan Narek - Papyan Karen,90,49,41,-8,8,17,16,24,20,13,-5,6,2,-2,-9,-8,11:6 - 5:11 - 11:13 - 11:9 - 11:2
16285579,2024-01-13 13:00:00,Diaryan Aleksandr - Arutyunov Ruben,0:3,11:5 - 11:9 - 11:4 - 0:0 - 0:0,3,0,Diaryan Aleksandr,Arutyunov Ruben,fiurst,Arutyunov Ruben - Diaryan Aleksandr,51,18,33,15,-15,16,20,15,0,0,6,2,7,0,0,15,5:11 - 9:11 - 4:11 - 0:0 - 0:0
16285574,2024-01-13 12:20:00,Diaryan Aleksandr - Papyan Karen,3:0,11:6 - 11:8 - 11:9 - 0:0 - 0:0,3,0,Diaryan Aleksandr,Papyan Karen,fiurst,Diaryan Aleksandr - Papyan Karen,56,33,23,-10,10,17,19,20,0,0,-5,-3,-2,0,0,-10,11:6 - 11:8 - 11:9 - 0:0 - 0:0
16285576,2024-01-13 12:20:00,Rafayelyan Edgar - Nikoghosyan Narek,1:3,11:9 - 11:7 - 8:11 - 11:2 - 0:0,3,1,Rafayelyan Edgar,Nikoghosyan Narek,fiurst,Nikoghosyan Narek - Rafayelyan Edgar,70,29,41,12,-12,20,18,19,13,0,2,4,-3,9,0,12,9:11 - 7:11 - 11:8 - 2:11 - 0:0
16285559,2024-01-13 11:45:00,Arutyunov Ruben - Rafayelyan Edgar,0:3,14:16 - 11:13 - 5:11 - 0:0 - 0:0,0,3,Arutyunov Ruben,Rafayelyan Edgar,fiurst,Arutyunov Ruben - Rafayelyan Edgar,70,30,40,10,-10,30,24,16,0,0,2,2,6,0,0,10,14:16 - 11:13 - 5:11 - 0:0 - 0:0
16285556,2024-01-13 11:30:00,Diaryan Aleksandr - Nikoghosyan Narek,2:3,13:15 - 6:11 - 11:3 - 11:5 - 13:15,2,3,Diaryan Aleksandr,Nikoghosyan Narek,fiurst,Diaryan Aleksandr - Nikoghosyan Narek,103,54,49,-5,5,28,17,14,16,28,2,5,-8,-6,2,-5,13:15 - 6:11 - 11:3 - 11:5 - 13:15
16285552,2024-01-13 11:20:00,Papyan Karen - Arutyunov Ruben,0:3,11:6 - 11:6 - 11:8 - 0:0 - 0:0,3,0,Papyan Karen,Arutyunov Ruben,fiurst,Arutyunov Ruben - Papyan Karen,53,20,33,13,-13,17,17,19,0,0,5,5,3,0,0,13,6:11 - 6:11 - 8:11 - 0:0 - 0:0
16285549,2024-01-13 11:00:00,Rafayelyan Edgar - Diaryan Aleksandr,2:3,4:11 - 6:11 - 13:11 - 11:7 - 11:5,3,2,Rafayelyan Edgar,Diaryan Aleksandr,fiurst,Diaryan Aleksandr - Rafayelyan Edgar,90,45,45,0,0,15,17,24,18,16,-7,-5,2,4,6,0,11:4 - 11:6 - 11:13 - 7:11 - 5:11
16285546,2024-01-13 10:45:00,Nikoghosyan Narek - Arutyunov Ruben,1:3,11:13 - 11:5 - 11:7 - 11:9 - 0:0,3,1,Nikoghosyan Narek,Arutyunov Ruben,fiurst,Arutyunov Ruben - Nikoghosyan Narek,78,34,44,10,-10,24,16,18,20,0,-2,6,4,2,0,10,13:11 - 5:11 - 7:11 - 9:11 - 0:0
16285545,2024-01-13 10:30:00,Papyan Karen - Rafayelyan Edgar,0:3,3:11 - 7:11 - 6:11 - 0:0 - 0:0,0,3,Papyan Karen,Rafayelyan Edgar,fiurst,Papyan Karen - Rafayelyan Edgar,49,16,33,17,-17,14,18,17,0,0,8,4,5,0,0,17,3:11 - 7:11 - 6:11 - 0:0 - 0:0
16285544,2024-01-13 10:15:00,Arutyunov Ruben - Diaryan Aleksandr,1:3,3:11 - 4:11 - 13:11 - 3:11 - 0:0,1,3,Arutyunov Ruben,Diaryan Aleksandr,fiurst,Arutyunov Ruben - Diaryan Aleksandr,67,23,44,21,-21,14,15,24,14,0,8,7,-2,8,0,21,3:11 - 4:11 - 13:11 - 3:11 - 0:0
16285532,2024-01-13 10:00:00,Nikoghosyan Narek - Papyan Karen,1:3,3:11 - 11:9 - 7:11 - 3:11 - 0:0,1,3,Nikoghosyan Narek,Papyan Karen,fiurst,Nikoghosyan Narek - Papyan Karen,66,24,42,18,-18,14,20,18,14,0,8,-2,4,8,0,18,3:11 - 11:9 - 7:11 - 3:11 - 0:0
16255020,2024-01-12 17:45:00,Miroyan Hakob - Gevorgyan Gegham,1:3,10:12 - 13:11 - 11:4 - 11:9 - 0:0,3,1,Miroyan Hakob,Gevorgyan Gegham,fiurst,Gevorgyan Gegham - Miroyan Hakob,81,36,45,9,-9,22,24,15,20,0,-2,2,7,2,0,9,12:10 - 11:13 - 4:11 - 9:11 - 0:0
16255017,2024-01-12 17:30:00,Gevorgyan Hayk - Avakimyan Davit,0:3,11:4 - 11:5 - 11:6 - 0:0 - 0:0,3,0,Gevorgyan Hayk,Avakimyan Davit,fiurst,Avakimyan Davit - Gevorgyan Hayk,48,15,33,18,-18,15,16,17,0,0,7,6,5,0,0,18,4:11 - 5:11 - 6:11 - 0:0 - 0:0
16254991,2024-01-12 17:15:00,Karakhanyan Mher - Miroyan Hakob,2:3,10:12 - 11:9 - 7:11 - 11:8 - 11:13,2,3,Karakhanyan Mher,Miroyan Hakob,fiurst,Karakhanyan Mher - Miroyan Hakob,103,50,53,3,-3,22,20,18,19,24,2,-2,4,-3,2,3,10:12 - 11:9 - 7:11 - 11:8 - 11:13
16254982,2024-01-12 17:00:00,Gevorgyan Hayk - Gevorgyan Gegham,0:3,11:9 - 16:14 - 16:14 - 0:0 - 0:0,3,0,Gevorgyan Hayk,Gevorgyan Gegham,fiurst,Gevorgyan Gegham - Gevorgyan Hayk,80,37,43,6,-6,20,30,30,0,0,2,2,2,0,0,6,9:11 - 14:16 - 14:16 - 0:0 - 0:0
16254978,2024-01-12 16:45:00,Avakimyan Davit - Karakhanyan Mher,3:1,7:11 - 11:7 - 11:9 - 11:6 - 0:0,3,1,Avakimyan Davit,Karakhanyan Mher,fiurst,Avakimyan Davit - Karakhanyan Mher,73,40,33,-7,7,18,18,20,17,0,4,-4,-2,-5,0,-7,7:11 - 11:7 - 11:9 - 11:6 - 0:0
16254976,2024-01-12 16:30:00,Miroyan Hakob - Gevorgyan Hayk,3:0,12:14 - 4:11 - 1:11 - 0:0 - 0:0,0,3,Miroyan Hakob,Gevorgyan Hayk,fiurst,Gevorgyan Hayk - Miroyan Hakob,53,36,17,-19,19,26,15,12,0,0,-2,-7,-10,0,0,-19,14:12 - 11:4 - 11:1 - 0:0 - 0:0
16254975,2024-01-12 16:15:00,Gevorgyan Gegham - Karakhanyan Mher,3:0,11:4 - 11:6 - 11:9 - 0:0 - 0:0,3,0,Gevorgyan Gegham,Karakhanyan Mher,fiurst,Gevorgyan Gegham - Karakhanyan Mher,52,33,19,-14,14,15,17,20,0,0,-7,-5,-2,0,0,-14,11:4 - 11:6 - 11:9 - 0:0 - 0:0
16254959,2024-01-12 16:00:00,Avakimyan Davit - Miroyan Hakob,3:1,11:7 - 8:11 - 11:3 - 11:7 - 0:0,3,1,Avakimyan Davit,Miroyan Hakob,fiurst,Avakimyan Davit - Miroyan Hakob,69,41,28,-13,13,18,19,14,18,0,-4,3,-8,-4,0,-13,11:7 - 8:11 - 11:3 - 11:7 - 0:0
16254958,2024-01-12 15:45:00,Karakhanyan Mher - Gevorgyan Hayk,3:0,7:11 - 7:11 - 9:11 - 0:0 - 0:0,0,3,Karakhanyan Mher,Gevorgyan Hayk,fiurst,Gevorgyan Hayk - Karakhanyan Mher,56,33,23,-10,10,18,18,20,0,0,-4,-4,-2,0,0,-10,11:7 - 11:7 - 11:9 - 0:0 - 0:0
16254957,2024-01-12 15:30:00,Gevorgyan Gegham - Avakimyan Davit,3:2,11:9 - 5:11 - 9:11 - 11:5 - 4:11,2,3,Gevorgyan Gegham,Avakimyan Davit,fiurst,Avakimyan Davit - Gevorgyan Gegham,87,47,40,-7,7,20,16,20,16,15,2,-6,-2,6,-7,-7,9:11 - 11:5 - 11:9 - 5:11 - 11:4
16254953,2024-01-12 15:15:00,Diaryan Aleksandr - Nikoghosyan Narek,1:3,6:11 - 14:12 - 10:12 - 9:11 - 0:0,1,3,Diaryan Aleksandr,Nikoghosyan Narek,fiurst,Diaryan Aleksandr - Nikoghosyan Narek,85,39,46,7,-7,17,26,22,20,0,5,-2,2,2,0,7,6:11 - 14:12 - 10:12 - 9:11 - 0:0
16254950,2024-01-12 14:45:00,Nikoghosyan Narek - Rafayelyan Edgar,0:3,6:11 - 8:11 - 6:11 - 0:0 - 0:0,0,3,Nikoghosyan Narek,Rafayelyan Edgar,fiurst,Nikoghosyan Narek - Rafayelyan Edgar,53,20,33,13,-13,17,19,17,0,0,5,3,5,0,0,13,6:11 - 8:11 - 6:11 - 0:0 - 0:0
16254949,2024-01-12 14:40:00,Papyan Karen - Diaryan Aleksandr,3:0,3:11 - 4:11 - 4:11 - 0:0 - 0:0,0,3,Papyan Karen,Diaryan Aleksandr,fiurst,Diaryan Aleksandr - Papyan Karen,44,33,11,-22,22,14,15,15,0,0,-8,-7,-7,0,0,-22,11:3 - 11:4 - 11:4 - 0:0 - 0:0
16254929,2024-01-12 14:00:00,Papyan Karen - Nikoghosyan Narek,3:1,9:11 - 11:8 - 2:11 - 7:11 - 0:0,1,3,Papyan Karen,Nikoghosyan Narek,fiurst,Nikoghosyan Narek - Papyan Karen,70,41,29,-12,12,20,19,13,18,0,-2,3,-9,-4,0,-12,11:9 - 8:11 - 11:2 - 11:7 - 0:0
16254932,2024-01-12 14:00:00,Diaryan Aleksandr - Rafayelyan Edgar,3:2,6:11 - 5:11 - 12:10 - 11:7 - 11:5,3,2,Diaryan Aleksandr,Rafayelyan Edgar,fiurst,Diaryan Aleksandr - Rafayelyan Edgar,89,45,44,-1,1,17,16,22,18,16,5,6,-2,-4,-6,-1,6:11 - 5:11 - 12:10 - 11:7 - 11:5
16254923,2024-01-12 13:15:00,Papyan Karen - Rafayelyan Edgar,1:3,6:11 - 11:8 - 9:11 - 10:12 - 0:0,1,3,Papyan Karen,Rafayelyan Edgar,fiurst,Papyan Karen - Rafayelyan Edgar,78,36,42,6,-6,17,19,20,22,0,5,-3,2,2,0,6,6:11 - 11:8 - 9:11 - 10:12 - 0:0
16254922,2024-01-12 13:10:00,Nikoghosyan Narek - Diaryan Aleksandr,3:2,11:6 - 9:11 - 11:5 - 7:11 - 11:13,2,3,Nikoghosyan Narek,Diaryan Aleksandr,fiurst,Diaryan Aleksandr - Nikoghosyan Narek,95,46,49,3,-3,17,20,16,18,24,5,-2,6,-4,-2,3,6:11 - 11:9 - 5:11 - 11:7 - 13:11
16254926,2024-01-12 12:30:00,Rafayelyan Edgar - Nikoghosyan Narek,2:3,7:11 - 6:11 - 11:3 - 11:7 - 11:9,3,2,Rafayelyan Edgar,Nikoghosyan Narek,fiurst,Nikoghosyan Narek - Rafayelyan Edgar,87,41,46,5,-5,18,17,14,18,20,-4,-5,8,4,2,5,11:7 - 11:6 - 3:11 - 7:11 - 9:11
16254907,2024-01-12 12:15:00,Diaryan Aleksandr - Papyan Karen,3:0,11:5 - 11:9 - 11:7 - 0:0 - 0:0,3,0,Diaryan Aleksandr,Papyan Karen,fiurst,Diaryan Aleksandr - Papyan Karen,54,33,21,-12,12,16,20,18,0,0,-6,-2,-4,0,0,-12,11:5 - 11:9 - 11:7 - 0:0 - 0:0
16254902,2024-01-12 11:45:00,Nikoghosyan Narek - Papyan Karen,3:1,11:8 - 11:6 - 7:11 - 11:3 - 0:0,3,1,Nikoghosyan Narek,Papyan Karen,fiurst,Nikoghosyan Narek - Papyan Karen,68,40,28,-12,12,19,17,18,14,0,-3,-5,4,-8,0,-12,11:8 - 11:6 - 7:11 - 11:3 - 0:0
16254901,2024-01-12 11:30:00,Rafayelyan Edgar - Diaryan Aleksandr,3:0,9:11 - 3:11 - 5:11 - 0:0 - 0:0,0,3,Rafayelyan Edgar,Diaryan Aleksandr,fiurst,Diaryan Aleksandr - Rafayelyan Edgar,50,33,17,-16,16,20,14,16,0,0,-2,-8,-6,0,0,-16,11:9 - 11:3 - 11:5 - 0:0 - 0:0
16254896,2024-01-12 11:00:00,Rafayelyan Edgar - Papyan Karen,2:3,11:2 - 11:7 - 3:11 - 11:13 - 11:7,3,2,Rafayelyan Edgar,Papyan Karen,fiurst,Papyan Karen - Rafayelyan Edgar,87,40,47,7,-7,13,18,14,24,18,9,4,-8,-2,4,7,2:11 - 7:11 - 11:3 - 13:11 - 7:11
16254885,2024-01-12 10:55:00,Diaryan Aleksandr - Nikoghosyan Narek,2:3,8:11 - 6:11 - 11:4 - 11:7 - 7:11,2,3,Diaryan Aleksandr,Nikoghosyan Narek,fiurst,Diaryan Aleksandr - Nikoghosyan Narek,87,43,44,1,-1,19,17,15,18,18,3,5,-7,-4,4,1,8:11 - 6:11 - 11:4 - 11:7 - 7:11
16254878,2024-01-12 10:15:00,Papyan Karen - Diaryan Aleksandr,2:3,9:11 - 11:4 - 11:9 - 5:11 - 11:8,3,2,Papyan Karen,Diaryan Aleksandr,fiurst,Diaryan Aleksandr - Papyan Karen,90,43,47,4,-4,20,15,20,16,19,-2,7,2,-6,3,4,11:9 - 4:11 - 9:11 - 11:5 - 8:11
16254880,2024-01-12 10:15:00,Nikoghosyan Narek - Rafayelyan Edgar,2:3,6:11 - 11:7 - 6:11 - 11:3 - 7:11,2,3,Nikoghosyan Narek,Rafayelyan Edgar,fiurst,Nikoghosyan Narek - Rafayelyan Edgar,84,41,43,2,-2,17,18,17,14,18,5,-4,5,-8,4,2,6:11 - 11:7 - 6:11 - 11:3 - 7:11
16235155,2024-01-11 17:45:00,Darbinyan Armen - Gevorgyan Hayk,0:3,5:11 - 4:11 - 3:11 - 0:0 - 0:0,0,3,Darbinyan Armen,Gevorgyan Hayk,fiurst,Darbinyan Armen - Gevorgyan Hayk,45,12,33,21,-21,16,15,14,0,0,6,7,8,0,0,21,5:11 - 4:11 - 3:11 - 0:0 - 0:0
16235153,2024-01-11 17:30:00,Gevorgyan Gegham - Miroyan Hakob,3:0,11:8 - 11:5 - 11:3 - 0:0 - 0:0,3,0,Gevorgyan Gegham,Miroyan Hakob,fiurst,Gevorgyan Gegham - Miroyan Hakob,49,33,16,-17,17,19,16,14,0,0,-3,-6,-8,0,0,-17,11:8 - 11:5 - 11:3 - 0:0 - 0:0
16235143,2024-01-11 17:15:00,Avakimyan Davit - Darbinyan Armen,3:0,11:8 - 11:4 - 11:7 - 0:0 - 0:0,3,0,Avakimyan Davit,Darbinyan Armen,fiurst,Avakimyan Davit - Darbinyan Armen,52,33,19,-14,14,19,15,18,0,0,-3,-7,-4,0,0,-14,11:8 - 11:4 - 11:7 - 0:0 - 0:0
16235141,2024-01-11 17:00:00,Gevorgyan Gegham - Gevorgyan Hayk,0:3,12:14 - 7:11 - 9:11 - 0:0 - 0:0,0,3,Gevorgyan Gegham,Gevorgyan Hayk,fiurst,Gevorgyan Gegham - Gevorgyan Hayk,64,28,36,8,-8,26,18,20,0,0,2,4,2,0,0,8,12:14 - 7:11 - 9:11 - 0:0 - 0:0
16235137,2024-01-11 16:45:00,Miroyan Hakob - Avakimyan Davit,3:0,6:11 - 7:11 - 8:11 - 0:0 - 0:0,0,3,Miroyan Hakob,Avakimyan Davit,fiurst,Avakimyan Davit - Miroyan Hakob,54,33,21,-12,12,17,18,19,0,0,-5,-4,-3,0,0,-12,11:6 - 11:7 - 11:8 - 0:0 - 0:0
16235132,2024-01-11 16:30:00,Darbinyan Armen - Gevorgyan Gegham,0:3,5:11 - 4:11 - 5:11 - 0:0 - 0:0,0,3,Darbinyan Armen,Gevorgyan Gegham,fiurst,Darbinyan Armen - Gevorgyan Gegham,47,14,33,19,-19,16,15,16,0,0,6,7,6,0,0,19,5:11 - 4:11 - 5:11 - 0:0 - 0:0
16235127,2024-01-11 16:15:00,Gevorgyan Hayk - Avakimyan Davit,2:3,10:12 - 8:11 - 11:8 - 11:2 - 11:4,3,2,Gevorgyan Hayk,Avakimyan Davit,fiurst,Avakimyan Davit - Gevorgyan Hayk,88,37,51,14,-14,22,19,19,13,15,-2,-3,3,9,7,14,12:10 - 11:8 - 8:11 - 2:11 - 4:11
16235113,2024-01-11 16:00:00,Miroyan Hakob - Darbinyan Armen,0:3,12:10 - 11:9 - 11:4 - 0:0 - 0:0,3,0,Miroyan Hakob,Darbinyan Armen,fiurst,Darbinyan Armen - Miroyan Hakob,57,23,34,11,-11,22,20,15,0,0,2,2,7,0,0,11,10:12 - 9:11 - 4:11 - 0:0 - 0:0
16235108,2024-01-11 15:50:00,Avakimyan Davit - Gevorgyan Gegham,3:0,11:3 - 11:8 - 11:8 - 0:0 - 0:0,3,0,Avakimyan Davit,Gevorgyan Gegham,fiurst,Avakimyan Davit - Gevorgyan Gegham,52,33,19,-14,14,14,19,19,0,0,-8,-3,-3,0,0,-14,11:3 - 11:8 - 11:8 - 0:0 - 0:0
16235105,2024-01-11 15:30:00,Gevorgyan Hayk - Miroyan Hakob,3:1,9:11 - 11:6 - 11:4 - 11:6 - 0:0,3,1,Gevorgyan Hayk,Miroyan Hakob,fiurst,Gevorgyan Hayk - Miroyan Hakob,69,42,27,-15,15,20,17,15,17,0,2,-5,-7,-5,0,-15,9:11 - 11:6 - 11:4 - 11:6 - 0:0
16235103,2024-01-11 15:20:00,Mkrtchyan Andranik - Diaryan Aleksandr,2:3,12:10 - 2:11 - 6:11 - 11:9 - 11:9,3,2,Mkrtchyan Andranik,Diaryan Aleksandr,fiurst,Diaryan Aleksandr - Mkrtchyan Andranik,92,50,42,-8,8,22,13,17,20,20,2,-9,-5,2,2,-8,10:12 - 11:2 - 11:6 - 9:11 - 9:11
16235101,2024-01-11 15:05:00,Nikoghosyan Narek - Arutyunov Ruben,1:3,8:11 - 11:8 - 11:1 - 11:6 - 0:0,3,1,Nikoghosyan Narek,Arutyunov Ruben,fiurst,Arutyunov Ruben - Nikoghosyan Narek,67,26,41,15,-15,19,19,12,17,0,-3,3,10,5,0,15,11:8 - 8:11 - 1:11 - 6:11 - 0:0
16235099,2024-01-11 14:45:00,Papyan Karen - Mkrtchyan Andranik,1:3,11:6 - 11:8 - 14:16 - 11:5 - 0:0,3,1,Papyan Karen,Mkrtchyan Andranik,fiurst,Mkrtchyan Andranik - Papyan Karen,82,35,47,12,-12,17,19,30,16,0,5,3,-2,6,0,12,6:11 - 8:11 - 16:14 - 5:11 - 0:0
16235096,2024-01-11 14:30:00,Diaryan Aleksandr - Nikoghosyan Narek,3:1,11:9 - 11:13 - 11:3 - 13:11 - 0:0,3,1,Diaryan Aleksandr,Nikoghosyan Narek,fiurst,Diaryan Aleksandr - Nikoghosyan Narek,82,46,36,-10,10,20,24,14,24,0,-2,2,-8,-2,0,-10,11:9 - 11:13 - 11:3 - 13:11 - 0:0
16235094,2024-01-11 14:15:00,Papyan Karen - Arutyunov Ruben,3:1,10:12 - 11:7 - 11:13 - 13:15 - 0:0,1,3,Papyan Karen,Arutyunov Ruben,fiurst,Arutyunov Ruben - Papyan Karen,92,47,45,-2,2,22,18,24,28,0,-2,4,-2,-2,0,-2,12:10 - 7:11 - 13:11 - 15:13 - 0:0
16235082,2024-01-11 14:05:00,Mkrtchyan Andranik - Nikoghosyan Narek,0:3,9:11 - 3:11 - 5:11 - 0:0 - 0:0,0,3,Mkrtchyan Andranik,Nikoghosyan Narek,fiurst,Mkrtchyan Andranik - Nikoghosyan Narek,50,17,33,16,-16,20,14,16,0,0,2,8,6,0,0,16,9:11 - 3:11 - 5:11 - 0:0 - 0:0
16235081,2024-01-11 13:45:00,Diaryan Aleksandr - Papyan Karen,3:0,11:6 - 11:4 - 11:5 - 0:0 - 0:0,3,0,Diaryan Aleksandr,Papyan Karen,fiurst,Diaryan Aleksandr - Papyan Karen,48,33,15,-18,18,17,15,16,0,0,-5,-7,-6,0,0,-18,11:6 - 11:4 - 11:5 - 0:0 - 0:0
16235078,2024-01-11 13:30:00,Arutyunov Ruben - Mkrtchyan Andranik,3:2,10:12 - 12:10 - 11:5 - 10:12 - 11:7,3,2,Arutyunov Ruben,Mkrtchyan Andranik,fiurst,Arutyunov Ruben - Mkrtchyan Andranik,100,54,46,-8,8,22,22,16,22,18,2,-2,-6,2,-4,-8,10:12 - 12:10 - 11:5 - 10:12 - 11:7
16235076,2024-01-11 13:15:00,Nikoghosyan Narek - Papyan Karen,3:0,11:2 - 11:3 - 11:4 - 0:0 - 0:0,3,0,Nikoghosyan Narek,Papyan Karen,fiurst,Nikoghosyan Narek - Papyan Karen,42,33,9,-24,24,13,14,15,0,0,-9,-8,-7,0,0,-24,11:2 - 11:3 - 11:4 - 0:0 - 0:0
16235074,2024-01-11 13:00:00,Arutyunov Ruben - Diaryan Aleksandr,0:3,2:11 - 5:11 - 6:11 - 0:0 - 0:0,0,3,Arutyunov Ruben,Diaryan Aleksandr,fiurst,Arutyunov Ruben - Diaryan Aleksandr,46,13,33,20,-20,13,16,17,0,0,9,6,5,0,0,20,2:11 - 5:11 - 6:11 - 0:0 - 0:0
16235068,2024-01-11 12:15:00,Arutyunov Ruben - Nikoghosyan Narek,1:3,9:11 - 11:13 - 11:9 - 8:11 - 0:0,1,3,Arutyunov Ruben,Nikoghosyan Narek,fiurst,Arutyunov Ruben - Nikoghosyan Narek,83,39,44,5,-5,20,24,20,19,0,2,2,-2,3,0,5,9:11 - 11:13 - 11:9 - 8:11 - 0:0
16235070,2024-01-11 12:15:00,Mkrtchyan Andranik - Papyan Karen,0:3,7:11 - 13:15 - 9:11 - 0:0 - 0:0,0,3,Mkrtchyan Andranik,Papyan Karen,fiurst,Mkrtchyan Andranik - Papyan Karen,66,29,37,8,-8,18,28,20,0,0,4,2,2,0,0,8,7:11 - 13:15 - 9:11 - 0:0 - 0:0
16235064,2024-01-11 11:50:00,Diaryan Aleksandr - Mkrtchyan Andranik,3:0,11:2 - 11:1 - 11:4 - 0:0 - 0:0,3,0,Diaryan Aleksandr,Mkrtchyan Andranik,fiurst,Diaryan Aleksandr - Mkrtchyan Andranik,40,33,7,-26,26,13,12,15,0,0,-9,-10,-7,0,0,-26,11:2 - 11:1 - 11:4 - 0:0 - 0:0
16235063,2024-01-11 11:40:00,Arutyunov Ruben - Papyan Karen,1:3,10:12 - 8:11 - 11:7 - 9:11 - 0:0,1,3,Arutyunov Ruben,Papyan Karen,fiurst,Arutyunov Ruben - Papyan Karen,79,38,41,3,-3,22,19,18,20,0,2,3,-4,2,0,3,10:12 - 8:11 - 11:7 - 9:11 - 0:0
16235051,2024-01-11 11:15:00,Nikoghosyan Narek - Diaryan Aleksandr,1:3,9:11 - 11:8 - 11:9 - 11:9 - 0:0,3,1,Nikoghosyan Narek,Diaryan Aleksandr,fiurst,Diaryan Aleksandr - Nikoghosyan Narek,79,37,42,5,-5,20,19,20,20,0,-2,3,2,2,0,5,11:9 - 8:11 - 9:11 - 9:11 - 0:0
16235050,2024-01-11 11:00:00,Mkrtchyan Andranik - Arutyunov Ruben,3:2,11:6 - 7:11 - 11:8 - 6:11 - 9:11,2,3,Mkrtchyan Andranik,Arutyunov Ruben,fiurst,Arutyunov Ruben - Mkrtchyan Andranik,91,47,44,-3,3,17,18,19,17,20,5,-4,3,-5,-2,-3,6:11 - 11:7 - 8:11 - 11:6 - 11:9
16235046,2024-01-11 10:45:00,Nikoghosyan Narek - Mkrtchyan Andranik,0:3,11:8 - 11:8 - 11:5 - 0:0 - 0:0,3,0,Nikoghosyan Narek,Mkrtchyan Andranik,fiurst,Mkrtchyan Andranik - Nikoghosyan Narek,54,21,33,12,-12,19,19,16,0,0,3,3,6,0,0,12,8:11 - 8:11 - 5:11 - 0:0 - 0:0
16235048,2024-01-11 10:45:00,Papyan Karen - Diaryan Aleksandr,3:1,11:4 - 6:11 - 3:11 - 4:11 - 0:0,1,3,Papyan Karen,Diaryan Aleksandr,fiurst,Diaryan Aleksandr - Papyan Karen,61,37,24,-13,13,15,17,14,15,0,7,-5,-8,-7,0,-13,4:11 - 11:6 - 11:3 - 11:4 - 0:0
16235045,2024-01-11 10:15:00,Diaryan Aleksandr - Arutyunov Ruben,0:3,18:16 - 11:2 - 11:3 - 0:0 - 0:0,3,0,Diaryan Aleksandr,Arutyunov Ruben,fiurst,Arutyunov Ruben - Diaryan Aleksandr,61,21,40,19,-19,34,13,14,0,0,2,9,8,0,0,19,16:18 - 2:11 - 3:11 - 0:0 - 0:0
16235042,2024-01-11 10:10:00,Papyan Karen - Nikoghosyan Narek,2:3,11:4 - 9:11 - 11:5 - 2:11 - 13:11,3,2,Papyan Karen,Nikoghosyan Narek,fiurst,Nikoghosyan Narek - Papyan Karen,88,42,46,4,-4,15,20,16,13,24,7,-2,6,-9,2,4,4:11 - 11:9 - 5:11 - 11:2 - 11:13
16220590,2024-01-10 17:50:00,Miroyan Hakob - Karakhanyan Mher,0:3,11:7 - 11:8 - 11:6 - 0:0 - 0:0,3,0,Miroyan Hakob,Karakhanyan Mher,fiurst,Karakhanyan Mher - Miroyan Hakob,54,21,33,12,-12,18,19,17,0,0,4,3,5,0,0,12,7:11 - 8:11 - 6:11 - 0:0 - 0:0
16220589,2024-01-10 17:30:00,Babakhanyan Artak - Avakimyan Davit,3:0,9:11 - 5:11 - 4:11 - 0:0 - 0:0,0,3,Babakhanyan Artak,Avakimyan Davit,fiurst,Avakimyan Davit - Babakhanyan Artak,51,33,18,-15,15,20,16,15,0,0,-2,-6,-7,0,0,-15,11:9 - 11:5 - 11:4 - 0:0 - 0:0
16220588,2024-01-10 17:20:00,Gevorgyan Hayk - Miroyan Hakob,3:1,11:7 - 8:11 - 11:3 - 12:10 - 0:0,3,1,Gevorgyan Hayk,Miroyan Hakob,fiurst,Gevorgyan Hayk - Miroyan Hakob,73,42,31,-11,11,18,19,14,22,0,-4,3,-8,-2,0,-11,11:7 - 8:11 - 11:3 - 12:10 - 0:0
16220586,2024-01-10 17:00:00,Babakhanyan Artak - Karakhanyan Mher,0:3,7:11 - 7:11 - 9:11 - 0:0 - 0:0,0,3,Babakhanyan Artak,Karakhanyan Mher,fiurst,Babakhanyan Artak - Karakhanyan Mher,56,23,33,10,-10,18,18,20,0,0,4,4,2,0,0,10,7:11 - 7:11 - 9:11 - 0:0 - 0:0
16220584,2024-01-10 16:45:00,Avakimyan Davit - Gevorgyan Hayk,2:3,10:12 - 11:7 - 13:11 - 1:11 - 12:14,2,3,Avakimyan Davit,Gevorgyan Hayk,fiurst,Avakimyan Davit - Gevorgyan Hayk,102,47,55,8,-8,22,18,24,12,26,2,-4,-2,10,2,8,10:12 - 11:7 - 13:11 - 1:11 - 12:14
16220583,2024-01-10 16:30:00,Miroyan Hakob - Grigoryan Erik,0:3,14:12 - 11:8 - 11:6 - 0:0 - 0:0,3,0,Miroyan Hakob,Grigoryan Erik,fiurst,Grigoryan Erik - Miroyan Hakob,62,26,36,10,-10,26,19,17,0,0,2,3,5,0,0,10,12:14 - 8:11 - 6:11 - 0:0 - 0:0
16220570,2024-01-10 16:15:00,Karakhanyan Mher - Gevorgyan Hayk,3:1,11:9 - 9:11 - 6:11 - 7:11 - 0:0,1,3,Karakhanyan Mher,Gevorgyan Hayk,fiurst,Gevorgyan Hayk - Karakhanyan Mher,75,42,33,-9,9,20,20,17,18,0,2,-2,-5,-4,0,-9,9:11 - 11:9 - 11:6 - 11:7 - 0:0
16220564,2024-01-10 16:00:00,Avakimyan Davit - Miroyan Hakob,3:1,7:11 - 11:8 - 11:3 - 11:7 - 0:0,3,1,Avakimyan Davit,Miroyan Hakob,fiurst,Avakimyan Davit - Miroyan Hakob,69,40,29,-11,11,18,19,14,18,0,4,-3,-8,-4,0,-11,7:11 - 11:8 - 11:3 - 11:7 - 0:0
16220562,2024-01-10 15:50:00,Gevorgyan Hayk - Grigoryan Erik,3:0,11:5 - 11:4 - 11:5 - 0:0 - 0:0,3,0,Gevorgyan Hayk,Grigoryan Erik,fiurst,Gevorgyan Hayk - Grigoryan Erik,47,33,14,-19,19,16,15,16,0,0,-6,-7,-6,0,0,-19,11:5 - 11:4 - 11:5 - 0:0 - 0:0
16220556,2024-01-10 15:40:00,Karakhanyan Mher - Avakimyan Davit,3:0,8:11 - 9:11 - 4:11 - 0:0 - 0:0,0,3,Karakhanyan Mher,Avakimyan Davit,fiurst,Avakimyan Davit - Karakhanyan Mher,54,33,21,-12,12,19,20,15,0,0,-3,-2,-7,0,0,-12,11:8 - 11:9 - 11:4 - 0:0 - 0:0
16220553,2024-01-10 15:20:00,Gevorgyan Hayk - Nikoghosyan Narek,1:3,8:11 - 11:8 - 4:11 - 4:11 - 0:0,1,3,Gevorgyan Hayk,Nikoghosyan Narek,fiurst,Gevorgyan Hayk - Nikoghosyan Narek,68,27,41,14,-14,19,19,15,15,0,3,-3,7,7,0,14,8:11 - 11:8 - 4:11 - 4:11 - 0:0
16220541,2024-01-10 15:15:00,Arutyunov Ruben - Papyan Karen,3:2,12:10 - 4:11 - 11:9 - 9:11 - 12:10,3,2,Arutyunov Ruben,Papyan Karen,fiurst,Arutyunov Ruben - Papyan Karen,99,48,51,3,-3,22,15,20,20,22,-2,7,-2,2,-2,3,12:10 - 4:11 - 11:9 - 9:11 - 12:10
16220540,2024-01-10 14:45:00,Rafayelyan Edgar - Gevorgyan Hayk,2:3,11:5 - 12:14 - 11:7 - 9:11 - 11:4,3,2,Rafayelyan Edgar,Gevorgyan Hayk,fiurst,Gevorgyan Hayk - Rafayelyan Edgar,95,41,54,13,-13,16,26,18,20,15,6,-2,4,-2,7,13,5:11 - 14:12 - 7:11 - 11:9 - 4:11
16220539,2024-01-10 14:40:00,Nikoghosyan Narek - Arutyunov Ruben,1:3,11:7 - 8:11 - 12:10 - 11:9 - 0:0,3,1,Nikoghosyan Narek,Arutyunov Ruben,fiurst,Arutyunov Ruben - Nikoghosyan Narek,79,37,42,5,-5,18,19,22,20,0,4,-3,2,2,0,5,7:11 - 11:8 - 10:12 - 9:11 - 0:0
16220537,2024-01-10 14:15:00,Rafayelyan Edgar - Papyan Karen,1:3,11:6 - 11:13 - 11:3 - 11:8 - 0:0,3,1,Rafayelyan Edgar,Papyan Karen,fiurst,Papyan Karen - Rafayelyan Edgar,74,30,44,14,-14,17,24,14,19,0,5,-2,8,3,0,14,6:11 - 13:11 - 3:11 - 8:11 - 0:0
16220528,2024-01-10 14:10:00,Gevorgyan Hayk - Arutyunov Ruben,3:1,8:11 - 11:8 - 6:11 - 5:11 - 0:0,1,3,Gevorgyan Hayk,Arutyunov Ruben,fiurst,Arutyunov Ruben - Gevorgyan Hayk,71,41,30,-11,11,19,19,17,16,0,-3,3,-5,-6,0,-11,11:8 - 8:11 - 11:6 - 11:5 - 0:0
16220526,2024-01-10 13:45:00,Nikoghosyan Narek - Rafayelyan Edgar,0:3,4:11 - 1:11 - 7:11 - 0:0 - 0:0,0,3,Nikoghosyan Narek,Rafayelyan Edgar,fiurst,Nikoghosyan Narek - Rafayelyan Edgar,45,12,33,21,-21,15,12,18,0,0,7,10,4,0,0,21,4:11 - 1:11 - 7:11 - 0:0 - 0:0
16220525,2024-01-10 13:40:00,Papyan Karen - Gevorgyan Hayk,1:3,11:8 - 11:9 - 11:13 - 11:7 - 0:0,3,1,Papyan Karen,Gevorgyan Hayk,fiurst,Gevorgyan Hayk - Papyan Karen,81,37,44,7,-7,19,20,24,18,0,3,2,-2,4,0,7,8:11 - 9:11 - 13:11 - 7:11 - 0:0
16220523,2024-01-10 13:15:00,Arutyunov Ruben - Rafayelyan Edgar,3:2,11:9 - 6:11 - 11:8 - 3:11 - 12:10,3,2,Arutyunov Ruben,Rafayelyan Edgar,fiurst,Arutyunov Ruben - Rafayelyan Edgar,92,43,49,6,-6,20,17,19,14,22,-2,5,-3,8,-2,6,11:9 - 6:11 - 11:8 - 3:11 - 12:10
16220519,2024-01-10 13:00:00,Papyan Karen - Nikoghosyan Narek,0:3,11:8 - 11:8 - 11:8 - 0:0 - 0:0,3,0,Papyan Karen,Nikoghosyan Narek,fiurst,Nikoghosyan Narek - Papyan Karen,57,24,33,9,-9,19,19,19,0,0,3,3,3,0,0,9,8:11 - 8:11 - 8:11 - 0:0 - 0:0
16220516,2024-01-10 12:20:00,Soghomonyan Hrayr - Rafayelyan Edgar,3:0,8:11 - 7:11 - 8:11 - 0:0 - 0:0,0,3,Soghomonyan Hrayr,Rafayelyan Edgar,fiurst,Rafayelyan Edgar - Soghomonyan Hrayr,56,33,23,-10,10,19,18,19,0,0,-3,-4,-3,0,0,-10,11:8 - 11:7 - 11:8 - 0:0 - 0:0
16220505,2024-01-10 12:05:00,Papyan Karen - Arutyunov Ruben,1:3,7:11 - 11:4 - 13:11 - 11:7 - 0:0,3,1,Papyan Karen,Arutyunov Ruben,fiurst,Arutyunov Ruben - Papyan Karen,75,33,42,9,-9,18,15,24,18,0,-4,7,2,4,0,9,11:7 - 4:11 - 11:13 - 7:11 - 0:0
16220504,2024-01-10 12:00:00,Nikoghosyan Narek - Soghomonyan Hrayr,3:0,11:5 - 11:6 - 11:8 - 0:0 - 0:0,3,0,Nikoghosyan Narek,Soghomonyan Hrayr,fiurst,Nikoghosyan Narek - Soghomonyan Hrayr,52,33,19,-14,14,16,17,19,0,0,-6,-5,-3,0,0,-14,11:5 - 11:6 - 11:8 - 0:0 - 0:0
16220501,2024-01-10 11:30:00,Papyan Karen - Rafayelyan Edgar,3:1,9:11 - 11:7 - 12:10 - 11:6 - 0:0,3,1,Papyan Karen,Rafayelyan Edgar,fiurst,Papyan Karen - Rafayelyan Edgar,77,43,34,-9,9,20,18,22,17,0,2,-4,-2,-5,0,-9,9:11 - 11:7 - 12:10 - 11:6 - 0:0
16220497,2024-01-10 11:25:00,Arutyunov Ruben - Nikoghosyan Narek,1:3,15:17 - 2:11 - 12:10 - 9:11 - 0:0,1,3,Arutyunov Ruben,Nikoghosyan Narek,fiurst,Arutyunov Ruben - Nikoghosyan Narek,87,38,49,11,-11,32,13,22,20,0,2,9,-2,2,0,11,15:17 - 2:11 - 12:10 - 9:11 - 0:0
16220491,2024-01-10 11:00:00,Soghomonyan Hrayr - Papyan Karen,3:1,4:11 - 7:11 - 11:7 - 6:11 - 0:0,1,3,Soghomonyan Hrayr,Papyan Karen,fiurst,Papyan Karen - Soghomonyan Hrayr,68,40,28,-12,12,15,18,18,17,0,-7,-4,4,-5,0,-12,11:4 - 11:7 - 7:11 - 11:6 - 0:0
16220486,2024-01-10 10:45:00,Rafayelyan Edgar - Nikoghosyan Narek,3:2,11:9 - 6:11 - 9:11 - 11:4 - 6:11,2,3,Rafayelyan Edgar,Nikoghosyan Narek,fiurst,Nikoghosyan Narek - Rafayelyan Edgar,89,46,43,-3,3,20,17,20,15,17,2,-5,-2,7,-5,-3,9:11 - 11:6 - 11:9 - 4:11 - 11:6
16220485,2024-01-10 10:35:00,Arutyunov Ruben - Soghomonyan Hrayr,3:1,11:8 - 15:17 - 11:8 - 11:4 - 0:0,3,1,Arutyunov Ruben,Soghomonyan Hrayr,fiurst,Arutyunov Ruben - Soghomonyan Hrayr,85,48,37,-11,11,19,32,19,15,0,-3,2,-3,-7,0,-11,11:8 - 15:17 - 11:8 - 11:4 - 0:0
16220477,2024-01-10 10:15:00,Nikoghosyan Narek - Papyan Karen,0:3,4:11 - 8:11 - 1:11 - 0:0 - 0:0,0,3,Nikoghosyan Narek,Papyan Karen,fiurst,Nikoghosyan Narek - Papyan Karen,46,13,33,20,-20,15,19,12,0,0,7,3,10,0,0,20,4:11 - 8:11 - 1:11 - 0:0 - 0:0
16220476,2024-01-10 10:00:00,Rafayelyan Edgar - Arutyunov Ruben,0:3,11:9 - 11:9 - 16:14 - 0:0 - 0:0,3,0,Rafayelyan Edgar,Arutyunov Ruben,fiurst,Arutyunov Ruben - Rafayelyan Edgar,70,32,38,6,-6,20,20,30,0,0,2,2,2,0,0,6,9:11 - 9:11 - 14:16 - 0:0 - 0:0
16196691,2024-01-09 17:45:00,Darbinyan Armen - Avakimyan Davit,3:0,4:11 - 7:11 - 4:11 - 0:0 - 0:0,0,3,Darbinyan Armen,Avakimyan Davit,fiurst,Avakimyan Davit - Darbinyan Armen,48,33,15,-18,18,15,18,15,0,0,-7,-4,-7,0,0,-18,11:4 - 11:7 - 11:4 - 0:0 - 0:0
16196688,2024-01-09 17:30:00,Karakhanyan Mher - Miroyan Hakob,3:0,11:9 - 11:7 - 14:12 - 0:0 - 0:0,3,0,Karakhanyan Mher,Miroyan Hakob,fiurst,Karakhanyan Mher - Miroyan Hakob,64,36,28,-8,8,20,18,26,0,0,-2,-4,-2,0,0,-8,11:9 - 11:7 - 14:12 - 0:0 - 0:0
16196680,2024-01-09 17:15:00,Grigoryan Erik - Darbinyan Armen,0:3,11:5 - 11:5 - 11:5 - 0:0 - 0:0,3,0,Grigoryan Erik,Darbinyan Armen,fiurst,Darbinyan Armen - Grigoryan Erik,48,15,33,18,-18,16,16,16,0,0,6,6,6,0,0,18,5:11 - 5:11 - 5:11 - 0:0 - 0:0
16196666,2024-01-09 17:00:00,Karakhanyan Mher - Avakimyan Davit,3:0,8:11 - 6:11 - 6:11 - 0:0 - 0:0,0,3,Karakhanyan Mher,Avakimyan Davit,fiurst,Avakimyan Davit - Karakhanyan Mher,53,33,20,-13,13,19,17,17,0,0,-3,-5,-5,0,0,-13,11:8 - 11:6 - 11:6 - 0:0 - 0:0
16196658,2024-01-09 16:55:00,Miroyan Hakob - Grigoryan Erik,3:1,6:11 - 6:11 - 11:7 - 8:11 - 0:0,1,3,Miroyan Hakob,Grigoryan Erik,fiurst,Grigoryan Erik - Miroyan Hakob,71,40,31,-9,9,17,17,18,19,0,-5,-5,4,-3,0,-9,11:6 - 11:6 - 7:11 - 11:8 - 0:0
16196643,2024-01-09 16:30:00,Avakimyan Davit - Grigoryan Erik,3:2,9:11 - 9:11 - 11:7 - 11:6 - 11:5,3,2,Avakimyan Davit,Grigoryan Erik,fiurst,Avakimyan Davit - Grigoryan Erik,91,51,40,-11,11,20,20,18,17,16,2,2,-4,-5,-6,-11,9:11 - 9:11 - 11:7 - 11:6 - 11:5
16196652,2024-01-09 16:30:00,Darbinyan Armen - Karakhanyan Mher,0:3,6:11 - 5:11 - 5:11 - 0:0 - 0:0,0,3,Darbinyan Armen,Karakhanyan Mher,fiurst,Darbinyan Armen - Karakhanyan Mher,49,16,33,17,-17,17,16,16,0,0,5,6,6,0,0,17,6:11 - 5:11 - 5:11 - 0:0 - 0:0
16196633,2024-01-09 16:10:00,Grigoryan Erik - Karakhanyan Mher,3:1,14:16 - 11:7 - 11:7 - 13:11 - 0:0,3,1,Grigoryan Erik,Karakhanyan Mher,fiurst,Grigoryan Erik - Karakhanyan Mher,90,49,41,-8,8,30,18,18,24,0,2,-4,-4,-2,0,-8,14:16 - 11:7 - 11:7 - 13:11 - 0:0
16196637,2024-01-09 16:00:00,Miroyan Hakob - Darbinyan Armen,0:3,15:13 - 11:8 - 11:7 - 0:0 - 0:0,3,0,Miroyan Hakob,Darbinyan Armen,fiurst,Darbinyan Armen - Miroyan Hakob,65,28,37,9,-9,28,19,18,0,0,2,3,4,0,0,9,13:15 - 8:11 - 7:11 - 0:0 - 0:0
16196627,2024-01-09 15:40:00,Arutyunov Ruben - Mkrtchyan Andranik,3:2,9:11 - 11:7 - 11:4 - 8:11 - 12:10,3,2,Arutyunov Ruben,Mkrtchyan Andranik,fiurst,Arutyunov Ruben - Mkrtchyan Andranik,94,51,43,-8,8,20,18,15,19,22,2,-4,-7,3,-2,-8,9:11 - 11:7 - 11:4 - 8:11 - 12:10
16196630,2024-01-09 15:30:00,Avakimyan Davit - Miroyan Hakob,3:0,11:7 - 11:6 - 11:5 - 0:0 - 0:0,3,0,Avakimyan Davit,Miroyan Hakob,fiurst,Avakimyan Davit - Miroyan Hakob,51,33,18,-15,15,18,17,16,0,0,-4,-5,-6,0,0,-15,11:7 - 11:6 - 11:5 - 0:0 - 0:0
16196624,2024-01-09 15:00:00,Rafayelyan Edgar - Diaryan Aleksandr,3:0,12:14 - 5:11 - 7:11 - 0:0 - 0:0,0,3,Rafayelyan Edgar,Diaryan Aleksandr,fiurst,Diaryan Aleksandr - Rafayelyan Edgar,60,36,24,-12,12,26,16,18,0,0,-2,-6,-4,0,0,-12,14:12 - 11:5 - 11:7 - 0:0 - 0:0
16196623,2024-01-09 14:55:00,Nikoghosyan Narek - Arutyunov Ruben,3:2,7:11 - 11:6 - 9:11 - 11:9 - 11:13,2,3,Nikoghosyan Narek,Arutyunov Ruben,fiurst,Arutyunov Ruben - Nikoghosyan Narek,99,50,49,-1,1,18,17,20,20,24,-4,5,-2,2,-2,-1,11:7 - 6:11 - 11:9 - 9:11 - 13:11
16196621,2024-01-09 14:30:00,Mkrtchyan Andranik - Rafayelyan Edgar,1:3,7:11 - 12:14 - 11:8 - 8:11 - 0:0,1,3,Mkrtchyan Andranik,Rafayelyan Edgar,fiurst,Mkrtchyan Andranik - Rafayelyan Edgar,82,38,44,6,-6,18,26,19,19,0,4,2,-3,3,0,6,7:11 - 12:14 - 11:8 - 8:11 - 0:0
16196620,2024-01-09 14:15:00,Nikoghosyan Narek - Diaryan Aleksandr,2:3,11:7 - 8:11 - 11:9 - 3:11 - 11:8,3,2,Nikoghosyan Narek,Diaryan Aleksandr,fiurst,Diaryan Aleksandr - Nikoghosyan Narek,90,46,44,-2,2,18,19,20,14,19,4,-3,2,-8,3,-2,7:11 - 11:8 - 9:11 - 11:3 - 8:11
16196606,2024-01-09 14:00:00,Arutyunov Ruben - Rafayelyan Edgar,0:3,11:13 - 3:11 - 2:11 - 0:0 - 0:0,0,3,Arutyunov Ruben,Rafayelyan Edgar,fiurst,Arutyunov Ruben - Rafayelyan Edgar,51,16,35,19,-19,24,14,13,0,0,2,8,9,0,0,19,11:13 - 3:11 - 2:11 - 0:0 - 0:0
16196602,2024-01-09 13:45:00,Mkrtchyan Andranik - Nikoghosyan Narek,0:3,9:11 - 5:11 - 7:11 - 0:0 - 0:0,0,3,Mkrtchyan Andranik,Nikoghosyan Narek,fiurst,Mkrtchyan Andranik - Nikoghosyan Narek,54,21,33,12,-12,20,16,18,0,0,2,6,4,0,0,12,9:11 - 5:11 - 7:11 - 0:0 - 0:0
16196598,2024-01-09 13:30:00,Diaryan Aleksandr - Arutyunov Ruben,0:3,11:8 - 11:9 - 11:3 - 0:0 - 0:0,3,0,Diaryan Aleksandr,Arutyunov Ruben,fiurst,Arutyunov Ruben - Diaryan Aleksandr,53,20,33,13,-13,19,20,14,0,0,3,2,8,0,0,13,8:11 - 9:11 - 3:11 - 0:0 - 0:0
16196592,2024-01-09 13:15:00,Rafayelyan Edgar - Nikoghosyan Narek,1:3,9:11 - 11:9 - 11:9 - 11:8 - 0:0,3,1,Rafayelyan Edgar,Nikoghosyan Narek,fiurst,Nikoghosyan Narek - Rafayelyan Edgar,79,37,42,5,-5,20,20,20,19,0,-2,2,2,3,0,5,11:9 - 9:11 - 9:11 - 8:11 - 0:0
16196588,2024-01-09 13:00:00,Diaryan Aleksandr - Mkrtchyan Andranik,3:1,11:9 - 11:13 - 11:5 - 11:9 - 0:0,3,1,Diaryan Aleksandr,Mkrtchyan Andranik,fiurst,Diaryan Aleksandr - Mkrtchyan Andranik,80,44,36,-8,8,20,24,16,20,0,-2,2,-6,-2,0,-8,11:9 - 11:13 - 11:5 - 11:9 - 0:0
16196584,2024-01-09 12:30:00,Arutyunov Ruben - Nikoghosyan Narek,3:0,11:9 - 11:8 - 11:7 - 0:0 - 0:0,3,0,Arutyunov Ruben,Nikoghosyan Narek,fiurst,Arutyunov Ruben - Nikoghosyan Narek,57,33,24,-9,9,20,19,18,0,0,-2,-3,-4,0,0,-9,11:9 - 11:8 - 11:7 - 0:0 - 0:0
16196573,2024-01-09 12:05:00,Diaryan Aleksandr - Rafayelyan Edgar,1:3,8:11 - 11:5 - 7:11 - 9:11 - 0:0,1,3,Diaryan Aleksandr,Rafayelyan Edgar,fiurst,Diaryan Aleksandr - Rafayelyan Edgar,73,35,38,3,-3,19,16,18,20,0,3,-6,4,2,0,3,8:11 - 11:5 - 7:11 - 9:11 - 0:0
16196569,2024-01-09 11:50:00,Mkrtchyan Andranik - Arutyunov Ruben,2:3,11:9 - 3:11 - 9:11 - 11:5 - 13:11,3,2,Mkrtchyan Andranik,Arutyunov Ruben,fiurst,Arutyunov Ruben - Mkrtchyan Andranik,94,47,47,0,0,20,14,20,16,24,2,-8,-2,6,2,0,9:11 - 11:3 - 11:9 - 5:11 - 11:13
16196566,2024-01-09 11:30:00,Diaryan Aleksandr - Nikoghosyan Narek,2:3,9:11 - 11:5 - 13:11 - 10:12 - 7:11,2,3,Diaryan Aleksandr,Nikoghosyan Narek,fiurst,Diaryan Aleksandr - Nikoghosyan Narek,100,50,50,0,0,20,16,24,22,18,2,-6,-2,2,4,0,9:11 - 11:5 - 13:11 - 10:12 - 7:11
16196565,2024-01-09 11:25:00,Rafayelyan Edgar - Mkrtchyan Andranik,0:3,11:5 - 12:10 - 11:4 - 0:0 - 0:0,3,0,Rafayelyan Edgar,Mkrtchyan Andranik,fiurst,Mkrtchyan Andranik - Rafayelyan Edgar,53,19,34,15,-15,16,22,15,0,0,6,2,7,0,0,15,5:11 - 10:12 - 4:11 - 0:0 - 0:0
16196561,2024-01-09 11:00:00,Arutyunov Ruben - Diaryan Aleksandr,0:3,3:11 - 8:11 - 5:11 - 0:0 - 0:0,0,3,Arutyunov Ruben,Diaryan Aleksandr,fiurst,Arutyunov Ruben - Diaryan Aleksandr,49,16,33,17,-17,14,19,16,0,0,8,3,6,0,0,17,3:11 - 8:11 - 5:11 - 0:0 - 0:0
16196558,2024-01-09 10:55:00,Nikoghosyan Narek - Mkrtchyan Andranik,0:3,11:5 - 11:7 - 11:5 - 0:0 - 0:0,3,0,Nikoghosyan Narek,Mkrtchyan Andranik,fiurst,Mkrtchyan Andranik - Nikoghosyan Narek,50,17,33,16,-16,16,18,16,0,0,6,4,6,0,0,16,5:11 - 7:11 - 5:11 - 0:0 - 0:0
16196555,2024-01-09 10:30:00,Rafayelyan Edgar - Arutyunov Ruben,0:3,11:5 - 12:10 - 12:10 - 0:0 - 0:0,3,0,Rafayelyan Edgar,Arutyunov Ruben,fiurst,Arutyunov Ruben - Rafayelyan Edgar,60,25,35,10,-10,16,22,22,0,0,6,2,2,0,0,10,5:11 - 10:12 - 10:12 - 0:0 - 0:0
16196540,2024-01-09 10:15:00,Mkrtchyan Andranik - Diaryan Aleksandr,3:2,12:14 - 13:11 - 11:6 - 1:11 - 7:11,2,3,Mkrtchyan Andranik,Diaryan Aleksandr,fiurst,Diaryan Aleksandr - Mkrtchyan Andranik,97,53,44,-9,9,26,24,17,12,18,-2,2,5,-10,-4,-9,14:12 - 11:13 - 6:11 - 11:1 - 11:7
16196537,2024-01-09 10:00:00,Nikoghosyan Narek - Rafayelyan Edgar,1:3,11:9 - 9:11 - 6:11 - 6:11 - 0:0,1,3,Nikoghosyan Narek,Rafayelyan Edgar,fiurst,Nikoghosyan Narek - Rafayelyan Edgar,74,32,42,10,-10,20,20,17,17,0,-2,2,5,5,0,10,11:9 - 9:11 - 6:11 - 6:11 - 0:0
16178793,2024-01-08 17:45:00,Avakimyan Davit - Grigoryan Erik,3:0,11:7 - 11:7 - 11:5 - 0:0 - 0:0,3,0,Avakimyan Davit,Grigoryan Erik,fiurst,Avakimyan Davit - Grigoryan Erik,52,33,19,-14,14,18,18,16,0,0,-4,-4,-6,0,0,-14,11:7 - 11:7 - 11:5 - 0:0 - 0:0
16178783,2024-01-08 17:35:00,Darbinyan Armen - Gevorgyan Hayk,0:3,7:11 - 4:11 - 4:11 - 0:0 - 0:0,0,3,Darbinyan Armen,Gevorgyan Hayk,fiurst,Darbinyan Armen - Gevorgyan Hayk,48,15,33,18,-18,18,15,15,0,0,4,7,7,0,0,18,7:11 - 4:11 - 4:11 - 0:0 - 0:0
16178782,2024-01-08 17:15:00,Gevorgyan Gegham - Avakimyan Davit,3:1,12:10 - 7:11 - 5:11 - 11:13 - 0:0,1,3,Gevorgyan Gegham,Avakimyan Davit,fiurst,Avakimyan Davit - Gevorgyan Gegham,80,45,35,-10,10,22,18,16,24,0,2,-4,-6,-2,0,-10,10:12 - 11:7 - 11:5 - 13:11 - 0:0
16178781,2024-01-08 17:00:00,Darbinyan Armen - Grigoryan Erik,3:0,11:4 - 12:10 - 13:11 - 0:0 - 0:0,3,0,Darbinyan Armen,Grigoryan Erik,fiurst,Darbinyan Armen - Grigoryan Erik,61,36,25,-11,11,15,22,24,0,0,-7,-2,-2,0,0,-11,11:4 - 12:10 - 13:11 - 0:0 - 0:0
16178768,2024-01-08 16:45:00,Gevorgyan Hayk - Gevorgyan Gegham,1:3,12:10 - 8:11 - 11:6 - 11:2 - 0:0,3,1,Gevorgyan Hayk,Gevorgyan Gegham,fiurst,Gevorgyan Gegham - Gevorgyan Hayk,71,29,42,13,-13,22,19,17,13,0,2,-3,5,9,0,13,10:12 - 11:8 - 6:11 - 2:11 - 0:0
16178758,2024-01-08 16:35:00,Avakimyan Davit - Darbinyan Armen,3:1,14:16 - 11:5 - 11:6 - 11:6 - 0:0,3,1,Avakimyan Davit,Darbinyan Armen,fiurst,Avakimyan Davit - Darbinyan Armen,80,47,33,-14,14,30,16,17,17,0,2,-6,-5,-5,0,-14,14:16 - 11:5 - 11:6 - 11:6 - 0:0
16178748,2024-01-08 16:15:00,Grigoryan Erik - Gevorgyan Gegham,3:1,6:11 - 7:11 - 11:2 - 12:14 - 0:0,1,3,Grigoryan Erik,Gevorgyan Gegham,fiurst,Gevorgyan Gegham - Grigoryan Erik,74,38,36,-2,2,17,18,13,26,0,-5,-4,9,-2,0,-2,11:6 - 11:7 - 2:11 - 14:12 - 0:0
16178738,2024-01-08 16:00:00,Gevorgyan Hayk - Avakimyan Davit,2:3,9:11 - 11:7 - 10:12 - 11:3 - 11:5,3,2,Gevorgyan Hayk,Avakimyan Davit,fiurst,Avakimyan Davit - Gevorgyan Hayk,90,38,52,14,-14,20,18,22,14,16,-2,4,-2,8,6,14,11:9 - 7:11 - 12:10 - 3:11 - 5:11
16178736,2024-01-08 15:45:00,Gevorgyan Gegham - Darbinyan Armen,0:3,11:4 - 11:5 - 11:4 - 0:0 - 0:0,3,0,Gevorgyan Gegham,Darbinyan Armen,fiurst,Darbinyan Armen - Gevorgyan Gegham,46,13,33,20,-20,15,16,15,0,0,7,6,7,0,0,20,4:11 - 5:11 - 4:11 - 0:0 - 0:0
16178734,2024-01-08 15:30:00,Grigoryan Erik - Gevorgyan Hayk,3:0,9:11 - 4:11 - 8:11 - 0:0 - 0:0,0,3,Grigoryan Erik,Gevorgyan Hayk,fiurst,Gevorgyan Hayk - Grigoryan Erik,54,33,21,-12,12,20,15,19,0,0,-2,-7,-3,0,0,-12,11:9 - 11:4 - 11:8 - 0:0 - 0:0
16178731,2024-01-08 15:15:00,Papyan Karen - Diaryan Aleksandr,1:3,12:10 - 17:15 - 11:13 - 11:8 - 0:0,3,1,Papyan Karen,Diaryan Aleksandr,fiurst,Diaryan Aleksandr - Papyan Karen,97,46,51,5,-5,22,32,24,19,0,2,2,-2,3,0,5,10:12 - 15:17 - 13:11 - 8:11 - 0:0
16178718,2024-01-08 15:00:00,Soghomonyan Hrayr - Mkrtchyan Andranik,3:0,9:11 - 11:13 - 8:11 - 0:0 - 0:0,0,3,Soghomonyan Hrayr,Mkrtchyan Andranik,fiurst,Mkrtchyan Andranik - Soghomonyan Hrayr,63,35,28,-7,7,20,24,19,0,0,-2,-2,-3,0,0,-7,11:9 - 13:11 - 11:8 - 0:0 - 0:0
16178715,2024-01-08 14:55:00,Arutyunov Ruben - Papyan Karen,1:3,11:4 - 11:13 - 11:13 - 8:11 - 0:0,1,3,Arutyunov Ruben,Papyan Karen,fiurst,Arutyunov Ruben - Papyan Karen,82,41,41,0,0,15,24,24,19,0,-7,2,2,3,0,0,11:4 - 11:13 - 11:13 - 8:11 - 0:0
16178712,2024-01-08 14:30:00,Diaryan Aleksandr - Soghomonyan Hrayr,3:1,11:8 - 9:11 - 12:10 - 11:5 - 0:0,3,1,Diaryan Aleksandr,Soghomonyan Hrayr,fiurst,Diaryan Aleksandr - Soghomonyan Hrayr,77,43,34,-9,9,19,20,22,16,0,-3,2,-2,-6,0,-9,11:8 - 9:11 - 12:10 - 11:5 - 0:0
16178708,2024-01-08 14:15:00,Arutyunov Ruben - Mkrtchyan Andranik,2:3,11:5 - 10:12 - 7:11 - 11:3 - 8:11,2,3,Arutyunov Ruben,Mkrtchyan Andranik,fiurst,Arutyunov Ruben - Mkrtchyan Andranik,89,47,42,-5,5,16,22,18,14,19,-6,2,4,-8,3,-5,11:5 - 10:12 - 7:11 - 11:3 - 8:11
16178702,2024-01-08 14:00:00,Papyan Karen - Soghomonyan Hrayr,3:2,7:11 - 12:10 - 12:10 - 3:11 - 11:8,3,2,Papyan Karen,Soghomonyan Hrayr,fiurst,Papyan Karen - Soghomonyan Hrayr,95,45,50,5,-5,18,22,22,14,19,4,-2,-2,8,-3,5,7:11 - 12:10 - 12:10 - 3:11 - 11:8
16178699,2024-01-08 13:55:00,Diaryan Aleksandr - Arutyunov Ruben,0:3,11:6 - 11:3 - 11:1 - 0:0 - 0:0,3,0,Diaryan Aleksandr,Arutyunov Ruben,fiurst,Arutyunov Ruben - Diaryan Aleksandr,43,10,33,23,-23,17,14,12,0,0,5,8,10,0,0,23,6:11 - 3:11 - 1:11 - 0:0 - 0:0
16178694,2024-01-08 13:35:00,Mkrtchyan Andranik - Papyan Karen,0:3,8:11 - 7:11 - 5:11 - 0:0 - 0:0,0,3,Mkrtchyan Andranik,Papyan Karen,fiurst,Mkrtchyan Andranik - Papyan Karen,53,20,33,13,-13,19,18,16,0,0,3,4,6,0,0,13,8:11 - 7:11 - 5:11 - 0:0 - 0:0
16178690,2024-01-08 13:15:00,Soghomonyan Hrayr - Arutyunov Ruben,1:3,11:6 - 9:11 - 14:12 - 11:8 - 0:0,3,1,Soghomonyan Hrayr,Arutyunov Ruben,fiurst,Arutyunov Ruben - Soghomonyan Hrayr,82,37,45,8,-8,17,20,26,19,0,5,-2,2,3,0,8,6:11 - 11:9 - 12:14 - 8:11 - 0:0
16178687,2024-01-08 13:00:00,Mkrtchyan Andranik - Diaryan Aleksandr,3:1,5:11 - 5:11 - 13:11 - 9:11 - 0:0,1,3,Mkrtchyan Andranik,Diaryan Aleksandr,fiurst,Diaryan Aleksandr - Mkrtchyan Andranik,76,44,32,-12,12,16,16,24,20,0,-6,-6,2,-2,0,-12,11:5 - 11:5 - 11:13 - 11:9 - 0:0
16178673,2024-01-08 12:15:00,Papyan Karen - Arutyunov Ruben,1:3,5:11 - 11:9 - 11:7 - 11:5 - 0:0,3,1,Papyan Karen,Arutyunov Ruben,fiurst,Arutyunov Ruben - Papyan Karen,70,32,38,6,-6,16,20,18,16,0,-6,2,4,6,0,6,11:5 - 9:11 - 7:11 - 5:11 - 0:0
16178670,2024-01-08 12:00:00,Mkrtchyan Andranik - Soghomonyan Hrayr,1:3,7:11 - 11:4 - 4:11 - 5:11 - 0:0,1,3,Mkrtchyan Andranik,Soghomonyan Hrayr,fiurst,Mkrtchyan Andranik - Soghomonyan Hrayr,64,27,37,10,-10,18,15,15,16,0,4,-7,7,6,0,10,7:11 - 11:4 - 4:11 - 5:11 - 0:0
16178662,2024-01-08 11:45:00,Diaryan Aleksandr - Papyan Karen,3:1,7:11 - 11:8 - 11:5 - 11:2 - 0:0,3,1,Diaryan Aleksandr,Papyan Karen,fiurst,Diaryan Aleksandr - Papyan Karen,66,40,26,-14,14,18,19,16,13,0,4,-3,-6,-9,0,-14,7:11 - 11:8 - 11:5 - 11:2 - 0:0
16178659,2024-01-08 11:30:00,Mkrtchyan Andranik - Arutyunov Ruben,3:0,5:11 - 6:11 - 3:11 - 0:0 - 0:0,0,3,Mkrtchyan Andranik,Arutyunov Ruben,fiurst,Arutyunov Ruben - Mkrtchyan Andranik,47,33,14,-19,19,16,17,14,0,0,-6,-5,-8,0,0,-19,11:5 - 11:6 - 11:3 - 0:0 - 0:0
16178657,2024-01-08 11:15:00,Soghomonyan Hrayr - Diaryan Aleksandr,3:0,8:11 - 6:11 - 10:12 - 0:0 - 0:0,0,3,Soghomonyan Hrayr,Diaryan Aleksandr,fiurst,Diaryan Aleksandr - Soghomonyan Hrayr,58,34,24,-10,10,19,17,22,0,0,-3,-5,-2,0,0,-10,11:8 - 11:6 - 12:10 - 0:0 - 0:0
16178656,2024-01-08 11:00:00,Papyan Karen - Mkrtchyan Andranik,1:3,8:11 - 11:7 - 11:3 - 11:7 - 0:0,3,1,Papyan Karen,Mkrtchyan Andranik,fiurst,Mkrtchyan Andranik - Papyan Karen,69,28,41,13,-13,19,18,14,18,0,-3,4,8,4,0,13,11:8 - 7:11 - 3:11 - 7:11 - 0:0
16178643,2024-01-08 10:45:00,Arutyunov Ruben - Diaryan Aleksandr,1:3,4:11 - 11:6 - 5:11 - 10:12 - 0:0,1,3,Arutyunov Ruben,Diaryan Aleksandr,fiurst,Arutyunov Ruben - Diaryan Aleksandr,70,30,40,10,-10,15,17,16,22,0,7,-5,6,2,0,10,4:11 - 11:6 - 5:11 - 10:12 - 0:0
16178636,2024-01-08 10:35:00,Soghomonyan Hrayr - Papyan Karen,3:1,11:6 - 9:11 - 7:11 - 4:11 - 0:0,1,3,Soghomonyan Hrayr,Papyan Karen,fiurst,Papyan Karen - Soghomonyan Hrayr,70,39,31,-8,8,17,20,18,15,0,5,-2,-4,-7,0,-8,6:11 - 11:9 - 11:7 - 11:4 - 0:0
16178633,2024-01-08 10:15:00,Diaryan Aleksandr - Mkrtchyan Andranik,3:0,11:4 - 11:7 - 11:3 - 0:0 - 0:0,3,0,Diaryan Aleksandr,Mkrtchyan Andranik,fiurst,Diaryan Aleksandr - Mkrtchyan Andranik,47,33,14,-19,19,15,18,14,0,0,-7,-4,-8,0,0,-19,11:4 - 11:7 - 11:3 - 0:0 - 0:0
16178632,2024-01-08 10:00:00,Arutyunov Ruben - Soghomonyan Hrayr,3:2,9:11 - 6:11 - 12:10 - 11:4 - 11:4,3,2,Arutyunov Ruben,Soghomonyan Hrayr,fiurst,Arutyunov Ruben - Soghomonyan Hrayr,89,49,40,-9,9,20,17,22,15,15,2,5,-2,-7,-7,-9,9:11 - 6:11 - 12:10 - 11:4 - 11:4
16161470,2024-01-07 17:45:00,Karakhanyan Mher - Darbinyan Armen,3:1,11:8 - 8:11 - 9:11 - 7:11 - 0:0,1,3,Karakhanyan Mher,Darbinyan Armen,fiurst,Darbinyan Armen - Karakhanyan Mher,76,41,35,-6,6,19,19,20,18,0,3,-3,-2,-4,0,-6,8:11 - 11:8 - 11:9 - 11:7 - 0:0
16161468,2024-01-07 17:30:00,Avakimyan Davit - Gevorgyan Hayk,2:3,5:11 - 11:5 - 8:11 - 11:5 - 5:11,2,3,Avakimyan Davit,Gevorgyan Hayk,fiurst,Avakimyan Davit - Gevorgyan Hayk,83,40,43,3,-3,16,16,19,16,16,6,-6,3,-6,6,3,5:11 - 11:5 - 8:11 - 11:5 - 5:11
16161466,2024-01-07 17:15:00,Miroyan Hakob - Karakhanyan Mher,3:0,8:11 - 8:11 - 8:11 - 0:0 - 0:0,0,3,Miroyan Hakob,Karakhanyan Mher,fiurst,Karakhanyan Mher - Miroyan Hakob,57,33,24,-9,9,19,19,19,0,0,-3,-3,-3,0,0,-9,11:8 - 11:8 - 11:8 - 0:0 - 0:0
16161464,2024-01-07 17:00:00,Avakimyan Davit - Darbinyan Armen,3:1,11:9 - 11:8 - 8:11 - 11:7 - 0:0,3,1,Avakimyan Davit,Darbinyan Armen,fiurst,Avakimyan Davit - Darbinyan Armen,76,41,35,-6,6,20,19,19,18,0,-2,-3,3,-4,0,-6,11:9 - 11:8 - 8:11 - 11:7 - 0:0
16161463,2024-01-07 16:45:00,Gevorgyan Hayk - Miroyan Hakob,3:0,12:10 - 11:4 - 11:9 - 0:0 - 0:0,3,0,Gevorgyan Hayk,Miroyan Hakob,fiurst,Gevorgyan Hayk - Miroyan Hakob,57,34,23,-11,11,22,15,20,0,0,-2,-7,-2,0,0,-11,12:10 - 11:4 - 11:9 - 0:0 - 0:0
16161462,2024-01-07 16:30:00,Karakhanyan Mher - Avakimyan Davit,3:0,8:11 - 3:11 - 10:12 - 0:0 - 0:0,0,3,Karakhanyan Mher,Avakimyan Davit,fiurst,Avakimyan Davit - Karakhanyan Mher,55,34,21,-13,13,19,14,22,0,0,-3,-8,-2,0,0,-13,11:8 - 11:3 - 12:10 - 0:0 - 0:0
16161458,2024-01-07 16:15:00,Darbinyan Armen - Miroyan Hakob,3:0,11:8 - 11:8 - 11:7 - 0:0 - 0:0,3,0,Darbinyan Armen,Miroyan Hakob,fiurst,Darbinyan Armen - Miroyan Hakob,56,33,23,-10,10,19,19,18,0,0,-3,-3,-4,0,0,-10,11:8 - 11:8 - 11:7 - 0:0 - 0:0
16161446,2024-01-07 16:00:00,Gevorgyan Hayk - Karakhanyan Mher,3:1,12:10 - 10:12 - 11:7 - 11:6 - 0:0,3,1,Gevorgyan Hayk,Karakhanyan Mher,fiurst,Gevorgyan Hayk - Karakhanyan Mher,79,44,35,-9,9,22,22,18,17,0,-2,2,-4,-5,0,-9,12:10 - 10:12 - 11:7 - 11:6 - 0:0
16161443,2024-01-07 15:45:00,Miroyan Hakob - Avakimyan Davit,3:2,5:11 - 13:11 - 10:12 - 11:9 - 9:11,2,3,Miroyan Hakob,Avakimyan Davit,fiurst,Avakimyan Davit - Miroyan Hakob,102,54,48,-6,6,16,24,22,20,20,-6,2,-2,2,-2,-6,11:5 - 11:13 - 12:10 - 9:11 - 11:9
16161442,2024-01-07 15:30:00,Darbinyan Armen - Gevorgyan Hayk,2:3,10:12 - 11:8 - 11:7 - 7:11 - 6:11,2,3,Darbinyan Armen,Gevorgyan Hayk,fiurst,Darbinyan Armen - Gevorgyan Hayk,94,45,49,4,-4,22,19,18,18,17,2,-3,-4,4,5,4,10:12 - 11:8 - 11:7 - 7:11 - 6:11
16161440,2024-01-07 15:20:00,Soghomonyan Hrayr - Rafayelyan Edgar,3:0,5:11 - 8:11 - 12:14 - 0:0 - 0:0,0,3,Soghomonyan Hrayr,Rafayelyan Edgar,fiurst,Rafayelyan Edgar - Soghomonyan Hrayr,61,36,25,-11,11,16,19,26,0,0,-6,-3,-2,0,0,-11,11:5 - 11:8 - 14:12 - 0:0 - 0:0
16161437,2024-01-07 15:00:00,Diaryan Aleksandr - Soghomonyan Hrayr,3:1,11:2 - 12:14 - 11:8 - 11:4 - 0:0,3,1,Diaryan Aleksandr,Soghomonyan Hrayr,fiurst,Diaryan Aleksandr - Soghomonyan Hrayr,73,45,28,-17,17,13,26,19,15,0,-9,2,-3,-7,0,-17,11:2 - 12:14 - 11:8 - 11:4 - 0:0
16161438,2024-01-07 15:00:00,Papyan Karen - Nikoghosyan Narek,3:2,3:11 - 12:10 - 11:5 - 8:11 - 8:11,2,3,Papyan Karen,Nikoghosyan Narek,fiurst,Nikoghosyan Narek - Papyan Karen,90,48,42,-6,6,14,22,16,19,19,-8,2,6,-3,-3,-6,11:3 - 10:12 - 5:11 - 11:8 - 11:8
16161433,2024-01-07 14:40:00,Rafayelyan Edgar - Papyan Karen,0:3,11:3 - 11:7 - 11:5 - 0:0 - 0:0,3,0,Rafayelyan Edgar,Papyan Karen,fiurst,Papyan Karen - Rafayelyan Edgar,48,15,33,18,-18,14,18,16,0,0,8,4,6,0,0,18,3:11 - 7:11 - 5:11 - 0:0 - 0:0
16161431,2024-01-07 14:20:00,Diaryan Aleksandr - Nikoghosyan Narek,1:3,10:12 - 12:10 - 6:11 - 13:15 - 0:0,1,3,Diaryan Aleksandr,Nikoghosyan Narek,fiurst,Diaryan Aleksandr - Nikoghosyan Narek,89,41,48,7,-7,22,22,17,28,0,2,-2,5,2,0,7,10:12 - 12:10 - 6:11 - 13:15 - 0:0
16161429,2024-01-07 14:00:00,Soghomonyan Hrayr - Papyan Karen,3:2,6:11 - 11:8 - 11:1 - 7:11 - 14:16,2,3,Soghomonyan Hrayr,Papyan Karen,fiurst,Papyan Karen - Soghomonyan Hrayr,96,47,49,2,-2,17,19,12,18,30,-5,3,10,-4,-2,2,11:6 - 8:11 - 1:11 - 11:7 - 16:14
16161428,2024-01-07 13:45:00,Rafayelyan Edgar - Diaryan Aleksandr,2:3,11:8 - 6:11 - 4:11 - 11:8 - 11:8,3,2,Rafayelyan Edgar,Diaryan Aleksandr,fiurst,Diaryan Aleksandr - Rafayelyan Edgar,89,46,43,-3,3,19,17,15,19,19,3,-5,-7,3,3,-3,8:11 - 11:6 - 11:4 - 8:11 - 8:11
16161425,2024-01-07 13:40:00,Nikoghosyan Narek - Soghomonyan Hrayr,3:0,11:7 - 11:5 - 11:8 - 0:0 - 0:0,3,0,Nikoghosyan Narek,Soghomonyan Hrayr,fiurst,Nikoghosyan Narek - Soghomonyan Hrayr,53,33,20,-13,13,18,16,19,0,0,-4,-6,-3,0,0,-13,11:7 - 11:5 - 11:8 - 0:0 - 0:0
16161423,2024-01-07 13:15:00,Papyan Karen - Diaryan Aleksandr,3:0,7:11 - 7:11 - 4:11 - 0:0 - 0:0,0,3,Papyan Karen,Diaryan Aleksandr,fiurst,Diaryan Aleksandr - Papyan Karen,51,33,18,-15,15,18,18,15,0,0,-4,-4,-7,0,0,-15,11:7 - 11:7 - 11:4 - 0:0 - 0:0
16161418,2024-01-07 13:00:00,Nikoghosyan Narek - Rafayelyan Edgar,3:2,11:9 - 6:11 - 4:11 - 11:9 - 11:4,3,2,Nikoghosyan Narek,Rafayelyan Edgar,fiurst,Nikoghosyan Narek - Rafayelyan Edgar,87,43,44,1,-1,20,17,15,20,15,-2,5,7,-2,-7,1,11:9 - 6:11 - 4:11 - 11:9 - 11:4
16161409,2024-01-07 12:15:00,Soghomonyan Hrayr - Diaryan Aleksandr,3:0,7:11 - 2:11 - 2:11 - 0:0 - 0:0,0,3,Soghomonyan Hrayr,Diaryan Aleksandr,fiurst,Diaryan Aleksandr - Soghomonyan Hrayr,44,33,11,-22,22,18,13,13,0,0,-4,-9,-9,0,0,-22,11:7 - 11:2 - 11:2 - 0:0 - 0:0
16161407,2024-01-07 12:10:00,Nikoghosyan Narek - Papyan Karen,2:3,11:6 - 11:9 - 4:11 - 8:11 - 9:11,2,3,Nikoghosyan Narek,Papyan Karen,fiurst,Nikoghosyan Narek - Papyan Karen,91,43,48,5,-5,17,20,15,19,20,-5,-2,7,3,2,5,11:6 - 11:9 - 4:11 - 8:11 - 9:11
16161405,2024-01-07 11:45:00,Rafayelyan Edgar - Soghomonyan Hrayr,3:0,11:7 - 11:6 - 11:6 - 0:0 - 0:0,3,0,Rafayelyan Edgar,Soghomonyan Hrayr,fiurst,Rafayelyan Edgar - Soghomonyan Hrayr,52,33,19,-14,14,18,17,17,0,0,-4,-5,-5,0,0,-14,11:7 - 11:6 - 11:6 - 0:0 - 0:0
16161402,2024-01-07 11:30:00,Nikoghosyan Narek - Diaryan Aleksandr,2:3,8:11 - 8:11 - 11:8 - 11:4 - 11:8,3,2,Nikoghosyan Narek,Diaryan Aleksandr,fiurst,Diaryan Aleksandr - Nikoghosyan Narek,91,42,49,7,-7,19,19,19,15,19,-3,-3,3,7,3,7,11:8 - 11:8 - 8:11 - 4:11 - 8:11
16161398,2024-01-07 11:20:00,Papyan Karen - Rafayelyan Edgar,0:3,4:11 - 8:11 - 2:11 - 0:0 - 0:0,0,3,Papyan Karen,Rafayelyan Edgar,fiurst,Papyan Karen - Rafayelyan Edgar,47,14,33,19,-19,15,19,13,0,0,7,3,9,0,0,19,4:11 - 8:11 - 2:11 - 0:0 - 0:0
16161396,2024-01-07 11:00:00,Soghomonyan Hrayr - Nikoghosyan Narek,3:0,7:11 - 6:11 - 5:11 - 0:0 - 0:0,0,3,Soghomonyan Hrayr,Nikoghosyan Narek,fiurst,Nikoghosyan Narek - Soghomonyan Hrayr,51,33,18,-15,15,18,17,16,0,0,-4,-5,-6,0,0,-15,11:7 - 11:6 - 11:5 - 0:0 - 0:0
16125225,2024-01-07 10:45:00,Diaryan Aleksandr - Rafayelyan Edgar,3:1,11:4 - 11:3 - 7:11 - 11:9 - 0:0,3,1,Diaryan Aleksandr,Rafayelyan Edgar,fiurst,Diaryan Aleksandr - Rafayelyan Edgar,67,40,27,-13,13,15,14,18,20,0,-7,-8,4,-2,0,-13,11:4 - 11:3 - 7:11 - 11:9 - 0:0
16125215,2024-01-07 10:35:00,Papyan Karen - Soghomonyan Hrayr,3:0,11:9 - 11:7 - 11:7 - 0:0 - 0:0,3,0,Papyan Karen,Soghomonyan Hrayr,fiurst,Papyan Karen - Soghomonyan Hrayr,56,33,23,-10,10,20,18,18,0,0,-2,-4,-4,0,0,-10,11:9 - 11:7 - 11:7 - 0:0 - 0:0
16125193,2024-01-07 10:15:00,Rafayelyan Edgar - Nikoghosyan Narek,0:3,11:4 - 11:1 - 11:6 - 0:0 - 0:0,3,0,Rafayelyan Edgar,Nikoghosyan Narek,fiurst,Nikoghosyan Narek - Rafayelyan Edgar,44,11,33,22,-22,15,12,17,0,0,7,10,5,0,0,22,4:11 - 1:11 - 6:11 - 0:0 - 0:0
16125188,2024-01-07 10:10:00,Diaryan Aleksandr - Papyan Karen,3:2,14:16 - 11:7 - 5:11 - 11:7 - 11:5,3,2,Diaryan Aleksandr,Papyan Karen,fiurst,Diaryan Aleksandr - Papyan Karen,98,52,46,-6,6,30,18,16,18,16,2,-4,6,-4,-6,-6,14:16 - 11:7 - 5:11 - 11:7 - 11:5
16142610,2024-01-06 17:45:00,Gevorgyan Hayk - Miroyan Hakob,3:0,11:5 - 11:9 - 11:3 - 0:0 - 0:0,3,0,Gevorgyan Hayk,Miroyan Hakob,fiurst,Gevorgyan Hayk - Miroyan Hakob,50,33,17,-16,16,16,20,14,0,0,-6,-2,-8,0,0,-16,11:5 - 11:9 - 11:3 - 0:0 - 0:0
16142606,2024-01-06 17:30:00,Karakhanyan Mher - Gevorgyan Gegham,3:0,5:11 - 7:11 - 10:12 - 0:0 - 0:0,0,3,Karakhanyan Mher,Gevorgyan Gegham,fiurst,Gevorgyan Gegham - Karakhanyan Mher,56,34,22,-12,12,16,18,22,0,0,-6,-4,-2,0,0,-12,11:5 - 11:7 - 12:10 - 0:0 - 0:0
16142601,2024-01-06 17:15:00,Grigoryan Erik - Gevorgyan Hayk,3:1,9:11 - 11:3 - 7:11 - 6:11 - 0:0,1,3,Grigoryan Erik,Gevorgyan Hayk,fiurst,Gevorgyan Hayk - Grigoryan Erik,69,36,33,-3,3,20,14,18,17,0,-2,8,-4,-5,0,-3,11:9 - 3:11 - 11:7 - 11:6 - 0:0
16142585,2024-01-06 17:00:00,Karakhanyan Mher - Miroyan Hakob,3:1,11:3 - 8:11 - 11:7 - 11:9 - 0:0,3,1,Karakhanyan Mher,Miroyan Hakob,fiurst,Karakhanyan Mher - Miroyan Hakob,71,41,30,-11,11,14,19,18,20,0,-8,3,-4,-2,0,-11,11:3 - 8:11 - 11:7 - 11:9 - 0:0
16142581,2024-01-06 16:45:00,Gevorgyan Gegham - Grigoryan Erik,0:3,8:11 - 5:11 - 9:11 - 0:0 - 0:0,0,3,Gevorgyan Gegham,Grigoryan Erik,fiurst,Gevorgyan Gegham - Grigoryan Erik,55,22,33,11,-11,19,16,20,0,0,3,6,2,0,0,11,8:11 - 5:11 - 9:11 - 0:0 - 0:0
16142564,2024-01-06 16:30:00,Gevorgyan Hayk - Karakhanyan Mher,3:0,11:5 - 11:5 - 11:9 - 0:0 - 0:0,3,0,Gevorgyan Hayk,Karakhanyan Mher,fiurst,Gevorgyan Hayk - Karakhanyan Mher,52,33,19,-14,14,16,16,20,0,0,-6,-6,-2,0,0,-14,11:5 - 11:5 - 11:9 - 0:0 - 0:0
16142556,2024-01-06 16:20:00,Miroyan Hakob - Grigoryan Erik,3:0,10:12 - 1:11 - 6:11 - 0:0 - 0:0,0,3,Miroyan Hakob,Grigoryan Erik,fiurst,Grigoryan Erik - Miroyan Hakob,51,34,17,-17,17,22,12,17,0,0,-2,-10,-5,0,0,-17,12:10 - 11:1 - 11:6 - 0:0 - 0:0
16142540,2024-01-06 16:05:00,Gevorgyan Gegham - Gevorgyan Hayk,0:3,6:11 - 0:11 - 7:11 - 0:0 - 0:0,0,3,Gevorgyan Gegham,Gevorgyan Hayk,fiurst,Gevorgyan Gegham - Gevorgyan Hayk,46,13,33,20,-20,17,11,18,0,0,5,11,4,0,0,20,6:11 - 0:11 - 7:11 - 0:0 - 0:0
16142535,2024-01-06 15:50:00,Grigoryan Erik - Karakhanyan Mher,3:1,6:11 - 11:6 - 11:9 - 11:7 - 0:0,3,1,Grigoryan Erik,Karakhanyan Mher,fiurst,Grigoryan Erik - Karakhanyan Mher,72,39,33,-6,6,17,17,20,18,0,5,-5,-2,-4,0,-6,6:11 - 11:6 - 11:9 - 11:7 - 0:0
16142531,2024-01-06 15:30:00,Miroyan Hakob - Gevorgyan Gegham,3:1,14:12 - 10:12 - 5:11 - 10:12 - 0:0,1,3,Miroyan Hakob,Gevorgyan Gegham,fiurst,Gevorgyan Gegham - Miroyan Hakob,86,47,39,-8,8,26,22,16,22,0,2,-2,-6,-2,0,-8,12:14 - 12:10 - 11:5 - 12:10 - 0:0
16142528,2024-01-06 15:25:00,Arutyunov Ruben - Nikoghosyan Narek,1:3,12:14 - 11:6 - 3:11 - 2:11 - 0:0,1,3,Arutyunov Ruben,Nikoghosyan Narek,fiurst,Arutyunov Ruben - Nikoghosyan Narek,70,28,42,14,-14,26,17,14,13,0,2,-5,8,9,0,14,12:14 - 11:6 - 3:11 - 2:11 - 0:0
16142525,2024-01-06 15:20:00,Rafayelyan Edgar - Papyan Karen,0:3,11:4 - 11:5 - 11:9 - 0:0 - 0:0,3,0,Rafayelyan Edgar,Papyan Karen,fiurst,Papyan Karen - Rafayelyan Edgar,51,18,33,15,-15,15,16,20,0,0,7,6,2,0,0,15,4:11 - 5:11 - 9:11 - 0:0 - 0:0
16142522,2024-01-06 14:45:00,Gevorgyan Hayk - Arutyunov Ruben,3:2,11:7 - 7:11 - 3:11 - 11:6 - 4:11,2,3,Gevorgyan Hayk,Arutyunov Ruben,fiurst,Arutyunov Ruben - Gevorgyan Hayk,82,46,36,-10,10,18,18,14,17,15,4,-4,-8,5,-7,-10,7:11 - 11:7 - 11:3 - 6:11 - 11:4
16142510,2024-01-06 14:40:00,Nikoghosyan Narek - Rafayelyan Edgar,1:3,11:8 - 10:12 - 11:13 - 10:12 - 0:0,1,3,Nikoghosyan Narek,Rafayelyan Edgar,fiurst,Nikoghosyan Narek - Rafayelyan Edgar,87,42,45,3,-3,19,22,24,22,0,-3,2,2,2,0,3,11:8 - 10:12 - 11:13 - 10:12 - 0:0
16142503,2024-01-06 14:20:00,Arutyunov Ruben - Rafayelyan Edgar,1:3,13:11 - 7:11 - 2:11 - 9:11 - 0:0,1,3,Arutyunov Ruben,Rafayelyan Edgar,fiurst,Arutyunov Ruben - Rafayelyan Edgar,75,31,44,13,-13,24,18,13,20,0,-2,4,9,2,0,13,13:11 - 7:11 - 2:11 - 9:11 - 0:0
16142508,2024-01-06 14:15:00,Gevorgyan Hayk - Papyan Karen,3:1,11:8 - 11:3 - 9:11 - 11:8 - 0:0,3,1,Gevorgyan Hayk,Papyan Karen,fiurst,Gevorgyan Hayk - Papyan Karen,72,42,30,-12,12,19,14,20,19,0,-3,-8,2,-3,0,-12,11:8 - 11:3 - 9:11 - 11:8 - 0:0
16142498,2024-01-06 13:45:00,Nikoghosyan Narek - Gevorgyan Hayk,0:3,11:7 - 11:9 - 11:5 - 0:0 - 0:0,3,0,Nikoghosyan Narek,Gevorgyan Hayk,fiurst,Gevorgyan Hayk - Nikoghosyan Narek,54,21,33,12,-12,18,20,16,0,0,4,2,6,0,0,12,7:11 - 9:11 - 5:11 - 0:0 - 0:0
16142495,2024-01-06 13:40:00,Papyan Karen - Arutyunov Ruben,2:3,11:9 - 5:11 - 11:8 - 9:11 - 12:10,3,2,Papyan Karen,Arutyunov Ruben,fiurst,Arutyunov Ruben - Papyan Karen,97,49,48,-1,1,20,16,19,20,22,2,-6,3,-2,2,-1,9:11 - 11:5 - 8:11 - 11:9 - 10:12
16142489,2024-01-06 13:15:00,Rafayelyan Edgar - Gevorgyan Hayk,0:3,11:6 - 11:8 - 11:9 - 0:0 - 0:0,3,0,Rafayelyan Edgar,Gevorgyan Hayk,fiurst,Gevorgyan Hayk - Rafayelyan Edgar,56,23,33,10,-10,17,19,20,0,0,5,3,2,0,0,10,6:11 - 8:11 - 9:11 - 0:0 - 0:0
16142486,2024-01-06 13:00:00,Papyan Karen - Nikoghosyan Narek,2:3,11:4 - 10:12 - 4:11 - 11:4 - 11:7,3,2,Papyan Karen,Nikoghosyan Narek,fiurst,Nikoghosyan Narek - Papyan Karen,85,38,47,9,-9,15,22,15,15,18,7,-2,-7,7,4,9,4:11 - 12:10 - 11:4 - 4:11 - 7:11
16142467,2024-01-06 12:20:00,Papyan Karen - Rafayelyan Edgar,1:3,5:11 - 11:9 - 3:11 - 8:11 - 0:0,1,3,Papyan Karen,Rafayelyan Edgar,fiurst,Papyan Karen - Rafayelyan Edgar,69,27,42,15,-15,16,20,14,19,0,6,-2,8,3,0,15,5:11 - 11:9 - 3:11 - 8:11 - 0:0
16142474,2024-01-06 12:15:00,Arutyunov Ruben - Gevorgyan Hayk,3:0,11:4 - 11:3 - 11:4 - 0:0 - 0:0,3,0,Arutyunov Ruben,Gevorgyan Hayk,fiurst,Arutyunov Ruben - Gevorgyan Hayk,44,33,11,-22,22,15,14,15,0,0,-7,-8,-7,0,0,-22,11:4 - 11:3 - 11:4 - 0:0 - 0:0
16142463,2024-01-06 12:00:00,Nikoghosyan Narek - Arutyunov Ruben,0:3,11:0 - 11:6 - 11:9 - 0:0 - 0:0,3,0,Nikoghosyan Narek,Arutyunov Ruben,fiurst,Arutyunov Ruben - Nikoghosyan Narek,48,15,33,18,-18,11,17,20,0,0,11,5,2,0,0,18,0:11 - 6:11 - 9:11 - 0:0 - 0:0
16142461,2024-01-06 11:30:00,Papyan Karen - Gevorgyan Hayk,1:3,9:11 - 11:9 - 11:7 - 13:11 - 0:0,3,1,Papyan Karen,Gevorgyan Hayk,fiurst,Gevorgyan Hayk - Papyan Karen,82,38,44,6,-6,20,20,18,24,0,-2,2,4,2,0,6,11:9 - 9:11 - 7:11 - 11:13 - 0:0
16142460,2024-01-06 11:25:00,Rafayelyan Edgar - Nikoghosyan Narek,0:3,11:8 - 12:10 - 11:6 - 0:0 - 0:0,3,0,Rafayelyan Edgar,Nikoghosyan Narek,fiurst,Nikoghosyan Narek - Rafayelyan Edgar,58,24,34,10,-10,19,22,17,0,0,3,2,5,0,0,10,8:11 - 10:12 - 6:11 - 0:0 - 0:0
16142446,2024-01-06 11:15:00,Arutyunov Ruben - Papyan Karen,3:2,8:11 - 13:11 - 10:12 - 11:7 - 11:8,3,2,Arutyunov Ruben,Papyan Karen,fiurst,Arutyunov Ruben - Papyan Karen,102,53,49,-4,4,19,24,22,18,19,3,-2,2,-4,-3,-4,8:11 - 13:11 - 10:12 - 11:7 - 11:8
16142441,2024-01-06 10:45:00,Gevorgyan Hayk - Nikoghosyan Narek,2:3,6:11 - 9:11 - 11:6 - 11:6 - 9:11,2,3,Gevorgyan Hayk,Nikoghosyan Narek,fiurst,Gevorgyan Hayk - Nikoghosyan Narek,91,46,45,-1,1,17,20,17,17,20,5,2,-5,-5,2,-1,6:11 - 9:11 - 11:6 - 11:6 - 9:11
16142438,2024-01-06 10:30:00,Rafayelyan Edgar - Arutyunov Ruben,2:3,13:11 - 11:3 - 11:13 - 8:11 - 11:5,3,2,Rafayelyan Edgar,Arutyunov Ruben,fiurst,Arutyunov Ruben - Rafayelyan Edgar,97,43,54,11,-11,24,14,24,19,16,2,8,-2,-3,6,11,11:13 - 3:11 - 13:11 - 11:8 - 5:11
16142437,2024-01-06 10:20:00,Nikoghosyan Narek - Papyan Karen,3:2,8:11 - 11:6 - 11:8 - 8:11 - 12:10,3,2,Nikoghosyan Narek,Papyan Karen,fiurst,Nikoghosyan Narek - Papyan Karen,96,50,46,-4,4,19,17,19,19,22,3,-5,-3,3,-2,-4,8:11 - 11:6 - 11:8 - 8:11 - 12:10
16142431,2024-01-06 10:00:00,Gevorgyan Hayk - Rafayelyan Edgar,0:3,8:11 - 4:11 - 9:11 - 0:0 - 0:0,0,3,Gevorgyan Hayk,Rafayelyan Edgar,fiurst,Gevorgyan Hayk - Rafayelyan Edgar,54,21,33,12,-12,19,15,20,0,0,3,7,2,0,0,12,8:11 - 4:11 - 9:11 - 0:0 - 0:0
16125298,2024-01-05 17:45:00,Darbinyan Armen - Gevorgyan Gegham,0:3,3:11 - 3:11 - 6:11 - 0:0 - 0:0,0,3,Darbinyan Armen,Gevorgyan Gegham,fiurst,Darbinyan Armen - Gevorgyan Gegham,45,12,33,21,-21,14,14,17,0,0,8,8,5,0,0,21,3:11 - 3:11 - 6:11 - 0:0 - 0:0
16125287,2024-01-05 17:30:00,Grigoryan Erik - Avakimyan Davit,3:1,9:11 - 11:9 - 7:11 - 9:11 - 0:0,1,3,Grigoryan Erik,Avakimyan Davit,fiurst,Avakimyan Davit - Grigoryan Erik,78,42,36,-6,6,20,20,18,20,0,-2,2,-4,-2,0,-6,11:9 - 9:11 - 11:7 - 11:9 - 0:0
16125276,2024-01-05 17:15:00,Karakhanyan Mher - Darbinyan Armen,2:3,7:11 - 11:5 - 9:11 - 11:7 - 11:8,3,2,Karakhanyan Mher,Darbinyan Armen,fiurst,Darbinyan Armen - Karakhanyan Mher,91,42,49,7,-7,18,16,20,18,19,-4,6,-2,4,3,7,11:7 - 5:11 - 11:9 - 7:11 - 8:11
16125275,2024-01-05 17:00:00,Grigoryan Erik - Gevorgyan Gegham,2:3,7:11 - 11:13 - 11:8 - 11:4 - 11:6,3,2,Grigoryan Erik,Gevorgyan Gegham,fiurst,Gevorgyan Gegham - Grigoryan Erik,93,42,51,9,-9,18,24,19,15,17,-4,-2,3,7,5,9,11:7 - 13:11 - 8:11 - 4:11 - 6:11
16125272,2024-01-05 16:45:00,Avakimyan Davit - Karakhanyan Mher,3:0,11:8 - 13:11 - 13:11 - 0:0 - 0:0,3,0,Avakimyan Davit,Karakhanyan Mher,fiurst,Avakimyan Davit - Karakhanyan Mher,67,37,30,-7,7,19,24,24,0,0,-3,-2,-2,0,0,-7,11:8 - 13:11 - 13:11 - 0:0 - 0:0
16125271,2024-01-05 16:35:00,Darbinyan Armen - Grigoryan Erik,1:3,11:9 - 7:11 - 3:11 - 7:11 - 0:0,1,3,Darbinyan Armen,Grigoryan Erik,fiurst,Darbinyan Armen - Grigoryan Erik,70,28,42,14,-14,20,18,14,18,0,-2,4,8,4,0,14,11:9 - 7:11 - 3:11 - 7:11 - 0:0
16125269,2024-01-05 16:15:00,Gevorgyan Gegham - Karakhanyan Mher,3:1,12:10 - 12:10 - 8:11 - 11:4 - 0:0,3,1,Gevorgyan Gegham,Karakhanyan Mher,fiurst,Gevorgyan Gegham - Karakhanyan Mher,78,43,35,-8,8,22,22,19,15,0,-2,-2,3,-7,0,-8,12:10 - 12:10 - 8:11 - 11:4 - 0:0
16125257,2024-01-05 16:05:00,Avakimyan Davit - Darbinyan Armen,3:2,11:3 - 12:10 - 8:11 - 9:11 - 15:13,3,2,Avakimyan Davit,Darbinyan Armen,fiurst,Avakimyan Davit - Darbinyan Armen,103,55,48,-7,7,14,22,19,20,28,-8,-2,3,2,-2,-7,11:3 - 12:10 - 8:11 - 9:11 - 15:13
16125256,2024-01-05 15:45:00,Karakhanyan Mher - Grigoryan Erik,3:1,6:11 - 19:17 - 8:11 - 10:12 - 0:0,1,3,Karakhanyan Mher,Grigoryan Erik,fiurst,Grigoryan Erik - Karakhanyan Mher,94,51,43,-8,8,17,36,19,22,0,-5,2,-3,-2,0,-8,11:6 - 17:19 - 11:8 - 12:10 - 0:0
16125254,2024-01-05 15:35:00,Gevorgyan Gegham - Avakimyan Davit,3:1,9:11 - 11:8 - 7:11 - 7:11 - 0:0,1,3,Gevorgyan Gegham,Avakimyan Davit,fiurst,Avakimyan Davit - Gevorgyan Gegham,75,41,34,-7,7,20,19,18,18,0,-2,3,-4,-4,0,-7,11:9 - 8:11 - 11:7 - 11:7 - 0:0
16125242,2024-01-05 15:15:00,Grigoryan Erik - Darbinyan Armen,0:3,11:6 - 11:4 - 11:6 - 0:0 - 0:0,3,0,Grigoryan Erik,Darbinyan Armen,fiurst,Darbinyan Armen - Grigoryan Erik,49,16,33,17,-17,17,15,17,0,0,5,7,5,0,0,17,6:11 - 4:11 - 6:11 - 0:0 - 0:0
16125252,2024-01-05 15:00:00,Gevorgyan Gegham - Karakhanyan Mher,3:0,11:9 - 11:7 - 11:7 - 0:0 - 0:0,3,0,Gevorgyan Gegham,Karakhanyan Mher,fiurst,Gevorgyan Gegham - Karakhanyan Mher,56,33,23,-10,10,20,18,18,0,0,-2,-4,-4,0,0,-10,11:9 - 11:7 - 11:7 - 0:0 - 0:0
16125228,2024-01-05 14:35:00,Avakimyan Davit - Karakhanyan Mher,3:2,8:11 - 8:11 - 11:8 - 11:6 - 11:6,3,2,Avakimyan Davit,Karakhanyan Mher,fiurst,Avakimyan Davit - Karakhanyan Mher,91,49,42,-7,7,19,19,19,17,17,3,3,-3,-5,-5,-7,8:11 - 8:11 - 11:8 - 11:6 - 11:6
16125248,2024-01-05 14:20:00,Arutyunov Ruben - Nikoghosyan Narek,3:1,8:11 - 11:5 - 11:3 - 11:6 - 0:0,3,1,Arutyunov Ruben,Nikoghosyan Narek,fiurst,Arutyunov Ruben - Nikoghosyan Narek,66,41,25,-16,16,19,16,14,17,0,3,-6,-8,-5,0,-16,8:11 - 11:5 - 11:3 - 11:6 - 0:0
16125240,2024-01-05 14:00:00,Diaryan Aleksandr - Arutyunov Ruben,0:3,11:7 - 11:6 - 11:3 - 0:0 - 0:0,3,0,Diaryan Aleksandr,Arutyunov Ruben,fiurst,Arutyunov Ruben - Diaryan Aleksandr,49,16,33,17,-17,18,17,14,0,0,4,5,8,0,0,17,7:11 - 6:11 - 3:11 - 0:0 - 0:0
16125219,2024-01-05 13:55:00,Diaryan Aleksandr - Soghomonyan Hrayr,0:0,0:0 - 0:0 - 0:0 - 0:0 - 0:0,0,0,Diaryan Aleksandr,Soghomonyan Hrayr,fiurst,Diaryan Aleksandr - Soghomonyan Hrayr,0,0,0,0,0,0,0,0,0,0,0,0,0,0,0,0,0:0 - 0:0 - 0:0 - 0:0 - 0:0
16125208,2024-01-05 13:15:00,Arutyunov Ruben - Soghomonyan Hrayr,3:2,11:4 - 10:12 - 11:7 - 9:11 - 11:4,3,2,Arutyunov Ruben,Soghomonyan Hrayr,fiurst,Arutyunov Ruben - Soghomonyan Hrayr,90,52,38,-14,14,15,22,18,20,15,-7,2,-4,2,-7,-14,11:4 - 10:12 - 11:7 - 9:11 - 11:4
16125206,2024-01-05 13:00:00,Nikoghosyan Narek - Diaryan Aleksandr,2:3,11:8 - 10:12 - 6:11 - 11:9 - 11:9,3,2,Nikoghosyan Narek,Diaryan Aleksandr,fiurst,Diaryan Aleksandr - Nikoghosyan Narek,98,49,49,0,0,19,22,17,20,20,3,-2,-5,2,2,0,8:11 - 12:10 - 11:6 - 9:11 - 9:11
16125192,2024-01-05 12:00:00,Nikoghosyan Narek - Arutyunov Ruben,1:3,11:5 - 11:8 - 9:11 - 11:8 - 0:0,3,1,Nikoghosyan Narek,Arutyunov Ruben,fiurst,Arutyunov Ruben - Nikoghosyan Narek,74,32,42,10,-10,16,19,20,19,0,6,3,-2,3,0,10,5:11 - 8:11 - 11:9 - 8:11 - 0:0
16125185,2024-01-05 11:30:00,Nikoghosyan Narek - Soghomonyan Hrayr,3:0,11:6 - 11:4 - 11:7 - 0:0 - 0:0,3,0,Nikoghosyan Narek,Soghomonyan Hrayr,fiurst,Nikoghosyan Narek - Soghomonyan Hrayr,50,33,17,-16,16,17,15,18,0,0,-5,-7,-4,0,0,-16,11:6 - 11:4 - 11:7 - 0:0 - 0:0
16125182,2024-01-05 11:15:00,Arutyunov Ruben - Diaryan Aleksandr,0:3,3:11 - 9:11 - 6:11 - 0:0 - 0:0,0,3,Arutyunov Ruben,Diaryan Aleksandr,fiurst,Arutyunov Ruben - Diaryan Aleksandr,51,18,33,15,-15,14,20,17,0,0,8,2,5,0,0,15,3:11 - 9:11 - 6:11 - 0:0 - 0:0
16125180,2024-01-05 11:00:00,Mkrtchyan Andranik - Nikoghosyan Narek,0:3,4:11 - 7:11 - 7:11 - 0:0 - 0:0,0,3,Mkrtchyan Andranik,Nikoghosyan Narek,fiurst,Mkrtchyan Andranik - Nikoghosyan Narek,51,18,33,15,-15,15,18,18,0,0,7,4,4,0,0,15,4:11 - 7:11 - 7:11 - 0:0 - 0:0
16125178,2024-01-05 10:45:00,Soghomonyan Hrayr - Diaryan Aleksandr,3:0,4:11 - 4:11 - 8:11 - 0:0 - 0:0,0,3,Soghomonyan Hrayr,Diaryan Aleksandr,fiurst,Diaryan Aleksandr - Soghomonyan Hrayr,49,33,16,-17,17,15,15,19,0,0,-7,-7,-3,0,0,-17,11:4 - 11:4 - 11:8 - 0:0 - 0:0
16125176,2024-01-05 10:30:00,Arutyunov Ruben - Mkrtchyan Andranik,3:1,11:7 - 11:8 - 8:11 - 11:5 - 0:0,3,1,Arutyunov Ruben,Mkrtchyan Andranik,fiurst,Arutyunov Ruben - Mkrtchyan Andranik,72,41,31,-10,10,18,19,19,16,0,-4,-3,3,-6,0,-10,11:7 - 11:8 - 8:11 - 11:5 - 0:0
16125164,2024-01-05 10:15:00,Diaryan Aleksandr - Nikoghosyan Narek,3:0,11:9 - 11:9 - 11:2 - 0:0 - 0:0,3,0,Diaryan Aleksandr,Nikoghosyan Narek,fiurst,Diaryan Aleksandr - Nikoghosyan Narek,53,33,20,-13,13,20,20,13,0,0,-2,-2,-9,0,0,-13,11:9 - 11:9 - 11:2 - 0:0 - 0:0
16125161,2024-01-05 10:00:00,Soghomonyan Hrayr - Arutyunov Ruben,3:0,7:11 - 9:11 - 4:11 - 0:0 - 0:0,0,3,Soghomonyan Hrayr,Arutyunov Ruben,fiurst,Arutyunov Ruben - Soghomonyan Hrayr,53,33,20,-13,13,18,20,15,0,0,-4,-2,-7,0,0,-13,11:7 - 11:9 - 11:4 - 0:0 - 0:0
16108363,2024-01-04 17:45:00,Grigoryan Erik - Miroyan Hakob,3:1,11:9 - 13:11 - 8:11 - 14:12 - 0:0,3,1,Grigoryan Erik,Miroyan Hakob,fiurst,Grigoryan Erik - Miroyan Hakob,89,46,43,-3,3,20,24,19,26,0,-2,-2,3,-2,0,-3,11:9 - 13:11 - 8:11 - 14:12 - 0:0
16108361,2024-01-04 17:30:00,Soghomonyan Hrayr - Avakimyan Davit,0:3,11:6 - 11:8 - 19:17 - 0:0 - 0:0,3,0,Soghomonyan Hrayr,Avakimyan Davit,fiurst,Avakimyan Davit - Soghomonyan Hrayr,72,31,41,10,-10,17,19,36,0,0,5,3,2,0,0,10,6:11 - 8:11 - 17:19 - 0:0 - 0:0
16108360,2024-01-04 17:15:00,Gevorgyan Gegham - Grigoryan Erik,3:0,11:3 - 11:6 - 11:5 - 0:0 - 0:0,3,0,Gevorgyan Gegham,Grigoryan Erik,fiurst,Gevorgyan Gegham - Grigoryan Erik,47,33,14,-19,19,14,17,16,0,0,-8,-5,-6,0,0,-19,11:3 - 11:6 - 11:5 - 0:0 - 0:0
16108357,2024-01-04 17:00:00,Soghomonyan Hrayr - Miroyan Hakob,0:3,12:10 - 11:9 - 11:5 - 0:0 - 0:0,3,0,Soghomonyan Hrayr,Miroyan Hakob,fiurst,Miroyan Hakob - Soghomonyan Hrayr,58,24,34,10,-10,22,20,16,0,0,2,2,6,0,0,10,10:12 - 9:11 - 5:11 - 0:0 - 0:0
16108352,2024-01-04 16:45:00,Avakimyan Davit - Gevorgyan Gegham,3:1,12:10 - 4:11 - 14:12 - 11:6 - 0:0,3,1,Avakimyan Davit,Gevorgyan Gegham,fiurst,Avakimyan Davit - Gevorgyan Gegham,80,41,39,-2,2,22,15,26,17,0,-2,7,-2,-5,0,-2,12:10 - 4:11 - 14:12 - 11:6 - 0:0
16108351,2024-01-04 16:30:00,Grigoryan Erik - Soghomonyan Hrayr,0:3,10:12 - 10:12 - 10:12 - 0:0 - 0:0,0,3,Grigoryan Erik,Soghomonyan Hrayr,fiurst,Grigoryan Erik - Soghomonyan Hrayr,66,30,36,6,-6,22,22,22,0,0,2,2,2,0,0,6,10:12 - 10:12 - 10:12 - 0:0 - 0:0
16108346,2024-01-04 16:15:00,Miroyan Hakob - Gevorgyan Gegham,3:1,2:11 - 11:8 - 9:11 - 10:12 - 0:0,1,3,Miroyan Hakob,Gevorgyan Gegham,fiurst,Gevorgyan Gegham - Miroyan Hakob,74,42,32,-10,10,13,19,20,22,0,-9,3,-2,-2,0,-10,11:2 - 8:11 - 11:9 - 12:10 - 0:0
16108334,2024-01-04 16:00:00,Avakimyan Davit - Grigoryan Erik,3:0,11:4 - 11:4 - 12:10 - 0:0 - 0:0,3,0,Avakimyan Davit,Grigoryan Erik,fiurst,Avakimyan Davit - Grigoryan Erik,52,34,18,-16,16,15,15,22,0,0,-7,-7,-2,0,0,-16,11:4 - 11:4 - 12:10 - 0:0 - 0:0
16108332,2024-01-04 15:50:00,Gevorgyan Gegham - Soghomonyan Hrayr,0:3,2:11 - 6:11 - 3:11 - 0:0 - 0:0,0,3,Gevorgyan Gegham,Soghomonyan Hrayr,fiurst,Gevorgyan Gegham - Soghomonyan Hrayr,44,11,33,22,-22,13,17,14,0,0,9,5,8,0,0,22,2:11 - 6:11 - 3:11 - 0:0 - 0:0
16108330,2024-01-04 15:30:00,Miroyan Hakob - Avakimyan Davit,3:0,5:11 - 9:11 - 8:11 - 0:0 - 0:0,0,3,Miroyan Hakob,Avakimyan Davit,fiurst,Avakimyan Davit - Miroyan Hakob,55,33,22,-11,11,16,20,19,0,0,-6,-2,-3,0,0,-11,11:5 - 11:9 - 11:8 - 0:0 - 0:0
16108275,2024-01-04 15:15:00,Mkrtchyan Andranik - Soghomonyan Hrayr,3:1,12:14 - 13:11 - 11:4 - 11:9 - 0:0,3,1,Mkrtchyan Andranik,Soghomonyan Hrayr,fiurst,Mkrtchyan Andranik - Soghomonyan Hrayr,85,47,38,-9,9,26,24,15,20,0,2,-2,-7,-2,0,-9,12:14 - 13:11 - 11:4 - 11:9 - 0:0
16108270,2024-01-04 15:00:00,Diaryan Aleksandr - Nikoghosyan Narek,3:1,14:12 - 11:5 - 9:11 - 11:6 - 0:0,3,1,Diaryan Aleksandr,Nikoghosyan Narek,fiurst,Diaryan Aleksandr - Nikoghosyan Narek,79,45,34,-11,11,26,16,20,17,0,-2,-6,2,-5,0,-11,14:12 - 11:5 - 9:11 - 11:6 - 0:0
16108268,2024-01-04 14:45:00,Rafayelyan Edgar - Mkrtchyan Andranik,2:3,11:8 - 11:5 - 7:11 - 8:11 - 11:4,3,2,Rafayelyan Edgar,Mkrtchyan Andranik,fiurst,Mkrtchyan Andranik - Rafayelyan Edgar,87,39,48,9,-9,19,16,18,19,15,3,6,-4,-3,7,9,8:11 - 5:11 - 11:7 - 11:8 - 4:11
16108265,2024-01-04 14:30:00,Soghomonyan Hrayr - Diaryan Aleksandr,3:0,6:11 - 6:11 - 7:11 - 0:0 - 0:0,0,3,Soghomonyan Hrayr,Diaryan Aleksandr,fiurst,Diaryan Aleksandr - Soghomonyan Hrayr,52,33,19,-14,14,17,17,18,0,0,-5,-5,-4,0,0,-14,11:6 - 11:6 - 11:7 - 0:0 - 0:0
16108261,2024-01-04 14:15:00,Rafayelyan Edgar - Nikoghosyan Narek,1:3,12:10 - 13:11 - 2:11 - 11:9 - 0:0,3,1,Rafayelyan Edgar,Nikoghosyan Narek,fiurst,Nikoghosyan Narek - Rafayelyan Edgar,79,41,38,-3,3,22,24,13,20,0,2,2,-9,2,0,-3,10:12 - 11:13 - 11:2 - 9:11 - 0:0
16108258,2024-01-04 14:00:00,Mkrtchyan Andranik - Diaryan Aleksandr,3:0,7:11 - 6:11 - 3:11 - 0:0 - 0:0,0,3,Mkrtchyan Andranik,Diaryan Aleksandr,fiurst,Diaryan Aleksandr - Mkrtchyan Andranik,49,33,16,-17,17,18,17,14,0,0,-4,-5,-8,0,0,-17,11:7 - 11:6 - 11:3 - 0:0 - 0:0
16108257,2024-01-04 13:45:00,Soghomonyan Hrayr - Rafayelyan Edgar,3:0,8:11 - 9:11 - 5:11 - 0:0 - 0:0,0,3,Soghomonyan Hrayr,Rafayelyan Edgar,fiurst,Rafayelyan Edgar - Soghomonyan Hrayr,55,33,22,-11,11,19,20,16,0,0,-3,-2,-6,0,0,-11,11:8 - 11:9 - 11:5 - 0:0 - 0:0
16108246,2024-01-04 13:30:00,Nikoghosyan Narek - Mkrtchyan Andranik,0:3,11:8 - 11:8 - 11:4 - 0:0 - 0:0,3,0,Nikoghosyan Narek,Mkrtchyan Andranik,fiurst,Mkrtchyan Andranik - Nikoghosyan Narek,53,20,33,13,-13,19,19,15,0,0,3,3,7,0,0,13,8:11 - 8:11 - 4:11 - 0:0 - 0:0
16108245,2024-01-04 13:15:00,Diaryan Aleksandr - Rafayelyan Edgar,0:3,4:11 - 12:14 - 4:11 - 0:0 - 0:0,0,3,Diaryan Aleksandr,Rafayelyan Edgar,fiurst,Diaryan Aleksandr - Rafayelyan Edgar,56,20,36,16,-16,15,26,15,0,0,7,2,7,0,0,16,4:11 - 12:14 - 4:11 - 0:0 - 0:0
16108240,2024-01-04 13:00:00,Nikoghosyan Narek - Soghomonyan Hrayr,3:0,11:8 - 11:6 - 11:3 - 0:0 - 0:0,3,0,Nikoghosyan Narek,Soghomonyan Hrayr,fiurst,Nikoghosyan Narek - Soghomonyan Hrayr,50,33,17,-16,16,19,17,14,0,0,-3,-5,-8,0,0,-16,11:8 - 11:6 - 11:3 - 0:0 - 0:0
16108238,2024-01-04 12:15:00,Mkrtchyan Andranik - Rafayelyan Edgar,0:3,4:11 - 2:11 - 5:11 - 0:0 - 0:0,0,3,Mkrtchyan Andranik,Rafayelyan Edgar,fiurst,Mkrtchyan Andranik - Rafayelyan Edgar,44,11,33,22,-22,15,13,16,0,0,7,9,6,0,0,22,4:11 - 2:11 - 5:11 - 0:0 - 0:0
16108237,2024-01-04 12:00:00,Nikoghosyan Narek - Diaryan Aleksandr,3:1,12:14 - 11:8 - 7:11 - 7:11 - 0:0,1,3,Nikoghosyan Narek,Diaryan Aleksandr,fiurst,Diaryan Aleksandr - Nikoghosyan Narek,81,44,37,-7,7,26,19,18,18,0,-2,3,-4,-4,0,-7,14:12 - 8:11 - 11:7 - 11:7 - 0:0
16108235,2024-01-04 11:45:00,Soghomonyan Hrayr - Mkrtchyan Andranik,3:1,9:11 - 4:11 - 14:12 - 4:11 - 0:0,1,3,Soghomonyan Hrayr,Mkrtchyan Andranik,fiurst,Mkrtchyan Andranik - Soghomonyan Hrayr,76,45,31,-14,14,20,15,26,15,0,-2,-7,2,-7,0,-14,11:9 - 11:4 - 12:14 - 11:4 - 0:0
16108223,2024-01-04 11:35:00,Nikoghosyan Narek - Rafayelyan Edgar,3:0,11:9 - 11:8 - 11:4 - 0:0 - 0:0,3,0,Nikoghosyan Narek,Rafayelyan Edgar,fiurst,Nikoghosyan Narek - Rafayelyan Edgar,54,33,21,-12,12,20,19,15,0,0,-2,-3,-7,0,0,-12,11:9 - 11:8 - 11:4 - 0:0 - 0:0
16108222,2024-01-04 11:15:00,Diaryan Aleksandr - Soghomonyan Hrayr,3:0,11:6 - 11:9 - 11:8 - 0:0 - 0:0,3,0,Diaryan Aleksandr,Soghomonyan Hrayr,fiurst,Diaryan Aleksandr - Soghomonyan Hrayr,56,33,23,-10,10,17,20,19,0,0,-5,-2,-3,0,0,-10,11:6 - 11:9 - 11:8 - 0:0 - 0:0
16108220,2024-01-04 11:00:00,Mkrtchyan Andranik - Nikoghosyan Narek,3:2,4:11 - 11:7 - 4:11 - 13:11 - 11:9,3,2,Mkrtchyan Andranik,Nikoghosyan Narek,fiurst,Mkrtchyan Andranik - Nikoghosyan Narek,92,43,49,6,-6,15,18,15,24,20,7,-4,7,-2,-2,6,4:11 - 11:7 - 4:11 - 13:11 - 11:9
16108216,2024-01-04 10:45:00,Rafayelyan Edgar - Soghomonyan Hrayr,3:0,11:8 - 11:6 - 16:14 - 0:0 - 0:0,3,0,Rafayelyan Edgar,Soghomonyan Hrayr,fiurst,Rafayelyan Edgar - Soghomonyan Hrayr,66,38,28,-10,10,19,17,30,0,0,-3,-5,-2,0,0,-10,11:8 - 11:6 - 16:14 - 0:0 - 0:0
16108213,2024-01-04 10:30:00,Diaryan Aleksandr - Mkrtchyan Andranik,3:0,11:8 - 11:4 - 11:8 - 0:0 - 0:0,3,0,Diaryan Aleksandr,Mkrtchyan Andranik,fiurst,Diaryan Aleksandr - Mkrtchyan Andranik,53,33,20,-13,13,19,15,19,0,0,-3,-7,-3,0,0,-13,11:8 - 11:4 - 11:8 - 0:0 - 0:0
16108211,2024-01-04 10:15:00,Soghomonyan Hrayr - Nikoghosyan Narek,3:0,8:11 - 6:11 - 9:11 - 0:0 - 0:0,0,3,Soghomonyan Hrayr,Nikoghosyan Narek,fiurst,Nikoghosyan Narek - Soghomonyan Hrayr,56,33,23,-10,10,19,17,20,0,0,-3,-5,-2,0,0,-10,11:8 - 11:6 - 11:9 - 0:0 - 0:0
16108205,2024-01-04 10:00:00,Rafayelyan Edgar - Diaryan Aleksandr,0:3,11:5 - 17:15 - 11:7 - 0:0 - 0:0,3,0,Rafayelyan Edgar,Diaryan Aleksandr,fiurst,Diaryan Aleksandr - Rafayelyan Edgar,66,27,39,12,-12,16,32,18,0,0,6,2,4,0,0,12,5:11 - 15:17 - 7:11 - 0:0 - 0:0
16089152,2024-01-03 17:45:00,Karakhanyan Mher - Avakimyan Davit,3:0,9:11 - 8:11 - 10:12 - 0:0 - 0:0,0,3,Karakhanyan Mher,Avakimyan Davit,fiurst,Avakimyan Davit - Karakhanyan Mher,61,34,27,-7,7,20,19,22,0,0,-2,-3,-2,0,0,-7,11:9 - 11:8 - 12:10 - 0:0 - 0:0
16089137,2024-01-03 17:30:00,Gevorgyan Gegham - Darbinyan Armen,0:3,11:3 - 11:2 - 11:7 - 0:0 - 0:0,3,0,Gevorgyan Gegham,Darbinyan Armen,fiurst,Darbinyan Armen - Gevorgyan Gegham,45,12,33,21,-21,14,13,18,0,0,8,9,4,0,0,21,3:11 - 2:11 - 7:11 - 0:0 - 0:0
16089135,2024-01-03 17:15:00,Miroyan Hakob - Karakhanyan Mher,3:1,12:10 - 8:11 - 8:11 - 7:11 - 0:0,1,3,Miroyan Hakob,Karakhanyan Mher,fiurst,Karakhanyan Mher - Miroyan Hakob,78,43,35,-8,8,22,19,19,18,0,2,-3,-3,-4,0,-8,10:12 - 11:8 - 11:8 - 11:7 - 0:0
16089134,2024-01-03 17:00:00,Gevorgyan Gegham - Avakimyan Davit,2:3,11:6 - 7:11 - 9:11 - 11:6 - 11:8,3,2,Gevorgyan Gegham,Avakimyan Davit,fiurst,Avakimyan Davit - Gevorgyan Gegham,91,42,49,7,-7,17,18,20,17,19,5,-4,-2,5,3,7,6:11 - 11:7 - 11:9 - 6:11 - 8:11
16089133,2024-01-03 16:45:00,Darbinyan Armen - Miroyan Hakob,2:3,3:11 - 11:8 - 11:6 - 6:11 - 3:11,2,3,Darbinyan Armen,Miroyan Hakob,fiurst,Darbinyan Armen - Miroyan Hakob,81,34,47,13,-13,14,19,17,17,14,8,-3,-5,5,8,13,3:11 - 11:8 - 11:6 - 6:11 - 3:11
16089121,2024-01-03 16:30:00,Karakhanyan Mher - Gevorgyan Gegham,3:0,11:13 - 8:11 - 9:11 - 0:0 - 0:0,0,3,Karakhanyan Mher,Gevorgyan Gegham,fiurst,Gevorgyan Gegham - Karakhanyan Mher,63,35,28,-7,7,24,19,20,0,0,-2,-3,-2,0,0,-7,13:11 - 11:8 - 11:9 - 0:0 - 0:0
16089118,2024-01-03 16:15:00,Avakimyan Davit - Miroyan Hakob,3:0,11:8 - 11:9 - 11:5 - 0:0 - 0:0,3,0,Avakimyan Davit,Miroyan Hakob,fiurst,Avakimyan Davit - Miroyan Hakob,55,33,22,-11,11,19,20,16,0,0,-3,-2,-6,0,0,-11,11:8 - 11:9 - 11:5 - 0:0 - 0:0
16089116,2024-01-03 16:00:00,Darbinyan Armen - Karakhanyan Mher,0:3,5:11 - 10:12 - 5:11 - 0:0 - 0:0,0,3,Darbinyan Armen,Karakhanyan Mher,fiurst,Darbinyan Armen - Karakhanyan Mher,54,20,34,14,-14,16,22,16,0,0,6,2,6,0,0,14,5:11 - 10:12 - 5:11 - 0:0 - 0:0
16089114,2024-01-03 15:45:00,Miroyan Hakob - Gevorgyan Gegham,2:3,11:8 - 11:13 - 8:11 - 11:8 - 11:5,3,2,Miroyan Hakob,Gevorgyan Gegham,fiurst,Gevorgyan Gegham - Miroyan Hakob,97,45,52,7,-7,19,24,19,19,16,3,-2,-3,3,6,7,8:11 - 13:11 - 11:8 - 8:11 - 5:11
16089090,2024-01-03 15:30:00,Avakimyan Davit - Darbinyan Armen,3:0,11:9 - 11:9 - 11:6 - 0:0 - 0:0,3,0,Avakimyan Davit,Darbinyan Armen,fiurst,Avakimyan Davit - Darbinyan Armen,57,33,24,-9,9,20,20,17,0,0,-2,-2,-5,0,0,-9,11:9 - 11:9 - 11:6 - 0:0 - 0:0
16089087,2024-01-03 15:15:00,Soghomonyan Hrayr - Arutyunov Ruben,1:3,8:11 - 11:9 - 11:7 - 11:3 - 0:0,3,1,Soghomonyan Hrayr,Arutyunov Ruben,fiurst,Arutyunov Ruben - Soghomonyan Hrayr,71,30,41,11,-11,19,20,18,14,0,-3,2,4,8,0,11,11:8 - 9:11 - 7:11 - 3:11 - 0:0
16089085,2024-01-03 15:00:00,Papyan Karen - Rafayelyan Edgar,0:3,4:11 - 4:11 - 5:11 - 0:0 - 0:0,0,3,Papyan Karen,Rafayelyan Edgar,fiurst,Papyan Karen - Rafayelyan Edgar,46,13,33,20,-20,15,15,16,0,0,7,7,6,0,0,20,4:11 - 4:11 - 5:11 - 0:0 - 0:0
16089083,2024-01-03 14:45:00,Nikoghosyan Narek - Soghomonyan Hrayr,3:0,11:5 - 11:4 - 12:10 - 0:0 - 0:0,3,0,Nikoghosyan Narek,Soghomonyan Hrayr,fiurst,Nikoghosyan Narek - Soghomonyan Hrayr,53,34,19,-15,15,16,15,22,0,0,-6,-7,-2,0,0,-15,11:5 - 11:4 - 12:10 - 0:0 - 0:0
16089082,2024-01-03 14:30:00,Arutyunov Ruben - Papyan Karen,1:3,11:4 - 7:11 - 6:11 - 8:11 - 0:0,1,3,Arutyunov Ruben,Papyan Karen,fiurst,Arutyunov Ruben - Papyan Karen,69,32,37,5,-5,15,18,17,19,0,-7,4,5,3,0,5,11:4 - 7:11 - 6:11 - 8:11 - 0:0
16089081,2024-01-03 14:15:00,Nikoghosyan Narek - Rafayelyan Edgar,0:3,10:12 - 7:11 - 9:11 - 0:0 - 0:0,0,3,Nikoghosyan Narek,Rafayelyan Edgar,fiurst,Nikoghosyan Narek - Rafayelyan Edgar,60,26,34,8,-8,22,18,20,0,0,2,4,2,0,0,8,10:12 - 7:11 - 9:11 - 0:0 - 0:0
16089080,2024-01-03 14:00:00,Soghomonyan Hrayr - Papyan Karen,3:2,11:9 - 11:6 - 9:11 - 6:11 - 7:11,2,3,Soghomonyan Hrayr,Papyan Karen,fiurst,Papyan Karen - Soghomonyan Hrayr,92,48,44,-4,4,20,17,20,17,18,2,5,-2,-5,-4,-4,9:11 - 6:11 - 11:9 - 11:6 - 11:7
16089073,2024-01-03 13:45:00,Arutyunov Ruben - Nikoghosyan Narek,0:3,7:11 - 6:11 - 4:11 - 0:0 - 0:0,0,3,Arutyunov Ruben,Nikoghosyan Narek,fiurst,Arutyunov Ruben - Nikoghosyan Narek,50,17,33,16,-16,18,17,15,0,0,4,5,7,0,0,16,7:11 - 6:11 - 4:11 - 0:0 - 0:0
16089065,2024-01-03 13:30:00,Rafayelyan Edgar - Soghomonyan Hrayr,3:0,11:7 - 11:3 - 11:2 - 0:0 - 0:0,3,0,Rafayelyan Edgar,Soghomonyan Hrayr,fiurst,Rafayelyan Edgar - Soghomonyan Hrayr,45,33,12,-21,21,18,14,13,0,0,-4,-8,-9,0,0,-21,11:7 - 11:3 - 11:2 - 0:0 - 0:0
16089064,2024-01-03 13:15:00,Papyan Karen - Nikoghosyan Narek,3:1,6:11 - 11:7 - 3:11 - 10:12 - 0:0,1,3,Papyan Karen,Nikoghosyan Narek,fiurst,Nikoghosyan Narek - Papyan Karen,71,41,30,-11,11,17,18,14,22,0,-5,4,-8,-2,0,-11,11:6 - 7:11 - 11:3 - 12:10 - 0:0
16089061,2024-01-03 13:00:00,Rafayelyan Edgar - Arutyunov Ruben,0:3,11:8 - 11:4 - 12:10 - 0:0 - 0:0,3,0,Rafayelyan Edgar,Arutyunov Ruben,fiurst,Arutyunov Ruben - Rafayelyan Edgar,56,22,34,12,-12,19,15,22,0,0,3,7,2,0,0,12,8:11 - 4:11 - 10:12 - 0:0 - 0:0
16089058,2024-01-03 12:15:00,Soghomonyan Hrayr - Nikoghosyan Narek,3:2,11:7 - 11:5 - 2:11 - 6:11 - 2:11,2,3,Soghomonyan Hrayr,Nikoghosyan Narek,fiurst,Nikoghosyan Narek - Soghomonyan Hrayr,77,45,32,-13,13,18,16,13,17,13,4,6,-9,-5,-9,-13,7:11 - 5:11 - 11:2 - 11:6 - 11:2
16089056,2024-01-03 12:10:00,Rafayelyan Edgar - Papyan Karen,2:3,11:8 - 11:7 - 7:11 - 6:11 - 12:10,3,2,Rafayelyan Edgar,Papyan Karen,fiurst,Papyan Karen - Rafayelyan Edgar,94,47,47,0,0,19,18,18,17,22,3,4,-4,-5,2,0,8:11 - 7:11 - 11:7 - 11:6 - 10:12
16089054,2024-01-03 11:55:00,Arutyunov Ruben - Soghomonyan Hrayr,0:3,3:11 - 9:11 - 13:15 - 0:0 - 0:0,0,3,Arutyunov Ruben,Soghomonyan Hrayr,fiurst,Arutyunov Ruben - Soghomonyan Hrayr,62,25,37,12,-12,14,20,28,0,0,8,2,2,0,0,12,3:11 - 9:11 - 13:15 - 0:0 - 0:0
16089053,2024-01-03 11:30:00,Rafayelyan Edgar - Nikoghosyan Narek,2:3,12:10 - 10:12 - 11:5 - 9:11 - 11:8,3,2,Rafayelyan Edgar,Nikoghosyan Narek,fiurst,Nikoghosyan Narek - Rafayelyan Edgar,99,46,53,7,-7,22,22,16,20,19,2,-2,6,-2,3,7,10:12 - 12:10 - 5:11 - 11:9 - 8:11
16089051,2024-01-03 11:20:00,Papyan Karen - Arutyunov Ruben,2:3,11:6 - 6:11 - 9:11 - 11:3 - 11:5,3,2,Papyan Karen,Arutyunov Ruben,fiurst,Arutyunov Ruben - Papyan Karen,84,36,48,12,-12,17,17,20,14,16,5,-5,-2,8,6,12,6:11 - 11:6 - 11:9 - 3:11 - 5:11
16089040,2024-01-03 11:00:00,Soghomonyan Hrayr - Rafayelyan Edgar,3:0,9:11 - 6:11 - 5:11 - 0:0 - 0:0,0,3,Soghomonyan Hrayr,Rafayelyan Edgar,fiurst,Rafayelyan Edgar - Soghomonyan Hrayr,53,33,20,-13,13,20,17,16,0,0,-2,-5,-6,0,0,-13,11:9 - 11:6 - 11:5 - 0:0 - 0:0
16089037,2024-01-03 10:45:00,Nikoghosyan Narek - Arutyunov Ruben,0:3,11:5 - 11:9 - 11:8 - 0:0 - 0:0,3,0,Nikoghosyan Narek,Arutyunov Ruben,fiurst,Arutyunov Ruben - Nikoghosyan Narek,55,22,33,11,-11,16,20,19,0,0,6,2,3,0,0,11,5:11 - 9:11 - 8:11 - 0:0 - 0:0
16089036,2024-01-03 10:30:00,Papyan Karen - Soghomonyan Hrayr,3:0,11:7 - 11:7 - 12:10 - 0:0 - 0:0,3,0,Papyan Karen,Soghomonyan Hrayr,fiurst,Papyan Karen - Soghomonyan Hrayr,58,34,24,-10,10,18,18,22,0,0,-4,-4,-2,0,0,-10,11:7 - 11:7 - 12:10 - 0:0 - 0:0
16089034,2024-01-03 10:15:00,Arutyunov Ruben - Rafayelyan Edgar,0:3,6:11 - 5:11 - 7:11 - 0:0 - 0:0,0,3,Arutyunov Ruben,Rafayelyan Edgar,fiurst,Arutyunov Ruben - Rafayelyan Edgar,51,18,33,15,-15,17,16,18,0,0,5,6,4,0,0,15,6:11 - 5:11 - 7:11 - 0:0 - 0:0
16089032,2024-01-03 10:05:00,Nikoghosyan Narek - Papyan Karen,0:3,9:11 - 7:11 - 3:11 - 0:0 - 0:0,0,3,Nikoghosyan Narek,Papyan Karen,fiurst,Nikoghosyan Narek - Papyan Karen,52,19,33,14,-14,20,18,14,0,0,2,4,8,0,0,14,9:11 - 7:11 - 3:11 - 0:0 - 0:0
16076975,2024-01-02 17:45:00,Darbinyan Armen - Karakhanyan Mher,2:3,5:11 - 11:7 - 8:11 - 11:7 - 13:15,2,3,Darbinyan Armen,Karakhanyan Mher,fiurst,Darbinyan Armen - Karakhanyan Mher,99,48,51,3,-3,16,18,19,18,28,6,-4,3,-4,2,3,5:11 - 11:7 - 8:11 - 11:7 - 13:15
16076964,2024-01-02 17:30:00,Grigoryan Erik - Miroyan Hakob,3:2,11:8 - 9:11 - 11:8 - 11:13 - 12:10,3,2,Grigoryan Erik,Miroyan Hakob,fiurst,Grigoryan Erik - Miroyan Hakob,104,54,50,-4,4,19,20,19,24,22,-3,2,-3,2,-2,-4,11:8 - 9:11 - 11:8 - 11:13 - 12:10
16076963,2024-01-02 17:15:00,Avakimyan Davit - Darbinyan Armen,3:0,11:6 - 11:8 - 11:9 - 0:0 - 0:0,3,0,Avakimyan Davit,Darbinyan Armen,fiurst,Avakimyan Davit - Darbinyan Armen,56,33,23,-10,10,17,19,20,0,0,-5,-3,-2,0,0,-10,11:6 - 11:8 - 11:9 - 0:0 - 0:0
16076961,2024-01-02 17:00:00,Grigoryan Erik - Karakhanyan Mher,2:3,11:7 - 12:10 - 6:11 - 9:11 - 9:11,2,3,Grigoryan Erik,Karakhanyan Mher,fiurst,Grigoryan Erik - Karakhanyan Mher,97,47,50,3,-3,18,22,17,20,20,-4,-2,5,2,2,3,11:7 - 12:10 - 6:11 - 9:11 - 9:11
16076957,2024-01-02 16:45:00,Miroyan Hakob - Avakimyan Davit,3:0,9:11 - 6:11 - 6:11 - 0:0 - 0:0,0,3,Miroyan Hakob,Avakimyan Davit,fiurst,Avakimyan Davit - Miroyan Hakob,54,33,21,-12,12,20,17,17,0,0,-2,-5,-5,0,0,-12,11:9 - 11:6 - 11:6 - 0:0 - 0:0
16076956,2024-01-02 16:30:00,Darbinyan Armen - Grigoryan Erik,0:3,9:11 - 7:11 - 1:11 - 0:0 - 0:0,0,3,Darbinyan Armen,Grigoryan Erik,fiurst,Darbinyan Armen - Grigoryan Erik,50,17,33,16,-16,20,18,12,0,0,2,4,10,0,0,16,9:11 - 7:11 - 1:11 - 0:0 - 0:0
16076955,2024-01-02 16:15:00,Karakhanyan Mher - Avakimyan Davit,3:2,11:9 - 11:7 - 7:11 - 5:11 - 7:11,2,3,Karakhanyan Mher,Avakimyan Davit,fiurst,Avakimyan Davit - Karakhanyan Mher,90,49,41,-8,8,20,18,18,16,18,2,4,-4,-6,-4,-8,9:11 - 7:11 - 11:7 - 11:5 - 11:7
16076954,2024-01-02 16:05:00,Miroyan Hakob - Darbinyan Armen,0:3,11:9 - 11:8 - 11:4 - 0:0 - 0:0,3,0,Miroyan Hakob,Darbinyan Armen,fiurst,Darbinyan Armen - Miroyan Hakob,54,21,33,12,-12,20,19,15,0,0,2,3,7,0,0,12,9:11 - 8:11 - 4:11 - 0:0 - 0:0
16076940,2024-01-02 15:55:00,Avakimyan Davit - Grigoryan Erik,3:1,12:10 - 11:8 - 8:11 - 11:9 - 0:0,3,1,Avakimyan Davit,Grigoryan Erik,fiurst,Avakimyan Davit - Grigoryan Erik,80,42,38,-4,4,22,19,19,20,0,-2,-3,3,-2,0,-4,12:10 - 11:8 - 8:11 - 11:9 - 0:0
16076920,2024-01-02 15:40:00,Nikoghosyan Narek - Mkrtchyan Andranik,0:3,11:9 - 12:10 - 11:9 - 0:0 - 0:0,3,0,Nikoghosyan Narek,Mkrtchyan Andranik,fiurst,Mkrtchyan Andranik - Nikoghosyan Narek,62,28,34,6,-6,20,22,20,0,0,2,2,2,0,0,6,9:11 - 10:12 - 9:11 - 0:0 - 0:0
16076934,2024-01-02 15:35:00,Karakhanyan Mher - Miroyan Hakob,3:0,11:6 - 11:9 - 11:8 - 0:0 - 0:0,3,0,Karakhanyan Mher,Miroyan Hakob,fiurst,Karakhanyan Mher - Miroyan Hakob,56,33,23,-10,10,17,20,19,0,0,-5,-2,-3,0,0,-10,11:6 - 11:9 - 11:8 - 0:0 - 0:0
16076919,2024-01-02 15:20:00,Arutyunov Ruben - Papyan Karen,1:3,7:11 - 8:11 - 11:3 - 4:11 - 0:0,1,3,Arutyunov Ruben,Papyan Karen,fiurst,Arutyunov Ruben - Papyan Karen,66,30,36,6,-6,18,19,14,15,0,4,3,-8,7,0,6,7:11 - 8:11 - 11:3 - 4:11 - 0:0
16076918,2024-01-02 15:00:00,Diaryan Aleksandr - Nikoghosyan Narek,3:2,5:11 - 11:9 - 9:11 - 11:8 - 11:8,3,2,Diaryan Aleksandr,Nikoghosyan Narek,fiurst,Diaryan Aleksandr - Nikoghosyan Narek,94,47,47,0,0,16,20,20,19,19,6,-2,2,-3,-3,0,5:11 - 11:9 - 9:11 - 11:8 - 11:8
16076914,2024-01-02 14:45:00,Mkrtchyan Andranik - Arutyunov Ruben,3:2,2:11 - 14:12 - 6:11 - 11:9 - 4:11,2,3,Mkrtchyan Andranik,Arutyunov Ruben,fiurst,Arutyunov Ruben - Mkrtchyan Andranik,91,54,37,-17,17,13,26,17,20,15,-9,2,-5,2,-7,-17,11:2 - 12:14 - 11:6 - 9:11 - 11:4
16076996,2024-01-02 14:20:00,Diaryan Aleksandr - Papyan Karen,3:2,11:6 - 9:11 - 9:11 - 11:6 - 11:7,3,2,Diaryan Aleksandr,Papyan Karen,fiurst,Diaryan Aleksandr - Papyan Karen,92,51,41,-10,10,17,20,20,17,18,-5,2,2,-5,-4,-10,11:6 - 9:11 - 9:11 - 11:6 - 11:7
16076869,2024-01-02 14:10:00,Nikoghosyan Narek - Arutyunov Ruben,1:3,3:11 - 11:7 - 11:9 - 11:4 - 0:0,3,1,Nikoghosyan Narek,Arutyunov Ruben,fiurst,Arutyunov Ruben - Nikoghosyan Narek,67,31,36,5,-5,14,18,20,15,0,-8,4,2,7,0,5,11:3 - 7:11 - 9:11 - 4:11 - 0:0
16076868,2024-01-02 13:50:00,Mkrtchyan Andranik - Diaryan Aleksandr,3:0,8:11 - 2:11 - 4:11 - 0:0 - 0:0,0,3,Mkrtchyan Andranik,Diaryan Aleksandr,fiurst,Diaryan Aleksandr - Mkrtchyan Andranik,47,33,14,-19,19,19,13,15,0,0,-3,-9,-7,0,0,-19,11:8 - 11:2 - 11:4 - 0:0 - 0:0
16076867,2024-01-02 13:40:00,Papyan Karen - Nikoghosyan Narek,1:3,7:11 - 11:6 - 13:11 - 13:11 - 0:0,3,1,Papyan Karen,Nikoghosyan Narek,fiurst,Nikoghosyan Narek - Papyan Karen,83,39,44,5,-5,18,17,24,24,0,-4,5,2,2,0,5,11:7 - 6:11 - 11:13 - 11:13 - 0:0
16076862,2024-01-02 13:20:00,Arutyunov Ruben - Diaryan Aleksandr,0:3,3:11 - 9:11 - 5:11 - 0:0 - 0:0,0,3,Arutyunov Ruben,Diaryan Aleksandr,fiurst,Arutyunov Ruben - Diaryan Aleksandr,50,17,33,16,-16,14,20,16,0,0,8,2,6,0,0,16,3:11 - 9:11 - 5:11 - 0:0 - 0:0
16076852,2024-01-02 13:00:00,Papyan Karen - Mkrtchyan Andranik,1:3,10:12 - 12:10 - 11:9 - 11:9 - 0:0,3,1,Papyan Karen,Mkrtchyan Andranik,fiurst,Mkrtchyan Andranik - Papyan Karen,84,40,44,4,-4,22,22,20,20,0,-2,2,2,2,0,4,12:10 - 10:12 - 9:11 - 9:11 - 0:0
16076849,2024-01-02 12:30:00,Nikoghosyan Narek - Diaryan Aleksandr,2:3,7:11 - 11:9 - 11:1 - 10:12 - 12:10,3,2,Nikoghosyan Narek,Diaryan Aleksandr,fiurst,Diaryan Aleksandr - Nikoghosyan Narek,94,43,51,8,-8,18,20,12,22,22,-4,2,10,-2,2,8,11:7 - 9:11 - 1:11 - 12:10 - 10:12
16076847,2024-01-02 12:00:00,Papyan Karen - Arutyunov Ruben,0:3,12:10 - 11:8 - 11:9 - 0:0 - 0:0,3,0,Papyan Karen,Arutyunov Ruben,fiurst,Arutyunov Ruben - Papyan Karen,61,27,34,7,-7,22,19,20,0,0,2,3,2,0,0,7,10:12 - 8:11 - 9:11 - 0:0 - 0:0
16076845,2024-01-02 11:55:00,Mkrtchyan Andranik - Nikoghosyan Narek,2:3,11:8 - 8:11 - 8:11 - 12:10 - 2:11,2,3,Mkrtchyan Andranik,Nikoghosyan Narek,fiurst,Mkrtchyan Andranik - Nikoghosyan Narek,92,41,51,10,-10,19,19,19,22,13,-3,3,3,-2,9,10,11:8 - 8:11 - 8:11 - 12:10 - 2:11
16076844,2024-01-02 11:45:00,Papyan Karen - Diaryan Aleksandr,0:3,11:8 - 11:8 - 11:9 - 0:0 - 0:0,3,0,Papyan Karen,Diaryan Aleksandr,fiurst,Diaryan Aleksandr - Papyan Karen,58,25,33,8,-8,19,19,20,0,0,3,3,2,0,0,8,8:11 - 8:11 - 9:11 - 0:0 - 0:0
16076842,2024-01-02 11:15:00,Arutyunov Ruben - Mkrtchyan Andranik,3:1,8:11 - 11:5 - 11:9 - 12:10 - 0:0,3,1,Arutyunov Ruben,Mkrtchyan Andranik,fiurst,Arutyunov Ruben - Mkrtchyan Andranik,77,42,35,-7,7,19,16,20,22,0,3,-6,-2,-2,0,-7,8:11 - 11:5 - 11:9 - 12:10 - 0:0
16076830,2024-01-02 11:10:00,Nikoghosyan Narek - Papyan Karen,0:3,9:11 - 8:11 - 14:16 - 0:0 - 0:0,0,3,Nikoghosyan Narek,Papyan Karen,fiurst,Nikoghosyan Narek - Papyan Karen,69,31,38,7,-7,20,19,30,0,0,2,3,2,0,0,7,9:11 - 8:11 - 14:16 - 0:0 - 0:0
16076829,2024-01-02 10:45:00,Diaryan Aleksandr - Mkrtchyan Andranik,3:0,11:5 - 11:4 - 11:6 - 0:0 - 0:0,3,0,Diaryan Aleksandr,Mkrtchyan Andranik,fiurst,Diaryan Aleksandr - Mkrtchyan Andranik,48,33,15,-18,18,16,15,17,0,0,-6,-7,-5,0,0,-18,11:5 - 11:4 - 11:6 - 0:0 - 0:0
16076828,2024-01-02 10:30:00,Arutyunov Ruben - Nikoghosyan Narek,2:3,11:8 - 16:14 - 5:11 - 7:11 - 8:11,2,3,Arutyunov Ruben,Nikoghosyan Narek,fiurst,Arutyunov Ruben - Nikoghosyan Narek,102,47,55,8,-8,19,30,16,18,19,-3,-2,6,4,3,8,11:8 - 16:14 - 5:11 - 7:11 - 8:11
16076827,2024-01-02 10:15:00,Mkrtchyan Andranik - Papyan Karen,0:3,10:12 - 5:11 - 8:11 - 0:0 - 0:0,0,3,Mkrtchyan Andranik,Papyan Karen,fiurst,Mkrtchyan Andranik - Papyan Karen,57,23,34,11,-11,22,16,19,0,0,2,6,3,0,0,11,10:12 - 5:11 - 8:11 - 0:0 - 0:0
16076824,2024-01-02 10:00:00,Diaryan Aleksandr - Arutyunov Ruben,0:3,13:11 - 11:5 - 11:6 - 0:0 - 0:0,3,0,Diaryan Aleksandr,Arutyunov Ruben,fiurst,Arutyunov Ruben - Diaryan Aleksandr,57,22,35,13,-13,24,16,17,0,0,2,6,5,0,0,13,11:13 - 5:11 - 6:11 - 0:0 - 0:0
16056455,2024-01-01 17:45:00,Gevorgyan Hayk - Grigoryan Erik,3:1,12:10 - 11:9 - 7:11 - 11:7 - 0:0,3,1,Gevorgyan Hayk,Grigoryan Erik,fiurst,Gevorgyan Hayk - Grigoryan Erik,78,41,37,-4,4,22,20,18,18,0,-2,-2,4,-4,0,-4,12:10 - 11:9 - 7:11 - 11:7 - 0:0
16056444,2024-01-01 17:30:00,Avakimyan Davit - Karakhanyan Mher,3:0,11:8 - 11:8 - 14:12 - 0:0 - 0:0,3,0,Avakimyan Davit,Karakhanyan Mher,fiurst,Avakimyan Davit - Karakhanyan Mher,64,36,28,-8,8,19,19,26,0,0,-3,-3,-2,0,0,-8,11:8 - 11:8 - 14:12 - 0:0 - 0:0
16056442,2024-01-01 17:25:00,Gevorgyan Gegham - Gevorgyan Hayk,1:3,9:11 - 11:9 - 9:11 - 7:11 - 0:0,1,3,Gevorgyan Gegham,Gevorgyan Hayk,fiurst,Gevorgyan Gegham - Gevorgyan Hayk,78,36,42,6,-6,20,20,20,18,0,2,-2,2,4,0,6,9:11 - 11:9 - 9:11 - 7:11 - 0:0
16056440,2024-01-01 17:00:00,Avakimyan Davit - Grigoryan Erik,3:0,11:7 - 11:7 - 11:9 - 0:0 - 0:0,3,0,Avakimyan Davit,Grigoryan Erik,fiurst,Avakimyan Davit - Grigoryan Erik,56,33,23,-10,10,18,18,20,0,0,-4,-4,-2,0,0,-10,11:7 - 11:7 - 11:9 - 0:0 - 0:0
16056438,2024-01-01 16:45:00,Karakhanyan Mher - Gevorgyan Gegham,3:2,10:12 - 9:11 - 11:7 - 11:7 - 5:11,2,3,Karakhanyan Mher,Gevorgyan Gegham,fiurst,Gevorgyan Gegham - Karakhanyan Mher,94,48,46,-2,2,22,20,18,18,16,-2,-2,4,4,-6,-2,12:10 - 11:9 - 7:11 - 7:11 - 11:5
16056436,2024-01-01 16:30:00,Gevorgyan Hayk - Avakimyan Davit,2:3,8:11 - 11:7 - 10:12 - 11:8 - 11:6,3,2,Gevorgyan Hayk,Avakimyan Davit,fiurst,Avakimyan Davit - Gevorgyan Hayk,95,44,51,7,-7,19,18,22,19,17,-3,4,-2,3,5,7,11:8 - 7:11 - 12:10 - 8:11 - 6:11
16056419,2024-01-01 16:15:00,Grigoryan Erik - Gevorgyan Gegham,3:0,7:11 - 7:11 - 9:11 - 0:0 - 0:0,0,3,Grigoryan Erik,Gevorgyan Gegham,fiurst,Gevorgyan Gegham - Grigoryan Erik,56,33,23,-10,10,18,18,20,0,0,-4,-4,-2,0,0,-10,11:7 - 11:7 - 11:9 - 0:0 - 0:0
16056417,2024-01-01 16:00:00,Karakhanyan Mher - Gevorgyan Hayk,3:0,7:11 - 9:11 - 7:11 - 0:0 - 0:0,0,3,Karakhanyan Mher,Gevorgyan Hayk,fiurst,Gevorgyan Hayk - Karakhanyan Mher,56,33,23,-10,10,18,20,18,0,0,-4,-2,-4,0,0,-10,11:7 - 11:9 - 11:7 - 0:0 - 0:0
16056407,2024-01-01 15:45:00,Gevorgyan Gegham - Avakimyan Davit,3:0,5:11 - 6:11 - 14:16 - 0:0 - 0:0,0,3,Gevorgyan Gegham,Avakimyan Davit,fiurst,Avakimyan Davit - Gevorgyan Gegham,63,38,25,-13,13,16,17,30,0,0,-6,-5,-2,0,0,-13,11:5 - 11:6 - 16:14 - 0:0 - 0:0
16056401,2024-01-01 15:30:00,Grigoryan Erik - Karakhanyan Mher,1:3,7:11 - 8:11 - 11:9 - 3:11 - 0:0,1,3,Grigoryan Erik,Karakhanyan Mher,fiurst,Grigoryan Erik - Karakhanyan Mher,71,29,42,13,-13,18,19,20,14,0,4,3,-2,8,0,13,7:11 - 8:11 - 11:9 - 3:11 - 0:0
16056399,2024-01-01 15:15:00,Nazaryan Mushegh - Papyan Karen,1:3,11:2 - 8:11 - 9:11 - 9:11 - 0:0,1,3,Nazaryan Mushegh,Papyan Karen,fiurst,Nazaryan Mushegh - Papyan Karen,72,37,35,-2,2,13,19,20,20,0,-9,3,2,2,0,-2,11:2 - 8:11 - 9:11 - 9:11 - 0:0
16056398,2024-01-01 15:00:00,Soghomonyan Hrayr - Diaryan Aleksandr,3:0,7:11 - 6:11 - 11:13 - 0:0 - 0:0,0,3,Soghomonyan Hrayr,Diaryan Aleksandr,fiurst,Diaryan Aleksandr - Soghomonyan Hrayr,59,35,24,-11,11,18,17,24,0,0,-4,-5,-2,0,0,-11,11:7 - 11:6 - 13:11 - 0:0 - 0:0
16056395,2024-01-01 14:50:00,Mkrtchyan Andranik - Papyan Karen,1:3,6:11 - 11:7 - 9:11 - 4:11 - 0:0,1,3,Mkrtchyan Andranik,Papyan Karen,fiurst,Mkrtchyan Andranik - Papyan Karen,70,30,40,10,-10,17,18,20,15,0,5,-4,2,7,0,10,6:11 - 11:7 - 9:11 - 4:11 - 0:0
16056392,2024-01-01 14:30:00,Soghomonyan Hrayr - Nazaryan Mushegh,0:3,11:9 - 11:7 - 11:8 - 0:0 - 0:0,3,0,Soghomonyan Hrayr,Nazaryan Mushegh,fiurst,Nazaryan Mushegh - Soghomonyan Hrayr,57,24,33,9,-9,20,18,19,0,0,2,4,3,0,0,9,9:11 - 7:11 - 8:11 - 0:0 - 0:0
16056390,2024-01-01 14:15:00,Diaryan Aleksandr - Papyan Karen,3:2,11:6 - 5:11 - 12:10 - 7:11 - 11:9,3,2,Diaryan Aleksandr,Papyan Karen,fiurst,Diaryan Aleksandr - Papyan Karen,93,46,47,1,-1,17,16,22,18,20,-5,6,-2,4,-2,1,11:6 - 5:11 - 12:10 - 7:11 - 11:9
16056894,2024-01-01 14:00:00,Soghomonyan Hrayr - Mkrtchyan Andranik,0:3,11:3 - 11:7 - 11:1 - 0:0 - 0:0,3,0,Soghomonyan Hrayr,Mkrtchyan Andranik,fiurst,Mkrtchyan Andranik - Soghomonyan Hrayr,44,11,33,22,-22,14,18,12,0,0,8,4,10,0,0,22,3:11 - 7:11 - 1:11 - 0:0 - 0:0
16056892,2024-01-01 13:50:00,Nazaryan Mushegh - Diaryan Aleksandr,3:0,5:11 - 10:12 - 2:11 - 0:0 - 0:0,0,3,Nazaryan Mushegh,Diaryan Aleksandr,fiurst,Diaryan Aleksandr - Nazaryan Mushegh,51,34,17,-17,17,16,22,13,0,0,-6,-2,-9,0,0,-17,11:5 - 12:10 - 11:2 - 0:0 - 0:0
16056879,2024-01-01 13:30:00,Soghomonyan Hrayr - Papyan Karen,0:3,11:5 - 11:6 - 11:9 - 0:0 - 0:0,3,0,Soghomonyan Hrayr,Papyan Karen,fiurst,Papyan Karen - Soghomonyan Hrayr,53,20,33,13,-13,16,17,20,0,0,6,5,2,0,0,13,5:11 - 6:11 - 9:11 - 0:0 - 0:0
16056877,2024-01-01 13:20:00,Mkrtchyan Andranik - Nazaryan Mushegh,1:3,7:11 - 11:8 - 5:11 - 8:11 - 0:0,1,3,Mkrtchyan Andranik,Nazaryan Mushegh,fiurst,Mkrtchyan Andranik - Nazaryan Mushegh,72,31,41,10,-10,18,19,16,19,0,4,-3,6,3,0,10,7:11 - 11:8 - 5:11 - 8:11 - 0:0
16056876,2024-01-01 13:00:00,Diaryan Aleksandr - Soghomonyan Hrayr,3:0,11:4 - 11:7 - 11:7 - 0:0 - 0:0,3,0,Diaryan Aleksandr,Soghomonyan Hrayr,fiurst,Diaryan Aleksandr - Soghomonyan Hrayr,51,33,18,-15,15,15,18,18,0,0,-7,-4,-4,0,0,-15,11:4 - 11:7 - 11:7 - 0:0 - 0:0
16056875,2024-01-01 12:45:00,Papyan Karen - Nazaryan Mushegh,3:2,10:12 - 11:6 - 4:11 - 15:13 - 8:11,2,3,Papyan Karen,Nazaryan Mushegh,fiurst,Nazaryan Mushegh - Papyan Karen,101,53,48,-5,5,22,17,15,28,19,-2,5,-7,2,-3,-5,12:10 - 6:11 - 11:4 - 13:15 - 11:8
16056872,2024-01-01 12:30:00,Mkrtchyan Andranik - Diaryan Aleksandr,3:0,6:11 - 7:11 - 9:11 - 0:0 - 0:0,0,3,Mkrtchyan Andranik,Diaryan Aleksandr,fiurst,Diaryan Aleksandr - Mkrtchyan Andranik,55,33,22,-11,11,17,18,20,0,0,-5,-4,-2,0,0,-11,11:6 - 11:7 - 11:9 - 0:0 - 0:0
16056870,2024-01-01 12:15:00,Nazaryan Mushegh - Soghomonyan Hrayr,3:0,11:8 - 11:8 - 11:8 - 0:0 - 0:0,3,0,Nazaryan Mushegh,Soghomonyan Hrayr,fiurst,Nazaryan Mushegh - Soghomonyan Hrayr,57,33,24,-9,9,19,19,19,0,0,-3,-3,-3,0,0,-9,11:8 - 11:8 - 11:8 - 0:0 - 0:0
16056869,2024-01-01 12:00:00,Papyan Karen - Mkrtchyan Andranik,0:3,11:7 - 11:9 - 11:5 - 0:0 - 0:0,3,0,Papyan Karen,Mkrtchyan Andranik,fiurst,Mkrtchyan Andranik - Papyan Karen,54,21,33,12,-12,18,20,16,0,0,4,2,6,0,0,12,7:11 - 9:11 - 5:11 - 0:0 - 0:0
16038092,2023-12-31 17:45:00,Miroyan Hakob - Darbinyan Armen,1:3,11:7 - 11:8 - 10:12 - 11:7 - 0:0,3,1,Miroyan Hakob,Darbinyan Armen,fiurst,Darbinyan Armen - Miroyan Hakob,77,34,43,9,-9,18,19,22,18,0,4,3,-2,4,0,9,7:11 - 8:11 - 12:10 - 7:11 - 0:0
16038091,2023-12-31 17:30:00,Gevorgyan Hayk - Gevorgyan Gegham,2:3,6:11 - 11:2 - 7:11 - 11:7 - 11:3,3,2,Gevorgyan Hayk,Gevorgyan Gegham,fiurst,Gevorgyan Gegham - Gevorgyan Hayk,80,34,46,12,-12,17,13,18,18,14,-5,9,-4,4,8,12,11:6 - 2:11 - 11:7 - 7:11 - 3:11
16038079,2023-12-31 17:15:00,Karakhanyan Mher - Miroyan Hakob,3:2,6:11 - 10:12 - 11:9 - 13:11 - 11:4,3,2,Karakhanyan Mher,Miroyan Hakob,fiurst,Karakhanyan Mher - Miroyan Hakob,98,51,47,-4,4,17,22,20,24,15,5,2,-2,-2,-7,-4,6:11 - 10:12 - 11:9 - 13:11 - 11:4
16038073,2023-12-31 17:00:00,Gevorgyan Hayk - Darbinyan Armen,0:3,11:6 - 13:11 - 12:10 - 0:0 - 0:0,3,0,Gevorgyan Hayk,Darbinyan Armen,fiurst,Darbinyan Armen - Gevorgyan Hayk,63,27,36,9,-9,17,24,22,0,0,5,2,2,0,0,9,6:11 - 11:13 - 10:12 - 0:0 - 0:0
16038066,2023-12-31 16:45:00,Gevorgyan Gegham - Karakhanyan Mher,3:1,4:11 - 11:5 - 11:4 - 11:8 - 0:0,3,1,Gevorgyan Gegham,Karakhanyan Mher,fiurst,Gevorgyan Gegham - Karakhanyan Mher,65,37,28,-9,9,15,16,15,19,0,7,-6,-7,-3,0,-9,4:11 - 11:5 - 11:4 - 11:8 - 0:0
16038063,2023-12-31 16:30:00,Miroyan Hakob - Gevorgyan Hayk,3:1,5:11 - 11:7 - 8:11 - 9:11 - 0:0,1,3,Miroyan Hakob,Gevorgyan Hayk,fiurst,Gevorgyan Hayk - Miroyan Hakob,73,40,33,-7,7,16,18,19,20,0,-6,4,-3,-2,0,-7,11:5 - 7:11 - 11:8 - 11:9 - 0:0
16038062,2023-12-31 16:15:00,Darbinyan Armen - Karakhanyan Mher,1:3,11:7 - 4:11 - 10:12 - 6:11 - 0:0,1,3,Darbinyan Armen,Karakhanyan Mher,fiurst,Darbinyan Armen - Karakhanyan Mher,72,31,41,10,-10,18,15,22,17,0,-4,7,2,5,0,10,11:7 - 4:11 - 10:12 - 6:11 - 0:0
16038060,2023-12-31 16:00:00,Gevorgyan Gegham - Miroyan Hakob,3:1,11:8 - 13:15 - 11:4 - 11:9 - 0:0,3,1,Gevorgyan Gegham,Miroyan Hakob,fiurst,Gevorgyan Gegham - Miroyan Hakob,82,46,36,-10,10,19,28,15,20,0,-3,2,-7,-2,0,-10,11:8 - 13:15 - 11:4 - 11:9 - 0:0
16038048,2023-12-31 15:45:00,Karakhanyan Mher - Gevorgyan Hayk,3:1,11:8 - 8:11 - 9:11 - 12:14 - 0:0,1,3,Karakhanyan Mher,Gevorgyan Hayk,fiurst,Gevorgyan Hayk - Karakhanyan Mher,84,44,40,-4,4,19,19,20,26,0,3,-3,-2,-2,0,-4,8:11 - 11:8 - 11:9 - 14:12 - 0:0
16038040,2023-12-31 15:30:00,Darbinyan Armen - Gevorgyan Gegham,0:3,9:11 - 3:11 - 3:11 - 0:0 - 0:0,0,3,Darbinyan Armen,Gevorgyan Gegham,fiurst,Darbinyan Armen - Gevorgyan Gegham,48,15,33,18,-18,20,14,14,0,0,2,8,8,0,0,18,9:11 - 3:11 - 3:11 - 0:0 - 0:0
16038034,2023-12-31 15:20:00,Soghomonyan Hrayr - Diaryan Aleksandr,3:1,11:9 - 9:11 - 5:11 - 4:11 - 0:0,1,3,Soghomonyan Hrayr,Diaryan Aleksandr,fiurst,Diaryan Aleksandr - Soghomonyan Hrayr,71,42,29,-13,13,20,20,16,15,0,2,-2,-6,-7,0,-13,9:11 - 11:9 - 11:5 - 11:4 - 0:0
16038031,2023-12-31 15:05:00,Nazaryan Mushegh - Nikoghosyan Narek,0:3,7:11 - 9:11 - 6:11 - 0:0 - 0:0,0,3,Nazaryan Mushegh,Nikoghosyan Narek,fiurst,Nazaryan Mushegh - Nikoghosyan Narek,55,22,33,11,-11,18,20,17,0,0,4,2,5,0,0,11,7:11 - 9:11 - 6:11 - 0:0 - 0:0
16038029,2023-12-31 14:55:00,Rafayelyan Edgar - Soghomonyan Hrayr,3:0,11:7 - 11:8 - 11:4 - 0:0 - 0:0,3,0,Rafayelyan Edgar,Soghomonyan Hrayr,fiurst,Rafayelyan Edgar - Soghomonyan Hrayr,52,33,19,-14,14,18,19,15,0,0,-4,-3,-7,0,0,-14,11:7 - 11:8 - 11:4 - 0:0 - 0:0
16038027,2023-12-31 14:50:00,Diaryan Aleksandr - Nazaryan Mushegh,3:0,11:8 - 11:5 - 11:7 - 0:0 - 0:0,3,0,Diaryan Aleksandr,Nazaryan Mushegh,fiurst,Diaryan Aleksandr - Nazaryan Mushegh,53,33,20,-13,13,19,16,18,0,0,-3,-6,-4,0,0,-13,11:8 - 11:5 - 11:7 - 0:0 - 0:0
16038015,2023-12-31 14:30:00,Rafayelyan Edgar - Nikoghosyan Narek,0:3,12:10 - 11:9 - 11:5 - 0:0 - 0:0,3,0,Rafayelyan Edgar,Nikoghosyan Narek,fiurst,Nikoghosyan Narek - Rafayelyan Edgar,58,24,34,10,-10,22,20,16,0,0,2,2,6,0,0,10,10:12 - 9:11 - 5:11 - 0:0 - 0:0
16038014,2023-12-31 14:20:00,Soghomonyan Hrayr - Nazaryan Mushegh,3:1,10:12 - 11:9 - 8:11 - 13:15 - 0:0,1,3,Soghomonyan Hrayr,Nazaryan Mushegh,fiurst,Nazaryan Mushegh - Soghomonyan Hrayr,89,47,42,-5,5,22,20,19,28,0,-2,2,-3,-2,0,-5,12:10 - 9:11 - 11:8 - 15:13 - 0:0
16037992,2023-12-31 13:50:00,Diaryan Aleksandr - Rafayelyan Edgar,2:3,3:11 - 13:11 - 11:6 - 9:11 - 13:15,2,3,Diaryan Aleksandr,Rafayelyan Edgar,fiurst,Diaryan Aleksandr - Rafayelyan Edgar,103,49,54,5,-5,14,24,17,20,28,8,-2,-5,2,2,5,3:11 - 13:11 - 11:6 - 9:11 - 13:15
16037990,2023-12-31 13:40:00,Nikoghosyan Narek - Soghomonyan Hrayr,3:2,10:12 - 11:6 - 11:5 - 3:11 - 11:6,3,2,Nikoghosyan Narek,Soghomonyan Hrayr,fiurst,Nikoghosyan Narek - Soghomonyan Hrayr,86,46,40,-6,6,22,17,16,14,17,2,-5,-6,8,-5,-6,10:12 - 11:6 - 11:5 - 3:11 - 11:6
16037986,2023-12-31 13:15:00,Nazaryan Mushegh - Rafayelyan Edgar,3:1,11:9 - 11:8 - 3:11 - 12:10 - 0:0,3,1,Nazaryan Mushegh,Rafayelyan Edgar,fiurst,Nazaryan Mushegh - Rafayelyan Edgar,75,37,38,1,-1,20,19,14,22,0,-2,-3,8,-2,0,1,11:9 - 11:8 - 3:11 - 12:10 - 0:0
16037982,2023-12-31 13:00:00,Nikoghosyan Narek - Diaryan Aleksandr,3:2,10:12 - 8:11 - 11:8 - 11:5 - 9:11,2,3,Nikoghosyan Narek,Diaryan Aleksandr,fiurst,Diaryan Aleksandr - Nikoghosyan Narek,96,47,49,2,-2,22,19,19,16,20,-2,-3,3,6,-2,2,12:10 - 11:8 - 8:11 - 5:11 - 11:9
16037976,2023-12-31 12:15:00,Soghomonyan Hrayr - Rafayelyan Edgar,3:0,9:11 - 9:11 - 7:11 - 0:0 - 0:0,0,3,Soghomonyan Hrayr,Rafayelyan Edgar,fiurst,Rafayelyan Edgar - Soghomonyan Hrayr,58,33,25,-8,8,20,20,18,0,0,-2,-2,-4,0,0,-8,11:9 - 11:9 - 11:7 - 0:0 - 0:0
16037972,2023-12-31 12:05:00,Nikoghosyan Narek - Nazaryan Mushegh,0:3,11:9 - 11:7 - 11:7 - 0:0 - 0:0,3,0,Nikoghosyan Narek,Nazaryan Mushegh,fiurst,Nazaryan Mushegh - Nikoghosyan Narek,56,23,33,10,-10,20,18,18,0,0,2,4,4,0,0,10,9:11 - 7:11 - 7:11 - 0:0 - 0:0
16037957,2023-12-31 11:45:00,Diaryan Aleksandr - Soghomonyan Hrayr,3:1,5:11 - 11:6 - 14:12 - 11:5 - 0:0,3,1,Diaryan Aleksandr,Soghomonyan Hrayr,fiurst,Diaryan Aleksandr - Soghomonyan Hrayr,75,41,34,-7,7,16,17,26,16,0,6,-5,-2,-6,0,-7,5:11 - 11:6 - 14:12 - 11:5 - 0:0
16037955,2023-12-31 11:35:00,Nikoghosyan Narek - Rafayelyan Edgar,0:3,7:11 - 5:11 - 8:11 - 0:0 - 0:0,0,3,Nikoghosyan Narek,Rafayelyan Edgar,fiurst,Nikoghosyan Narek - Rafayelyan Edgar,53,20,33,13,-13,18,16,19,0,0,4,6,3,0,0,13,7:11 - 5:11 - 8:11 - 0:0 - 0:0
16037951,2023-12-31 11:15:00,Nazaryan Mushegh - Diaryan Aleksandr,3:0,5:11 - 6:11 - 6:11 - 0:0 - 0:0,0,3,Nazaryan Mushegh,Diaryan Aleksandr,fiurst,Diaryan Aleksandr - Nazaryan Mushegh,50,33,17,-16,16,16,17,17,0,0,-6,-5,-5,0,0,-16,11:5 - 11:6 - 11:6 - 0:0 - 0:0
16037917,2023-12-31 11:05:00,Soghomonyan Hrayr - Nikoghosyan Narek,3:0,8:11 - 5:11 - 7:11 - 0:0 - 0:0,0,3,Soghomonyan Hrayr,Nikoghosyan Narek,fiurst,Nikoghosyan Narek - Soghomonyan Hrayr,53,33,20,-13,13,19,16,18,0,0,-3,-6,-4,0,0,-13,11:8 - 11:5 - 11:7 - 0:0 - 0:0
16037916,2023-12-31 10:50:00,Rafayelyan Edgar - Diaryan Aleksandr,2:3,7:11 - 11:8 - 5:11 - 11:8 - 11:4,3,2,Rafayelyan Edgar,Diaryan Aleksandr,fiurst,Diaryan Aleksandr - Rafayelyan Edgar,87,42,45,3,-3,18,19,16,19,15,-4,3,-6,3,7,3,11:7 - 8:11 - 11:5 - 8:11 - 4:11
16037915,2023-12-31 10:30:00,Nazaryan Mushegh - Soghomonyan Hrayr,2:3,11:6 - 7:11 - 7:11 - 11:8 - 4:11,2,3,Nazaryan Mushegh,Soghomonyan Hrayr,fiurst,Nazaryan Mushegh - Soghomonyan Hrayr,87,40,47,7,-7,17,18,18,19,15,-5,4,4,-3,7,7,11:6 - 7:11 - 7:11 - 11:8 - 4:11
16037914,2023-12-31 10:15:00,Diaryan Aleksandr - Nikoghosyan Narek,2:3,11:7 - 7:11 - 11:8 - 7:11 - 8:11,2,3,Diaryan Aleksandr,Nikoghosyan Narek,fiurst,Diaryan Aleksandr - Nikoghosyan Narek,92,44,48,4,-4,18,18,19,18,19,-4,4,-3,4,3,4,11:7 - 7:11 - 11:8 - 7:11 - 8:11
16037913,2023-12-31 10:00:00,Rafayelyan Edgar - Nazaryan Mushegh,1:3,9:11 - 11:4 - 11:3 - 11:8 - 0:0,3,1,Rafayelyan Edgar,Nazaryan Mushegh,fiurst,Nazaryan Mushegh - Rafayelyan Edgar,68,26,42,16,-16,20,15,14,19,0,-2,7,8,3,0,16,11:9 - 4:11 - 3:11 - 8:11 - 0:0
16020694,2023-12-30 17:45:00,Gevorgyan Gegham - Gevorgyan Hayk,2:3,11:8 - 11:8 - 6:11 - 7:11 - 8:11,2,3,Gevorgyan Gegham,Gevorgyan Hayk,fiurst,Gevorgyan Gegham - Gevorgyan Hayk,92,43,49,6,-6,19,19,17,18,19,-3,-3,5,4,3,6,11:8 - 11:8 - 6:11 - 7:11 - 8:11
16020692,2023-12-30 17:30:00,Grigoryan Erik - Darbinyan Armen,0:3,11:4 - 11:6 - 11:5 - 0:0 - 0:0,3,0,Grigoryan Erik,Darbinyan Armen,fiurst,Darbinyan Armen - Grigoryan Erik,48,15,33,18,-18,15,17,16,0,0,7,5,6,0,0,18,4:11 - 6:11 - 5:11 - 0:0 - 0:0
16020690,2023-12-30 17:15:00,Miroyan Hakob - Gevorgyan Gegham,3:0,7:11 - 5:11 - 7:11 - 0:0 - 0:0,0,3,Miroyan Hakob,Gevorgyan Gegham,fiurst,Gevorgyan Gegham - Miroyan Hakob,52,33,19,-14,14,18,16,18,0,0,-4,-6,-4,0,0,-14,11:7 - 11:5 - 11:7 - 0:0 - 0:0
16020688,2023-12-30 17:00:00,Grigoryan Erik - Gevorgyan Hayk,3:1,11:7 - 8:11 - 6:11 - 10:12 - 0:0,1,3,Grigoryan Erik,Gevorgyan Hayk,fiurst,Gevorgyan Hayk - Grigoryan Erik,76,41,35,-6,6,18,19,17,22,0,4,-3,-5,-2,0,-6,7:11 - 11:8 - 11:6 - 12:10 - 0:0
16020684,2023-12-30 16:46:00,Darbinyan Armen - Miroyan Hakob,1:3,4:11 - 11:8 - 4:11 - 6:11 - 0:0,1,3,Darbinyan Armen,Miroyan Hakob,fiurst,Darbinyan Armen - Miroyan Hakob,66,25,41,16,-16,15,19,15,17,0,7,-3,7,5,0,16,4:11 - 11:8 - 4:11 - 6:11 - 0:0
16020673,2023-12-30 16:30:00,Gevorgyan Gegham - Grigoryan Erik,3:0,12:10 - 11:7 - 11:9 - 0:0 - 0:0,3,0,Gevorgyan Gegham,Grigoryan Erik,fiurst,Gevorgyan Gegham - Grigoryan Erik,60,34,26,-8,8,22,18,20,0,0,-2,-4,-2,0,0,-8,12:10 - 11:7 - 11:9 - 0:0 - 0:0
16020672,2023-12-30 16:15:00,Gevorgyan Hayk - Miroyan Hakob,3:1,11:8 - 9:11 - 11:7 - 11:7 - 0:0,3,1,Gevorgyan Hayk,Miroyan Hakob,fiurst,Gevorgyan Hayk - Miroyan Hakob,75,42,33,-9,9,19,20,18,18,0,-3,2,-4,-4,0,-9,11:8 - 9:11 - 11:7 - 11:7 - 0:0
16020666,2023-12-30 16:00:00,Darbinyan Armen - Gevorgyan Gegham,1:3,9:11 - 12:10 - 5:11 - 3:11 - 0:0,1,3,Darbinyan Armen,Gevorgyan Gegham,fiurst,Darbinyan Armen - Gevorgyan Gegham,72,29,43,14,-14,20,22,16,14,0,2,-2,6,8,0,14,9:11 - 12:10 - 5:11 - 3:11 - 0:0
16020664,2023-12-30 15:45:00,Miroyan Hakob - Grigoryan Erik,3:0,4:11 - 8:11 - 9:11 - 0:0 - 0:0,0,3,Miroyan Hakob,Grigoryan Erik,fiurst,Grigoryan Erik - Miroyan Hakob,54,33,21,-12,12,15,19,20,0,0,-7,-3,-2,0,0,-12,11:4 - 11:8 - 11:9 - 0:0 - 0:0
16020651,2023-12-30 15:30:00,Gevorgyan Hayk - Darbinyan Armen,0:3,11:8 - 11:9 - 12:10 - 0:0 - 0:0,3,0,Gevorgyan Hayk,Darbinyan Armen,fiurst,Darbinyan Armen - Gevorgyan Hayk,61,27,34,7,-7,19,20,22,0,0,3,2,2,0,0,7,8:11 - 9:11 - 10:12 - 0:0 - 0:0
16020650,2023-12-30 15:20:00,Nikoghosyan Narek - Papyan Karen,3:1,12:10 - 6:11 - 11:2 - 11:9 - 0:0,3,1,Nikoghosyan Narek,Papyan Karen,fiurst,Nikoghosyan Narek - Papyan Karen,72,40,32,-8,8,22,17,13,20,0,-2,5,-9,-2,0,-8,12:10 - 6:11 - 11:2 - 11:9 - 0:0
16020646,2023-12-30 15:00:00,Nazaryan Mushegh - Soghomonyan Hrayr,3:0,11:9 - 11:9 - 11:5 - 0:0 - 0:0,3,0,Nazaryan Mushegh,Soghomonyan Hrayr,fiurst,Nazaryan Mushegh - Soghomonyan Hrayr,56,33,23,-10,10,20,20,16,0,0,-2,-2,-6,0,0,-10,11:9 - 11:9 - 11:5 - 0:0 - 0:0
16020644,2023-12-30 14:45:00,Arutyunov Ruben - Nikoghosyan Narek,1:3,6:11 - 11:8 - 7:11 - 8:11 - 0:0,1,3,Arutyunov Ruben,Nikoghosyan Narek,fiurst,Arutyunov Ruben - Nikoghosyan Narek,73,32,41,9,-9,17,19,18,19,0,5,-3,4,3,0,9,6:11 - 11:8 - 7:11 - 8:11 - 0:0
16020641,2023-12-30 14:35:00,Papyan Karen - Nazaryan Mushegh,3:2,7:11 - 12:10 - 11:9 - 4:11 - 6:11,2,3,Papyan Karen,Nazaryan Mushegh,fiurst,Nazaryan Mushegh - Papyan Karen,92,52,40,-12,12,18,22,20,15,17,-4,2,2,-7,-5,-12,11:7 - 10:12 - 9:11 - 11:4 - 11:6
16020632,2023-12-30 14:15:00,Arutyunov Ruben - Soghomonyan Hrayr,3:0,11:6 - 11:4 - 11:5 - 0:0 - 0:0,3,0,Arutyunov Ruben,Soghomonyan Hrayr,fiurst,Arutyunov Ruben - Soghomonyan Hrayr,48,33,15,-18,18,17,15,16,0,0,-5,-7,-6,0,0,-18,11:6 - 11:4 - 11:5 - 0:0 - 0:0
16020630,2023-12-30 14:00:00,Nikoghosyan Narek - Nazaryan Mushegh,2:3,11:3 - 11:3 - 3:11 - 8:11 - 11:6,3,2,Nikoghosyan Narek,Nazaryan Mushegh,fiurst,Nazaryan Mushegh - Nikoghosyan Narek,78,34,44,10,-10,14,14,14,19,17,8,8,-8,-3,5,10,3:11 - 3:11 - 11:3 - 11:8 - 6:11
16020622,2023-12-30 13:45:00,Papyan Karen - Arutyunov Ruben,0:3,11:9 - 11:3 - 11:7 - 0:0 - 0:0,3,0,Papyan Karen,Arutyunov Ruben,fiurst,Arutyunov Ruben - Papyan Karen,52,19,33,14,-14,20,14,18,0,0,2,8,4,0,0,14,9:11 - 3:11 - 7:11 - 0:0 - 0:0
16020614,2023-12-30 13:30:00,Soghomonyan Hrayr - Nikoghosyan Narek,3:0,6:11 - 7:11 - 6:11 - 0:0 - 0:0,0,3,Soghomonyan Hrayr,Nikoghosyan Narek,fiurst,Nikoghosyan Narek - Soghomonyan Hrayr,52,33,19,-14,14,17,18,17,0,0,-5,-4,-5,0,0,-14,11:6 - 11:7 - 11:6 - 0:0 - 0:0
16020613,2023-12-30 13:15:00,Nazaryan Mushegh - Arutyunov Ruben,0:3,11:5 - 11:7 - 11:6 - 0:0 - 0:0,3,0,Nazaryan Mushegh,Arutyunov Ruben,fiurst,Arutyunov Ruben - Nazaryan Mushegh,51,18,33,15,-15,16,18,17,0,0,6,4,5,0,0,15,5:11 - 7:11 - 6:11 - 0:0 - 0:0
16020609,2023-12-30 13:05:00,Soghomonyan Hrayr - Papyan Karen,3:0,9:11 - 12:14 - 7:11 - 0:0 - 0:0,0,3,Soghomonyan Hrayr,Papyan Karen,fiurst,Papyan Karen - Soghomonyan Hrayr,64,36,28,-8,8,20,26,18,0,0,-2,-2,-4,0,0,-8,11:9 - 14:12 - 11:7 - 0:0 - 0:0
16020606,2023-12-30 12:30:00,Nikoghosyan Narek - Arutyunov Ruben,0:3,11:7 - 11:5 - 11:2 - 0:0 - 0:0,3,0,Nikoghosyan Narek,Arutyunov Ruben,fiurst,Arutyunov Ruben - Nikoghosyan Narek,47,14,33,19,-19,18,16,13,0,0,4,6,9,0,0,19,7:11 - 5:11 - 2:11 - 0:0 - 0:0
16020603,2023-12-30 12:00:00,Papyan Karen - Nikoghosyan Narek,3:1,11:7 - 9:11 - 4:11 - 9:11 - 0:0,1,3,Papyan Karen,Nikoghosyan Narek,fiurst,Nikoghosyan Narek - Papyan Karen,73,40,33,-7,7,18,20,15,20,0,4,-2,-7,-2,0,-7,7:11 - 11:9 - 11:4 - 11:9 - 0:0
16020605,2023-12-30 12:00:00,Soghomonyan Hrayr - Nazaryan Mushegh,3:1,11:6 - 7:11 - 7:11 - 8:11 - 0:0,1,3,Soghomonyan Hrayr,Nazaryan Mushegh,fiurst,Nazaryan Mushegh - Soghomonyan Hrayr,72,39,33,-6,6,17,18,18,19,0,5,-4,-4,-3,0,-6,6:11 - 11:7 - 11:7 - 11:8 - 0:0
16020591,2023-12-30 11:30:00,Soghomonyan Hrayr - Arutyunov Ruben,3:1,6:11 - 5:11 - 11:3 - 6:11 - 0:0,1,3,Soghomonyan Hrayr,Arutyunov Ruben,fiurst,Arutyunov Ruben - Soghomonyan Hrayr,64,36,28,-8,8,17,16,14,17,0,-5,-6,8,-5,0,-8,11:6 - 11:5 - 3:11 - 11:6 - 0:0
16020589,2023-12-30 11:20:00,Nazaryan Mushegh - Papyan Karen,3:1,13:11 - 11:8 - 13:15 - 11:8 - 0:0,3,1,Nazaryan Mushegh,Papyan Karen,fiurst,Nazaryan Mushegh - Papyan Karen,90,48,42,-6,6,24,19,28,19,0,-2,-3,2,-3,0,-6,13:11 - 11:8 - 13:15 - 11:8 - 0:0
16020587,2023-12-30 11:00:00,Nikoghosyan Narek - Soghomonyan Hrayr,3:0,11:7 - 11:6 - 11:5 - 0:0 - 0:0,3,0,Nikoghosyan Narek,Soghomonyan Hrayr,fiurst,Nikoghosyan Narek - Soghomonyan Hrayr,51,33,18,-15,15,18,17,16,0,0,-4,-5,-6,0,0,-15,11:7 - 11:6 - 11:5 - 0:0 - 0:0
16020585,2023-12-30 10:45:00,Arutyunov Ruben - Papyan Karen,1:3,12:10 - 10:12 - 7:11 - 6:11 - 0:0,1,3,Arutyunov Ruben,Papyan Karen,fiurst,Arutyunov Ruben - Papyan Karen,79,35,44,9,-9,22,22,18,17,0,-2,2,4,5,0,9,12:10 - 10:12 - 7:11 - 6:11 - 0:0
16020583,2023-12-30 10:30:00,Nazaryan Mushegh - Nikoghosyan Narek,3:2,11:8 - 7:11 - 11:4 - 9:11 - 11:4,3,2,Nazaryan Mushegh,Nikoghosyan Narek,fiurst,Nazaryan Mushegh - Nikoghosyan Narek,87,49,38,-11,11,19,18,15,20,15,-3,4,-7,2,-7,-11,11:8 - 7:11 - 11:4 - 9:11 - 11:4
16020581,2023-12-30 10:15:00,Papyan Karen - Soghomonyan Hrayr,3:2,11:6 - 9:11 - 7:11 - 11:7 - 11:9,3,2,Papyan Karen,Soghomonyan Hrayr,fiurst,Papyan Karen - Soghomonyan Hrayr,93,49,44,-5,5,17,20,18,18,20,-5,2,4,-4,-2,-5,11:6 - 9:11 - 7:11 - 11:7 - 11:9
16020578,2023-12-30 10:00:00,Arutyunov Ruben - Nazaryan Mushegh,3:1,12:10 - 11:7 - 5:11 - 11:7 - 0:0,3,1,Arutyunov Ruben,Nazaryan Mushegh,fiurst,Arutyunov Ruben - Nazaryan Mushegh,74,39,35,-4,4,22,18,16,18,0,-2,-4,6,-4,0,-4,12:10 - 11:7 - 5:11 - 11:7 - 0:0
16006865,2023-12-29 17:45:00,Gevorgyan Hayk - Grigoryan Erik,3:0,11:4 - 11:7 - 11:8 - 0:0 - 0:0,3,0,Gevorgyan Hayk,Grigoryan Erik,fiurst,Gevorgyan Hayk - Grigoryan Erik,52,33,19,-14,14,15,18,19,0,0,-7,-4,-3,0,0,-14,11:4 - 11:7 - 11:8 - 0:0 - 0:0
16006853,2023-12-29 17:30:00,Karakhanyan Mher - Miroyan Hakob,3:2,10:12 - 11:8 - 7:11 - 11:7 - 11:7,3,2,Karakhanyan Mher,Miroyan Hakob,fiurst,Karakhanyan Mher - Miroyan Hakob,95,50,45,-5,5,22,19,18,18,18,2,-3,4,-4,-4,-5,10:12 - 11:8 - 7:11 - 11:7 - 11:7
16006849,2023-12-29 17:15:00,Darbinyan Armen - Gevorgyan Hayk,0:3,6:11 - 13:15 - 11:13 - 0:0 - 0:0,0,3,Darbinyan Armen,Gevorgyan Hayk,fiurst,Darbinyan Armen - Gevorgyan Hayk,69,30,39,9,-9,17,28,24,0,0,5,2,2,0,0,9,6:11 - 13:15 - 11:13 - 0:0 - 0:0
16006847,2023-12-29 17:00:00,Karakhanyan Mher - Grigoryan Erik,3:2,5:11 - 11:5 - 11:3 - 9:11 - 9:11,2,3,Karakhanyan Mher,Grigoryan Erik,fiurst,Grigoryan Erik - Karakhanyan Mher,86,41,45,4,-4,16,16,14,20,20,-6,6,8,-2,-2,4,11:5 - 5:11 - 3:11 - 11:9 - 11:9
16006844,2023-12-29 16:50:00,Miroyan Hakob - Darbinyan Armen,3:0,9:11 - 8:11 - 10:12 - 0:0 - 0:0,0,3,Miroyan Hakob,Darbinyan Armen,fiurst,Darbinyan Armen - Miroyan Hakob,61,34,27,-7,7,20,19,22,0,0,-2,-3,-2,0,0,-7,11:9 - 11:8 - 12:10 - 0:0 - 0:0
16006841,2023-12-29 16:30:00,Gevorgyan Hayk - Karakhanyan Mher,3:0,11:7 - 11:6 - 11:9 - 0:0 - 0:0,3,0,Gevorgyan Hayk,Karakhanyan Mher,fiurst,Gevorgyan Hayk - Karakhanyan Mher,55,33,22,-11,11,18,17,20,0,0,-4,-5,-2,0,0,-11,11:7 - 11:6 - 11:9 - 0:0 - 0:0
16006839,2023-12-29 16:15:00,Grigoryan Erik - Darbinyan Armen,3:2,5:11 - 5:11 - 11:7 - 11:9 - 9:11,2,3,Grigoryan Erik,Darbinyan Armen,fiurst,Darbinyan Armen - Grigoryan Erik,90,49,41,-8,8,16,16,18,20,20,-6,-6,4,2,-2,-8,11:5 - 11:5 - 7:11 - 9:11 - 11:9
16006826,2023-12-29 16:00:00,Darbinyan Armen - Karakhanyan Mher,0:3,8:11 - 4:11 - 7:11 - 0:0 - 0:0,0,3,Darbinyan Armen,Karakhanyan Mher,fiurst,Darbinyan Armen - Karakhanyan Mher,52,19,33,14,-14,19,15,18,0,0,3,7,4,0,0,14,8:11 - 4:11 - 7:11 - 0:0 - 0:0
16006828,2023-12-29 16:00:00,Miroyan Hakob - Gevorgyan Hayk,3:0,6:11 - 9:11 - 5:11 - 0:0 - 0:0,0,3,Miroyan Hakob,Gevorgyan Hayk,fiurst,Gevorgyan Hayk - Miroyan Hakob,53,33,20,-13,13,17,20,16,0,0,-5,-2,-6,0,0,-13,11:6 - 11:9 - 11:5 - 0:0 - 0:0
16006822,2023-12-29 15:40:00,Grigoryan Erik - Miroyan Hakob,3:0,11:7 - 11:9 - 11:8 - 0:0 - 0:0,3,0,Grigoryan Erik,Miroyan Hakob,fiurst,Grigoryan Erik - Miroyan Hakob,57,33,24,-9,9,18,20,19,0,0,-4,-2,-3,0,0,-9,11:7 - 11:9 - 11:8 - 0:0 - 0:0
16006799,2023-12-29 15:30:00,Rafayelyan Edgar - Nazaryan Mushegh,2:3,8:11 - 5:11 - 14:12 - 11:8 - 13:11,3,2,Rafayelyan Edgar,Nazaryan Mushegh,fiurst,Nazaryan Mushegh - Rafayelyan Edgar,104,53,51,-2,2,19,16,26,19,24,-3,-6,2,3,2,-2,11:8 - 11:5 - 12:14 - 8:11 - 11:13
16006797,2023-12-29 15:15:00,Arutyunov Ruben - Papyan Karen,0:3,8:11 - 10:12 - 13:15 - 0:0 - 0:0,0,3,Arutyunov Ruben,Papyan Karen,fiurst,Arutyunov Ruben - Papyan Karen,69,31,38,7,-7,19,22,28,0,0,3,2,2,0,0,7,8:11 - 10:12 - 13:15 - 0:0 - 0:0
16006762,2023-12-29 14:50:00,Diaryan Aleksandr - Rafayelyan Edgar,3:2,6:11 - 14:12 - 11:9 - 8:11 - 11:5,3,2,Diaryan Aleksandr,Rafayelyan Edgar,fiurst,Diaryan Aleksandr - Rafayelyan Edgar,98,50,48,-2,2,17,26,20,19,16,5,-2,-2,3,-6,-2,6:11 - 14:12 - 11:9 - 8:11 - 11:5
16006754,2023-12-29 14:40:00,Nazaryan Mushegh - Arutyunov Ruben,0:3,11:7 - 11:3 - 11:8 - 0:0 - 0:0,3,0,Nazaryan Mushegh,Arutyunov Ruben,fiurst,Arutyunov Ruben - Nazaryan Mushegh,51,18,33,15,-15,18,14,19,0,0,4,8,3,0,0,15,7:11 - 3:11 - 8:11 - 0:0 - 0:0
16006752,2023-12-29 14:25:00,Diaryan Aleksandr - Papyan Karen,2:3,10:12 - 11:9 - 11:8 - 7:11 - 5:11,2,3,Diaryan Aleksandr,Papyan Karen,fiurst,Diaryan Aleksandr - Papyan Karen,95,44,51,7,-7,22,20,19,18,16,2,-2,-3,4,6,7,10:12 - 11:9 - 11:8 - 7:11 - 5:11
16006750,2023-12-29 14:00:00,Rafayelyan Edgar - Arutyunov Ruben,1:3,11:6 - 5:11 - 11:6 - 11:7 - 0:0,3,1,Rafayelyan Edgar,Arutyunov Ruben,fiurst,Arutyunov Ruben - Rafayelyan Edgar,68,30,38,8,-8,17,16,17,18,0,5,-6,5,4,0,8,6:11 - 11:5 - 6:11 - 7:11 - 0:0
16006747,2023-12-29 13:50:00,Nazaryan Mushegh - Diaryan Aleksandr,3:1,11:9 - 2:11 - 2:11 - 8:11 - 0:0,1,3,Nazaryan Mushegh,Diaryan Aleksandr,fiurst,Diaryan Aleksandr - Nazaryan Mushegh,65,42,23,-19,19,20,13,13,19,0,2,-9,-9,-3,0,-19,9:11 - 11:2 - 11:2 - 11:8 - 0:0
16006737,2023-12-29 13:30:00,Papyan Karen - Rafayelyan Edgar,3:0,11:8 - 11:4 - 11:6 - 0:0 - 0:0,3,0,Papyan Karen,Rafayelyan Edgar,fiurst,Papyan Karen - Rafayelyan Edgar,51,33,18,-15,15,19,15,17,0,0,-3,-7,-5,0,0,-15,11:8 - 11:4 - 11:6 - 0:0 - 0:0
16006730,2023-12-29 13:15:00,Arutyunov Ruben - Diaryan Aleksandr,1:3,7:11 - 11:9 - 6:11 - 4:11 - 0:0,1,3,Arutyunov Ruben,Diaryan Aleksandr,fiurst,Arutyunov Ruben - Diaryan Aleksandr,70,28,42,14,-14,18,20,17,15,0,4,-2,5,7,0,14,7:11 - 11:9 - 6:11 - 4:11 - 0:0
16006727,2023-12-29 13:00:00,Papyan Karen - Nazaryan Mushegh,0:3,11:8 - 11:7 - 12:10 - 0:0 - 0:0,3,0,Papyan Karen,Nazaryan Mushegh,fiurst,Nazaryan Mushegh - Papyan Karen,59,25,34,9,-9,19,18,22,0,0,3,4,2,0,0,9,8:11 - 7:11 - 10:12 - 0:0 - 0:0
16006723,2023-12-29 12:15:00,Rafayelyan Edgar - Diaryan Aleksandr,3:2,12:10 - 11:6 - 9:11 - 7:11 - 1:11,2,3,Rafayelyan Edgar,Diaryan Aleksandr,fiurst,Diaryan Aleksandr - Rafayelyan Edgar,89,49,40,-9,9,22,17,20,18,12,2,5,-2,-4,-10,-9,10:12 - 6:11 - 11:9 - 11:7 - 11:1
16006722,2023-12-29 12:10:00,Papyan Karen - Arutyunov Ruben,2:3,11:7 - 8:11 - 11:9 - 5:11 - 11:8,3,2,Papyan Karen,Arutyunov Ruben,fiurst,Arutyunov Ruben - Papyan Karen,92,46,46,0,0,18,19,20,16,19,4,-3,2,-6,3,0,7:11 - 11:8 - 9:11 - 11:5 - 8:11
16006710,2023-12-29 12:00:00,Nazaryan Mushegh - Rafayelyan Edgar,0:3,3:11 - 6:11 - 6:11 - 0:0 - 0:0,0,3,Nazaryan Mushegh,Rafayelyan Edgar,fiurst,Nazaryan Mushegh - Rafayelyan Edgar,48,15,33,18,-18,14,17,17,0,0,8,5,5,0,0,18,3:11 - 6:11 - 6:11 - 0:0 - 0:0
16006709,2023-12-29 11:30:00,Papyan Karen - Diaryan Aleksandr,1:3,11:8 - 5:11 - 11:9 - 11:8 - 0:0,3,1,Papyan Karen,Diaryan Aleksandr,fiurst,Diaryan Aleksandr - Papyan Karen,74,36,38,2,-2,19,16,20,19,0,3,-6,2,3,0,2,8:11 - 11:5 - 9:11 - 8:11 - 0:0
16006707,2023-12-29 11:20:00,Arutyunov Ruben - Nazaryan Mushegh,2:3,13:11 - 11:8 - 11:13 - 11:13 - 6:11,2,3,Arutyunov Ruben,Nazaryan Mushegh,fiurst,Arutyunov Ruben - Nazaryan Mushegh,108,52,56,4,-4,24,19,24,24,17,-2,-3,2,2,5,4,13:11 - 11:8 - 11:13 - 11:13 - 6:11
16006705,2023-12-29 11:05:00,Rafayelyan Edgar - Papyan Karen,0:3,11:7 - 11:5 - 11:7 - 0:0 - 0:0,3,0,Rafayelyan Edgar,Papyan Karen,fiurst,Papyan Karen - Rafayelyan Edgar,52,19,33,14,-14,18,16,18,0,0,4,6,4,0,0,14,7:11 - 5:11 - 7:11 - 0:0 - 0:0
16006702,2023-12-29 10:50:00,Diaryan Aleksandr - Nazaryan Mushegh,3:1,11:6 - 13:11 - 11:13 - 11:5 - 0:0,3,1,Diaryan Aleksandr,Nazaryan Mushegh,fiurst,Diaryan Aleksandr - Nazaryan Mushegh,81,46,35,-11,11,17,24,24,16,0,-5,-2,2,-6,0,-11,11:6 - 13:11 - 11:13 - 11:5 - 0:0
16006698,2023-12-29 10:30:00,Arutyunov Ruben - Rafayelyan Edgar,1:3,11:9 - 6:11 - 7:11 - 13:15 - 0:0,1,3,Arutyunov Ruben,Rafayelyan Edgar,fiurst,Arutyunov Ruben - Rafayelyan Edgar,83,37,46,9,-9,20,17,18,28,0,-2,5,4,2,0,9,11:9 - 6:11 - 7:11 - 13:15 - 0:0
16006697,2023-12-29 10:15:00,Nazaryan Mushegh - Papyan Karen,1:3,11:4 - 9:11 - 8:11 - 7:11 - 0:0,1,3,Nazaryan Mushegh,Papyan Karen,fiurst,Nazaryan Mushegh - Papyan Karen,72,35,37,2,-2,15,20,19,18,0,-7,2,3,4,0,2,11:4 - 9:11 - 8:11 - 7:11 - 0:0
16006695,2023-12-29 10:00:00,Diaryan Aleksandr - Arutyunov Ruben,3:0,11:13 - 6:11 - 3:11 - 0:0 - 0:0,0,3,Diaryan Aleksandr,Arutyunov Ruben,fiurst,Arutyunov Ruben - Diaryan Aleksandr,55,35,20,-15,15,24,17,14,0,0,-2,-5,-8,0,0,-15,13:11 - 11:6 - 11:3 - 0:0 - 0:0
15987060,2023-12-28 17:45:00,Darbinyan Armen - Gevorgyan Gegham,0:3,5:11 - 6:11 - 6:11 - 0:0 - 0:0,0,3,Darbinyan Armen,Gevorgyan Gegham,fiurst,Darbinyan Armen - Gevorgyan Gegham,50,17,33,16,-16,16,17,17,0,0,6,5,5,0,0,16,5:11 - 6:11 - 6:11 - 0:0 - 0:0
15987029,2023-12-28 17:30:00,Gevorgyan Hayk - Karakhanyan Mher,3:0,11:6 - 11:8 - 11:3 - 0:0 - 0:0,3,0,Gevorgyan Hayk,Karakhanyan Mher,fiurst,Gevorgyan Hayk - Karakhanyan Mher,50,33,17,-16,16,17,19,14,0,0,-5,-3,-8,0,0,-16,11:6 - 11:8 - 11:3 - 0:0 - 0:0
15987024,2023-12-28 17:15:00,Grigoryan Erik - Darbinyan Armen,2:3,8:11 - 9:11 - 11:7 - 11:7 - 11:8,3,2,Grigoryan Erik,Darbinyan Armen,fiurst,Darbinyan Armen - Grigoryan Erik,94,44,50,6,-6,19,20,18,18,19,-3,-2,4,4,3,6,11:8 - 11:9 - 7:11 - 7:11 - 8:11
15987022,2023-12-28 17:00:00,Gevorgyan Hayk - Gevorgyan Gegham,0:3,12:10 - 11:1 - 11:6 - 0:0 - 0:0,3,0,Gevorgyan Hayk,Gevorgyan Gegham,fiurst,Gevorgyan Gegham - Gevorgyan Hayk,51,17,34,17,-17,22,12,17,0,0,2,10,5,0,0,17,10:12 - 1:11 - 6:11 - 0:0 - 0:0
15987020,2023-12-28 16:45:00,Karakhanyan Mher - Grigoryan Erik,0:3,11:8 - 11:7 - 11:7 - 0:0 - 0:0,3,0,Karakhanyan Mher,Grigoryan Erik,fiurst,Grigoryan Erik - Karakhanyan Mher,55,22,33,11,-11,19,18,18,0,0,3,4,4,0,0,11,8:11 - 7:11 - 7:11 - 0:0 - 0:0
15987019,2023-12-28 16:35:00,Darbinyan Armen - Gevorgyan Hayk,1:3,8:11 - 11:5 - 7:11 - 3:11 - 0:0,1,3,Darbinyan Armen,Gevorgyan Hayk,fiurst,Darbinyan Armen - Gevorgyan Hayk,67,29,38,9,-9,19,16,18,14,0,3,-6,4,8,0,9,8:11 - 11:5 - 7:11 - 3:11 - 0:0
15987015,2023-12-28 16:15:00,Gevorgyan Gegham - Grigoryan Erik,3:1,11:2 - 11:13 - 11:6 - 11:6 - 0:0,3,1,Gevorgyan Gegham,Grigoryan Erik,fiurst,Gevorgyan Gegham - Grigoryan Erik,71,44,27,-17,17,13,24,17,17,0,-9,2,-5,-5,0,-17,11:2 - 11:13 - 11:6 - 11:6 - 0:0
15987013,2023-12-28 16:00:00,Karakhanyan Mher - Darbinyan Armen,1:3,14:12 - 11:7 - 9:11 - 11:6 - 0:0,3,1,Karakhanyan Mher,Darbinyan Armen,fiurst,Darbinyan Armen - Karakhanyan Mher,81,36,45,9,-9,26,18,20,17,0,2,4,-2,5,0,9,12:14 - 7:11 - 11:9 - 6:11 - 0:0
15987009,2023-12-28 15:45:00,Grigoryan Erik - Gevorgyan Hayk,3:0,3:11 - 9:11 - 6:11 - 0:0 - 0:0,0,3,Grigoryan Erik,Gevorgyan Hayk,fiurst,Gevorgyan Hayk - Grigoryan Erik,51,33,18,-15,15,14,20,17,0,0,-8,-2,-5,0,0,-15,11:3 - 11:9 - 11:6 - 0:0 - 0:0
15987006,2023-12-28 15:30:00,Gevorgyan Gegham - Karakhanyan Mher,3:0,11:4 - 11:8 - 11:4 - 0:0 - 0:0,3,0,Gevorgyan Gegham,Karakhanyan Mher,fiurst,Gevorgyan Gegham - Karakhanyan Mher,49,33,16,-17,17,15,19,15,0,0,-7,-3,-7,0,0,-17,11:4 - 11:8 - 11:4 - 0:0 - 0:0
15986995,2023-12-28 15:15:00,Soghomonyan Hrayr - Papyan Karen,3:0,9:11 - 6:11 - 8:11 - 0:0 - 0:0,0,3,Soghomonyan Hrayr,Papyan Karen,fiurst,Papyan Karen - Soghomonyan Hrayr,56,33,23,-10,10,20,17,19,0,0,-2,-5,-3,0,0,-10,11:9 - 11:6 - 11:8 - 0:0 - 0:0
15986992,2023-12-28 15:05:00,Diaryan Aleksandr - Rafayelyan Edgar,3:1,13:11 - 8:11 - 11:6 - 11:4 - 0:0,3,1,Diaryan Aleksandr,Rafayelyan Edgar,fiurst,Diaryan Aleksandr - Rafayelyan Edgar,75,43,32,-11,11,24,19,17,15,0,-2,3,-5,-7,0,-11,13:11 - 8:11 - 11:6 - 11:4 - 0:0
15986990,2023-12-28 14:50:00,Nikoghosyan Narek - Soghomonyan Hrayr,3:0,11:8 - 11:6 - 11:5 - 0:0 - 0:0,3,0,Nikoghosyan Narek,Soghomonyan Hrayr,fiurst,Nikoghosyan Narek - Soghomonyan Hrayr,52,33,19,-14,14,19,17,16,0,0,-3,-5,-6,0,0,-14,11:8 - 11:6 - 11:5 - 0:0 - 0:0
15986988,2023-12-28 14:35:00,Papyan Karen - Diaryan Aleksandr,3:0,8:11 - 9:11 - 9:11 - 0:0 - 0:0,0,3,Papyan Karen,Diaryan Aleksandr,fiurst,Diaryan Aleksandr - Papyan Karen,59,33,26,-7,7,19,20,20,0,0,-3,-2,-2,0,0,-7,11:8 - 11:9 - 11:9 - 0:0 - 0:0
15986973,2023-12-28 14:20:00,Nikoghosyan Narek - Rafayelyan Edgar,3:1,11:8 - 6:11 - 11:8 - 11:8 - 0:0,3,1,Nikoghosyan Narek,Rafayelyan Edgar,fiurst,Nikoghosyan Narek - Rafayelyan Edgar,74,39,35,-4,4,19,17,19,19,0,-3,5,-3,-3,0,-4,11:8 - 6:11 - 11:8 - 11:8 - 0:0
15986858,2023-12-28 14:10:00,Soghomonyan Hrayr - Diaryan Aleksandr,3:2,5:11 - 12:10 - 12:10 - 8:11 - 4:11,2,3,Soghomonyan Hrayr,Diaryan Aleksandr,fiurst,Diaryan Aleksandr - Soghomonyan Hrayr,94,53,41,-12,12,16,22,22,19,15,-6,2,2,-3,-7,-12,11:5 - 10:12 - 10:12 - 11:8 - 11:4
15986852,2023-12-28 13:50:00,Papyan Karen - Nikoghosyan Narek,0:3,11:8 - 11:8 - 12:10 - 0:0 - 0:0,3,0,Papyan Karen,Nikoghosyan Narek,fiurst,Nikoghosyan Narek - Papyan Karen,60,26,34,8,-8,19,19,22,0,0,3,3,2,0,0,8,8:11 - 8:11 - 10:12 - 0:0 - 0:0
15986848,2023-12-28 13:30:00,Rafayelyan Edgar - Soghomonyan Hrayr,3:0,11:6 - 12:10 - 11:7 - 0:0 - 0:0,3,0,Rafayelyan Edgar,Soghomonyan Hrayr,fiurst,Rafayelyan Edgar - Soghomonyan Hrayr,57,34,23,-11,11,17,22,18,0,0,-5,-2,-4,0,0,-11,11:6 - 12:10 - 11:7 - 0:0 - 0:0
15986846,2023-12-28 13:15:00,Diaryan Aleksandr - Nikoghosyan Narek,3:1,11:9 - 5:11 - 11:7 - 11:5 - 0:0,3,1,Diaryan Aleksandr,Nikoghosyan Narek,fiurst,Diaryan Aleksandr - Nikoghosyan Narek,70,38,32,-6,6,20,16,18,16,0,-2,6,-4,-6,0,-6,11:9 - 5:11 - 11:7 - 11:5 - 0:0
15986843,2023-12-28 13:00:00,Rafayelyan Edgar - Papyan Karen,0:3,11:6 - 11:9 - 13:11 - 0:0 - 0:0,3,0,Rafayelyan Edgar,Papyan Karen,fiurst,Papyan Karen - Rafayelyan Edgar,61,26,35,9,-9,17,20,24,0,0,5,2,2,0,0,9,6:11 - 9:11 - 11:13 - 0:0 - 0:0
15986831,2023-12-28 12:25:00,Soghomonyan Hrayr - Nikoghosyan Narek,3:1,11:9 - 8:11 - 4:11 - 3:11 - 0:0,1,3,Soghomonyan Hrayr,Nikoghosyan Narek,fiurst,Nikoghosyan Narek - Soghomonyan Hrayr,68,42,26,-16,16,20,19,15,14,0,2,-3,-7,-8,0,-16,9:11 - 11:8 - 11:4 - 11:3 - 0:0
15986826,2023-12-28 12:10:00,Rafayelyan Edgar - Diaryan Aleksandr,3:0,8:11 - 7:11 - 9:11 - 0:0 - 0:0,0,3,Rafayelyan Edgar,Diaryan Aleksandr,fiurst,Diaryan Aleksandr - Rafayelyan Edgar,57,33,24,-9,9,19,18,20,0,0,-3,-4,-2,0,0,-9,11:8 - 11:7 - 11:9 - 0:0 - 0:0
15986822,2023-12-28 11:50:00,Papyan Karen - Soghomonyan Hrayr,2:3,11:7 - 5:11 - 12:10 - 7:11 - 8:11,2,3,Papyan Karen,Soghomonyan Hrayr,fiurst,Papyan Karen - Soghomonyan Hrayr,93,43,50,7,-7,18,16,22,18,19,-4,6,-2,4,3,7,11:7 - 5:11 - 12:10 - 7:11 - 8:11
15986820,2023-12-28 11:35:00,Rafayelyan Edgar - Nikoghosyan Narek,3:2,11:7 - 7:11 - 8:11 - 11:8 - 9:11,2,3,Rafayelyan Edgar,Nikoghosyan Narek,fiurst,Nikoghosyan Narek - Rafayelyan Edgar,94,48,46,-2,2,18,18,19,19,20,4,-4,-3,3,-2,-2,7:11 - 11:7 - 11:8 - 8:11 - 11:9
15986817,2023-12-28 11:25:00,Diaryan Aleksandr - Papyan Karen,3:1,11:6 - 8:11 - 11:8 - 11:9 - 0:0,3,1,Diaryan Aleksandr,Papyan Karen,fiurst,Diaryan Aleksandr - Papyan Karen,75,41,34,-7,7,17,19,19,20,0,-5,3,-3,-2,0,-7,11:6 - 8:11 - 11:8 - 11:9 - 0:0
15986809,2023-12-28 11:00:00,Soghomonyan Hrayr - Rafayelyan Edgar,3:1,7:11 - 11:9 - 10:12 - 7:11 - 0:0,1,3,Soghomonyan Hrayr,Rafayelyan Edgar,fiurst,Rafayelyan Edgar - Soghomonyan Hrayr,78,43,35,-8,8,18,20,22,18,0,-4,2,-2,-4,0,-8,11:7 - 9:11 - 12:10 - 11:7 - 0:0
15986805,2023-12-28 10:55:00,Nikoghosyan Narek - Papyan Karen,1:3,8:11 - 2:11 - 11:4 - 7:11 - 0:0,1,3,Nikoghosyan Narek,Papyan Karen,fiurst,Nikoghosyan Narek - Papyan Karen,65,28,37,9,-9,19,13,15,18,0,3,9,-7,4,0,9,8:11 - 2:11 - 11:4 - 7:11 - 0:0
15986803,2023-12-28 10:35:00,Diaryan Aleksandr - Soghomonyan Hrayr,3:0,11:4 - 11:7 - 11:4 - 0:0 - 0:0,3,0,Diaryan Aleksandr,Soghomonyan Hrayr,fiurst,Diaryan Aleksandr - Soghomonyan Hrayr,48,33,15,-18,18,15,18,15,0,0,-7,-4,-7,0,0,-18,11:4 - 11:7 - 11:4 - 0:0 - 0:0
15986802,2023-12-28 10:15:00,Papyan Karen - Rafayelyan Edgar,3:2,8:11 - 11:9 - 12:10 - 10:12 - 13:11,3,2,Papyan Karen,Rafayelyan Edgar,fiurst,Papyan Karen - Rafayelyan Edgar,107,54,53,-1,1,19,20,22,22,24,3,-2,-2,2,-2,-1,8:11 - 11:9 - 12:10 - 10:12 - 13:11
15986798,2023-12-28 10:00:00,Nikoghosyan Narek - Diaryan Aleksandr,3:2,11:2 - 6:11 - 9:11 - 13:11 - 5:11,2,3,Nikoghosyan Narek,Diaryan Aleksandr,fiurst,Diaryan Aleksandr - Nikoghosyan Narek,90,46,44,-2,2,13,17,20,24,16,9,-5,-2,2,-6,-2,2:11 - 11:6 - 11:9 - 11:13 - 11:5
15973047,2023-12-27 17:45:00,Darbinyan Armen - Karakhanyan Mher,0:3,4:11 - 8:11 - 8:11 - 0:0 - 0:0,0,3,Darbinyan Armen,Karakhanyan Mher,fiurst,Darbinyan Armen - Karakhanyan Mher,53,20,33,13,-13,15,19,19,0,0,7,3,3,0,0,13,4:11 - 8:11 - 8:11 - 0:0 - 0:0
15973045,2023-12-27 17:30:00,Grigoryan Erik - Miroyan Hakob,3:2,7:11 - 12:10 - 11:7 - 11:13 - 11:5,3,2,Grigoryan Erik,Miroyan Hakob,fiurst,Grigoryan Erik - Miroyan Hakob,98,52,46,-6,6,18,22,18,24,16,4,-2,-4,2,-6,-6,7:11 - 12:10 - 11:7 - 11:13 - 11:5
15973033,2023-12-27 17:15:00,Gevorgyan Gegham - Darbinyan Armen,0:3,11:5 - 11:5 - 11:6 - 0:0 - 0:0,3,0,Gevorgyan Gegham,Darbinyan Armen,fiurst,Darbinyan Armen - Gevorgyan Gegham,49,16,33,17,-17,16,16,17,0,0,6,6,5,0,0,17,5:11 - 5:11 - 6:11 - 0:0 - 0:0
15973031,2023-12-27 17:00:00,Grigoryan Erik - Karakhanyan Mher,3:0,11:9 - 11:5 - 11:6 - 0:0 - 0:0,3,0,Grigoryan Erik,Karakhanyan Mher,fiurst,Grigoryan Erik - Karakhanyan Mher,53,33,20,-13,13,20,16,17,0,0,-2,-6,-5,0,0,-13,11:9 - 11:5 - 11:6 - 0:0 - 0:0
15973029,2023-12-27 16:45:00,Miroyan Hakob - Gevorgyan Gegham,3:0,8:11 - 4:11 - 6:11 - 0:0 - 0:0,0,3,Miroyan Hakob,Gevorgyan Gegham,fiurst,Gevorgyan Gegham - Miroyan Hakob,51,33,18,-15,15,19,15,17,0,0,-3,-7,-5,0,0,-15,11:8 - 11:4 - 11:6 - 0:0 - 0:0
15973028,2023-12-27 16:30:00,Darbinyan Armen - Grigoryan Erik,0:3,9:11 - 6:11 - 4:11 - 0:0 - 0:0,0,3,Darbinyan Armen,Grigoryan Erik,fiurst,Darbinyan Armen - Grigoryan Erik,52,19,33,14,-14,20,17,15,0,0,2,5,7,0,0,14,9:11 - 6:11 - 4:11 - 0:0 - 0:0
15973023,2023-12-27 16:10:00,Gevorgyan Gegham - Grigoryan Erik,3:1,12:10 - 11:6 - 10:12 - 11:7 - 0:0,3,1,Gevorgyan Gegham,Grigoryan Erik,fiurst,Gevorgyan Gegham - Grigoryan Erik,79,44,35,-9,9,22,17,22,18,0,-2,-5,2,-4,0,-9,12:10 - 11:6 - 10:12 - 11:7 - 0:0
15973024,2023-12-27 16:00:00,Miroyan Hakob - Darbinyan Armen,0:3,11:8 - 11:5 - 11:9 - 0:0 - 0:0,3,0,Miroyan Hakob,Darbinyan Armen,fiurst,Darbinyan Armen - Miroyan Hakob,55,22,33,11,-11,19,16,20,0,0,3,6,2,0,0,11,8:11 - 5:11 - 9:11 - 0:0 - 0:0
15973026,2023-12-27 15:50:00,Karakhanyan Mher - Gevorgyan Gegham,0:3,11:7 - 11:6 - 11:8 - 0:0 - 0:0,3,0,Karakhanyan Mher,Gevorgyan Gegham,fiurst,Gevorgyan Gegham - Karakhanyan Mher,54,21,33,12,-12,18,17,19,0,0,4,5,3,0,0,12,7:11 - 6:11 - 8:11 - 0:0 - 0:0
15973022,2023-12-27 15:30:00,Karakhanyan Mher - Miroyan Hakob,1:3,11:8 - 7:11 - 5:11 - 11:13 - 0:0,1,3,Karakhanyan Mher,Miroyan Hakob,fiurst,Karakhanyan Mher - Miroyan Hakob,77,34,43,9,-9,19,18,16,24,0,-3,4,6,2,0,9,11:8 - 7:11 - 5:11 - 11:13 - 0:0
15973002,2023-12-27 15:25:00,Nazaryan Mushegh - Arutyunov Ruben,0:3,11:2 - 11:9 - 11:8 - 0:0 - 0:0,3,0,Nazaryan Mushegh,Arutyunov Ruben,fiurst,Arutyunov Ruben - Nazaryan Mushegh,52,19,33,14,-14,13,20,19,0,0,9,2,3,0,0,14,2:11 - 9:11 - 8:11 - 0:0 - 0:0
15973001,2023-12-27 15:00:00,Soghomonyan Hrayr - Nikoghosyan Narek,3:0,4:11 - 9:11 - 8:11 - 0:0 - 0:0,0,3,Soghomonyan Hrayr,Nikoghosyan Narek,fiurst,Nikoghosyan Narek - Soghomonyan Hrayr,54,33,21,-12,12,15,20,19,0,0,-7,-2,-3,0,0,-12,11:4 - 11:9 - 11:8 - 0:0 - 0:0
15973000,2023-12-27 14:45:00,Rafayelyan Edgar - Nazaryan Mushegh,2:3,8:11 - 14:12 - 8:11 - 11:9 - 11:9,3,2,Rafayelyan Edgar,Nazaryan Mushegh,fiurst,Nazaryan Mushegh - Rafayelyan Edgar,104,52,52,0,0,19,26,19,20,20,-3,2,-3,2,2,0,11:8 - 12:14 - 11:8 - 9:11 - 9:11
15972999,2023-12-27 14:30:00,Arutyunov Ruben - Soghomonyan Hrayr,0:3,7:11 - 6:11 - 9:11 - 0:0 - 0:0,0,3,Arutyunov Ruben,Soghomonyan Hrayr,fiurst,Arutyunov Ruben - Soghomonyan Hrayr,55,22,33,11,-11,18,17,20,0,0,4,5,2,0,0,11,7:11 - 6:11 - 9:11 - 0:0 - 0:0
15972996,2023-12-27 14:15:00,Rafayelyan Edgar - Nikoghosyan Narek,1:3,11:8 - 11:3 - 7:11 - 11:7 - 0:0,3,1,Rafayelyan Edgar,Nikoghosyan Narek,fiurst,Nikoghosyan Narek - Rafayelyan Edgar,69,29,40,11,-11,19,14,18,18,0,3,8,-4,4,0,11,8:11 - 3:11 - 11:7 - 7:11 - 0:0
15972995,2023-12-27 14:00:00,Nazaryan Mushegh - Soghomonyan Hrayr,3:2,14:16 - 11:9 - 11:7 - 7:11 - 11:8,3,2,Nazaryan Mushegh,Soghomonyan Hrayr,fiurst,Nazaryan Mushegh - Soghomonyan Hrayr,105,54,51,-3,3,30,20,18,18,19,2,-2,-4,4,-3,-3,14:16 - 11:9 - 11:7 - 7:11 - 11:8
15972988,2023-12-27 13:45:00,Arutyunov Ruben - Rafayelyan Edgar,0:3,6:11 - 7:11 - 6:11 - 0:0 - 0:0,0,3,Arutyunov Ruben,Rafayelyan Edgar,fiurst,Arutyunov Ruben - Rafayelyan Edgar,52,19,33,14,-14,17,18,17,0,0,5,4,5,0,0,14,6:11 - 7:11 - 6:11 - 0:0 - 0:0
15972986,2023-12-27 13:40:00,Nikoghosyan Narek - Nazaryan Mushegh,1:3,11:7 - 11:5 - 5:11 - 11:6 - 0:0,3,1,Nikoghosyan Narek,Nazaryan Mushegh,fiurst,Nazaryan Mushegh - Nikoghosyan Narek,67,29,38,9,-9,18,16,16,17,0,4,6,-6,5,0,9,7:11 - 5:11 - 11:5 - 6:11 - 0:0
15972975,2023-12-27 13:15:00,Soghomonyan Hrayr - Rafayelyan Edgar,3:0,1:11 - 4:11 - 2:11 - 0:0 - 0:0,0,3,Soghomonyan Hrayr,Rafayelyan Edgar,fiurst,Rafayelyan Edgar - Soghomonyan Hrayr,40,33,7,-26,26,12,15,13,0,0,-10,-7,-9,0,0,-26,11:1 - 11:4 - 11:2 - 0:0 - 0:0
15972973,2023-12-27 13:00:00,Nikoghosyan Narek - Arutyunov Ruben,3:2,11:5 - 15:13 - 5:11 - 8:11 - 9:11,2,3,Nikoghosyan Narek,Arutyunov Ruben,fiurst,Arutyunov Ruben - Nikoghosyan Narek,99,51,48,-3,3,16,28,16,19,20,6,2,-6,-3,-2,-3,5:11 - 13:15 - 11:5 - 11:8 - 11:9
15972268,2023-12-27 12:25:00,Nazaryan Mushegh - Rafayelyan Edgar,3:1,11:9 - 11:9 - 9:11 - 11:5 - 0:0,3,1,Nazaryan Mushegh,Rafayelyan Edgar,fiurst,Nazaryan Mushegh - Rafayelyan Edgar,76,42,34,-8,8,20,20,20,16,0,-2,-2,2,-6,0,-8,11:9 - 11:9 - 9:11 - 11:5 - 0:0
15972267,2023-12-27 12:05:00,Nikoghosyan Narek - Soghomonyan Hrayr,3:0,11:9 - 11:5 - 13:11 - 0:0 - 0:0,3,0,Nikoghosyan Narek,Soghomonyan Hrayr,fiurst,Nikoghosyan Narek - Soghomonyan Hrayr,60,35,25,-10,10,20,16,24,0,0,-2,-6,-2,0,0,-10,11:9 - 11:5 - 13:11 - 0:0 - 0:0
15972266,2023-12-27 11:45:00,Arutyunov Ruben - Nazaryan Mushegh,3:2,6:11 - 11:9 - 11:6 - 10:12 - 12:10,3,2,Arutyunov Ruben,Nazaryan Mushegh,fiurst,Arutyunov Ruben - Nazaryan Mushegh,98,50,48,-2,2,17,20,17,22,22,5,-2,-5,2,-2,-2,6:11 - 11:9 - 11:6 - 10:12 - 12:10
15972254,2023-12-27 11:35:00,Nikoghosyan Narek - Rafayelyan Edgar,0:3,4:11 - 3:11 - 9:11 - 0:0 - 0:0,0,3,Nikoghosyan Narek,Rafayelyan Edgar,fiurst,Nikoghosyan Narek - Rafayelyan Edgar,49,16,33,17,-17,15,14,20,0,0,7,8,2,0,0,17,4:11 - 3:11 - 9:11 - 0:0 - 0:0
15972253,2023-12-27 11:15:00,Soghomonyan Hrayr - Arutyunov Ruben,3:0,1:11 - 7:11 - 8:11 - 0:0 - 0:0,0,3,Soghomonyan Hrayr,Arutyunov Ruben,fiurst,Arutyunov Ruben - Soghomonyan Hrayr,49,33,16,-17,17,12,18,19,0,0,-10,-4,-3,0,0,-17,11:1 - 11:7 - 11:8 - 0:0 - 0:0
15972250,2023-12-27 11:00:00,Nazaryan Mushegh - Nikoghosyan Narek,1:3,8:11 - 9:11 - 11:3 - 7:11 - 0:0,1,3,Nazaryan Mushegh,Nikoghosyan Narek,fiurst,Nazaryan Mushegh - Nikoghosyan Narek,71,35,36,1,-1,19,20,14,18,0,3,2,-8,4,0,1,8:11 - 9:11 - 11:3 - 7:11 - 0:0
15972249,2023-12-27 10:50:00,Rafayelyan Edgar - Arutyunov Ruben,0:3,11:7 - 11:5 - 11:8 - 0:0 - 0:0,3,0,Rafayelyan Edgar,Arutyunov Ruben,fiurst,Arutyunov Ruben - Rafayelyan Edgar,53,20,33,13,-13,18,16,19,0,0,4,6,3,0,0,13,7:11 - 5:11 - 8:11 - 0:0 - 0:0
15972245,2023-12-27 10:40:00,Soghomonyan Hrayr - Nazaryan Mushegh,3:0,6:11 - 12:14 - 7:11 - 0:0 - 0:0,0,3,Soghomonyan Hrayr,Nazaryan Mushegh,fiurst,Nazaryan Mushegh - Soghomonyan Hrayr,61,36,25,-11,11,17,26,18,0,0,-5,-2,-4,0,0,-11,11:6 - 14:12 - 11:7 - 0:0 - 0:0
15972241,2023-12-27 10:15:00,Arutyunov Ruben - Nikoghosyan Narek,3:1,11:9 - 6:11 - 11:6 - 11:5 - 0:0,3,1,Arutyunov Ruben,Nikoghosyan Narek,fiurst,Arutyunov Ruben - Nikoghosyan Narek,70,39,31,-8,8,20,17,17,16,0,-2,5,-5,-6,0,-8,11:9 - 6:11 - 11:6 - 11:5 - 0:0
15972239,2023-12-27 10:00:00,Rafayelyan Edgar - Soghomonyan Hrayr,3:2,14:16 - 9:11 - 11:8 - 12:10 - 11:5,3,2,Rafayelyan Edgar,Soghomonyan Hrayr,fiurst,Rafayelyan Edgar - Soghomonyan Hrayr,107,57,50,-7,7,30,20,19,22,16,2,2,-3,-2,-6,-7,14:16 - 9:11 - 11:8 - 12:10 - 11:5
15956200,2023-12-26 17:50:00,Gevorgyan Gegham - Gevorgyan Hayk,2:3,7:11 - 11:7 - 12:10 - 6:11 - 2:11,2,3,Gevorgyan Gegham,Gevorgyan Hayk,fiurst,Gevorgyan Gegham - Gevorgyan Hayk,88,38,50,12,-12,18,18,22,17,13,4,-4,-2,5,9,12,7:11 - 11:7 - 12:10 - 6:11 - 2:11
15956196,2023-12-26 17:30:00,Karakhanyan Mher - Grigoryan Erik,0:3,11:9 - 11:3 - 11:5 - 0:0 - 0:0,3,0,Karakhanyan Mher,Grigoryan Erik,fiurst,Grigoryan Erik - Karakhanyan Mher,50,17,33,16,-16,20,14,16,0,0,2,8,6,0,0,16,9:11 - 3:11 - 5:11 - 0:0 - 0:0
15956194,2023-12-26 17:15:00,Miroyan Hakob - Gevorgyan Gegham,3:1,6:11 - 8:11 - 11:8 - 5:11 - 0:0,1,3,Miroyan Hakob,Gevorgyan Gegham,fiurst,Gevorgyan Gegham - Miroyan Hakob,71,41,30,-11,11,17,19,19,16,0,-5,-3,3,-6,0,-11,11:6 - 11:8 - 8:11 - 11:5 - 0:0
15956189,2023-12-26 17:00:00,Karakhanyan Mher - Gevorgyan Hayk,3:1,6:11 - 11:8 - 7:11 - 8:11 - 0:0,1,3,Karakhanyan Mher,Gevorgyan Hayk,fiurst,Gevorgyan Hayk - Karakhanyan Mher,73,41,32,-9,9,17,19,18,19,0,-5,3,-4,-3,0,-9,11:6 - 8:11 - 11:7 - 11:8 - 0:0
15956185,2023-12-26 16:45:00,Grigoryan Erik - Miroyan Hakob,1:3,11:13 - 4:11 - 11:8 - 6:11 - 0:0,1,3,Grigoryan Erik,Miroyan Hakob,fiurst,Grigoryan Erik - Miroyan Hakob,75,32,43,11,-11,24,15,19,17,0,2,7,-3,5,0,11,11:13 - 4:11 - 11:8 - 6:11 - 0:0
15956174,2023-12-26 16:30:00,Gevorgyan Gegham - Karakhanyan Mher,3:2,11:8 - 11:6 - 7:11 - 7:11 - 13:11,3,2,Gevorgyan Gegham,Karakhanyan Mher,fiurst,Gevorgyan Gegham - Karakhanyan Mher,96,49,47,-2,2,19,17,18,18,24,-3,-5,4,4,-2,-2,11:8 - 11:6 - 7:11 - 7:11 - 13:11
15956172,2023-12-26 16:20:00,Gevorgyan Hayk - Miroyan Hakob,3:0,11:8 - 11:9 - 11:9 - 0:0 - 0:0,3,0,Gevorgyan Hayk,Miroyan Hakob,fiurst,Gevorgyan Hayk - Miroyan Hakob,59,33,26,-7,7,19,20,20,0,0,-3,-2,-2,0,0,-7,11:8 - 11:9 - 11:9 - 0:0 - 0:0
15956171,2023-12-26 16:00:00,Grigoryan Erik - Gevorgyan Gegham,3:0,9:11 - 8:11 - 8:11 - 0:0 - 0:0,0,3,Grigoryan Erik,Gevorgyan Gegham,fiurst,Gevorgyan Gegham - Grigoryan Erik,58,33,25,-8,8,20,19,19,0,0,-2,-3,-3,0,0,-8,11:9 - 11:8 - 11:8 - 0:0 - 0:0
15956167,2023-12-26 15:50:00,Miroyan Hakob - Karakhanyan Mher,0:3,14:12 - 14:12 - 11:8 - 0:0 - 0:0,3,0,Miroyan Hakob,Karakhanyan Mher,fiurst,Karakhanyan Mher - Miroyan Hakob,71,32,39,7,-7,26,26,19,0,0,2,2,3,0,0,7,12:14 - 12:14 - 8:11 - 0:0 - 0:0
15956162,2023-12-26 15:35:00,Gevorgyan Hayk - Grigoryan Erik,3:1,11:3 - 12:10 - 5:11 - 11:5 - 0:0,3,1,Gevorgyan Hayk,Grigoryan Erik,fiurst,Gevorgyan Hayk - Grigoryan Erik,68,39,29,-10,10,14,22,16,16,0,-8,-2,6,-6,0,-10,11:3 - 12:10 - 5:11 - 11:5 - 0:0
15956160,2023-12-26 15:15:00,Diaryan Aleksandr - Nikoghosyan Narek,3:1,11:8 - 11:6 - 9:11 - 11:5 - 0:0,3,1,Diaryan Aleksandr,Nikoghosyan Narek,fiurst,Diaryan Aleksandr - Nikoghosyan Narek,72,42,30,-12,12,19,17,20,16,0,-3,-5,2,-6,0,-12,11:8 - 11:6 - 9:11 - 11:5 - 0:0
15956158,2023-12-26 15:10:00,Papyan Karen - Nazaryan Mushegh,2:3,5:11 - 13:15 - 11:7 - 11:9 - 11:6,3,2,Papyan Karen,Nazaryan Mushegh,fiurst,Nazaryan Mushegh - Papyan Karen,99,48,51,3,-3,16,28,18,20,17,-6,-2,4,2,5,3,11:5 - 15:13 - 7:11 - 9:11 - 6:11
15956146,2023-12-26 14:50:00,Arutyunov Ruben - Diaryan Aleksandr,2:3,12:10 - 11:6 - 10:12 - 8:11 - 8:11,2,3,Arutyunov Ruben,Diaryan Aleksandr,fiurst,Arutyunov Ruben - Diaryan Aleksandr,99,49,50,1,-1,22,17,22,19,19,-2,-5,2,3,3,1,12:10 - 11:6 - 10:12 - 8:11 - 8:11
15956145,2023-12-26 14:30:00,Nikoghosyan Narek - Papyan Karen,3:2,5:11 - 11:8 - 14:12 - 9:11 - 11:6,3,2,Nikoghosyan Narek,Papyan Karen,fiurst,Nikoghosyan Narek - Papyan Karen,98,50,48,-2,2,16,19,26,20,17,6,-3,-2,2,-5,-2,5:11 - 11:8 - 14:12 - 9:11 - 11:6
15956143,2023-12-26 14:25:00,Arutyunov Ruben - Nazaryan Mushegh,3:0,11:5 - 11:3 - 11:8 - 0:0 - 0:0,3,0,Arutyunov Ruben,Nazaryan Mushegh,fiurst,Arutyunov Ruben - Nazaryan Mushegh,49,33,16,-17,17,16,14,19,0,0,-6,-8,-3,0,0,-17,11:5 - 11:3 - 11:8 - 0:0 - 0:0
15956141,2023-12-26 14:00:00,Diaryan Aleksandr - Papyan Karen,3:2,11:7 - 11:8 - 12:14 - 9:11 - 11:9,3,2,Diaryan Aleksandr,Papyan Karen,fiurst,Diaryan Aleksandr - Papyan Karen,103,54,49,-5,5,18,19,26,20,20,-4,-3,2,2,-2,-5,11:7 - 11:8 - 12:14 - 9:11 - 11:9
15956139,2023-12-26 13:45:00,Nikoghosyan Narek - Arutyunov Ruben,2:3,5:11 - 4:11 - 11:3 - 11:9 - 11:5,3,2,Nikoghosyan Narek,Arutyunov Ruben,fiurst,Arutyunov Ruben - Nikoghosyan Narek,81,39,42,3,-3,16,15,14,20,16,-6,-7,8,2,6,3,11:5 - 11:4 - 3:11 - 9:11 - 5:11
15956138,2023-12-26 13:30:00,Nazaryan Mushegh - Diaryan Aleksandr,3:0,5:11 - 3:11 - 3:11 - 0:0 - 0:0,0,3,Nazaryan Mushegh,Diaryan Aleksandr,fiurst,Diaryan Aleksandr - Nazaryan Mushegh,44,33,11,-22,22,16,14,14,0,0,-6,-8,-8,0,0,-22,11:5 - 11:3 - 11:3 - 0:0 - 0:0
15956123,2023-12-26 13:15:00,Papyan Karen - Arutyunov Ruben,1:3,11:7 - 5:11 - 11:7 - 11:5 - 0:0,3,1,Papyan Karen,Arutyunov Ruben,fiurst,Arutyunov Ruben - Papyan Karen,68,30,38,8,-8,18,16,18,16,0,4,-6,4,6,0,8,7:11 - 11:5 - 7:11 - 5:11 - 0:0
15956109,2023-12-26 13:00:00,Nazaryan Mushegh - Nikoghosyan Narek,0:3,7:11 - 8:11 - 4:11 - 0:0 - 0:0,0,3,Nazaryan Mushegh,Nikoghosyan Narek,fiurst,Nazaryan Mushegh - Nikoghosyan Narek,52,19,33,14,-14,18,19,15,0,0,4,3,7,0,0,14,7:11 - 8:11 - 4:11 - 0:0 - 0:0
15956107,2023-12-26 12:20:00,Diaryan Aleksandr - Arutyunov Ruben,0:3,11:6 - 12:10 - 11:5 - 0:0 - 0:0,3,0,Diaryan Aleksandr,Arutyunov Ruben,fiurst,Arutyunov Ruben - Diaryan Aleksandr,55,21,34,13,-13,17,22,16,0,0,5,2,6,0,0,13,6:11 - 10:12 - 5:11 - 0:0 - 0:0
15956106,2023-12-26 12:10:00,Nazaryan Mushegh - Papyan Karen,0:3,7:11 - 8:11 - 10:12 - 0:0 - 0:0,0,3,Nazaryan Mushegh,Papyan Karen,fiurst,Nazaryan Mushegh - Papyan Karen,59,25,34,9,-9,18,19,22,0,0,4,3,2,0,0,9,7:11 - 8:11 - 10:12 - 0:0 - 0:0
15956104,2023-12-26 12:00:00,Nikoghosyan Narek - Diaryan Aleksandr,3:0,3:11 - 3:11 - 5:11 - 0:0 - 0:0,0,3,Nikoghosyan Narek,Diaryan Aleksandr,fiurst,Diaryan Aleksandr - Nikoghosyan Narek,44,33,11,-22,22,14,14,16,0,0,-8,-8,-6,0,0,-22,11:3 - 11:3 - 11:5 - 0:0 - 0:0
15968974,2023-12-26 11:35:00,Arutyunov Ruben - Nazaryan Mushegh,3:2,12:10 - 5:11 - 11:6 - 6:11 - 11:8,3,2,Arutyunov Ruben,Nazaryan Mushegh,fiurst,Arutyunov Ruben - Nazaryan Mushegh,91,45,46,1,-1,22,16,17,17,19,-2,6,-5,5,-3,1,12:10 - 5:11 - 11:6 - 6:11 - 11:8
15956095,2023-12-26 11:30:00,Nazaryan Mushegh - Arutyunov Ruben,0:0,0:0 - 0:0 - 0:0 - 0:0 - 0:0,0,0,Nazaryan Mushegh,Arutyunov Ruben,fiurst,Arutyunov Ruben - Nazaryan Mushegh,0,0,0,0,0,0,0,0,0,0,0,0,0,0,0,0,0:0 - 0:0 - 0:0 - 0:0 - 0:0
15956093,2023-12-26 11:20:00,Papyan Karen - Nikoghosyan Narek,3:2,7:11 - 7:11 - 11:7 - 11:7 - 9:11,2,3,Papyan Karen,Nikoghosyan Narek,fiurst,Nikoghosyan Narek - Papyan Karen,92,47,45,-2,2,18,18,18,18,20,-4,-4,4,4,-2,-2,11:7 - 11:7 - 7:11 - 7:11 - 11:9
15956092,2023-12-26 11:00:00,Diaryan Aleksandr - Nazaryan Mushegh,3:0,11:2 - 11:4 - 11:6 - 0:0 - 0:0,3,0,Diaryan Aleksandr,Nazaryan Mushegh,fiurst,Diaryan Aleksandr - Nazaryan Mushegh,45,33,12,-21,21,13,15,17,0,0,-9,-7,-5,0,0,-21,11:2 - 11:4 - 11:6 - 0:0 - 0:0
15956086,2023-12-26 10:45:00,Arutyunov Ruben - Nikoghosyan Narek,3:1,11:8 - 5:11 - 11:7 - 11:6 - 0:0,3,1,Arutyunov Ruben,Nikoghosyan Narek,fiurst,Arutyunov Ruben - Nikoghosyan Narek,70,38,32,-6,6,19,16,18,17,0,-3,6,-4,-5,0,-6,11:8 - 5:11 - 11:7 - 11:6 - 0:0
15956078,2023-12-26 10:35:00,Papyan Karen - Diaryan Aleksandr,3:1,12:10 - 10:12 - 5:11 - 7:11 - 0:0,1,3,Papyan Karen,Diaryan Aleksandr,fiurst,Diaryan Aleksandr - Papyan Karen,78,44,34,-10,10,22,22,16,18,0,2,-2,-6,-4,0,-10,10:12 - 12:10 - 11:5 - 11:7 - 0:0
15956076,2023-12-26 10:15:00,Nikoghosyan Narek - Nazaryan Mushegh,0:3,11:7 - 11:6 - 11:9 - 0:0 - 0:0,3,0,Nikoghosyan Narek,Nazaryan Mushegh,fiurst,Nazaryan Mushegh - Nikoghosyan Narek,55,22,33,11,-11,18,17,20,0,0,4,5,2,0,0,11,7:11 - 6:11 - 9:11 - 0:0 - 0:0
15956075,2023-12-26 10:00:00,Arutyunov Ruben - Papyan Karen,3:1,11:8 - 6:11 - 11:3 - 11:9 - 0:0,3,1,Arutyunov Ruben,Papyan Karen,fiurst,Arutyunov Ruben - Papyan Karen,70,39,31,-8,8,19,17,14,20,0,-3,5,-8,-2,0,-8,11:8 - 6:11 - 11:3 - 11:9 - 0:0
15940070,2023-12-25 17:45:00,Darbinyan Armen - Miroyan Hakob,3:2,15:13 - 4:11 - 11:8 - 7:11 - 11:5,3,2,Darbinyan Armen,Miroyan Hakob,fiurst,Darbinyan Armen - Miroyan Hakob,96,48,48,0,0,28,15,19,18,16,-2,7,-3,4,-6,0,15:13 - 4:11 - 11:8 - 7:11 - 11:5
15940057,2023-12-25 17:30:00,Petrosyan Davit - Gevorgyan Gegham,1:3,11:8 - 11:5 - 8:11 - 11:4 - 0:0,3,1,Petrosyan Davit,Gevorgyan Gegham,fiurst,Gevorgyan Gegham - Petrosyan Davit,69,28,41,13,-13,19,16,19,15,0,3,6,-3,7,0,13,8:11 - 5:11 - 11:8 - 4:11 - 0:0
15940056,2023-12-25 17:15:00,Gevorgyan Hayk - Darbinyan Armen,1:3,11:13 - 11:3 - 11:5 - 11:8 - 0:0,3,1,Gevorgyan Hayk,Darbinyan Armen,fiurst,Darbinyan Armen - Gevorgyan Hayk,73,29,44,15,-15,24,14,16,19,0,-2,8,6,3,0,15,13:11 - 3:11 - 5:11 - 8:11 - 0:0
15940052,2023-12-25 17:00:00,Petrosyan Davit - Miroyan Hakob,0:3,11:7 - 11:7 - 11:8 - 0:0 - 0:0,3,0,Petrosyan Davit,Miroyan Hakob,fiurst,Miroyan Hakob - Petrosyan Davit,55,22,33,11,-11,18,18,19,0,0,4,4,3,0,0,11,7:11 - 7:11 - 8:11 - 0:0 - 0:0
15940049,2023-12-25 16:45:00,Gevorgyan Gegham - Gevorgyan Hayk,1:3,11:13 - 11:7 - 9:11 - 6:11 - 0:0,1,3,Gevorgyan Gegham,Gevorgyan Hayk,fiurst,Gevorgyan Gegham - Gevorgyan Hayk,79,37,42,5,-5,24,18,20,17,0,2,-4,2,5,0,5,11:13 - 11:7 - 9:11 - 6:11 - 0:0
15940044,2023-12-25 16:30:00,Darbinyan Armen - Petrosyan Davit,0:3,6:11 - 8:11 - 5:11 - 0:0 - 0:0,0,3,Darbinyan Armen,Petrosyan Davit,fiurst,Darbinyan Armen - Petrosyan Davit,52,19,33,14,-14,17,19,16,0,0,5,3,6,0,0,14,6:11 - 8:11 - 5:11 - 0:0 - 0:0
15940039,2023-12-25 16:15:00,Miroyan Hakob - Gevorgyan Hayk,3:0,9:11 - 7:11 - 9:11 - 0:0 - 0:0,0,3,Miroyan Hakob,Gevorgyan Hayk,fiurst,Gevorgyan Hayk - Miroyan Hakob,58,33,25,-8,8,20,18,20,0,0,-2,-4,-2,0,0,-8,11:9 - 11:7 - 11:9 - 0:0 - 0:0
15940036,2023-12-25 16:00:00,Gevorgyan Gegham - Darbinyan Armen,0:3,11:4 - 11:9 - 13:11 - 0:0 - 0:0,3,0,Gevorgyan Gegham,Darbinyan Armen,fiurst,Darbinyan Armen - Gevorgyan Gegham,59,24,35,11,-11,15,20,24,0,0,7,2,2,0,0,11,4:11 - 9:11 - 11:13 - 0:0 - 0:0
15940029,2023-12-25 15:45:00,Gevorgyan Hayk - Petrosyan Davit,2:3,6:11 - 11:4 - 11:9 - 9:11 - 6:11,2,3,Gevorgyan Hayk,Petrosyan Davit,fiurst,Gevorgyan Hayk - Petrosyan Davit,89,43,46,3,-3,17,15,20,20,17,5,-7,-2,2,5,3,6:11 - 11:4 - 11:9 - 9:11 - 6:11
15940020,2023-12-25 15:30:00,Miroyan Hakob - Gevorgyan Gegham,3:2,11:8 - 12:10 - 5:11 - 7:11 - 8:11,2,3,Miroyan Hakob,Gevorgyan Gegham,fiurst,Gevorgyan Gegham - Miroyan Hakob,94,51,43,-8,8,19,22,16,18,19,3,2,-6,-4,-3,-8,8:11 - 10:12 - 11:5 - 11:7 - 11:8
15939987,2023-12-25 15:15:00,Papyan Karen - Rafayelyan Edgar,0:3,6:11 - 7:11 - 4:11 - 0:0 - 0:0,0,3,Papyan Karen,Rafayelyan Edgar,fiurst,Papyan Karen - Rafayelyan Edgar,50,17,33,16,-16,17,18,15,0,0,5,4,7,0,0,16,6:11 - 7:11 - 4:11 - 0:0 - 0:0
15939982,2023-12-25 15:10:00,Diaryan Aleksandr - Arutyunov Ruben,1:3,8:11 - 14:12 - 11:4 - 13:11 - 0:0,3,1,Diaryan Aleksandr,Arutyunov Ruben,fiurst,Arutyunov Ruben - Diaryan Aleksandr,84,38,46,8,-8,19,26,15,24,0,-3,2,7,2,0,8,11:8 - 12:14 - 4:11 - 11:13 - 0:0
15939973,2023-12-25 14:45:00,Soghomonyan Hrayr - Papyan Karen,3:0,12:14 - 8:11 - 6:11 - 0:0 - 0:0,0,3,Soghomonyan Hrayr,Papyan Karen,fiurst,Papyan Karen - Soghomonyan Hrayr,62,36,26,-10,10,26,19,17,0,0,-2,-3,-5,0,0,-10,14:12 - 11:8 - 11:6 - 0:0 - 0:0
15939970,2023-12-25 14:30:00,Rafayelyan Edgar - Diaryan Aleksandr,2:3,11:8 - 9:11 - 11:8 - 6:11 - 13:11,3,2,Rafayelyan Edgar,Diaryan Aleksandr,fiurst,Diaryan Aleksandr - Rafayelyan Edgar,99,49,50,1,-1,19,20,19,17,24,3,-2,3,-5,2,1,8:11 - 11:9 - 8:11 - 11:6 - 11:13
15939968,2023-12-25 14:15:00,Soghomonyan Hrayr - Arutyunov Ruben,3:1,11:9 - 5:11 - 10:12 - 8:11 - 0:0,1,3,Soghomonyan Hrayr,Arutyunov Ruben,fiurst,Arutyunov Ruben - Soghomonyan Hrayr,77,43,34,-9,9,20,16,22,19,0,2,-6,-2,-3,0,-9,9:11 - 11:5 - 12:10 - 11:8 - 0:0
15939964,2023-12-25 14:00:00,Papyan Karen - Diaryan Aleksandr,2:3,2:11 - 5:11 - 11:7 - 11:9 - 11:8,3,2,Papyan Karen,Diaryan Aleksandr,fiurst,Diaryan Aleksandr - Papyan Karen,86,46,40,-6,6,13,16,18,20,19,-9,-6,4,2,3,-6,11:2 - 11:5 - 7:11 - 9:11 - 8:11
15939961,2023-12-25 13:45:00,Rafayelyan Edgar - Soghomonyan Hrayr,3:0,11:7 - 11:9 - 11:3 - 0:0 - 0:0,3,0,Rafayelyan Edgar,Soghomonyan Hrayr,fiurst,Rafayelyan Edgar - Soghomonyan Hrayr,52,33,19,-14,14,18,20,14,0,0,-4,-2,-8,0,0,-14,11:7 - 11:9 - 11:3 - 0:0 - 0:0
15939951,2023-12-25 13:40:00,Arutyunov Ruben - Papyan Karen,0:3,9:11 - 8:11 - 7:11 - 0:0 - 0:0,0,3,Arutyunov Ruben,Papyan Karen,fiurst,Arutyunov Ruben - Papyan Karen,57,24,33,9,-9,20,19,18,0,0,2,3,4,0,0,9,9:11 - 8:11 - 7:11 - 0:0 - 0:0
15939948,2023-12-25 13:15:00,Diaryan Aleksandr - Soghomonyan Hrayr,3:1,11:4 - 8:11 - 11:6 - 11:1 - 0:0,3,1,Diaryan Aleksandr,Soghomonyan Hrayr,fiurst,Diaryan Aleksandr - Soghomonyan Hrayr,63,41,22,-19,19,15,19,17,12,0,-7,3,-5,-10,0,-19,11:4 - 8:11 - 11:6 - 11:1 - 0:0
15939947,2023-12-25 13:00:00,Arutyunov Ruben - Rafayelyan Edgar,2:3,11:9 - 11:4 - 7:11 - 7:11 - 5:11,2,3,Arutyunov Ruben,Rafayelyan Edgar,fiurst,Arutyunov Ruben - Rafayelyan Edgar,87,41,46,5,-5,20,15,18,18,16,-2,-7,4,4,6,5,11:9 - 11:4 - 7:11 - 7:11 - 5:11
15939929,2023-12-25 12:15:00,Papyan Karen - Soghomonyan Hrayr,3:0,11:8 - 11:9 - 11:8 - 0:0 - 0:0,3,0,Papyan Karen,Soghomonyan Hrayr,fiurst,Papyan Karen - Soghomonyan Hrayr,58,33,25,-8,8,19,20,19,0,0,-3,-2,-3,0,0,-8,11:8 - 11:9 - 11:8 - 0:0 - 0:0
15939928,2023-12-25 12:00:00,Arutyunov Ruben - Diaryan Aleksandr,0:3,2:11 - 7:11 - 5:11 - 0:0 - 0:0,0,3,Arutyunov Ruben,Diaryan Aleksandr,fiurst,Arutyunov Ruben - Diaryan Aleksandr,47,14,33,19,-19,13,18,16,0,0,9,4,6,0,0,19,2:11 - 7:11 - 5:11 - 0:0 - 0:0
15939907,2023-12-25 11:45:00,Rafayelyan Edgar - Papyan Karen,2:3,6:11 - 11:7 - 11:4 - 8:11 - 11:9,3,2,Rafayelyan Edgar,Papyan Karen,fiurst,Papyan Karen - Rafayelyan Edgar,89,42,47,5,-5,17,18,15,19,20,-5,4,7,-3,2,5,11:6 - 7:11 - 4:11 - 11:8 - 9:11
15939905,2023-12-25 11:30:00,Arutyunov Ruben - Soghomonyan Hrayr,3:0,11:8 - 11:8 - 11:5 - 0:0 - 0:0,3,0,Arutyunov Ruben,Soghomonyan Hrayr,fiurst,Arutyunov Ruben - Soghomonyan Hrayr,54,33,21,-12,12,19,19,16,0,0,-3,-3,-6,0,0,-12,11:8 - 11:8 - 11:5 - 0:0 - 0:0
15939902,2023-12-25 11:15:00,Diaryan Aleksandr - Rafayelyan Edgar,3:2,7:11 - 11:4 - 11:2 - 6:11 - 11:9,3,2,Diaryan Aleksandr,Rafayelyan Edgar,fiurst,Diaryan Aleksandr - Rafayelyan Edgar,83,46,37,-9,9,18,15,13,17,20,4,-7,-9,5,-2,-9,7:11 - 11:4 - 11:2 - 6:11 - 11:9
15939899,2023-12-25 11:00:00,Papyan Karen - Arutyunov Ruben,1:3,11:5 - 12:10 - 7:11 - 11:3 - 0:0,3,1,Papyan Karen,Arutyunov Ruben,fiurst,Arutyunov Ruben - Papyan Karen,70,29,41,12,-12,16,22,18,14,0,6,2,-4,8,0,12,5:11 - 10:12 - 11:7 - 3:11 - 0:0
15939893,2023-12-25 10:45:00,Soghomonyan Hrayr - Rafayelyan Edgar,3:0,8:11 - 5:11 - 6:11 - 0:0 - 0:0,0,3,Soghomonyan Hrayr,Rafayelyan Edgar,fiurst,Rafayelyan Edgar - Soghomonyan Hrayr,52,33,19,-14,14,19,16,17,0,0,-3,-6,-5,0,0,-14,11:8 - 11:5 - 11:6 - 0:0 - 0:0
15939887,2023-12-25 10:30:00,Diaryan Aleksandr - Papyan Karen,0:3,10:12 - 9:11 - 9:11 - 0:0 - 0:0,0,3,Diaryan Aleksandr,Papyan Karen,fiurst,Diaryan Aleksandr - Papyan Karen,62,28,34,6,-6,22,20,20,0,0,2,2,2,0,0,6,10:12 - 9:11 - 9:11 - 0:0 - 0:0
15939871,2023-12-25 10:15:00,Rafayelyan Edgar - Arutyunov Ruben,1:3,11:3 - 7:11 - 11:3 - 11:6 - 0:0,3,1,Rafayelyan Edgar,Arutyunov Ruben,fiurst,Arutyunov Ruben - Rafayelyan Edgar,63,23,40,17,-17,14,18,14,17,0,8,-4,8,5,0,17,3:11 - 11:7 - 3:11 - 6:11 - 0:0
15939866,2023-12-25 10:00:00,Soghomonyan Hrayr - Diaryan Aleksandr,3:0,8:11 - 8:11 - 7:11 - 0:0 - 0:0,0,3,Soghomonyan Hrayr,Diaryan Aleksandr,fiurst,Diaryan Aleksandr - Soghomonyan Hrayr,56,33,23,-10,10,19,19,18,0,0,-3,-3,-4,0,0,-10,11:8 - 11:8 - 11:7 - 0:0 - 0:0
15921685,2023-12-24 17:45:00,Darbinyan Armen - Avakimyan Davit,3:1,6:11 - 11:6 - 11:13 - 13:15 - 0:0,1,3,Darbinyan Armen,Avakimyan Davit,fiurst,Avakimyan Davit - Darbinyan Armen,86,45,41,-4,4,17,17,24,28,0,-5,5,-2,-2,0,-4,11:6 - 6:11 - 13:11 - 15:13 - 0:0
15921682,2023-12-24 17:30:00,Gevorgyan Hayk - Karakhanyan Mher,3:0,11:7 - 11:5 - 11:5 - 0:0 - 0:0,3,0,Gevorgyan Hayk,Karakhanyan Mher,fiurst,Gevorgyan Hayk - Karakhanyan Mher,50,33,17,-16,16,18,16,16,0,0,-4,-6,-6,0,0,-16,11:7 - 11:5 - 11:5 - 0:0 - 0:0
15921680,2023-12-24 17:15:00,Petrosyan Davit - Darbinyan Armen,0:3,11:2 - 11:3 - 11:1 - 0:0 - 0:0,3,0,Petrosyan Davit,Darbinyan Armen,fiurst,Darbinyan Armen - Petrosyan Davit,39,6,33,27,-27,13,14,12,0,0,9,8,10,0,0,27,2:11 - 3:11 - 1:11 - 0:0 - 0:0
15921669,2023-12-24 17:00:00,Gevorgyan Hayk - Avakimyan Davit,2:3,11:6 - 12:14 - 8:11 - 13:11 - 11:7,3,2,Gevorgyan Hayk,Avakimyan Davit,fiurst,Avakimyan Davit - Gevorgyan Hayk,104,49,55,6,-6,17,26,19,24,18,5,-2,-3,2,4,6,6:11 - 14:12 - 11:8 - 11:13 - 7:11
15921665,2023-12-24 16:45:00,Karakhanyan Mher - Petrosyan Davit,0:3,7:11 - 6:11 - 6:11 - 0:0 - 0:0,0,3,Karakhanyan Mher,Petrosyan Davit,fiurst,Karakhanyan Mher - Petrosyan Davit,52,19,33,14,-14,18,17,17,0,0,4,5,5,0,0,14,7:11 - 6:11 - 6:11 - 0:0 - 0:0
15921659,2023-12-24 16:30:00,Darbinyan Armen - Gevorgyan Hayk,0:3,4:11 - 9:11 - 5:11 - 0:0 - 0:0,0,3,Darbinyan Armen,Gevorgyan Hayk,fiurst,Darbinyan Armen - Gevorgyan Hayk,51,18,33,15,-15,15,20,16,0,0,7,2,6,0,0,15,4:11 - 9:11 - 5:11 - 0:0 - 0:0
15921651,2023-12-24 16:15:00,Avakimyan Davit - Petrosyan Davit,3:0,12:10 - 11:6 - 14:12 - 0:0 - 0:0,3,0,Avakimyan Davit,Petrosyan Davit,fiurst,Avakimyan Davit - Petrosyan Davit,65,37,28,-9,9,22,17,26,0,0,-2,-5,-2,0,0,-9,12:10 - 11:6 - 14:12 - 0:0 - 0:0
15921649,2023-12-24 16:00:00,Karakhanyan Mher - Darbinyan Armen,3:1,14:16 - 11:4 - 7:11 - 11:13 - 0:0,1,3,Karakhanyan Mher,Darbinyan Armen,fiurst,Darbinyan Armen - Karakhanyan Mher,87,44,43,-1,1,30,15,18,24,0,-2,7,-4,-2,0,-1,16:14 - 4:11 - 11:7 - 13:11 - 0:0
15921643,2023-12-24 15:45:00,Petrosyan Davit - Gevorgyan Hayk,3:0,3:11 - 7:11 - 9:11 - 0:0 - 0:0,0,3,Petrosyan Davit,Gevorgyan Hayk,fiurst,Gevorgyan Hayk - Petrosyan Davit,52,33,19,-14,14,14,18,20,0,0,-8,-4,-2,0,0,-14,11:3 - 11:7 - 11:9 - 0:0 - 0:0
15921641,2023-12-24 15:30:00,Avakimyan Davit - Karakhanyan Mher,3:0,11:9 - 11:7 - 11:9 - 0:0 - 0:0,3,0,Avakimyan Davit,Karakhanyan Mher,fiurst,Avakimyan Davit - Karakhanyan Mher,58,33,25,-8,8,20,18,20,0,0,-2,-4,-2,0,0,-8,11:9 - 11:7 - 11:9 - 0:0 - 0:0
15921637,2023-12-24 15:25:00,Soghomonyan Hrayr - Diaryan Aleksandr,3:0,6:11 - 7:11 - 6:11 - 0:0 - 0:0,0,3,Soghomonyan Hrayr,Diaryan Aleksandr,fiurst,Diaryan Aleksandr - Soghomonyan Hrayr,52,33,19,-14,14,17,18,17,0,0,-5,-4,-5,0,0,-14,11:6 - 11:7 - 11:6 - 0:0 - 0:0
15921635,2023-12-24 15:00:00,Rafayelyan Edgar - Nazaryan Mushegh,0:3,11:8 - 11:7 - 11:7 - 0:0 - 0:0,3,0,Rafayelyan Edgar,Nazaryan Mushegh,fiurst,Nazaryan Mushegh - Rafayelyan Edgar,55,22,33,11,-11,19,18,18,0,0,3,4,4,0,0,11,8:11 - 7:11 - 7:11 - 0:0 - 0:0
15921633,2023-12-24 14:50:00,Nikoghosyan Narek - Soghomonyan Hrayr,3:0,11:8 - 13:11 - 11:9 - 0:0 - 0:0,3,0,Nikoghosyan Narek,Soghomonyan Hrayr,fiurst,Nikoghosyan Narek - Soghomonyan Hrayr,63,35,28,-7,7,19,24,20,0,0,-3,-2,-2,0,0,-7,11:8 - 13:11 - 11:9 - 0:0 - 0:0
15921626,2023-12-24 14:30:00,Nikoghosyan Narek - Nazaryan Mushegh,0:3,11:8 - 11:7 - 11:7 - 0:0 - 0:0,3,0,Nikoghosyan Narek,Nazaryan Mushegh,fiurst,Nazaryan Mushegh - Nikoghosyan Narek,55,22,33,11,-11,19,18,18,0,0,3,4,4,0,0,11,8:11 - 7:11 - 7:11 - 0:0 - 0:0
15921628,2023-12-24 14:30:00,Diaryan Aleksandr - Rafayelyan Edgar,3:1,9:11 - 11:3 - 15:13 - 11:5 - 0:0,3,1,Diaryan Aleksandr,Rafayelyan Edgar,fiurst,Diaryan Aleksandr - Rafayelyan Edgar,78,46,32,-14,14,20,14,28,16,0,2,-8,-2,-6,0,-14,9:11 - 11:3 - 15:13 - 11:5 - 0:0
15921623,2023-12-24 14:00:00,Soghomonyan Hrayr - Rafayelyan Edgar,3:2,3:11 - 11:8 - 11:9 - 5:11 - 6:11,2,3,Soghomonyan Hrayr,Rafayelyan Edgar,fiurst,Rafayelyan Edgar - Soghomonyan Hrayr,86,50,36,-14,14,14,19,20,16,17,-8,3,2,-6,-5,-14,11:3 - 8:11 - 9:11 - 11:5 - 11:6
15921620,2023-12-24 13:45:00,Diaryan Aleksandr - Nikoghosyan Narek,3:0,17:15 - 11:7 - 15:13 - 0:0 - 0:0,3,0,Diaryan Aleksandr,Nikoghosyan Narek,fiurst,Diaryan Aleksandr - Nikoghosyan Narek,78,43,35,-8,8,32,18,28,0,0,-2,-4,-2,0,0,-8,17:15 - 11:7 - 15:13 - 0:0 - 0:0
15921609,2023-12-24 13:30:00,Nazaryan Mushegh - Soghomonyan Hrayr,0:3,10:12 - 7:11 - 8:11 - 0:0 - 0:0,0,3,Nazaryan Mushegh,Soghomonyan Hrayr,fiurst,Nazaryan Mushegh - Soghomonyan Hrayr,59,25,34,9,-9,22,18,19,0,0,2,4,3,0,0,9,10:12 - 7:11 - 8:11 - 0:0 - 0:0
15921604,2023-12-24 13:15:00,Rafayelyan Edgar - Nikoghosyan Narek,3:0,10:12 - 5:11 - 14:16 - 0:0 - 0:0,0,3,Rafayelyan Edgar,Nikoghosyan Narek,fiurst,Nikoghosyan Narek - Rafayelyan Edgar,68,39,29,-10,10,22,16,30,0,0,-2,-6,-2,0,0,-10,12:10 - 11:5 - 16:14 - 0:0 - 0:0
15921601,2023-12-24 13:00:00,Nazaryan Mushegh - Diaryan Aleksandr,3:0,4:11 - 5:11 - 1:11 - 0:0 - 0:0,0,3,Nazaryan Mushegh,Diaryan Aleksandr,fiurst,Diaryan Aleksandr - Nazaryan Mushegh,43,33,10,-23,23,15,16,12,0,0,-7,-6,-10,0,0,-23,11:4 - 11:5 - 11:1 - 0:0 - 0:0
15921598,2023-12-24 12:15:00,Soghomonyan Hrayr - Nikoghosyan Narek,3:2,11:8 - 5:11 - 5:11 - 11:8 - 7:11,2,3,Soghomonyan Hrayr,Nikoghosyan Narek,fiurst,Nikoghosyan Narek - Soghomonyan Hrayr,88,49,39,-10,10,19,16,16,19,18,3,-6,-6,3,-4,-10,8:11 - 11:5 - 11:5 - 8:11 - 11:7
15921593,2023-12-24 12:10:00,Nazaryan Mushegh - Rafayelyan Edgar,0:3,6:11 - 8:11 - 7:11 - 0:0 - 0:0,0,3,Nazaryan Mushegh,Rafayelyan Edgar,fiurst,Nazaryan Mushegh - Rafayelyan Edgar,54,21,33,12,-12,17,19,18,0,0,5,3,4,0,0,12,6:11 - 8:11 - 7:11 - 0:0 - 0:0
15902843,2023-12-24 11:45:00,Nazaryan Mushegh - Nikoghosyan Narek,1:3,4:11 - 11:5 - 5:11 - 9:11 - 0:0,1,3,Nazaryan Mushegh,Nikoghosyan Narek,fiurst,Nazaryan Mushegh - Nikoghosyan Narek,67,29,38,9,-9,15,16,16,20,0,7,-6,6,2,0,9,4:11 - 11:5 - 5:11 - 9:11 - 0:0
15921592,2023-12-24 11:45:00,Diaryan Aleksandr - Soghomonyan Hrayr,3:0,11:5 - 12:10 - 11:4 - 0:0 - 0:0,3,0,Diaryan Aleksandr,Soghomonyan Hrayr,fiurst,Diaryan Aleksandr - Soghomonyan Hrayr,53,34,19,-15,15,16,22,15,0,0,-6,-2,-7,0,0,-15,11:5 - 12:10 - 11:4 - 0:0 - 0:0
15902837,2023-12-24 11:15:00,Rafayelyan Edgar - Diaryan Aleksandr,0:3,11:7 - 11:9 - 11:6 - 0:0 - 0:0,3,0,Rafayelyan Edgar,Diaryan Aleksandr,fiurst,Diaryan Aleksandr - Rafayelyan Edgar,55,22,33,11,-11,18,20,17,0,0,4,2,5,0,0,11,7:11 - 9:11 - 6:11 - 0:0 - 0:0
15902814,2023-12-24 11:10:00,Soghomonyan Hrayr - Nazaryan Mushegh,1:3,11:7 - 10:12 - 11:8 - 11:6 - 0:0,3,1,Soghomonyan Hrayr,Nazaryan Mushegh,fiurst,Nazaryan Mushegh - Soghomonyan Hrayr,76,33,43,10,-10,18,22,19,17,0,4,-2,3,5,0,10,7:11 - 12:10 - 8:11 - 6:11 - 0:0
15902799,2023-12-24 10:50:00,Nikoghosyan Narek - Diaryan Aleksandr,3:0,4:11 - 8:11 - 7:11 - 0:0 - 0:0,0,3,Nikoghosyan Narek,Diaryan Aleksandr,fiurst,Diaryan Aleksandr - Nikoghosyan Narek,52,33,19,-14,14,15,19,18,0,0,-7,-3,-4,0,0,-14,11:4 - 11:8 - 11:7 - 0:0 - 0:0
15902791,2023-12-24 10:40:00,Rafayelyan Edgar - Soghomonyan Hrayr,3:0,11:8 - 11:7 - 12:10 - 0:0 - 0:0,3,0,Rafayelyan Edgar,Soghomonyan Hrayr,fiurst,Rafayelyan Edgar - Soghomonyan Hrayr,59,34,25,-9,9,19,18,22,0,0,-3,-4,-2,0,0,-9,11:8 - 11:7 - 12:10 - 0:0 - 0:0
15902779,2023-12-24 10:15:00,Diaryan Aleksandr - Nazaryan Mushegh,3:1,6:11 - 11:4 - 11:5 - 11:6 - 0:0,3,1,Diaryan Aleksandr,Nazaryan Mushegh,fiurst,Diaryan Aleksandr - Nazaryan Mushegh,65,39,26,-13,13,17,15,16,17,0,5,-7,-6,-5,0,-13,6:11 - 11:4 - 11:5 - 11:6 - 0:0
15902774,2023-12-24 10:05:00,Nikoghosyan Narek - Rafayelyan Edgar,2:3,5:11 - 11:5 - 8:11 - 11:6 - 10:12,2,3,Nikoghosyan Narek,Rafayelyan Edgar,fiurst,Nikoghosyan Narek - Rafayelyan Edgar,90,45,45,0,0,16,16,19,17,22,6,-6,3,-5,2,0,5:11 - 11:5 - 8:11 - 11:6 - 10:12
15902884,2023-12-23 17:45:00,Karakhanyan Mher - Darbinyan Armen,3:2,7:11 - 8:11 - 11:9 - 11:7 - 6:11,2,3,Karakhanyan Mher,Darbinyan Armen,fiurst,Darbinyan Armen - Karakhanyan Mher,92,49,43,-6,6,18,19,20,18,17,-4,-3,2,4,-5,-6,11:7 - 11:8 - 9:11 - 7:11 - 11:6
15902882,2023-12-23 17:30:00,Petrosyan Davit - Gevorgyan Gegham,1:3,4:11 - 11:6 - 11:5 - 11:7 - 0:0,3,1,Petrosyan Davit,Gevorgyan Gegham,fiurst,Gevorgyan Gegham - Petrosyan Davit,66,29,37,8,-8,15,17,16,18,0,-7,5,6,4,0,8,11:4 - 6:11 - 5:11 - 7:11 - 0:0
15902881,2023-12-23 17:15:00,Avakimyan Davit - Karakhanyan Mher,3:0,11:9 - 11:8 - 11:7 - 0:0 - 0:0,3,0,Avakimyan Davit,Karakhanyan Mher,fiurst,Avakimyan Davit - Karakhanyan Mher,57,33,24,-9,9,20,19,18,0,0,-2,-3,-4,0,0,-9,11:9 - 11:8 - 11:7 - 0:0 - 0:0
15902878,2023-12-23 17:00:00,Petrosyan Davit - Darbinyan Armen,0:3,11:9 - 11:9 - 11:2 - 0:0 - 0:0,3,0,Petrosyan Davit,Darbinyan Armen,fiurst,Darbinyan Armen - Petrosyan Davit,53,20,33,13,-13,20,20,13,0,0,2,2,9,0,0,13,9:11 - 9:11 - 2:11 - 0:0 - 0:0
15902868,2023-12-23 16:45:00,Gevorgyan Gegham - Avakimyan Davit,3:2,6:11 - 12:10 - 9:11 - 11:9 - 5:11,2,3,Gevorgyan Gegham,Avakimyan Davit,fiurst,Avakimyan Davit - Gevorgyan Gegham,95,52,43,-9,9,17,22,20,20,16,-5,2,-2,2,-6,-9,11:6 - 10:12 - 11:9 - 9:11 - 11:5
15902866,2023-12-23 16:30:00,Karakhanyan Mher - Petrosyan Davit,1:3,8:11 - 7:11 - 11:8 - 8:11 - 0:0,1,3,Karakhanyan Mher,Petrosyan Davit,fiurst,Karakhanyan Mher - Petrosyan Davit,75,34,41,7,-7,19,18,19,19,0,3,4,-3,3,0,7,8:11 - 7:11 - 11:8 - 8:11 - 0:0
15902864,2023-12-23 16:15:00,Darbinyan Armen - Avakimyan Davit,3:0,4:11 - 7:11 - 6:11 - 0:0 - 0:0,0,3,Darbinyan Armen,Avakimyan Davit,fiurst,Avakimyan Davit - Darbinyan Armen,50,33,17,-16,16,15,18,17,0,0,-7,-4,-5,0,0,-16,11:4 - 11:7 - 11:6 - 0:0 - 0:0
15902851,2023-12-23 16:00:00,Gevorgyan Gegham - Karakhanyan Mher,3:1,11:5 - 8:11 - 11:3 - 11:8 - 0:0,3,1,Gevorgyan Gegham,Karakhanyan Mher,fiurst,Gevorgyan Gegham - Karakhanyan Mher,68,41,27,-14,14,16,19,14,19,0,-6,3,-8,-3,0,-14,11:5 - 8:11 - 11:3 - 11:8 - 0:0
15902849,2023-12-23 15:45:00,Avakimyan Davit - Petrosyan Davit,3:1,11:5 - 4:11 - 11:4 - 11:2 - 0:0,3,1,Avakimyan Davit,Petrosyan Davit,fiurst,Avakimyan Davit - Petrosyan Davit,59,37,22,-15,15,16,15,15,13,0,-6,7,-7,-9,0,-15,11:5 - 4:11 - 11:4 - 11:2 - 0:0
15902847,2023-12-23 15:30:00,Darbinyan Armen - Gevorgyan Gegham,0:3,5:11 - 5:11 - 5:11 - 0:0 - 0:0,0,3,Darbinyan Armen,Gevorgyan Gegham,fiurst,Darbinyan Armen - Gevorgyan Gegham,48,15,33,18,-18,16,16,16,0,0,6,6,6,0,0,18,5:11 - 5:11 - 5:11 - 0:0 - 0:0
15902840,2023-12-23 15:00:00,Arutyunov Ruben - Soghomonyan Hrayr,3:0,11:5 - 11:4 - 14:12 - 0:0 - 0:0,3,0,Arutyunov Ruben,Soghomonyan Hrayr,fiurst,Arutyunov Ruben - Soghomonyan Hrayr,57,36,21,-15,15,16,15,26,0,0,-6,-7,-2,0,0,-15,11:5 - 11:4 - 14:12 - 0:0 - 0:0
15902839,2023-12-23 14:45:00,Papyan Karen - Nikoghosyan Narek,3:0,5:11 - 10:12 - 7:11 - 0:0 - 0:0,0,3,Papyan Karen,Nikoghosyan Narek,fiurst,Nikoghosyan Narek - Papyan Karen,56,34,22,-12,12,16,22,18,0,0,-6,-2,-4,0,0,-12,11:5 - 12:10 - 11:7 - 0:0 - 0:0
15902825,2023-12-23 14:15:00,Papyan Karen - Soghomonyan Hrayr,0:3,7:11 - 7:11 - 5:11 - 0:0 - 0:0,0,3,Papyan Karen,Soghomonyan Hrayr,fiurst,Papyan Karen - Soghomonyan Hrayr,52,19,33,14,-14,18,18,16,0,0,4,4,6,0,0,14,7:11 - 7:11 - 5:11 - 0:0 - 0:0
15902815,2023-12-23 14:10:00,Nikoghosyan Narek - Arutyunov Ruben,3:1,11:13 - 11:6 - 3:11 - 3:11 - 0:0,1,3,Nikoghosyan Narek,Arutyunov Ruben,fiurst,Arutyunov Ruben - Nikoghosyan Narek,69,41,28,-13,13,24,17,14,14,0,-2,5,-8,-8,0,-13,13:11 - 6:11 - 11:3 - 11:3 - 0:0
15902805,2023-12-23 13:30:00,Soghomonyan Hrayr - Nikoghosyan Narek,3:2,11:5 - 9:11 - 11:13 - 11:8 - 7:11,2,3,Soghomonyan Hrayr,Nikoghosyan Narek,fiurst,Nikoghosyan Narek - Soghomonyan Hrayr,97,48,49,1,-1,16,20,24,19,18,6,-2,-2,3,-4,1,5:11 - 11:9 - 13:11 - 8:11 - 11:7
15902801,2023-12-23 13:20:00,Arutyunov Ruben - Papyan Karen,3:1,11:7 - 4:11 - 11:1 - 11:2 - 0:0,3,1,Arutyunov Ruben,Papyan Karen,fiurst,Arutyunov Ruben - Papyan Karen,58,37,21,-16,16,18,15,12,13,0,-4,7,-10,-9,0,-16,11:7 - 4:11 - 11:1 - 11:2 - 0:0
15902797,2023-12-23 12:15:00,Nikoghosyan Narek - Papyan Karen,0:3,6:11 - 4:11 - 8:11 - 0:0 - 0:0,0,3,Nikoghosyan Narek,Papyan Karen,fiurst,Nikoghosyan Narek - Papyan Karen,51,18,33,15,-15,17,15,19,0,0,5,7,3,0,0,15,6:11 - 4:11 - 8:11 - 0:0 - 0:0
15902794,2023-12-23 12:05:00,Soghomonyan Hrayr - Arutyunov Ruben,3:0,7:11 - 11:13 - 5:11 - 0:0 - 0:0,0,3,Soghomonyan Hrayr,Arutyunov Ruben,fiurst,Arutyunov Ruben - Soghomonyan Hrayr,58,35,23,-12,12,18,24,16,0,0,-4,-2,-6,0,0,-12,11:7 - 13:11 - 11:5 - 0:0 - 0:0
15902782,2023-12-23 11:45:00,Soghomonyan Hrayr - Papyan Karen,3:1,8:11 - 7:11 - 11:4 - 3:11 - 0:0,1,3,Soghomonyan Hrayr,Papyan Karen,fiurst,Papyan Karen - Soghomonyan Hrayr,66,37,29,-8,8,19,18,15,14,0,-3,-4,7,-8,0,-8,11:8 - 11:7 - 4:11 - 11:3 - 0:0
15902775,2023-12-23 11:25:00,Nikoghosyan Narek - Soghomonyan Hrayr,3:0,11:5 - 11:4 - 16:14 - 0:0 - 0:0,3,0,Nikoghosyan Narek,Soghomonyan Hrayr,fiurst,Nikoghosyan Narek - Soghomonyan Hrayr,61,38,23,-15,15,16,15,30,0,0,-6,-7,-2,0,0,-15,11:5 - 11:4 - 16:14 - 0:0 - 0:0
15902767,2023-12-23 10:50:00,Arutyunov Ruben - Nikoghosyan Narek,3:1,11:8 - 11:6 - 15:17 - 11:9 - 0:0,3,1,Arutyunov Ruben,Nikoghosyan Narek,fiurst,Arutyunov Ruben - Nikoghosyan Narek,88,48,40,-8,8,19,17,32,20,0,-3,-5,2,-2,0,-8,11:8 - 11:6 - 15:17 - 11:9 - 0:0
15902765,2023-12-23 10:15:00,Nazaryan Mushegh - Soghomonyan Hrayr,0:0,0:0 - 0:0 - 0:0 - 0:0 - 0:0,0,0,Nazaryan Mushegh,Soghomonyan Hrayr,fiurst,Nazaryan Mushegh - Soghomonyan Hrayr,0,0,0,0,0,0,0,0,0,0,0,0,0,0,0,0,0:0 - 0:0 - 0:0 - 0:0 - 0:0
15902764,2023-12-23 10:05:00,Papyan Karen - Arutyunov Ruben,3:2,12:10 - 6:11 - 11:6 - 8:11 - 7:11,2,3,Papyan Karen,Arutyunov Ruben,fiurst,Arutyunov Ruben - Papyan Karen,93,49,44,-5,5,22,17,17,19,18,2,-5,5,-3,-4,-5,10:12 - 11:6 - 6:11 - 11:8 - 11:7
15886620,2023-12-22 17:45:00,Gevorgyan Hayk - Avakimyan Davit,1:3,16:14 - 8:11 - 11:9 - 11:4 - 0:0,3,1,Gevorgyan Hayk,Avakimyan Davit,fiurst,Avakimyan Davit - Gevorgyan Hayk,84,38,46,8,-8,30,19,20,15,0,2,-3,2,7,0,8,14:16 - 11:8 - 9:11 - 4:11 - 0:0
15886622,2023-12-22 17:45:00,Gevorgyan Gegham - Petrosyan Davit,0:3,8:11 - 8:11 - 7:11 - 0:0 - 0:0,0,3,Gevorgyan Gegham,Petrosyan Davit,fiurst,Gevorgyan Gegham - Petrosyan Davit,56,23,33,10,-10,19,19,18,0,0,3,3,4,0,0,10,8:11 - 8:11 - 7:11 - 0:0 - 0:0
15886617,2023-12-22 17:15:00,Karakhanyan Mher - Gevorgyan Gegham,3:0,9:11 - 9:11 - 8:11 - 0:0 - 0:0,0,3,Karakhanyan Mher,Gevorgyan Gegham,fiurst,Gevorgyan Gegham - Karakhanyan Mher,59,33,26,-7,7,20,20,19,0,0,-2,-2,-3,0,0,-7,11:9 - 11:9 - 11:8 - 0:0 - 0:0
15886616,2023-12-22 17:00:00,Gevorgyan Hayk - Petrosyan Davit,2:3,7:11 - 11:7 - 11:6 - 12:14 - 7:11,2,3,Gevorgyan Hayk,Petrosyan Davit,fiurst,Gevorgyan Hayk - Petrosyan Davit,97,48,49,1,-1,18,18,17,26,18,4,-4,-5,2,4,1,7:11 - 11:7 - 11:6 - 12:14 - 7:11
15886611,2023-12-22 16:45:00,Avakimyan Davit - Karakhanyan Mher,3:0,11:6 - 11:7 - 11:6 - 0:0 - 0:0,3,0,Avakimyan Davit,Karakhanyan Mher,fiurst,Avakimyan Davit - Karakhanyan Mher,52,33,19,-14,14,17,18,17,0,0,-5,-4,-5,0,0,-14,11:6 - 11:7 - 11:6 - 0:0 - 0:0
15886602,2023-12-22 16:30:00,Gevorgyan Gegham - Gevorgyan Hayk,1:3,8:11 - 11:3 - 7:11 - 11:13 - 0:0,1,3,Gevorgyan Gegham,Gevorgyan Hayk,fiurst,Gevorgyan Gegham - Gevorgyan Hayk,75,37,38,1,-1,19,14,18,24,0,3,-8,4,2,0,1,8:11 - 11:3 - 7:11 - 11:13 - 0:0
15886600,2023-12-22 16:15:00,Petrosyan Davit - Karakhanyan Mher,1:3,9:11 - 11:9 - 11:7 - 11:7 - 0:0,3,1,Petrosyan Davit,Karakhanyan Mher,fiurst,Karakhanyan Mher - Petrosyan Davit,76,34,42,8,-8,20,20,18,18,0,-2,2,4,4,0,8,11:9 - 9:11 - 7:11 - 7:11 - 0:0
15886595,2023-12-22 16:00:00,Avakimyan Davit - Gevorgyan Gegham,3:0,11:9 - 11:9 - 11:6 - 0:0 - 0:0,3,0,Avakimyan Davit,Gevorgyan Gegham,fiurst,Avakimyan Davit - Gevorgyan Gegham,57,33,24,-9,9,20,20,17,0,0,-2,-2,-5,0,0,-9,11:9 - 11:9 - 11:6 - 0:0 - 0:0
15886593,2023-12-22 15:45:00,Karakhanyan Mher - Gevorgyan Hayk,3:2,12:10 - 7:11 - 7:11 - 11:9 - 5:11,2,3,Karakhanyan Mher,Gevorgyan Hayk,fiurst,Gevorgyan Hayk - Karakhanyan Mher,94,52,42,-10,10,22,18,18,20,16,2,-4,-4,2,-6,-10,10:12 - 11:7 - 11:7 - 9:11 - 11:5
15886591,2023-12-22 15:30:00,Petrosyan Davit - Avakimyan Davit,1:3,14:12 - 11:6 - 8:11 - 11:9 - 0:0,3,1,Petrosyan Davit,Avakimyan Davit,fiurst,Avakimyan Davit - Petrosyan Davit,82,38,44,6,-6,26,17,19,20,0,2,5,-3,2,0,6,12:14 - 6:11 - 11:8 - 9:11 - 0:0
15886578,2023-12-22 15:15:00,Mkrtchyan Andranik - Arutyunov Ruben,0:3,11:9 - 11:3 - 11:6 - 0:0 - 0:0,3,0,Mkrtchyan Andranik,Arutyunov Ruben,fiurst,Arutyunov Ruben - Mkrtchyan Andranik,51,18,33,15,-15,20,14,17,0,0,2,8,5,0,0,15,9:11 - 3:11 - 6:11 - 0:0 - 0:0
15886577,2023-12-22 15:05:00,Rafayelyan Edgar - Soghomonyan Hrayr,3:0,11:8 - 11:9 - 11:4 - 0:0 - 0:0,3,0,Rafayelyan Edgar,Soghomonyan Hrayr,fiurst,Rafayelyan Edgar - Soghomonyan Hrayr,54,33,21,-12,12,19,20,15,0,0,-3,-2,-7,0,0,-12,11:8 - 11:9 - 11:4 - 0:0 - 0:0
15886575,2023-12-22 14:45:00,Diaryan Aleksandr - Mkrtchyan Andranik,3:0,11:6 - 11:9 - 11:7 - 0:0 - 0:0,3,0,Diaryan Aleksandr,Mkrtchyan Andranik,fiurst,Diaryan Aleksandr - Mkrtchyan Andranik,55,33,22,-11,11,17,20,18,0,0,-5,-2,-4,0,0,-11,11:6 - 11:9 - 11:7 - 0:0 - 0:0
15886561,2023-12-22 14:30:00,Arutyunov Ruben - Rafayelyan Edgar,1:3,12:10 - 2:11 - 8:11 - 10:12 - 0:0,1,3,Arutyunov Ruben,Rafayelyan Edgar,fiurst,Arutyunov Ruben - Rafayelyan Edgar,76,32,44,12,-12,22,13,19,22,0,-2,9,3,2,0,12,12:10 - 2:11 - 8:11 - 10:12 - 0:0
15886558,2023-12-22 14:20:00,Diaryan Aleksandr - Soghomonyan Hrayr,3:0,11:5 - 11:5 - 12:10 - 0:0 - 0:0,3,0,Diaryan Aleksandr,Soghomonyan Hrayr,fiurst,Diaryan Aleksandr - Soghomonyan Hrayr,54,34,20,-14,14,16,16,22,0,0,-6,-6,-2,0,0,-14,11:5 - 11:5 - 12:10 - 0:0 - 0:0
15886546,2023-12-22 14:05:00,Mkrtchyan Andranik - Rafayelyan Edgar,1:3,3:11 - 5:11 - 11:7 - 5:11 - 0:0,1,3,Mkrtchyan Andranik,Rafayelyan Edgar,fiurst,Mkrtchyan Andranik - Rafayelyan Edgar,64,24,40,16,-16,14,16,18,16,0,8,6,-4,6,0,16,3:11 - 5:11 - 11:7 - 5:11 - 0:0
15886544,2023-12-22 13:55:00,Arutyunov Ruben - Diaryan Aleksandr,1:3,11:7 - 4:11 - 8:11 - 4:11 - 0:0,1,3,Arutyunov Ruben,Diaryan Aleksandr,fiurst,Arutyunov Ruben - Diaryan Aleksandr,67,27,40,13,-13,18,15,19,15,0,-4,7,3,7,0,13,11:7 - 4:11 - 8:11 - 4:11 - 0:0
15886538,2023-12-22 13:30:00,Soghomonyan Hrayr - Mkrtchyan Andranik,1:3,11:6 - 15:13 - 8:11 - 11:7 - 0:0,3,1,Soghomonyan Hrayr,Mkrtchyan Andranik,fiurst,Mkrtchyan Andranik - Soghomonyan Hrayr,82,37,45,8,-8,17,28,19,18,0,5,2,-3,4,0,8,6:11 - 13:15 - 11:8 - 7:11 - 0:0
15886521,2023-12-22 13:15:00,Rafayelyan Edgar - Diaryan Aleksandr,2:3,6:11 - 14:12 - 11:8 - 8:11 - 13:11,3,2,Rafayelyan Edgar,Diaryan Aleksandr,fiurst,Diaryan Aleksandr - Rafayelyan Edgar,105,53,52,-1,1,17,26,19,19,24,-5,2,3,-3,2,-1,11:6 - 12:14 - 8:11 - 11:8 - 11:13
15886503,2023-12-22 13:00:00,Soghomonyan Hrayr - Arutyunov Ruben,3:0,7:11 - 4:11 - 8:11 - 0:0 - 0:0,0,3,Soghomonyan Hrayr,Arutyunov Ruben,fiurst,Arutyunov Ruben - Soghomonyan Hrayr,52,33,19,-14,14,18,15,19,0,0,-4,-7,-3,0,0,-14,11:7 - 11:4 - 11:8 - 0:0 - 0:0
15886500,2023-12-22 12:15:00,Mkrtchyan Andranik - Diaryan Aleksandr,3:0,13:15 - 14:16 - 8:11 - 0:0 - 0:0,0,3,Mkrtchyan Andranik,Diaryan Aleksandr,fiurst,Diaryan Aleksandr - Mkrtchyan Andranik,77,42,35,-7,7,28,30,19,0,0,-2,-2,-3,0,0,-7,15:13 - 16:14 - 11:8 - 0:0 - 0:0
15886494,2023-12-22 12:00:00,Soghomonyan Hrayr - Rafayelyan Edgar,3:0,4:11 - 8:11 - 4:11 - 0:0 - 0:0,0,3,Soghomonyan Hrayr,Rafayelyan Edgar,fiurst,Rafayelyan Edgar - Soghomonyan Hrayr,49,33,16,-17,17,15,19,15,0,0,-7,-3,-7,0,0,-17,11:4 - 11:8 - 11:4 - 0:0 - 0:0
15886468,2023-12-22 11:45:00,Arutyunov Ruben - Mkrtchyan Andranik,1:3,5:11 - 11:8 - 7:11 - 7:11 - 0:0,1,3,Arutyunov Ruben,Mkrtchyan Andranik,fiurst,Arutyunov Ruben - Mkrtchyan Andranik,71,30,41,11,-11,16,19,18,18,0,6,-3,4,4,0,11,5:11 - 11:8 - 7:11 - 7:11 - 0:0
15886466,2023-12-22 11:35:00,Soghomonyan Hrayr - Diaryan Aleksandr,3:1,11:9 - 3:11 - 7:11 - 4:11 - 0:0,1,3,Soghomonyan Hrayr,Diaryan Aleksandr,fiurst,Diaryan Aleksandr - Soghomonyan Hrayr,67,42,25,-17,17,20,14,18,15,0,2,-8,-4,-7,0,-17,9:11 - 11:3 - 11:7 - 11:4 - 0:0
15886457,2023-12-22 11:15:00,Rafayelyan Edgar - Arutyunov Ruben,0:3,11:5 - 11:7 - 11:8 - 0:0 - 0:0,3,0,Rafayelyan Edgar,Arutyunov Ruben,fiurst,Arutyunov Ruben - Rafayelyan Edgar,53,20,33,13,-13,16,18,19,0,0,6,4,3,0,0,13,5:11 - 7:11 - 8:11 - 0:0 - 0:0
15886453,2023-12-22 11:00:00,Mkrtchyan Andranik - Soghomonyan Hrayr,2:3,11:7 - 6:11 - 8:11 - 11:8 - 4:11,2,3,Mkrtchyan Andranik,Soghomonyan Hrayr,fiurst,Mkrtchyan Andranik - Soghomonyan Hrayr,88,40,48,8,-8,18,17,19,19,15,-4,5,3,-3,7,8,11:7 - 6:11 - 8:11 - 11:8 - 4:11
15886452,2023-12-22 10:45:00,Diaryan Aleksandr - Arutyunov Ruben,0:3,11:6 - 11:4 - 11:8 - 0:0 - 0:0,3,0,Diaryan Aleksandr,Arutyunov Ruben,fiurst,Arutyunov Ruben - Diaryan Aleksandr,51,18,33,15,-15,17,15,19,0,0,5,7,3,0,0,15,6:11 - 4:11 - 8:11 - 0:0 - 0:0
15886448,2023-12-22 10:30:00,Rafayelyan Edgar - Mkrtchyan Andranik,0:3,11:2 - 11:8 - 11:2 - 0:0 - 0:0,3,0,Rafayelyan Edgar,Mkrtchyan Andranik,fiurst,Mkrtchyan Andranik - Rafayelyan Edgar,45,12,33,21,-21,13,19,13,0,0,9,3,9,0,0,21,2:11 - 8:11 - 2:11 - 0:0 - 0:0
15886446,2023-12-22 10:15:00,Arutyunov Ruben - Soghomonyan Hrayr,3:2,9:11 - 7:11 - 13:11 - 11:3 - 11:6,3,2,Arutyunov Ruben,Soghomonyan Hrayr,fiurst,Arutyunov Ruben - Soghomonyan Hrayr,93,51,42,-9,9,20,18,24,14,17,2,4,-2,-8,-5,-9,9:11 - 7:11 - 13:11 - 11:3 - 11:6
15886445,2023-12-22 10:00:00,Diaryan Aleksandr - Rafayelyan Edgar,3:2,11:8 - 7:11 - 11:7 - 6:11 - 11:8,3,2,Diaryan Aleksandr,Rafayelyan Edgar,fiurst,Diaryan Aleksandr - Rafayelyan Edgar,91,46,45,-1,1,19,18,18,17,19,-3,4,-4,5,-3,-1,11:8 - 7:11 - 11:7 - 6:11 - 11:8
15864254,2023-12-21 17:45:00,Darbinyan Armen - Gevorgyan Gegham,0:3,7:11 - 6:11 - 6:11 - 0:0 - 0:0,0,3,Darbinyan Armen,Gevorgyan Gegham,fiurst,Darbinyan Armen - Gevorgyan Gegham,52,19,33,14,-14,18,17,17,0,0,4,5,5,0,0,14,7:11 - 6:11 - 6:11 - 0:0 - 0:0
15864248,2023-12-21 17:30:00,Petrosyan Davit - Karakhanyan Mher,0:3,11:8 - 11:6 - 11:9 - 0:0 - 0:0,3,0,Petrosyan Davit,Karakhanyan Mher,fiurst,Karakhanyan Mher - Petrosyan Davit,56,23,33,10,-10,19,17,20,0,0,3,5,2,0,0,10,8:11 - 6:11 - 9:11 - 0:0 - 0:0
15864241,2023-12-21 17:15:00,Gevorgyan Hayk - Darbinyan Armen,0:3,11:4 - 11:9 - 11:3 - 0:0 - 0:0,3,0,Gevorgyan Hayk,Darbinyan Armen,fiurst,Darbinyan Armen - Gevorgyan Hayk,49,16,33,17,-17,15,20,14,0,0,7,2,8,0,0,17,4:11 - 9:11 - 3:11 - 0:0 - 0:0
15864234,2023-12-21 17:00:00,Petrosyan Davit - Gevorgyan Gegham,1:3,11:3 - 15:13 - 10:12 - 11:8 - 0:0,3,1,Petrosyan Davit,Gevorgyan Gegham,fiurst,Gevorgyan Gegham - Petrosyan Davit,83,36,47,11,-11,14,28,22,19,0,8,2,-2,3,0,11,3:11 - 13:15 - 12:10 - 8:11 - 0:0
15864232,2023-12-21 16:55:00,Karakhanyan Mher - Gevorgyan Hayk,3:0,7:11 - 7:11 - 8:11 - 0:0 - 0:0,0,3,Karakhanyan Mher,Gevorgyan Hayk,fiurst,Gevorgyan Hayk - Karakhanyan Mher,55,33,22,-11,11,18,18,19,0,0,-4,-4,-3,0,0,-11,11:7 - 11:7 - 11:8 - 0:0 - 0:0
15864230,2023-12-21 16:30:00,Darbinyan Armen - Petrosyan Davit,0:3,6:11 - 7:11 - 4:11 - 0:0 - 0:0,0,3,Darbinyan Armen,Petrosyan Davit,fiurst,Darbinyan Armen - Petrosyan Davit,50,17,33,16,-16,17,18,15,0,0,5,4,7,0,0,16,6:11 - 7:11 - 4:11 - 0:0 - 0:0
15864229,2023-12-21 16:15:00,Gevorgyan Gegham - Gevorgyan Hayk,2:3,11:9 - 8:11 - 12:10 - 6:11 - 10:12,2,3,Gevorgyan Gegham,Gevorgyan Hayk,fiurst,Gevorgyan Gegham - Gevorgyan Hayk,100,47,53,6,-6,20,19,22,17,22,-2,3,-2,5,2,6,11:9 - 8:11 - 12:10 - 6:11 - 10:12
15864228,2023-12-21 16:00:00,Karakhanyan Mher - Darbinyan Armen,2:3,11:7 - 4:11 - 11:8 - 5:11 - 11:5,3,2,Karakhanyan Mher,Darbinyan Armen,fiurst,Darbinyan Armen - Karakhanyan Mher,84,42,42,0,0,18,15,19,16,16,4,-7,3,-6,6,0,7:11 - 11:4 - 8:11 - 11:5 - 5:11
15864216,2023-12-21 15:45:00,Gevorgyan Hayk - Petrosyan Davit,3:1,11:4 - 10:12 - 11:3 - 12:10 - 0:0,3,1,Gevorgyan Hayk,Petrosyan Davit,fiurst,Gevorgyan Hayk - Petrosyan Davit,73,44,29,-15,15,15,22,14,22,0,-7,2,-8,-2,0,-15,11:4 - 10:12 - 11:3 - 12:10 - 0:0
15864215,2023-12-21 15:30:00,Gevorgyan Gegham - Karakhanyan Mher,3:1,11:8 - 13:15 - 13:11 - 11:5 - 0:0,3,1,Gevorgyan Gegham,Karakhanyan Mher,fiurst,Gevorgyan Gegham - Karakhanyan Mher,87,48,39,-9,9,19,28,24,16,0,-3,2,-2,-6,0,-9,11:8 - 13:15 - 13:11 - 11:5 - 0:0
15863910,2023-12-21 15:15:00,Soghomonyan Hrayr - Papyan Karen,1:3,11:6 - 11:9 - 4:11 - 11:8 - 0:0,3,1,Soghomonyan Hrayr,Papyan Karen,fiurst,Papyan Karen - Soghomonyan Hrayr,71,34,37,3,-3,17,20,15,19,0,5,2,-7,3,0,3,6:11 - 9:11 - 11:4 - 8:11 - 0:0
15863899,2023-12-21 15:10:00,Diaryan Aleksandr - Rafayelyan Edgar,0:3,7:11 - 8:11 - 9:11 - 0:0 - 0:0,0,3,Diaryan Aleksandr,Rafayelyan Edgar,fiurst,Diaryan Aleksandr - Rafayelyan Edgar,57,24,33,9,-9,18,19,20,0,0,4,3,2,0,0,9,7:11 - 8:11 - 9:11 - 0:0 - 0:0
15863896,2023-12-21 14:55:00,Arutyunov Ruben - Soghomonyan Hrayr,0:3,6:11 - 11:13 - 7:11 - 0:0 - 0:0,0,3,Arutyunov Ruben,Soghomonyan Hrayr,fiurst,Arutyunov Ruben - Soghomonyan Hrayr,59,24,35,11,-11,17,24,18,0,0,5,2,4,0,0,11,6:11 - 11:13 - 7:11 - 0:0 - 0:0
15863879,2023-12-21 14:30:00,Arutyunov Ruben - Rafayelyan Edgar,1:3,11:6 - 6:11 - 0:11 - 2:11 - 0:0,1,3,Arutyunov Ruben,Rafayelyan Edgar,fiurst,Arutyunov Ruben - Rafayelyan Edgar,58,19,39,20,-20,17,17,11,13,0,-5,5,11,9,0,20,11:6 - 6:11 - 0:11 - 2:11 - 0:0
15863882,2023-12-21 14:30:00,Papyan Karen - Diaryan Aleksandr,3:1,5:11 - 11:7 - 2:11 - 7:11 - 0:0,1,3,Papyan Karen,Diaryan Aleksandr,fiurst,Diaryan Aleksandr - Papyan Karen,65,40,25,-15,15,16,18,13,18,0,-6,4,-9,-4,0,-15,11:5 - 7:11 - 11:2 - 11:7 - 0:0
15863878,2023-12-21 14:00:00,Soghomonyan Hrayr - Diaryan Aleksandr,3:0,7:11 - 3:11 - 12:14 - 0:0 - 0:0,0,3,Soghomonyan Hrayr,Diaryan Aleksandr,fiurst,Diaryan Aleksandr - Soghomonyan Hrayr,58,36,22,-14,14,18,14,26,0,0,-4,-8,-2,0,0,-14,11:7 - 11:3 - 14:12 - 0:0 - 0:0
15863872,2023-12-21 13:45:00,Papyan Karen - Arutyunov Ruben,2:3,11:9 - 6:11 - 4:11 - 11:4 - 12:10,3,2,Papyan Karen,Arutyunov Ruben,fiurst,Arutyunov Ruben - Papyan Karen,89,45,44,-1,1,20,17,15,15,22,2,-5,-7,7,2,-1,9:11 - 11:6 - 11:4 - 4:11 - 10:12
15863867,2023-12-21 13:30:00,Rafayelyan Edgar - Soghomonyan Hrayr,3:0,11:7 - 11:8 - 11:9 - 0:0 - 0:0,3,0,Rafayelyan Edgar,Soghomonyan Hrayr,fiurst,Rafayelyan Edgar - Soghomonyan Hrayr,57,33,24,-9,9,18,19,20,0,0,-4,-3,-2,0,0,-9,11:7 - 11:8 - 11:9 - 0:0 - 0:0
15863862,2023-12-21 13:15:00,Diaryan Aleksandr - Arutyunov Ruben,0:3,11:9 - 11:8 - 11:5 - 0:0 - 0:0,3,0,Diaryan Aleksandr,Arutyunov Ruben,fiurst,Arutyunov Ruben - Diaryan Aleksandr,55,22,33,11,-11,20,19,16,0,0,2,3,6,0,0,11,9:11 - 8:11 - 5:11 - 0:0 - 0:0
15863859,2023-12-21 13:00:00,Rafayelyan Edgar - Papyan Karen,0:3,11:8 - 11:9 - 11:8 - 0:0 - 0:0,3,0,Rafayelyan Edgar,Papyan Karen,fiurst,Papyan Karen - Rafayelyan Edgar,58,25,33,8,-8,19,20,19,0,0,3,2,3,0,0,8,8:11 - 9:11 - 8:11 - 0:0 - 0:0
15863847,2023-12-21 12:20:00,Soghomonyan Hrayr - Arutyunov Ruben,2:3,11:7 - 9:11 - 11:0 - 8:11 - 11:3,3,2,Soghomonyan Hrayr,Arutyunov Ruben,fiurst,Arutyunov Ruben - Soghomonyan Hrayr,82,32,50,18,-18,18,20,11,19,14,4,-2,11,-3,8,18,7:11 - 11:9 - 0:11 - 11:8 - 3:11
15863844,2023-12-21 12:00:00,Rafayelyan Edgar - Diaryan Aleksandr,3:1,4:11 - 11:6 - 6:11 - 6:11 - 0:0,1,3,Rafayelyan Edgar,Diaryan Aleksandr,fiurst,Diaryan Aleksandr - Rafayelyan Edgar,66,39,27,-12,12,15,17,17,17,0,-7,5,-5,-5,0,-12,11:4 - 6:11 - 11:6 - 11:6 - 0:0
15863842,2023-12-21 11:50:00,Papyan Karen - Soghomonyan Hrayr,1:3,5:11 - 12:10 - 9:11 - 10:12 - 0:0,1,3,Papyan Karen,Soghomonyan Hrayr,fiurst,Papyan Karen - Soghomonyan Hrayr,80,36,44,8,-8,16,22,20,22,0,6,-2,2,2,0,8,5:11 - 12:10 - 9:11 - 10:12 - 0:0
15863839,2023-12-21 11:35:00,Rafayelyan Edgar - Arutyunov Ruben,0:3,11:6 - 11:8 - 11:3 - 0:0 - 0:0,3,0,Rafayelyan Edgar,Arutyunov Ruben,fiurst,Arutyunov Ruben - Rafayelyan Edgar,50,17,33,16,-16,17,19,14,0,0,5,3,8,0,0,16,6:11 - 8:11 - 3:11 - 0:0 - 0:0
15863837,2023-12-21 11:20:00,Diaryan Aleksandr - Papyan Karen,3:0,14:12 - 11:4 - 12:10 - 0:0 - 0:0,3,0,Diaryan Aleksandr,Papyan Karen,fiurst,Diaryan Aleksandr - Papyan Karen,63,37,26,-11,11,26,15,22,0,0,-2,-7,-2,0,0,-11,14:12 - 11:4 - 12:10 - 0:0 - 0:0
15863834,2023-12-21 11:00:00,Soghomonyan Hrayr - Rafayelyan Edgar,3:1,6:11 - 11:7 - 6:11 - 7:11 - 0:0,1,3,Soghomonyan Hrayr,Rafayelyan Edgar,fiurst,Rafayelyan Edgar - Soghomonyan Hrayr,70,40,30,-10,10,17,18,17,18,0,-5,4,-5,-4,0,-10,11:6 - 7:11 - 11:6 - 11:7 - 0:0
15863833,2023-12-21 10:50:00,Arutyunov Ruben - Papyan Karen,3:1,13:11 - 7:11 - 11:9 - 11:7 - 0:0,3,1,Arutyunov Ruben,Papyan Karen,fiurst,Arutyunov Ruben - Papyan Karen,80,42,38,-4,4,24,18,20,18,0,-2,4,-2,-4,0,-4,13:11 - 7:11 - 11:9 - 11:7 - 0:0
15863829,2023-12-21 10:35:00,Diaryan Aleksandr - Soghomonyan Hrayr,3:0,11:5 - 11:9 - 11:8 - 0:0 - 0:0,3,0,Diaryan Aleksandr,Soghomonyan Hrayr,fiurst,Diaryan Aleksandr - Soghomonyan Hrayr,55,33,22,-11,11,16,20,19,0,0,-6,-2,-3,0,0,-11,11:5 - 11:9 - 11:8 - 0:0 - 0:0
15863827,2023-12-21 10:15:00,Papyan Karen - Rafayelyan Edgar,0:3,9:11 - 3:11 - 8:11 - 0:0 - 0:0,0,3,Papyan Karen,Rafayelyan Edgar,fiurst,Papyan Karen - Rafayelyan Edgar,53,20,33,13,-13,20,14,19,0,0,2,8,3,0,0,13,9:11 - 3:11 - 8:11 - 0:0 - 0:0
15863814,2023-12-21 10:00:00,Arutyunov Ruben - Diaryan Aleksandr,1:3,11:9 - 10:12 - 12:14 - 9:11 - 0:0,1,3,Arutyunov Ruben,Diaryan Aleksandr,fiurst,Arutyunov Ruben - Diaryan Aleksandr,88,42,46,4,-4,20,22,26,20,0,-2,2,2,2,0,4,11:9 - 10:12 - 12:14 - 9:11 - 0:0
15850763,2023-12-20 17:45:00,Darbinyan Armen - Karakhanyan Mher,1:3,10:12 - 11:13 - 12:10 - 5:11 - 0:0,1,3,Darbinyan Armen,Karakhanyan Mher,fiurst,Darbinyan Armen - Karakhanyan Mher,84,38,46,8,-8,22,24,22,16,0,2,2,-2,6,0,8,10:12 - 11:13 - 12:10 - 5:11 - 0:0
15850759,2023-12-20 17:30:00,Gevorgyan Hayk - Avakimyan Davit,0:3,11:5 - 11:9 - 12:10 - 0:0 - 0:0,3,0,Gevorgyan Hayk,Avakimyan Davit,fiurst,Avakimyan Davit - Gevorgyan Hayk,58,24,34,10,-10,16,20,22,0,0,6,2,2,0,0,10,5:11 - 9:11 - 10:12 - 0:0 - 0:0
15850757,2023-12-20 17:15:00,Gevorgyan Gegham - Darbinyan Armen,0:3,11:7 - 11:6 - 11:3 - 0:0 - 0:0,3,0,Gevorgyan Gegham,Darbinyan Armen,fiurst,Darbinyan Armen - Gevorgyan Gegham,49,16,33,17,-17,18,17,14,0,0,4,5,8,0,0,17,7:11 - 6:11 - 3:11 - 0:0 - 0:0
15850756,2023-12-20 17:00:00,Gevorgyan Hayk - Karakhanyan Mher,3:0,11:7 - 12:10 - 11:9 - 0:0 - 0:0,3,0,Gevorgyan Hayk,Karakhanyan Mher,fiurst,Gevorgyan Hayk - Karakhanyan Mher,60,34,26,-8,8,18,22,20,0,0,-4,-2,-2,0,0,-8,11:7 - 12:10 - 11:9 - 0:0 - 0:0
15850750,2023-12-20 16:45:00,Avakimyan Davit - Gevorgyan Gegham,2:3,11:7 - 10:12 - 8:11 - 11:5 - 8:11,2,3,Avakimyan Davit,Gevorgyan Gegham,fiurst,Avakimyan Davit - Gevorgyan Gegham,94,48,46,-2,2,18,22,19,16,19,-4,2,3,-6,3,-2,11:7 - 10:12 - 8:11 - 11:5 - 8:11
15850742,2023-12-20 16:30:00,Darbinyan Armen - Gevorgyan Hayk,0:3,8:11 - 3:11 - 5:11 - 0:0 - 0:0,0,3,Darbinyan Armen,Gevorgyan Hayk,fiurst,Darbinyan Armen - Gevorgyan Hayk,49,16,33,17,-17,19,14,16,0,0,3,8,6,0,0,17,8:11 - 3:11 - 5:11 - 0:0 - 0:0
15850738,2023-12-20 16:15:00,Karakhanyan Mher - Gevorgyan Gegham,1:3,11:7 - 11:8 - 8:11 - 11:7 - 0:0,3,1,Karakhanyan Mher,Gevorgyan Gegham,fiurst,Gevorgyan Gegham - Karakhanyan Mher,74,33,41,8,-8,18,19,19,18,0,4,3,-3,4,0,8,7:11 - 8:11 - 11:8 - 7:11 - 0:0
15850736,2023-12-20 16:05:00,Avakimyan Davit - Darbinyan Armen,3:0,11:9 - 11:5 - 11:6 - 0:0 - 0:0,3,0,Avakimyan Davit,Darbinyan Armen,fiurst,Avakimyan Davit - Darbinyan Armen,53,33,20,-13,13,20,16,17,0,0,-2,-6,-5,0,0,-13,11:9 - 11:5 - 11:6 - 0:0 - 0:0
15850735,2023-12-20 15:45:00,Gevorgyan Gegham - Gevorgyan Hayk,1:3,11:8 - 6:11 - 5:11 - 6:11 - 0:0,1,3,Gevorgyan Gegham,Gevorgyan Hayk,fiurst,Gevorgyan Gegham - Gevorgyan Hayk,69,28,41,13,-13,19,17,16,17,0,-3,5,6,5,0,13,11:8 - 6:11 - 5:11 - 6:11 - 0:0
15850734,2023-12-20 15:30:00,Karakhanyan Mher - Avakimyan Davit,3:1,9:11 - 11:7 - 6:11 - 7:11 - 0:0,1,3,Karakhanyan Mher,Avakimyan Davit,fiurst,Avakimyan Davit - Karakhanyan Mher,73,40,33,-7,7,20,18,17,18,0,-2,4,-5,-4,0,-7,11:9 - 7:11 - 11:6 - 11:7 - 0:0
15850257,2023-12-20 15:15:00,Nazaryan Mushegh - Rafayelyan Edgar,0:3,6:11 - 6:11 - 6:11 - 0:0 - 0:0,0,3,Nazaryan Mushegh,Rafayelyan Edgar,fiurst,Nazaryan Mushegh - Rafayelyan Edgar,51,18,33,15,-15,17,17,17,0,0,5,5,5,0,0,15,6:11 - 6:11 - 6:11 - 0:0 - 0:0
15850254,2023-12-20 15:00:00,Mkrtchyan Andranik - Papyan Karen,0:3,10:12 - 11:13 - 8:11 - 0:0 - 0:0,0,3,Mkrtchyan Andranik,Papyan Karen,fiurst,Mkrtchyan Andranik - Papyan Karen,65,29,36,7,-7,22,24,19,0,0,2,2,3,0,0,7,10:12 - 11:13 - 8:11 - 0:0 - 0:0
15850252,2023-12-20 14:45:00,Soghomonyan Hrayr - Nazaryan Mushegh,3:1,14:12 - 7:11 - 8:11 - 9:11 - 0:0,1,3,Soghomonyan Hrayr,Nazaryan Mushegh,fiurst,Nazaryan Mushegh - Soghomonyan Hrayr,83,45,38,-7,7,26,18,19,20,0,2,-4,-3,-2,0,-7,12:14 - 11:7 - 11:8 - 11:9 - 0:0
15850250,2023-12-20 14:35:00,Rafayelyan Edgar - Mkrtchyan Andranik,0:3,11:5 - 11:5 - 14:12 - 0:0 - 0:0,3,0,Rafayelyan Edgar,Mkrtchyan Andranik,fiurst,Mkrtchyan Andranik - Rafayelyan Edgar,58,22,36,14,-14,16,16,26,0,0,6,6,2,0,0,14,5:11 - 5:11 - 12:14 - 0:0 - 0:0
15850247,2023-12-20 14:15:00,Soghomonyan Hrayr - Papyan Karen,3:1,8:11 - 11:5 - 11:13 - 3:11 - 0:0,1,3,Soghomonyan Hrayr,Papyan Karen,fiurst,Papyan Karen - Soghomonyan Hrayr,73,40,33,-7,7,19,16,24,14,0,-3,6,-2,-8,0,-7,11:8 - 5:11 - 13:11 - 11:3 - 0:0
15850239,2023-12-20 14:00:00,Nazaryan Mushegh - Mkrtchyan Andranik,2:3,6:11 - 11:9 - 11:9 - 7:11 - 12:10,3,2,Nazaryan Mushegh,Mkrtchyan Andranik,fiurst,Mkrtchyan Andranik - Nazaryan Mushegh,97,50,47,-3,3,17,20,20,18,22,-5,2,2,-4,2,-3,11:6 - 9:11 - 9:11 - 11:7 - 10:12
15850226,2023-12-20 13:45:00,Rafayelyan Edgar - Soghomonyan Hrayr,3:0,11:5 - 11:3 - 11:8 - 0:0 - 0:0,3,0,Rafayelyan Edgar,Soghomonyan Hrayr,fiurst,Rafayelyan Edgar - Soghomonyan Hrayr,49,33,16,-17,17,16,14,19,0,0,-6,-8,-3,0,0,-17,11:5 - 11:3 - 11:8 - 0:0 - 0:0
15850224,2023-12-20 13:35:00,Papyan Karen - Nazaryan Mushegh,0:3,11:9 - 11:8 - 11:8 - 0:0 - 0:0,3,0,Papyan Karen,Nazaryan Mushegh,fiurst,Nazaryan Mushegh - Papyan Karen,58,25,33,8,-8,20,19,19,0,0,2,3,3,0,0,8,9:11 - 8:11 - 8:11 - 0:0 - 0:0
15850222,2023-12-20 13:15:00,Mkrtchyan Andranik - Soghomonyan Hrayr,3:0,11:4 - 11:9 - 11:8 - 0:0 - 0:0,3,0,Mkrtchyan Andranik,Soghomonyan Hrayr,fiurst,Mkrtchyan Andranik - Soghomonyan Hrayr,54,33,21,-12,12,15,20,19,0,0,-7,-2,-3,0,0,-12,11:4 - 11:9 - 11:8 - 0:0 - 0:0
15850212,2023-12-20 13:00:00,Papyan Karen - Rafayelyan Edgar,3:2,12:10 - 2:11 - 12:10 - 6:11 - 11:9,3,2,Papyan Karen,Rafayelyan Edgar,fiurst,Papyan Karen - Rafayelyan Edgar,94,43,51,8,-8,22,13,22,17,20,-2,9,-2,5,-2,8,12:10 - 2:11 - 12:10 - 6:11 - 11:9
15850211,2023-12-20 12:15:00,Nazaryan Mushegh - Soghomonyan Hrayr,3:2,7:11 - 11:3 - 12:10 - 7:11 - 11:8,3,2,Nazaryan Mushegh,Soghomonyan Hrayr,fiurst,Nazaryan Mushegh - Soghomonyan Hrayr,91,48,43,-5,5,18,14,22,18,19,4,-8,-2,4,-3,-5,7:11 - 11:3 - 12:10 - 7:11 - 11:8
15850196,2023-12-20 12:00:00,Papyan Karen - Mkrtchyan Andranik,0:3,11:8 - 13:11 - 11:7 - 0:0 - 0:0,3,0,Papyan Karen,Mkrtchyan Andranik,fiurst,Mkrtchyan Andranik - Papyan Karen,61,26,35,9,-9,19,24,18,0,0,3,2,4,0,0,9,8:11 - 11:13 - 7:11 - 0:0 - 0:0
15850193,2023-12-20 11:45:00,Rafayelyan Edgar - Nazaryan Mushegh,1:3,6:11 - 11:5 - 11:9 - 11:8 - 0:0,3,1,Rafayelyan Edgar,Nazaryan Mushegh,fiurst,Nazaryan Mushegh - Rafayelyan Edgar,72,33,39,6,-6,17,16,20,19,0,-5,6,2,3,0,6,11:6 - 5:11 - 9:11 - 8:11 - 0:0
15850192,2023-12-20 11:30:00,Papyan Karen - Soghomonyan Hrayr,3:1,9:11 - 11:5 - 11:7 - 13:11 - 0:0,3,1,Papyan Karen,Soghomonyan Hrayr,fiurst,Papyan Karen - Soghomonyan Hrayr,78,44,34,-10,10,20,16,18,24,0,2,-6,-4,-2,0,-10,9:11 - 11:5 - 11:7 - 13:11 - 0:0
15850189,2023-12-20 11:15:00,Mkrtchyan Andranik - Rafayelyan Edgar,0:3,5:11 - 12:14 - 9:11 - 0:0 - 0:0,0,3,Mkrtchyan Andranik,Rafayelyan Edgar,fiurst,Mkrtchyan Andranik - Rafayelyan Edgar,62,26,36,10,-10,16,26,20,0,0,6,2,2,0,0,10,5:11 - 12:14 - 9:11 - 0:0 - 0:0
15850188,2023-12-20 11:00:00,Nazaryan Mushegh - Papyan Karen,0:3,10:12 - 8:11 - 8:11 - 0:0 - 0:0,0,3,Nazaryan Mushegh,Papyan Karen,fiurst,Nazaryan Mushegh - Papyan Karen,60,26,34,8,-8,22,19,19,0,0,2,3,3,0,0,8,10:12 - 8:11 - 8:11 - 0:0 - 0:0
15850186,2023-12-20 10:45:00,Soghomonyan Hrayr - Rafayelyan Edgar,3:0,8:11 - 5:11 - 5:11 - 0:0 - 0:0,0,3,Soghomonyan Hrayr,Rafayelyan Edgar,fiurst,Rafayelyan Edgar - Soghomonyan Hrayr,51,33,18,-15,15,19,16,16,0,0,-3,-6,-6,0,0,-15,11:8 - 11:5 - 11:5 - 0:0 - 0:0
15850184,2023-12-20 10:35:00,Mkrtchyan Andranik - Nazaryan Mushegh,0:3,9:11 - 8:11 - 7:11 - 0:0 - 0:0,0,3,Mkrtchyan Andranik,Nazaryan Mushegh,fiurst,Mkrtchyan Andranik - Nazaryan Mushegh,57,24,33,9,-9,20,19,18,0,0,2,3,4,0,0,9,9:11 - 8:11 - 7:11 - 0:0 - 0:0
15850174,2023-12-20 10:15:00,Rafayelyan Edgar - Papyan Karen,1:3,11:3 - 11:5 - 7:11 - 11:9 - 0:0,3,1,Rafayelyan Edgar,Papyan Karen,fiurst,Papyan Karen - Rafayelyan Edgar,68,28,40,12,-12,14,16,18,20,0,8,6,-4,2,0,12,3:11 - 5:11 - 11:7 - 9:11 - 0:0
15850172,2023-12-20 10:00:00,Soghomonyan Hrayr - Mkrtchyan Andranik,3:1,5:11 - 8:11 - 14:12 - 5:11 - 0:0,1,3,Soghomonyan Hrayr,Mkrtchyan Andranik,fiurst,Mkrtchyan Andranik - Soghomonyan Hrayr,77,45,32,-13,13,16,19,26,16,0,-6,-3,2,-6,0,-13,11:5 - 11:8 - 12:14 - 11:5 - 0:0
15826049,2023-12-19 17:45:00,Darbinyan Armen - Gevorgyan Hayk,0:3,7:11 - 3:11 - 5:11 - 0:0 - 0:0,0,3,Darbinyan Armen,Gevorgyan Hayk,fiurst,Darbinyan Armen - Gevorgyan Hayk,48,15,33,18,-18,18,14,16,0,0,4,8,6,0,0,18,7:11 - 3:11 - 5:11 - 0:0 - 0:0
15826044,2023-12-19 17:30:00,Gevorgyan Gegham - Avakimyan Davit,3:0,10:12 - 10:12 - 7:11 - 0:0 - 0:0,0,3,Gevorgyan Gegham,Avakimyan Davit,fiurst,Avakimyan Davit - Gevorgyan Gegham,62,35,27,-8,8,22,22,18,0,0,-2,-2,-4,0,0,-8,12:10 - 12:10 - 11:7 - 0:0 - 0:0
15826041,2023-12-19 17:15:00,Petrosyan Davit - Darbinyan Armen,1:3,11:8 - 9:11 - 13:11 - 11:9 - 0:0,3,1,Petrosyan Davit,Darbinyan Armen,fiurst,Darbinyan Armen - Petrosyan Davit,83,39,44,5,-5,19,20,24,20,0,3,-2,2,2,0,5,8:11 - 11:9 - 11:13 - 9:11 - 0:0
15826034,2023-12-19 17:00:00,Gevorgyan Gegham - Gevorgyan Hayk,0:3,10:12 - 8:11 - 7:11 - 0:0 - 0:0,0,3,Gevorgyan Gegham,Gevorgyan Hayk,fiurst,Gevorgyan Gegham - Gevorgyan Hayk,59,25,34,9,-9,22,19,18,0,0,2,3,4,0,0,9,10:12 - 8:11 - 7:11 - 0:0 - 0:0
15826031,2023-12-19 16:45:00,Avakimyan Davit - Petrosyan Davit,3:1,5:11 - 11:9 - 11:8 - 11:8 - 0:0,3,1,Avakimyan Davit,Petrosyan Davit,fiurst,Avakimyan Davit - Petrosyan Davit,74,38,36,-2,2,16,20,19,19,0,6,-2,-3,-3,0,-2,5:11 - 11:9 - 11:8 - 11:8 - 0:0
15826013,2023-12-19 16:30:00,Gevorgyan Hayk - Petrosyan Davit,3:0,11:7 - 11:1 - 11:3 - 0:0 - 0:0,3,0,Gevorgyan Hayk,Petrosyan Davit,fiurst,Gevorgyan Hayk - Petrosyan Davit,44,33,11,-22,22,18,12,14,0,0,-4,-10,-8,0,0,-22,11:7 - 11:1 - 11:3 - 0:0 - 0:0
15826029,2023-12-19 16:30:00,Darbinyan Armen - Gevorgyan Gegham,0:3,10:12 - 7:11 - 3:11 - 0:0 - 0:0,0,3,Darbinyan Armen,Gevorgyan Gegham,fiurst,Darbinyan Armen - Gevorgyan Gegham,54,20,34,14,-14,22,18,14,0,0,2,4,8,0,0,14,10:12 - 7:11 - 3:11 - 0:0 - 0:0
15826003,2023-12-19 16:10:00,Gevorgyan Hayk - Avakimyan Davit,2:3,11:9 - 5:11 - 4:11 - 11:9 - 11:3,3,2,Gevorgyan Hayk,Avakimyan Davit,fiurst,Avakimyan Davit - Gevorgyan Hayk,85,43,42,-1,1,20,16,15,20,14,2,-6,-7,2,8,-1,9:11 - 11:5 - 11:4 - 9:11 - 3:11
15826009,2023-12-19 15:45:00,Petrosyan Davit - Gevorgyan Gegham,0:3,11:3 - 11:3 - 11:3 - 0:0 - 0:0,3,0,Petrosyan Davit,Gevorgyan Gegham,fiurst,Gevorgyan Gegham - Petrosyan Davit,42,9,33,24,-24,14,14,14,0,0,8,8,8,0,0,24,3:11 - 3:11 - 3:11 - 0:0 - 0:0
15826011,2023-12-19 15:45:00,Avakimyan Davit - Darbinyan Armen,3:1,11:5 - 11:3 - 10:12 - 11:9 - 0:0,3,1,Avakimyan Davit,Darbinyan Armen,fiurst,Avakimyan Davit - Darbinyan Armen,72,43,29,-14,14,16,14,22,20,0,-6,-8,2,-2,0,-14,11:5 - 11:3 - 10:12 - 11:9 - 0:0
15825998,2023-12-19 15:15:00,Diaryan Aleksandr - Arutyunov Ruben,1:3,12:10 - 20:22 - 11:6 - 11:5 - 0:0,3,1,Diaryan Aleksandr,Arutyunov Ruben,fiurst,Arutyunov Ruben - Diaryan Aleksandr,97,43,54,11,-11,22,42,17,16,0,2,-2,5,6,0,11,10:12 - 22:20 - 6:11 - 5:11 - 0:0
15825994,2023-12-19 15:05:00,Papyan Karen - Nazaryan Mushegh,0:3,11:8 - 11:9 - 11:8 - 0:0 - 0:0,3,0,Papyan Karen,Nazaryan Mushegh,fiurst,Nazaryan Mushegh - Papyan Karen,58,25,33,8,-8,19,20,19,0,0,3,2,3,0,0,8,8:11 - 9:11 - 8:11 - 0:0 - 0:0
15825981,2023-12-19 14:50:00,Mkrtchyan Andranik - Diaryan Aleksandr,3:1,11:3 - 5:11 - 8:11 - 5:11 - 0:0,1,3,Mkrtchyan Andranik,Diaryan Aleksandr,fiurst,Diaryan Aleksandr - Mkrtchyan Andranik,65,36,29,-7,7,14,16,19,16,0,8,-6,-3,-6,0,-7,3:11 - 11:5 - 11:8 - 11:5 - 0:0
15825978,2023-12-19 14:30:00,Arutyunov Ruben - Papyan Karen,3:0,11:9 - 11:3 - 11:6 - 0:0 - 0:0,3,0,Arutyunov Ruben,Papyan Karen,fiurst,Arutyunov Ruben - Papyan Karen,51,33,18,-15,15,20,14,17,0,0,-2,-8,-5,0,0,-15,11:9 - 11:3 - 11:6 - 0:0 - 0:0
15825954,2023-12-19 14:25:00,Mkrtchyan Andranik - Nazaryan Mushegh,3:1,11:8 - 11:8 - 5:11 - 11:7 - 0:0,3,1,Mkrtchyan Andranik,Nazaryan Mushegh,fiurst,Mkrtchyan Andranik - Nazaryan Mushegh,72,38,34,-4,4,19,19,16,18,0,-3,-3,6,-4,0,-4,11:8 - 11:8 - 5:11 - 11:7 - 0:0
15825946,2023-12-19 14:10:00,Diaryan Aleksandr - Papyan Karen,3:0,11:5 - 12:10 - 11:2 - 0:0 - 0:0,3,0,Diaryan Aleksandr,Papyan Karen,fiurst,Diaryan Aleksandr - Papyan Karen,51,34,17,-17,17,16,22,13,0,0,-6,-2,-9,0,0,-17,11:5 - 12:10 - 11:2 - 0:0 - 0:0
15825940,2023-12-19 14:05:00,Arutyunov Ruben - Mkrtchyan Andranik,0:3,7:11 - 4:11 - 5:11 - 0:0 - 0:0,0,3,Arutyunov Ruben,Mkrtchyan Andranik,fiurst,Arutyunov Ruben - Mkrtchyan Andranik,49,16,33,17,-17,18,15,16,0,0,4,7,6,0,0,17,7:11 - 4:11 - 5:11 - 0:0 - 0:0
15825926,2023-12-19 13:30:00,Nazaryan Mushegh - Diaryan Aleksandr,3:2,11:6 - 6:11 - 11:5 - 3:11 - 6:11,2,3,Nazaryan Mushegh,Diaryan Aleksandr,fiurst,Diaryan Aleksandr - Nazaryan Mushegh,81,44,37,-7,7,17,17,16,14,17,5,-5,6,-8,-5,-7,6:11 - 11:6 - 5:11 - 11:3 - 11:6
15825909,2023-12-19 13:30:00,Papyan Karen - Mkrtchyan Andranik,2:3,7:11 - 11:6 - 11:9 - 6:11 - 11:7,3,2,Papyan Karen,Mkrtchyan Andranik,fiurst,Mkrtchyan Andranik - Papyan Karen,90,44,46,2,-2,18,17,20,17,18,-4,5,2,-5,4,2,11:7 - 6:11 - 9:11 - 11:6 - 7:11
15825904,2023-12-19 13:20:00,Nazaryan Mushegh - Arutyunov Ruben,0:3,11:7 - 11:1 - 11:8 - 0:0 - 0:0,3,0,Nazaryan Mushegh,Arutyunov Ruben,fiurst,Arutyunov Ruben - Nazaryan Mushegh,49,16,33,17,-17,18,12,19,0,0,4,10,3,0,0,17,7:11 - 1:11 - 8:11 - 0:0 - 0:0
15846364,2023-12-19 13:00:00,Diaryan Aleksandr - Mkrtchyan Andranik,3:0,11:7 - 13:11 - 11:6 - 0:0 - 0:0,3,0,Diaryan Aleksandr,Mkrtchyan Andranik,fiurst,Diaryan Aleksandr - Mkrtchyan Andranik,59,35,24,-11,11,18,24,17,0,0,-4,-2,-5,0,0,-11,11:7 - 13:11 - 11:6 - 0:0 - 0:0
15825872,2023-12-19 12:25:00,Arutyunov Ruben - Diaryan Aleksandr,3:2,8:11 - 11:9 - 14:12 - 1:11 - 12:10,3,2,Arutyunov Ruben,Diaryan Aleksandr,fiurst,Arutyunov Ruben - Diaryan Aleksandr,99,46,53,7,-7,19,20,26,12,22,3,-2,-2,10,-2,7,8:11 - 11:9 - 14:12 - 1:11 - 12:10
15825885,2023-12-19 12:15:00,Nazaryan Mushegh - Papyan Karen,1:3,11:13 - 11:6 - 9:11 - 9:11 - 0:0,1,3,Nazaryan Mushegh,Papyan Karen,fiurst,Nazaryan Mushegh - Papyan Karen,81,40,41,1,-1,24,17,20,20,0,2,-5,2,2,0,1,11:13 - 11:6 - 9:11 - 9:11 - 0:0
15825862,2023-12-19 11:40:00,Papyan Karen - Arutyunov Ruben,3:2,11:7 - 6:11 - 11:6 - 9:11 - 17:19,2,3,Papyan Karen,Arutyunov Ruben,fiurst,Arutyunov Ruben - Papyan Karen,108,54,54,0,0,18,17,17,20,36,4,-5,5,-2,-2,0,7:11 - 11:6 - 6:11 - 11:9 - 19:17
15825864,2023-12-19 11:40:00,Nazaryan Mushegh - Mkrtchyan Andranik,0:3,11:4 - 11:9 - 11:8 - 0:0 - 0:0,3,0,Nazaryan Mushegh,Mkrtchyan Andranik,fiurst,Mkrtchyan Andranik - Nazaryan Mushegh,54,21,33,12,-12,15,20,19,0,0,7,2,3,0,0,12,4:11 - 9:11 - 8:11 - 0:0 - 0:0
15825859,2023-12-19 11:05:00,Diaryan Aleksandr - Nazaryan Mushegh,3:0,11:5 - 11:8 - 11:4 - 0:0 - 0:0,3,0,Diaryan Aleksandr,Nazaryan Mushegh,fiurst,Diaryan Aleksandr - Nazaryan Mushegh,50,33,17,-16,16,16,19,15,0,0,-6,-3,-7,0,0,-16,11:5 - 11:8 - 11:4 - 0:0 - 0:0
15825838,2023-12-19 10:45:00,Papyan Karen - Diaryan Aleksandr,1:3,11:9 - 8:11 - 11:9 - 11:8 - 0:0,3,1,Papyan Karen,Diaryan Aleksandr,fiurst,Diaryan Aleksandr - Papyan Karen,78,37,41,4,-4,20,19,20,19,0,2,-3,2,3,0,4,9:11 - 11:8 - 9:11 - 8:11 - 0:0
15825842,2023-12-19 10:45:00,Mkrtchyan Andranik - Arutyunov Ruben,2:3,5:11 - 8:11 - 11:5 - 13:11 - 11:6,3,2,Mkrtchyan Andranik,Arutyunov Ruben,fiurst,Arutyunov Ruben - Mkrtchyan Andranik,92,44,48,4,-4,16,19,16,24,17,-6,-3,6,2,5,4,11:5 - 11:8 - 5:11 - 11:13 - 6:11
15825833,2023-12-19 10:15:00,Arutyunov Ruben - Nazaryan Mushegh,2:3,11:7 - 11:7 - 4:11 - 12:14 - 5:11,2,3,Arutyunov Ruben,Nazaryan Mushegh,fiurst,Arutyunov Ruben - Nazaryan Mushegh,93,43,50,7,-7,18,18,15,26,16,-4,-4,7,2,6,7,11:7 - 11:7 - 4:11 - 12:14 - 5:11
15825830,2023-12-19 10:05:00,Mkrtchyan Andranik - Papyan Karen,2:3,9:11 - 12:10 - 11:8 - 9:11 - 8:11,2,3,Mkrtchyan Andranik,Papyan Karen,fiurst,Mkrtchyan Andranik - Papyan Karen,100,49,51,2,-2,20,22,19,20,19,2,-2,-3,2,3,2,9:11 - 12:10 - 11:8 - 9:11 - 8:11
15808120,2023-12-18 17:45:00,Darbinyan Armen - Avakimyan Davit,3:0,6:11 - 4:11 - 9:11 - 0:0 - 0:0,0,3,Darbinyan Armen,Avakimyan Davit,fiurst,Avakimyan Davit - Darbinyan Armen,52,33,19,-14,14,17,15,20,0,0,-5,-7,-2,0,0,-14,11:6 - 11:4 - 11:9 - 0:0 - 0:0
15808116,2023-12-18 17:30:00,Gevorgyan Hayk - Petrosyan Davit,3:1,7:11 - 11:5 - 11:4 - 11:4 - 0:0,3,1,Gevorgyan Hayk,Petrosyan Davit,fiurst,Gevorgyan Hayk - Petrosyan Davit,64,40,24,-16,16,18,16,15,15,0,4,-6,-7,-7,0,-16,7:11 - 11:5 - 11:4 - 11:4 - 0:0
15808115,2023-12-18 17:15:00,Karakhanyan Mher - Darbinyan Armen,3:2,12:10 - 12:14 - 11:6 - 3:11 - 8:11,2,3,Karakhanyan Mher,Darbinyan Armen,fiurst,Darbinyan Armen - Karakhanyan Mher,98,52,46,-6,6,22,26,17,14,19,2,-2,5,-8,-3,-6,10:12 - 14:12 - 6:11 - 11:3 - 11:8
15808112,2023-12-18 17:00:00,Gevorgyan Hayk - Avakimyan Davit,1:3,11:6 - 13:11 - 8:11 - 11:6 - 0:0,3,1,Gevorgyan Hayk,Avakimyan Davit,fiurst,Avakimyan Davit - Gevorgyan Hayk,77,34,43,9,-9,17,24,19,17,0,5,2,-3,5,0,9,6:11 - 11:13 - 11:8 - 6:11 - 0:0
15808110,2023-12-18 16:45:00,Petrosyan Davit - Karakhanyan Mher,1:3,11:6 - 11:8 - 9:11 - 11:8 - 0:0,3,1,Petrosyan Davit,Karakhanyan Mher,fiurst,Karakhanyan Mher - Petrosyan Davit,75,33,42,9,-9,17,19,20,19,0,5,3,-2,3,0,9,6:11 - 8:11 - 11:9 - 8:11 - 0:0
15808100,2023-12-18 16:30:00,Darbinyan Armen - Gevorgyan Hayk,1:3,5:11 - 6:11 - 11:7 - 7:11 - 0:0,1,3,Darbinyan Armen,Gevorgyan Hayk,fiurst,Darbinyan Armen - Gevorgyan Hayk,69,29,40,11,-11,16,17,18,18,0,6,5,-4,4,0,11,5:11 - 6:11 - 11:7 - 7:11 - 0:0
15808099,2023-12-18 16:15:00,Avakimyan Davit - Karakhanyan Mher,1:3,9:11 - 11:9 - 9:11 - 6:11 - 0:0,1,3,Avakimyan Davit,Karakhanyan Mher,fiurst,Avakimyan Davit - Karakhanyan Mher,77,35,42,7,-7,20,20,20,17,0,2,-2,2,5,0,7,9:11 - 11:9 - 9:11 - 6:11 - 0:0
15808098,2023-12-18 16:00:00,Petrosyan Davit - Darbinyan Armen,1:3,11:5 - 9:11 - 11:4 - 11:2 - 0:0,3,1,Petrosyan Davit,Darbinyan Armen,fiurst,Darbinyan Armen - Petrosyan Davit,64,22,42,20,-20,16,20,15,13,0,6,-2,7,9,0,20,5:11 - 11:9 - 4:11 - 2:11 - 0:0
15808096,2023-12-18 15:45:00,Karakhanyan Mher - Gevorgyan Hayk,3:0,7:11 - 7:11 - 9:11 - 0:0 - 0:0,0,3,Karakhanyan Mher,Gevorgyan Hayk,fiurst,Gevorgyan Hayk - Karakhanyan Mher,56,33,23,-10,10,18,18,20,0,0,-4,-4,-2,0,0,-10,11:7 - 11:7 - 11:9 - 0:0 - 0:0
15808092,2023-12-18 15:30:00,Avakimyan Davit - Petrosyan Davit,3:0,11:8 - 11:6 - 11:9 - 0:0 - 0:0,3,0,Avakimyan Davit,Petrosyan Davit,fiurst,Avakimyan Davit - Petrosyan Davit,56,33,23,-10,10,19,17,20,0,0,-3,-5,-2,0,0,-10,11:8 - 11:6 - 11:9 - 0:0 - 0:0
15808090,2023-12-18 15:15:00,Soghomonyan Hrayr - Mkrtchyan Andranik,3:2,11:5 - 13:15 - 8:11 - 11:7 - 9:11,2,3,Soghomonyan Hrayr,Mkrtchyan Andranik,fiurst,Mkrtchyan Andranik - Soghomonyan Hrayr,101,49,52,3,-3,16,28,19,18,20,6,-2,-3,4,-2,3,5:11 - 15:13 - 11:8 - 7:11 - 11:9
15808078,2023-12-18 15:00:00,Arutyunov Ruben - Diaryan Aleksandr,3:2,12:10 - 1:11 - 7:11 - 11:9 - 11:9,3,2,Arutyunov Ruben,Diaryan Aleksandr,fiurst,Arutyunov Ruben - Diaryan Aleksandr,92,42,50,8,-8,22,12,18,20,20,-2,10,4,-2,-2,8,12:10 - 1:11 - 7:11 - 11:9 - 11:9
15808076,2023-12-18 14:45:00,Rafayelyan Edgar - Soghomonyan Hrayr,3:0,11:5 - 11:4 - 11:6 - 0:0 - 0:0,3,0,Rafayelyan Edgar,Soghomonyan Hrayr,fiurst,Rafayelyan Edgar - Soghomonyan Hrayr,48,33,15,-18,18,16,15,17,0,0,-6,-7,-5,0,0,-18,11:5 - 11:4 - 11:6 - 0:0 - 0:0
15808074,2023-12-18 14:30:00,Mkrtchyan Andranik - Arutyunov Ruben,3:0,5:11 - 4:11 - 6:11 - 0:0 - 0:0,0,3,Mkrtchyan Andranik,Arutyunov Ruben,fiurst,Arutyunov Ruben - Mkrtchyan Andranik,48,33,15,-18,18,16,15,17,0,0,-6,-7,-5,0,0,-18,11:5 - 11:4 - 11:6 - 0:0 - 0:0
15808070,2023-12-18 14:15:00,Rafayelyan Edgar - Diaryan Aleksandr,3:1,11:1 - 8:11 - 7:11 - 10:12 - 0:0,1,3,Rafayelyan Edgar,Diaryan Aleksandr,fiurst,Diaryan Aleksandr - Rafayelyan Edgar,71,35,36,1,-1,12,19,18,22,0,10,-3,-4,-2,0,1,1:11 - 11:8 - 11:7 - 12:10 - 0:0
15808057,2023-12-18 14:00:00,Soghomonyan Hrayr - Arutyunov Ruben,3:0,6:11 - 8:11 - 9:11 - 0:0 - 0:0,0,3,Soghomonyan Hrayr,Arutyunov Ruben,fiurst,Arutyunov Ruben - Soghomonyan Hrayr,56,33,23,-10,10,17,19,20,0,0,-5,-3,-2,0,0,-10,11:6 - 11:8 - 11:9 - 0:0 - 0:0
15808056,2023-12-18 13:45:00,Mkrtchyan Andranik - Rafayelyan Edgar,0:3,2:11 - 6:11 - 4:11 - 0:0 - 0:0,0,3,Mkrtchyan Andranik,Rafayelyan Edgar,fiurst,Mkrtchyan Andranik - Rafayelyan Edgar,45,12,33,21,-21,13,17,15,0,0,9,5,7,0,0,21,2:11 - 6:11 - 4:11 - 0:0 - 0:0
15808054,2023-12-18 13:30:00,Diaryan Aleksandr - Soghomonyan Hrayr,3:0,11:6 - 11:4 - 11:7 - 0:0 - 0:0,3,0,Diaryan Aleksandr,Soghomonyan Hrayr,fiurst,Diaryan Aleksandr - Soghomonyan Hrayr,50,33,17,-16,16,17,15,18,0,0,-5,-7,-4,0,0,-16,11:6 - 11:4 - 11:7 - 0:0 - 0:0
15808042,2023-12-18 13:15:00,Arutyunov Ruben - Rafayelyan Edgar,2:3,11:8 - 3:11 - 5:11 - 13:11 - 6:11,2,3,Arutyunov Ruben,Rafayelyan Edgar,fiurst,Arutyunov Ruben - Rafayelyan Edgar,90,38,52,14,-14,19,14,16,24,17,-3,8,6,-2,5,14,11:8 - 3:11 - 5:11 - 13:11 - 6:11
15807978,2023-12-18 13:00:00,Diaryan Aleksandr - Mkrtchyan Andranik,3:2,11:3 - 10:12 - 6:11 - 11:9 - 11:8,3,2,Diaryan Aleksandr,Mkrtchyan Andranik,fiurst,Diaryan Aleksandr - Mkrtchyan Andranik,92,49,43,-6,6,14,22,17,20,19,-8,2,5,-2,-3,-6,11:3 - 10:12 - 6:11 - 11:9 - 11:8
15807965,2023-12-18 12:15:00,Soghomonyan Hrayr - Rafayelyan Edgar,3:0,8:11 - 6:11 - 5:11 - 0:0 - 0:0,0,3,Soghomonyan Hrayr,Rafayelyan Edgar,fiurst,Rafayelyan Edgar - Soghomonyan Hrayr,52,33,19,-14,14,19,17,16,0,0,-3,-5,-6,0,0,-14,11:8 - 11:6 - 11:5 - 0:0 - 0:0
15807963,2023-12-18 12:00:00,Diaryan Aleksandr - Arutyunov Ruben,3:0,6:11 - 9:11 - 4:11 - 0:0 - 0:0,0,3,Diaryan Aleksandr,Arutyunov Ruben,fiurst,Arutyunov Ruben - Diaryan Aleksandr,52,33,19,-14,14,17,20,15,0,0,-5,-2,-7,0,0,-14,11:6 - 11:9 - 11:4 - 0:0 - 0:0
15807959,2023-12-18 11:45:00,Mkrtchyan Andranik - Soghomonyan Hrayr,1:3,9:11 - 11:7 - 7:11 - 10:12 - 0:0,1,3,Mkrtchyan Andranik,Soghomonyan Hrayr,fiurst,Mkrtchyan Andranik - Soghomonyan Hrayr,78,37,41,4,-4,20,18,18,22,0,2,-4,4,2,0,4,9:11 - 11:7 - 7:11 - 10:12 - 0:0
15807956,2023-12-18 11:30:00,Diaryan Aleksandr - Rafayelyan Edgar,1:3,13:11 - 7:11 - 6:11 - 9:11 - 0:0,1,3,Diaryan Aleksandr,Rafayelyan Edgar,fiurst,Diaryan Aleksandr - Rafayelyan Edgar,79,35,44,9,-9,24,18,17,20,0,-2,4,5,2,0,9,13:11 - 7:11 - 6:11 - 9:11 - 0:0
15807952,2023-12-18 11:15:00,Arutyunov Ruben - Mkrtchyan Andranik,3:1,11:4 - 11:6 - 10:12 - 11:4 - 0:0,3,1,Arutyunov Ruben,Mkrtchyan Andranik,fiurst,Arutyunov Ruben - Mkrtchyan Andranik,69,43,26,-17,17,15,17,22,15,0,-7,-5,2,-7,0,-17,11:4 - 11:6 - 10:12 - 11:4 - 0:0
15807937,2023-12-18 11:00:00,Soghomonyan Hrayr - Diaryan Aleksandr,3:0,7:11 - 2:11 - 6:11 - 0:0 - 0:0,0,3,Soghomonyan Hrayr,Diaryan Aleksandr,fiurst,Diaryan Aleksandr - Soghomonyan Hrayr,48,33,15,-18,18,18,13,17,0,0,-4,-9,-5,0,0,-18,11:7 - 11:2 - 11:6 - 0:0 - 0:0
15807936,2023-12-18 10:45:00,Rafayelyan Edgar - Mkrtchyan Andranik,0:3,11:9 - 11:9 - 11:5 - 0:0 - 0:0,3,0,Rafayelyan Edgar,Mkrtchyan Andranik,fiurst,Mkrtchyan Andranik - Rafayelyan Edgar,56,23,33,10,-10,20,20,16,0,0,2,2,6,0,0,10,9:11 - 9:11 - 5:11 - 0:0 - 0:0
15807934,2023-12-18 10:30:00,Arutyunov Ruben - Soghomonyan Hrayr,3:0,11:7 - 11:2 - 11:8 - 0:0 - 0:0,3,0,Arutyunov Ruben,Soghomonyan Hrayr,fiurst,Arutyunov Ruben - Soghomonyan Hrayr,50,33,17,-16,16,18,13,19,0,0,-4,-9,-3,0,0,-16,11:7 - 11:2 - 11:8 - 0:0 - 0:0
15807933,2023-12-18 10:15:00,Mkrtchyan Andranik - Diaryan Aleksandr,3:1,11:8 - 10:12 - 7:11 - 6:11 - 0:0,1,3,Mkrtchyan Andranik,Diaryan Aleksandr,fiurst,Diaryan Aleksandr - Mkrtchyan Andranik,76,42,34,-8,8,19,22,18,17,0,3,-2,-4,-5,0,-8,8:11 - 12:10 - 11:7 - 11:6 - 0:0
15807929,2023-12-18 10:00:00,Rafayelyan Edgar - Arutyunov Ruben,0:3,11:6 - 11:3 - 12:10 - 0:0 - 0:0,3,0,Rafayelyan Edgar,Arutyunov Ruben,fiurst,Arutyunov Ruben - Rafayelyan Edgar,53,19,34,15,-15,17,14,22,0,0,5,8,2,0,0,15,6:11 - 3:11 - 10:12 - 0:0 - 0:0
15789046,2023-12-17 17:45:00,Gevorgyan Hayk - Darbinyan Armen,0:3,11:2 - 11:9 - 11:1 - 0:0 - 0:0,3,0,Gevorgyan Hayk,Darbinyan Armen,fiurst,Darbinyan Armen - Gevorgyan Hayk,45,12,33,21,-21,13,20,12,0,0,9,2,10,0,0,21,2:11 - 9:11 - 1:11 - 0:0 - 0:0
15789044,2023-12-17 17:30:00,Soghomonyan Hrayr - Grigoryan Erik,0:3,11:3 - 11:7 - 11:4 - 0:0 - 0:0,3,0,Soghomonyan Hrayr,Grigoryan Erik,fiurst,Grigoryan Erik - Soghomonyan Hrayr,47,14,33,19,-19,14,18,15,0,0,8,4,7,0,0,19,3:11 - 7:11 - 4:11 - 0:0 - 0:0
15789041,2023-12-17 17:20:00,Petrosyan Davit - Gevorgyan Hayk,3:2,11:9 - 6:11 - 3:11 - 12:10 - 7:11,2,3,Petrosyan Davit,Gevorgyan Hayk,fiurst,Gevorgyan Hayk - Petrosyan Davit,91,52,39,-13,13,20,17,14,22,18,2,-5,-8,2,-4,-13,9:11 - 11:6 - 11:3 - 10:12 - 11:7
15789039,2023-12-17 17:00:00,Soghomonyan Hrayr - Darbinyan Armen,2:3,9:11 - 15:13 - 11:7 - 8:11 - 11:1,3,2,Soghomonyan Hrayr,Darbinyan Armen,fiurst,Darbinyan Armen - Soghomonyan Hrayr,97,43,54,11,-11,20,28,18,19,12,-2,2,4,-3,10,11,11:9 - 13:15 - 7:11 - 11:8 - 1:11
15789034,2023-12-17 16:55:00,Grigoryan Erik - Petrosyan Davit,0:3,3:11 - 4:11 - 5:11 - 0:0 - 0:0,0,3,Grigoryan Erik,Petrosyan Davit,fiurst,Grigoryan Erik - Petrosyan Davit,45,12,33,21,-21,14,15,16,0,0,8,7,6,0,0,21,3:11 - 4:11 - 5:11 - 0:0 - 0:0
15789031,2023-12-17 16:35:00,Gevorgyan Hayk - Soghomonyan Hrayr,0:3,7:11 - 6:11 - 2:11 - 0:0 - 0:0,0,3,Gevorgyan Hayk,Soghomonyan Hrayr,fiurst,Gevorgyan Hayk - Soghomonyan Hrayr,48,15,33,18,-18,18,17,13,0,0,4,5,9,0,0,18,7:11 - 6:11 - 2:11 - 0:0 - 0:0
15789027,2023-12-17 16:20:00,Darbinyan Armen - Petrosyan Davit,1:3,11:9 - 2:11 - 4:11 - 8:11 - 0:0,1,3,Darbinyan Armen,Petrosyan Davit,fiurst,Darbinyan Armen - Petrosyan Davit,67,25,42,17,-17,20,13,15,19,0,-2,9,7,3,0,17,11:9 - 2:11 - 4:11 - 8:11 - 0:0
15789014,2023-12-17 16:00:00,Grigoryan Erik - Gevorgyan Hayk,3:2,7:11 - 5:11 - 11:9 - 13:11 - 8:11,2,3,Grigoryan Erik,Gevorgyan Hayk,fiurst,Gevorgyan Hayk - Grigoryan Erik,97,53,44,-9,9,18,16,20,24,19,-4,-6,2,2,-3,-9,11:7 - 11:5 - 9:11 - 11:13 - 11:8
15789013,2023-12-17 15:45:00,Petrosyan Davit - Soghomonyan Hrayr,3:2,11:8 - 11:9 - 7:11 - 4:11 - 11:8,3,2,Petrosyan Davit,Soghomonyan Hrayr,fiurst,Petrosyan Davit - Soghomonyan Hrayr,91,44,47,3,-3,19,20,18,15,19,-3,-2,4,7,-3,3,11:8 - 11:9 - 7:11 - 4:11 - 11:8
15789012,2023-12-17 15:30:00,Darbinyan Armen - Grigoryan Erik,1:3,6:11 - 11:9 - 5:11 - 9:11 - 0:0,1,3,Darbinyan Armen,Grigoryan Erik,fiurst,Darbinyan Armen - Grigoryan Erik,73,31,42,11,-11,17,20,16,20,0,5,-2,6,2,0,11,6:11 - 11:9 - 5:11 - 9:11 - 0:0
15788997,2023-12-17 15:15:00,Diaryan Aleksandr - Rafayelyan Edgar,3:0,11:6 - 11:8 - 11:5 - 0:0 - 0:0,3,0,Diaryan Aleksandr,Rafayelyan Edgar,fiurst,Diaryan Aleksandr - Rafayelyan Edgar,52,33,19,-14,14,17,19,16,0,0,-5,-3,-6,0,0,-14,11:6 - 11:8 - 11:5 - 0:0 - 0:0
15788996,2023-12-17 15:00:00,Soghomonyan Hrayr - Nazaryan Mushegh,0:3,11:8 - 11:9 - 11:8 - 0:0 - 0:0,3,0,Soghomonyan Hrayr,Nazaryan Mushegh,fiurst,Nazaryan Mushegh - Soghomonyan Hrayr,58,25,33,8,-8,19,20,19,0,0,3,2,3,0,0,8,8:11 - 9:11 - 8:11 - 0:0 - 0:0
15788993,2023-12-17 14:50:00,Papyan Karen - Diaryan Aleksandr,3:0,6:11 - 4:11 - 3:11 - 0:0 - 0:0,0,3,Papyan Karen,Diaryan Aleksandr,fiurst,Diaryan Aleksandr - Papyan Karen,46,33,13,-20,20,17,15,14,0,0,-5,-7,-8,0,0,-20,11:6 - 11:4 - 11:3 - 0:0 - 0:0
15788980,2023-12-17 14:30:00,Rafayelyan Edgar - Soghomonyan Hrayr,3:0,11:8 - 11:6 - 11:4 - 0:0 - 0:0,3,0,Rafayelyan Edgar,Soghomonyan Hrayr,fiurst,Rafayelyan Edgar - Soghomonyan Hrayr,51,33,18,-15,15,19,17,15,0,0,-3,-5,-7,0,0,-15,11:8 - 11:6 - 11:4 - 0:0 - 0:0
15788979,2023-12-17 14:15:00,Papyan Karen - Nazaryan Mushegh,1:3,11:8 - 11:8 - 10:12 - 11:8 - 0:0,3,1,Papyan Karen,Nazaryan Mushegh,fiurst,Nazaryan Mushegh - Papyan Karen,79,36,43,7,-7,19,19,22,19,0,3,3,-2,3,0,7,8:11 - 8:11 - 12:10 - 8:11 - 0:0
15788964,2023-12-17 14:00:00,Diaryan Aleksandr - Soghomonyan Hrayr,3:0,12:10 - 11:7 - 11:7 - 0:0 - 0:0,3,0,Diaryan Aleksandr,Soghomonyan Hrayr,fiurst,Diaryan Aleksandr - Soghomonyan Hrayr,58,34,24,-10,10,22,18,18,0,0,-2,-4,-4,0,0,-10,12:10 - 11:7 - 11:7 - 0:0 - 0:0
15788953,2023-12-17 13:45:00,Rafayelyan Edgar - Papyan Karen,1:3,10:12 - 11:5 - 11:7 - 11:4 - 0:0,3,1,Rafayelyan Edgar,Papyan Karen,fiurst,Papyan Karen - Rafayelyan Edgar,71,28,43,15,-15,22,16,18,15,0,-2,6,4,7,0,15,12:10 - 5:11 - 7:11 - 4:11 - 0:0
15788952,2023-12-17 13:30:00,Nazaryan Mushegh - Diaryan Aleksandr,3:0,9:11 - 5:11 - 8:11 - 0:0 - 0:0,0,3,Nazaryan Mushegh,Diaryan Aleksandr,fiurst,Diaryan Aleksandr - Nazaryan Mushegh,55,33,22,-11,11,20,16,19,0,0,-2,-6,-3,0,0,-11,11:9 - 11:5 - 11:8 - 0:0 - 0:0
15788951,2023-12-17 13:15:00,Soghomonyan Hrayr - Papyan Karen,0:3,11:8 - 11:9 - 12:10 - 0:0 - 0:0,3,0,Soghomonyan Hrayr,Papyan Karen,fiurst,Papyan Karen - Soghomonyan Hrayr,61,27,34,7,-7,19,20,22,0,0,3,2,2,0,0,7,8:11 - 9:11 - 10:12 - 0:0 - 0:0
15788941,2023-12-17 13:00:00,Nazaryan Mushegh - Rafayelyan Edgar,0:3,7:11 - 6:11 - 9:11 - 0:0 - 0:0,0,3,Nazaryan Mushegh,Rafayelyan Edgar,fiurst,Nazaryan Mushegh - Rafayelyan Edgar,55,22,33,11,-11,18,17,20,0,0,4,5,2,0,0,11,7:11 - 6:11 - 9:11 - 0:0 - 0:0
15788930,2023-12-17 12:20:00,Diaryan Aleksandr - Papyan Karen,3:0,12:10 - 11:8 - 11:9 - 0:0 - 0:0,3,0,Diaryan Aleksandr,Papyan Karen,fiurst,Diaryan Aleksandr - Papyan Karen,61,34,27,-7,7,22,19,20,0,0,-2,-3,-2,0,0,-7,12:10 - 11:8 - 11:9 - 0:0 - 0:0
15788928,2023-12-17 12:00:00,Nazaryan Mushegh - Soghomonyan Hrayr,1:3,15:17 - 11:8 - 8:11 - 7:11 - 0:0,1,3,Nazaryan Mushegh,Soghomonyan Hrayr,fiurst,Nazaryan Mushegh - Soghomonyan Hrayr,88,41,47,6,-6,32,19,19,18,0,2,-3,3,4,0,6,15:17 - 11:8 - 8:11 - 7:11 - 0:0
15788924,2023-12-17 11:45:00,Rafayelyan Edgar - Diaryan Aleksandr,1:3,11:6 - 7:11 - 11:3 - 11:9 - 0:0,3,1,Rafayelyan Edgar,Diaryan Aleksandr,fiurst,Diaryan Aleksandr - Rafayelyan Edgar,69,29,40,11,-11,17,18,14,20,0,5,-4,8,2,0,11,6:11 - 11:7 - 3:11 - 9:11 - 0:0
15788910,2023-12-17 11:30:00,Nazaryan Mushegh - Papyan Karen,0:3,7:11 - 9:11 - 8:11 - 0:0 - 0:0,0,3,Nazaryan Mushegh,Papyan Karen,fiurst,Nazaryan Mushegh - Papyan Karen,57,24,33,9,-9,18,20,19,0,0,4,2,3,0,0,9,7:11 - 9:11 - 8:11 - 0:0 - 0:0
15788906,2023-12-17 11:20:00,Soghomonyan Hrayr - Rafayelyan Edgar,3:0,8:11 - 10:12 - 9:11 - 0:0 - 0:0,0,3,Soghomonyan Hrayr,Rafayelyan Edgar,fiurst,Rafayelyan Edgar - Soghomonyan Hrayr,61,34,27,-7,7,19,22,20,0,0,-3,-2,-2,0,0,-7,11:8 - 12:10 - 11:9 - 0:0 - 0:0
15788897,2023-12-17 11:00:00,Diaryan Aleksandr - Nazaryan Mushegh,3:0,11:9 - 11:5 - 11:4 - 0:0 - 0:0,3,0,Diaryan Aleksandr,Nazaryan Mushegh,fiurst,Diaryan Aleksandr - Nazaryan Mushegh,51,33,18,-15,15,20,16,15,0,0,-2,-6,-7,0,0,-15,11:9 - 11:5 - 11:4 - 0:0 - 0:0
15788896,2023-12-17 10:45:00,Papyan Karen - Rafayelyan Edgar,0:3,3:11 - 3:11 - 1:11 - 0:0 - 0:0,0,3,Papyan Karen,Rafayelyan Edgar,fiurst,Papyan Karen - Rafayelyan Edgar,40,7,33,26,-26,14,14,12,0,0,8,8,10,0,0,26,3:11 - 3:11 - 1:11 - 0:0 - 0:0
15788895,2023-12-17 10:30:00,Soghomonyan Hrayr - Diaryan Aleksandr,0:3,12:10 - 11:5 - 11:8 - 0:0 - 0:0,3,0,Soghomonyan Hrayr,Diaryan Aleksandr,fiurst,Diaryan Aleksandr - Soghomonyan Hrayr,57,23,34,11,-11,22,16,19,0,0,2,6,3,0,0,11,10:12 - 5:11 - 8:11 - 0:0 - 0:0
15788880,2023-12-17 10:15:00,Rafayelyan Edgar - Nazaryan Mushegh,0:3,11:7 - 11:3 - 11:8 - 0:0 - 0:0,3,0,Rafayelyan Edgar,Nazaryan Mushegh,fiurst,Nazaryan Mushegh - Rafayelyan Edgar,51,18,33,15,-15,18,14,19,0,0,4,8,3,0,0,15,7:11 - 3:11 - 8:11 - 0:0 - 0:0
15788879,2023-12-17 10:00:00,Papyan Karen - Soghomonyan Hrayr,3:0,11:9 - 11:8 - 11:6 - 0:0 - 0:0,3,0,Papyan Karen,Soghomonyan Hrayr,fiurst,Papyan Karen - Soghomonyan Hrayr,56,33,23,-10,10,20,19,17,0,0,-2,-3,-5,0,0,-10,11:9 - 11:8 - 11:6 - 0:0 - 0:0
15770935,2023-12-16 17:30:00,Grigoryan Erik - Petrosyan Davit,3:2,12:10 - 15:13 - 6:11 - 2:11 - 11:8,3,2,Grigoryan Erik,Petrosyan Davit,fiurst,Grigoryan Erik - Petrosyan Davit,99,46,53,7,-7,22,28,17,13,19,-2,-2,5,9,-3,7,12:10 - 15:13 - 6:11 - 2:11 - 11:8
15770933,2023-12-16 17:15:00,Soghomonyan Hrayr - Darbinyan Armen,0:3,11:6 - 11:4 - 11:7 - 0:0 - 0:0,3,0,Soghomonyan Hrayr,Darbinyan Armen,fiurst,Darbinyan Armen - Soghomonyan Hrayr,50,17,33,16,-16,17,15,18,0,0,5,7,4,0,0,16,6:11 - 4:11 - 7:11 - 0:0 - 0:0
15770931,2023-12-16 17:00:00,Avakimyan Davit - Grigoryan Erik,3:2,7:11 - 11:4 - 9:11 - 11:9 - 11:6,3,2,Avakimyan Davit,Grigoryan Erik,fiurst,Avakimyan Davit - Grigoryan Erik,90,49,41,-8,8,18,15,20,20,17,4,-7,2,-2,-5,-8,7:11 - 11:4 - 9:11 - 11:9 - 11:6
15770914,2023-12-16 16:45:00,Soghomonyan Hrayr - Petrosyan Davit,0:3,13:11 - 11:7 - 11:7 - 0:0 - 0:0,3,0,Soghomonyan Hrayr,Petrosyan Davit,fiurst,Petrosyan Davit - Soghomonyan Hrayr,60,25,35,10,-10,24,18,18,0,0,2,4,4,0,0,10,11:13 - 7:11 - 7:11 - 0:0 - 0:0
15770913,2023-12-16 16:30:00,Darbinyan Armen - Avakimyan Davit,3:0,5:11 - 8:11 - 9:11 - 0:0 - 0:0,0,3,Darbinyan Armen,Avakimyan Davit,fiurst,Avakimyan Davit - Darbinyan Armen,55,33,22,-11,11,16,19,20,0,0,-6,-3,-2,0,0,-11,11:5 - 11:8 - 11:9 - 0:0 - 0:0
15770911,2023-12-16 16:15:00,Grigoryan Erik - Soghomonyan Hrayr,2:3,11:6 - 11:9 - 6:11 - 3:11 - 6:11,2,3,Grigoryan Erik,Soghomonyan Hrayr,fiurst,Grigoryan Erik - Soghomonyan Hrayr,85,37,48,11,-11,17,20,17,14,17,-5,-2,5,8,5,11,11:6 - 11:9 - 6:11 - 3:11 - 6:11
15770907,2023-12-16 16:00:00,Petrosyan Davit - Avakimyan Davit,3:0,7:11 - 11:13 - 7:11 - 0:0 - 0:0,0,3,Petrosyan Davit,Avakimyan Davit,fiurst,Avakimyan Davit - Petrosyan Davit,60,35,25,-10,10,18,24,18,0,0,-4,-2,-4,0,0,-10,11:7 - 13:11 - 11:7 - 0:0 - 0:0
15770906,2023-12-16 15:45:00,Darbinyan Armen - Grigoryan Erik,2:3,11:7 - 11:8 - 3:11 - 4:11 - 7:11,2,3,Darbinyan Armen,Grigoryan Erik,fiurst,Darbinyan Armen - Grigoryan Erik,84,36,48,12,-12,18,19,14,15,18,-4,-3,8,7,4,12,11:7 - 11:8 - 3:11 - 4:11 - 7:11
15770904,2023-12-16 15:30:00,Avakimyan Davit - Soghomonyan Hrayr,2:3,10:12 - 13:11 - 11:6 - 6:11 - 6:11,2,3,Avakimyan Davit,Soghomonyan Hrayr,fiurst,Avakimyan Davit - Soghomonyan Hrayr,97,46,51,5,-5,22,24,17,17,17,2,-2,-5,5,5,5,10:12 - 13:11 - 11:6 - 6:11 - 6:11
15770889,2023-12-16 15:15:00,Petrosyan Davit - Darbinyan Armen,1:3,11:4 - 11:8 - 6:11 - 11:4 - 0:0,3,1,Petrosyan Davit,Darbinyan Armen,fiurst,Darbinyan Armen - Petrosyan Davit,66,27,39,12,-12,15,19,17,15,0,7,3,-5,7,0,12,4:11 - 8:11 - 11:6 - 4:11 - 0:0
15770876,2023-12-16 15:05:00,Nazaryan Mushegh - Papyan Karen,3:0,11:3 - 11:6 - 11:8 - 0:0 - 0:0,3,0,Nazaryan Mushegh,Papyan Karen,fiurst,Nazaryan Mushegh - Papyan Karen,50,33,17,-16,16,14,17,19,0,0,-8,-5,-3,0,0,-16,11:3 - 11:6 - 11:8 - 0:0 - 0:0
15770873,2023-12-16 14:45:00,Soghomonyan Hrayr - Arutyunov Ruben,1:3,11:1 - 11:3 - 10:12 - 11:7 - 0:0,3,1,Soghomonyan Hrayr,Arutyunov Ruben,fiurst,Arutyunov Ruben - Soghomonyan Hrayr,66,23,43,20,-20,12,14,22,18,0,10,8,-2,4,0,20,1:11 - 3:11 - 12:10 - 7:11 - 0:0
15770870,2023-12-16 14:35:00,Rafayelyan Edgar - Nazaryan Mushegh,2:3,6:11 - 11:6 - 12:10 - 11:13 - 11:8,3,2,Rafayelyan Edgar,Nazaryan Mushegh,fiurst,Nazaryan Mushegh - Rafayelyan Edgar,99,48,51,3,-3,17,17,22,24,19,-5,5,2,-2,3,3,11:6 - 6:11 - 10:12 - 13:11 - 8:11
15770867,2023-12-16 14:30:00,Papyan Karen - Soghomonyan Hrayr,3:0,12:10 - 11:8 - 11:7 - 0:0 - 0:0,3,0,Papyan Karen,Soghomonyan Hrayr,fiurst,Papyan Karen - Soghomonyan Hrayr,59,34,25,-9,9,22,19,18,0,0,-2,-3,-4,0,0,-9,12:10 - 11:8 - 11:7 - 0:0 - 0:0
15770866,2023-12-16 14:10:00,Rafayelyan Edgar - Arutyunov Ruben,1:3,11:6 - 11:5 - 10:12 - 11:4 - 0:0,3,1,Rafayelyan Edgar,Arutyunov Ruben,fiurst,Arutyunov Ruben - Rafayelyan Edgar,70,27,43,16,-16,17,16,22,15,0,5,6,-2,7,0,16,6:11 - 5:11 - 12:10 - 4:11 - 0:0
15770863,2023-12-16 14:00:00,Nazaryan Mushegh - Soghomonyan Hrayr,1:3,8:11 - 11:6 - 7:11 - 6:11 - 0:0,1,3,Nazaryan Mushegh,Soghomonyan Hrayr,fiurst,Nazaryan Mushegh - Soghomonyan Hrayr,71,32,39,7,-7,19,17,18,17,0,3,-5,4,5,0,7,8:11 - 11:6 - 7:11 - 6:11 - 0:0
15770852,2023-12-16 13:30:00,Papyan Karen - Rafayelyan Edgar,0:3,5:11 - 5:11 - 10:12 - 0:0 - 0:0,0,3,Papyan Karen,Rafayelyan Edgar,fiurst,Papyan Karen - Rafayelyan Edgar,54,20,34,14,-14,16,16,22,0,0,6,6,2,0,0,14,5:11 - 5:11 - 10:12 - 0:0 - 0:0
15770851,2023-12-16 13:25:00,Arutyunov Ruben - Nazaryan Mushegh,2:3,9:11 - 7:11 - 15:13 - 11:9 - 8:11,2,3,Arutyunov Ruben,Nazaryan Mushegh,fiurst,Arutyunov Ruben - Nazaryan Mushegh,105,50,55,5,-5,20,18,28,20,19,2,4,-2,-2,3,5,9:11 - 7:11 - 15:13 - 11:9 - 8:11
15770838,2023-12-16 13:05:00,Soghomonyan Hrayr - Rafayelyan Edgar,3:1,6:11 - 11:9 - 8:11 - 8:11 - 0:0,1,3,Soghomonyan Hrayr,Rafayelyan Edgar,fiurst,Rafayelyan Edgar - Soghomonyan Hrayr,75,42,33,-9,9,17,20,19,19,0,-5,2,-3,-3,0,-9,11:6 - 9:11 - 11:8 - 11:8 - 0:0
15770802,2023-12-16 12:45:00,Arutyunov Ruben - Papyan Karen,2:3,5:11 - 4:11 - 11:6 - 11:5 - 5:11,2,3,Arutyunov Ruben,Papyan Karen,fiurst,Arutyunov Ruben - Papyan Karen,80,36,44,8,-8,16,15,17,16,16,6,7,-5,-6,6,8,5:11 - 4:11 - 11:6 - 11:5 - 5:11
15770791,2023-12-16 12:20:00,Nazaryan Mushegh - Rafayelyan Edgar,1:3,6:11 - 11:9 - 2:11 - 7:11 - 0:0,1,3,Nazaryan Mushegh,Rafayelyan Edgar,fiurst,Nazaryan Mushegh - Rafayelyan Edgar,68,26,42,16,-16,17,20,13,18,0,5,-2,9,4,0,16,6:11 - 11:9 - 2:11 - 7:11 - 0:0
15770778,2023-12-16 12:10:00,Arutyunov Ruben - Soghomonyan Hrayr,3:2,11:8 - 11:8 - 10:12 - 7:11 - 11:8,3,2,Arutyunov Ruben,Soghomonyan Hrayr,fiurst,Arutyunov Ruben - Soghomonyan Hrayr,97,50,47,-3,3,19,19,22,18,19,-3,-3,2,4,-3,-3,11:8 - 11:8 - 10:12 - 7:11 - 11:8
15770773,2023-12-16 11:55:00,Papyan Karen - Nazaryan Mushegh,1:3,11:8 - 7:11 - 11:8 - 11:7 - 0:0,3,1,Papyan Karen,Nazaryan Mushegh,fiurst,Nazaryan Mushegh - Papyan Karen,74,34,40,6,-6,19,18,19,18,0,3,-4,3,4,0,6,8:11 - 11:7 - 8:11 - 7:11 - 0:0
15770772,2023-12-16 11:40:00,Arutyunov Ruben - Rafayelyan Edgar,1:3,6:11 - 9:11 - 11:4 - 4:11 - 0:0,1,3,Arutyunov Ruben,Rafayelyan Edgar,fiurst,Arutyunov Ruben - Rafayelyan Edgar,67,30,37,7,-7,17,20,15,15,0,5,2,-7,7,0,7,6:11 - 9:11 - 11:4 - 4:11 - 0:0
15770770,2023-12-16 11:25:00,Soghomonyan Hrayr - Papyan Karen,3:1,9:11 - 11:6 - 12:14 - 7:11 - 0:0,1,3,Soghomonyan Hrayr,Papyan Karen,fiurst,Papyan Karen - Soghomonyan Hrayr,81,42,39,-3,3,20,17,26,18,0,-2,5,-2,-4,0,-3,11:9 - 6:11 - 14:12 - 11:7 - 0:0
15770753,2023-12-16 11:00:00,Nazaryan Mushegh - Arutyunov Ruben,3:2,8:11 - 10:12 - 11:2 - 11:6 - 9:11,2,3,Nazaryan Mushegh,Arutyunov Ruben,fiurst,Arutyunov Ruben - Nazaryan Mushegh,91,42,49,7,-7,19,22,13,17,20,-3,-2,9,5,-2,7,11:8 - 12:10 - 2:11 - 6:11 - 11:9
15770746,2023-12-16 10:45:00,Rafayelyan Edgar - Papyan Karen,2:3,11:9 - 11:9 - 5:11 - 7:11 - 11:6,3,2,Rafayelyan Edgar,Papyan Karen,fiurst,Papyan Karen - Rafayelyan Edgar,91,46,45,-1,1,20,20,16,18,17,2,2,-6,-4,5,-1,9:11 - 9:11 - 11:5 - 11:7 - 6:11
15770743,2023-12-16 10:30:00,Soghomonyan Hrayr - Nazaryan Mushegh,3:1,11:9 - 8:11 - 7:11 - 9:11 - 0:0,1,3,Soghomonyan Hrayr,Nazaryan Mushegh,fiurst,Nazaryan Mushegh - Soghomonyan Hrayr,77,42,35,-7,7,20,19,18,20,0,2,-3,-4,-2,0,-7,9:11 - 11:8 - 11:7 - 11:9 - 0:0
15770740,2023-12-16 10:15:00,Papyan Karen - Arutyunov Ruben,3:2,9:11 - 11:8 - 6:11 - 12:10 - 4:11,2,3,Papyan Karen,Arutyunov Ruben,fiurst,Arutyunov Ruben - Papyan Karen,93,51,42,-9,9,20,19,17,22,15,-2,3,-5,2,-7,-9,11:9 - 8:11 - 11:6 - 10:12 - 11:4
15770737,2023-12-16 10:00:00,Rafayelyan Edgar - Soghomonyan Hrayr,3:1,11:13 - 11:8 - 11:3 - 11:6 - 0:0,3,1,Rafayelyan Edgar,Soghomonyan Hrayr,fiurst,Rafayelyan Edgar - Soghomonyan Hrayr,74,44,30,-14,14,24,19,14,17,0,2,-3,-8,-5,0,-14,11:13 - 11:8 - 11:3 - 11:6 - 0:0
15756254,2023-12-15 17:35:00,Gevorgyan Hayk - Grigoryan Erik,2:3,2:11 - 11:7 - 11:5 - 8:11 - 7:11,2,3,Gevorgyan Hayk,Grigoryan Erik,fiurst,Gevorgyan Hayk - Grigoryan Erik,84,39,45,6,-6,13,18,16,19,18,9,-4,-6,3,4,6,2:11 - 11:7 - 11:5 - 8:11 - 7:11
15756253,2023-12-15 17:20:00,Mkrtchyan Andranik - Avakimyan Davit,1:3,11:5 - 11:4 - 10:12 - 13:11 - 0:0,3,1,Mkrtchyan Andranik,Avakimyan Davit,fiurst,Avakimyan Davit - Mkrtchyan Andranik,77,32,45,13,-13,16,15,22,24,0,6,7,-2,2,0,13,5:11 - 4:11 - 12:10 - 11:13 - 0:0
15756252,2023-12-15 17:05:00,Petrosyan Davit - Gevorgyan Hayk,3:1,11:9 - 5:11 - 9:11 - 5:11 - 0:0,1,3,Petrosyan Davit,Gevorgyan Hayk,fiurst,Gevorgyan Hayk - Petrosyan Davit,72,42,30,-12,12,20,16,20,16,0,2,-6,-2,-6,0,-12,9:11 - 11:5 - 11:9 - 11:5 - 0:0
15756247,2023-12-15 16:50:00,Mkrtchyan Andranik - Grigoryan Erik,1:3,3:11 - 11:8 - 11:8 - 14:12 - 0:0,3,1,Mkrtchyan Andranik,Grigoryan Erik,fiurst,Grigoryan Erik - Mkrtchyan Andranik,78,39,39,0,0,14,19,19,26,0,-8,3,3,2,0,0,11:3 - 8:11 - 8:11 - 12:14 - 0:0
15756239,2023-12-15 16:30:00,Avakimyan Davit - Petrosyan Davit,3:1,11:7 - 9:11 - 11:7 - 11:8 - 0:0,3,1,Avakimyan Davit,Petrosyan Davit,fiurst,Avakimyan Davit - Petrosyan Davit,75,42,33,-9,9,18,20,18,19,0,-4,2,-4,-3,0,-9,11:7 - 9:11 - 11:7 - 11:8 - 0:0
15756229,2023-12-15 16:15:00,Gevorgyan Hayk - Mkrtchyan Andranik,1:3,7:11 - 4:11 - 11:8 - 9:11 - 0:0,1,3,Gevorgyan Hayk,Mkrtchyan Andranik,fiurst,Gevorgyan Hayk - Mkrtchyan Andranik,72,31,41,10,-10,18,15,19,20,0,4,7,-3,2,0,10,7:11 - 4:11 - 11:8 - 9:11 - 0:0
15756228,2023-12-15 16:00:00,Grigoryan Erik - Petrosyan Davit,3:2,14:12 - 7:11 - 11:6 - 6:11 - 15:13,3,2,Grigoryan Erik,Petrosyan Davit,fiurst,Grigoryan Erik - Petrosyan Davit,106,53,53,0,0,26,18,17,17,28,-2,4,-5,5,-2,0,14:12 - 7:11 - 11:6 - 6:11 - 15:13
15756225,2023-12-15 15:45:00,Avakimyan Davit - Gevorgyan Hayk,3:1,11:5 - 7:11 - 15:13 - 11:8 - 0:0,3,1,Avakimyan Davit,Gevorgyan Hayk,fiurst,Avakimyan Davit - Gevorgyan Hayk,81,44,37,-7,7,16,18,28,19,0,-6,4,-2,-3,0,-7,11:5 - 7:11 - 15:13 - 11:8 - 0:0
15756213,2023-12-15 15:30:00,Petrosyan Davit - Mkrtchyan Andranik,3:1,11:7 - 8:11 - 9:11 - 7:11 - 0:0,1,3,Petrosyan Davit,Mkrtchyan Andranik,fiurst,Mkrtchyan Andranik - Petrosyan Davit,75,40,35,-5,5,18,19,20,18,0,4,-3,-2,-4,0,-5,7:11 - 11:8 - 11:9 - 11:7 - 0:0
15756204,2023-12-15 15:15:00,Grigoryan Erik - Avakimyan Davit,3:0,8:11 - 7:11 - 2:11 - 0:0 - 0:0,0,3,Grigoryan Erik,Avakimyan Davit,fiurst,Avakimyan Davit - Grigoryan Erik,50,33,17,-16,16,19,18,13,0,0,-3,-4,-9,0,0,-16,11:8 - 11:7 - 11:2 - 0:0 - 0:0
15756196,2023-12-15 15:05:00,Arutyunov Ruben - Diaryan Aleksandr,1:3,5:11 - 11:6 - 6:11 - 6:11 - 0:0,1,3,Arutyunov Ruben,Diaryan Aleksandr,fiurst,Arutyunov Ruben - Diaryan Aleksandr,67,28,39,11,-11,16,17,17,17,0,6,-5,5,5,0,11,5:11 - 11:6 - 6:11 - 6:11 - 0:0
15756182,2023-12-15 14:45:00,Mkrtchyan Andranik - Rafayelyan Edgar,0:3,5:11 - 7:11 - 10:12 - 0:0 - 0:0,0,3,Mkrtchyan Andranik,Rafayelyan Edgar,fiurst,Mkrtchyan Andranik - Rafayelyan Edgar,56,22,34,12,-12,16,18,22,0,0,6,4,2,0,0,12,5:11 - 7:11 - 10:12 - 0:0 - 0:0
15756177,2023-12-15 14:30:00,Nazaryan Mushegh - Arutyunov Ruben,1:3,11:8 - 11:13 - 11:9 - 11:7 - 0:0,3,1,Nazaryan Mushegh,Arutyunov Ruben,fiurst,Arutyunov Ruben - Nazaryan Mushegh,81,37,44,7,-7,19,24,20,18,0,3,-2,2,4,0,7,8:11 - 13:11 - 9:11 - 7:11 - 0:0
15756162,2023-12-15 14:15:00,Diaryan Aleksandr - Mkrtchyan Andranik,3:1,10:12 - 11:8 - 11:7 - 11:8 - 0:0,3,1,Diaryan Aleksandr,Mkrtchyan Andranik,fiurst,Diaryan Aleksandr - Mkrtchyan Andranik,78,43,35,-8,8,22,19,18,19,0,2,-3,-4,-3,0,-8,10:12 - 11:8 - 11:7 - 11:8 - 0:0
15756161,2023-12-15 14:00:00,Nazaryan Mushegh - Rafayelyan Edgar,1:3,8:11 - 6:11 - 11:8 - 6:11 - 0:0,1,3,Nazaryan Mushegh,Rafayelyan Edgar,fiurst,Nazaryan Mushegh - Rafayelyan Edgar,72,31,41,10,-10,19,17,19,17,0,3,5,-3,5,0,10,8:11 - 6:11 - 11:8 - 6:11 - 0:0
15756157,2023-12-15 13:50:00,Arutyunov Ruben - Mkrtchyan Andranik,3:0,11:8 - 11:4 - 11:7 - 0:0 - 0:0,3,0,Arutyunov Ruben,Mkrtchyan Andranik,fiurst,Arutyunov Ruben - Mkrtchyan Andranik,52,33,19,-14,14,19,15,18,0,0,-3,-7,-4,0,0,-14,11:8 - 11:4 - 11:7 - 0:0 - 0:0
15756152,2023-12-15 13:35:00,Diaryan Aleksandr - Nazaryan Mushegh,3:0,11:5 - 11:4 - 11:4 - 0:0 - 0:0,3,0,Diaryan Aleksandr,Nazaryan Mushegh,fiurst,Diaryan Aleksandr - Nazaryan Mushegh,46,33,13,-20,20,16,15,15,0,0,-6,-7,-7,0,0,-20,11:5 - 11:4 - 11:4 - 0:0 - 0:0
15756146,2023-12-15 13:15:00,Rafayelyan Edgar - Arutyunov Ruben,0:3,11:8 - 11:9 - 11:8 - 0:0 - 0:0,3,0,Rafayelyan Edgar,Arutyunov Ruben,fiurst,Arutyunov Ruben - Rafayelyan Edgar,58,25,33,8,-8,19,20,19,0,0,3,2,3,0,0,8,8:11 - 9:11 - 8:11 - 0:0 - 0:0
15756144,2023-12-15 13:10:00,Mkrtchyan Andranik - Nazaryan Mushegh,3:2,9:11 - 11:6 - 11:2 - 9:11 - 11:6,3,2,Mkrtchyan Andranik,Nazaryan Mushegh,fiurst,Mkrtchyan Andranik - Nazaryan Mushegh,87,51,36,-15,15,20,17,13,20,17,2,-5,-9,2,-5,-15,9:11 - 11:6 - 11:2 - 9:11 - 11:6
15756103,2023-12-15 12:45:00,Rafayelyan Edgar - Diaryan Aleksandr,2:3,7:11 - 11:8 - 9:11 - 11:5 - 11:2,3,2,Rafayelyan Edgar,Diaryan Aleksandr,fiurst,Diaryan Aleksandr - Rafayelyan Edgar,86,37,49,12,-12,18,19,20,16,13,-4,3,-2,6,9,12,11:7 - 8:11 - 11:9 - 5:11 - 2:11
15756083,2023-12-15 12:15:00,Arutyunov Ruben - Nazaryan Mushegh,0:3,4:11 - 9:11 - 12:14 - 0:0 - 0:0,0,3,Arutyunov Ruben,Nazaryan Mushegh,fiurst,Arutyunov Ruben - Nazaryan Mushegh,61,25,36,11,-11,15,20,26,0,0,7,2,2,0,0,11,4:11 - 9:11 - 12:14 - 0:0 - 0:0
15756079,2023-12-15 12:00:00,Rafayelyan Edgar - Mkrtchyan Andranik,1:3,11:7 - 11:8 - 7:11 - 11:4 - 0:0,3,1,Rafayelyan Edgar,Mkrtchyan Andranik,fiurst,Mkrtchyan Andranik - Rafayelyan Edgar,70,30,40,10,-10,18,19,18,15,0,4,3,-4,7,0,10,7:11 - 8:11 - 11:7 - 4:11 - 0:0
15756078,2023-12-15 11:45:00,Diaryan Aleksandr - Arutyunov Ruben,0:3,11:6 - 11:3 - 12:10 - 0:0 - 0:0,3,0,Diaryan Aleksandr,Arutyunov Ruben,fiurst,Arutyunov Ruben - Diaryan Aleksandr,53,19,34,15,-15,17,14,22,0,0,5,8,2,0,0,15,6:11 - 3:11 - 10:12 - 0:0 - 0:0
15756071,2023-12-15 11:30:00,Rafayelyan Edgar - Nazaryan Mushegh,0:3,11:3 - 11:7 - 11:6 - 0:0 - 0:0,3,0,Rafayelyan Edgar,Nazaryan Mushegh,fiurst,Nazaryan Mushegh - Rafayelyan Edgar,49,16,33,17,-17,14,18,17,0,0,8,4,5,0,0,17,3:11 - 7:11 - 6:11 - 0:0 - 0:0
15756070,2023-12-15 11:20:00,Mkrtchyan Andranik - Diaryan Aleksandr,3:0,8:11 - 7:11 - 8:11 - 0:0 - 0:0,0,3,Mkrtchyan Andranik,Diaryan Aleksandr,fiurst,Diaryan Aleksandr - Mkrtchyan Andranik,56,33,23,-10,10,19,18,19,0,0,-3,-4,-3,0,0,-10,11:8 - 11:7 - 11:8 - 0:0 - 0:0
15756063,2023-12-15 11:00:00,Arutyunov Ruben - Rafayelyan Edgar,0:3,6:11 - 7:11 - 8:11 - 0:0 - 0:0,0,3,Arutyunov Ruben,Rafayelyan Edgar,fiurst,Arutyunov Ruben - Rafayelyan Edgar,54,21,33,12,-12,17,18,19,0,0,5,4,3,0,0,12,6:11 - 7:11 - 8:11 - 0:0 - 0:0
15756059,2023-12-15 10:45:00,Nazaryan Mushegh - Diaryan Aleksandr,3:0,8:11 - 13:15 - 8:11 - 0:0 - 0:0,0,3,Nazaryan Mushegh,Diaryan Aleksandr,fiurst,Diaryan Aleksandr - Nazaryan Mushegh,66,37,29,-8,8,19,28,19,0,0,-3,-2,-3,0,0,-8,11:8 - 15:13 - 11:8 - 0:0 - 0:0
15756049,2023-12-15 10:30:00,Mkrtchyan Andranik - Arutyunov Ruben,3:0,7:11 - 7:11 - 13:15 - 0:0 - 0:0,0,3,Mkrtchyan Andranik,Arutyunov Ruben,fiurst,Arutyunov Ruben - Mkrtchyan Andranik,64,37,27,-10,10,18,18,28,0,0,-4,-4,-2,0,0,-10,11:7 - 11:7 - 15:13 - 0:0 - 0:0
15756045,2023-12-15 10:15:00,Diaryan Aleksandr - Rafayelyan Edgar,3:2,11:4 - 3:11 - 11:9 - 8:11 - 11:4,3,2,Diaryan Aleksandr,Rafayelyan Edgar,fiurst,Diaryan Aleksandr - Rafayelyan Edgar,83,44,39,-5,5,15,14,20,19,15,-7,8,-2,3,-7,-5,11:4 - 3:11 - 11:9 - 8:11 - 11:4
15756041,2023-12-15 10:00:00,Nazaryan Mushegh - Mkrtchyan Andranik,0:3,11:6 - 11:8 - 12:10 - 0:0 - 0:0,3,0,Nazaryan Mushegh,Mkrtchyan Andranik,fiurst,Mkrtchyan Andranik - Nazaryan Mushegh,58,24,34,10,-10,17,19,22,0,0,5,3,2,0,0,10,6:11 - 8:11 - 10:12 - 0:0 - 0:0
15739389,2023-12-14 17:30:00,Darbinyan Armen - Gevorgyan Hayk,0:3,4:11 - 9:11 - 5:11 - 0:0 - 0:0,0,3,Darbinyan Armen,Gevorgyan Hayk,fiurst,Darbinyan Armen - Gevorgyan Hayk,51,18,33,15,-15,15,20,16,0,0,7,2,6,0,0,15,4:11 - 9:11 - 5:11 - 0:0 - 0:0
15739383,2023-12-14 17:20:00,Soghomonyan Hrayr - Grigoryan Erik,1:3,11:5 - 9:11 - 11:6 - 11:7 - 0:0,3,1,Soghomonyan Hrayr,Grigoryan Erik,fiurst,Grigoryan Erik - Soghomonyan Hrayr,71,29,42,13,-13,16,20,17,18,0,6,-2,5,4,0,13,5:11 - 11:9 - 6:11 - 7:11 - 0:0
15739379,2023-12-14 17:00:00,Avakimyan Davit - Darbinyan Armen,3:1,11:5 - 12:10 - 4:11 - 11:6 - 0:0,3,1,Avakimyan Davit,Darbinyan Armen,fiurst,Avakimyan Davit - Darbinyan Armen,70,38,32,-6,6,16,22,15,17,0,-6,-2,7,-5,0,-6,11:5 - 12:10 - 4:11 - 11:6 - 0:0
15739374,2023-12-14 16:45:00,Soghomonyan Hrayr - Gevorgyan Hayk,2:3,8:11 - 11:7 - 11:7 - 7:11 - 11:5,3,2,Soghomonyan Hrayr,Gevorgyan Hayk,fiurst,Gevorgyan Hayk - Soghomonyan Hrayr,89,41,48,7,-7,19,18,18,18,16,-3,4,4,-4,6,7,11:8 - 7:11 - 7:11 - 11:7 - 5:11
15739370,2023-12-14 16:30:00,Grigoryan Erik - Avakimyan Davit,3:2,11:6 - 11:5 - 11:13 - 8:11 - 3:11,2,3,Grigoryan Erik,Avakimyan Davit,fiurst,Avakimyan Davit - Grigoryan Erik,90,46,44,-2,2,17,16,24,19,14,5,6,-2,-3,-8,-2,6:11 - 5:11 - 13:11 - 11:8 - 11:3
15739369,2023-12-14 16:15:00,Darbinyan Armen - Soghomonyan Hrayr,0:3,7:11 - 5:11 - 3:11 - 0:0 - 0:0,0,3,Darbinyan Armen,Soghomonyan Hrayr,fiurst,Darbinyan Armen - Soghomonyan Hrayr,48,15,33,18,-18,18,16,14,0,0,4,6,8,0,0,18,7:11 - 5:11 - 3:11 - 0:0 - 0:0
15739363,2023-12-14 16:00:00,Gevorgyan Hayk - Avakimyan Davit,0:3,11:9 - 11:6 - 11:6 - 0:0 - 0:0,3,0,Gevorgyan Hayk,Avakimyan Davit,fiurst,Avakimyan Davit - Gevorgyan Hayk,54,21,33,12,-12,20,17,17,0,0,2,5,5,0,0,12,9:11 - 6:11 - 6:11 - 0:0 - 0:0
15739340,2023-12-14 15:50:00,Grigoryan Erik - Darbinyan Armen,3:1,11:8 - 11:13 - 6:11 - 4:11 - 0:0,1,3,Grigoryan Erik,Darbinyan Armen,fiurst,Darbinyan Armen - Grigoryan Erik,75,43,32,-11,11,19,24,17,15,0,3,-2,-5,-7,0,-11,8:11 - 13:11 - 11:6 - 11:4 - 0:0
15739337,2023-12-14 15:30:00,Avakimyan Davit - Soghomonyan Hrayr,0:3,4:11 - 7:11 - 4:11 - 0:0 - 0:0,0,3,Avakimyan Davit,Soghomonyan Hrayr,fiurst,Avakimyan Davit - Soghomonyan Hrayr,48,15,33,18,-18,15,18,15,0,0,7,4,7,0,0,18,4:11 - 7:11 - 4:11 - 0:0 - 0:0
15739326,2023-12-14 15:15:00,Gevorgyan Hayk - Grigoryan Erik,3:2,6:11 - 11:8 - 8:11 - 11:5 - 11:3,3,2,Gevorgyan Hayk,Grigoryan Erik,fiurst,Gevorgyan Hayk - Grigoryan Erik,85,47,38,-9,9,17,19,19,16,14,5,-3,3,-6,-8,-9,6:11 - 11:8 - 8:11 - 11:5 - 11:3
15739254,2023-12-14 15:05:00,Rafayelyan Edgar - Papyan Karen,0:3,11:4 - 11:8 - 11:7 - 0:0 - 0:0,3,0,Rafayelyan Edgar,Papyan Karen,fiurst,Papyan Karen - Rafayelyan Edgar,52,19,33,14,-14,15,19,18,0,0,7,3,4,0,0,14,4:11 - 8:11 - 7:11 - 0:0 - 0:0
15739243,2023-12-14 14:55:00,Soghomonyan Hrayr - Mkrtchyan Andranik,2:3,11:6 - 7:11 - 7:11 - 11:6 - 11:7,3,2,Soghomonyan Hrayr,Mkrtchyan Andranik,fiurst,Mkrtchyan Andranik - Soghomonyan Hrayr,88,41,47,6,-6,17,18,18,17,18,5,-4,-4,5,4,6,6:11 - 11:7 - 11:7 - 6:11 - 7:11
15739241,2023-12-14 14:40:00,Diaryan Aleksandr - Rafayelyan Edgar,3:1,11:7 - 11:7 - 7:11 - 11:9 - 0:0,3,1,Diaryan Aleksandr,Rafayelyan Edgar,fiurst,Diaryan Aleksandr - Rafayelyan Edgar,74,40,34,-6,6,18,18,18,20,0,-4,-4,4,-2,0,-6,11:7 - 11:7 - 7:11 - 11:9 - 0:0
15739237,2023-12-14 14:25:00,Papyan Karen - Soghomonyan Hrayr,3:0,13:11 - 13:11 - 11:5 - 0:0 - 0:0,3,0,Papyan Karen,Soghomonyan Hrayr,fiurst,Papyan Karen - Soghomonyan Hrayr,64,37,27,-10,10,24,24,16,0,0,-2,-2,-6,0,0,-10,13:11 - 13:11 - 11:5 - 0:0 - 0:0
15739234,2023-12-14 14:00:00,Diaryan Aleksandr - Mkrtchyan Andranik,3:1,17:15 - 11:13 - 11:5 - 14:12 - 0:0,3,1,Diaryan Aleksandr,Mkrtchyan Andranik,fiurst,Diaryan Aleksandr - Mkrtchyan Andranik,98,53,45,-8,8,32,24,16,26,0,-2,2,-6,-2,0,-8,17:15 - 11:13 - 11:5 - 14:12 - 0:0
15739230,2023-12-14 13:45:00,Rafayelyan Edgar - Soghomonyan Hrayr,3:0,11:5 - 11:7 - 11:6 - 0:0 - 0:0,3,0,Rafayelyan Edgar,Soghomonyan Hrayr,fiurst,Rafayelyan Edgar - Soghomonyan Hrayr,51,33,18,-15,15,16,18,17,0,0,-6,-4,-5,0,0,-15,11:5 - 11:7 - 11:6 - 0:0 - 0:0
15739220,2023-12-14 13:30:00,Papyan Karen - Diaryan Aleksandr,3:1,7:11 - 11:7 - 6:11 - 9:11 - 0:0,1,3,Papyan Karen,Diaryan Aleksandr,fiurst,Diaryan Aleksandr - Papyan Karen,73,40,33,-7,7,18,18,17,20,0,-4,4,-5,-2,0,-7,11:7 - 7:11 - 11:6 - 11:9 - 0:0
15739217,2023-12-14 13:20:00,Mkrtchyan Andranik - Rafayelyan Edgar,1:3,11:8 - 6:11 - 3:11 - 8:11 - 0:0,1,3,Mkrtchyan Andranik,Rafayelyan Edgar,fiurst,Mkrtchyan Andranik - Rafayelyan Edgar,69,28,41,13,-13,19,17,14,19,0,-3,5,8,3,0,13,11:8 - 6:11 - 3:11 - 8:11 - 0:0
15739207,2023-12-14 13:00:00,Soghomonyan Hrayr - Diaryan Aleksandr,3:1,1:11 - 4:11 - 11:7 - 8:11 - 0:0,1,3,Soghomonyan Hrayr,Diaryan Aleksandr,fiurst,Diaryan Aleksandr - Soghomonyan Hrayr,64,40,24,-16,16,12,15,18,19,0,-10,-7,4,-3,0,-16,11:1 - 11:4 - 7:11 - 11:8 - 0:0
15739205,2023-12-14 12:45:00,Mkrtchyan Andranik - Papyan Karen,2:3,11:7 - 5:11 - 9:11 - 11:5 - 3:11,2,3,Mkrtchyan Andranik,Papyan Karen,fiurst,Mkrtchyan Andranik - Papyan Karen,84,39,45,6,-6,18,16,20,16,14,-4,6,2,-6,8,6,11:7 - 5:11 - 9:11 - 11:5 - 3:11
15739200,2023-12-14 12:15:00,Rafayelyan Edgar - Diaryan Aleksandr,0:3,11:7 - 11:9 - 12:10 - 0:0 - 0:0,3,0,Rafayelyan Edgar,Diaryan Aleksandr,fiurst,Diaryan Aleksandr - Rafayelyan Edgar,60,26,34,8,-8,18,20,22,0,0,4,2,2,0,0,8,7:11 - 9:11 - 10:12 - 0:0 - 0:0
15739199,2023-12-14 12:00:00,Mkrtchyan Andranik - Soghomonyan Hrayr,3:2,11:8 - 3:11 - 4:11 - 11:8 - 11:7,3,2,Mkrtchyan Andranik,Soghomonyan Hrayr,fiurst,Mkrtchyan Andranik - Soghomonyan Hrayr,85,40,45,5,-5,19,14,15,19,18,-3,8,7,-3,-4,5,11:8 - 3:11 - 4:11 - 11:8 - 11:7
15739197,2023-12-14 11:45:00,Papyan Karen - Rafayelyan Edgar,0:3,6:11 - 5:11 - 5:11 - 0:0 - 0:0,0,3,Papyan Karen,Rafayelyan Edgar,fiurst,Papyan Karen - Rafayelyan Edgar,49,16,33,17,-17,17,16,16,0,0,5,6,6,0,0,17,6:11 - 5:11 - 5:11 - 0:0 - 0:0
15739181,2023-12-14 11:30:00,Mkrtchyan Andranik - Diaryan Aleksandr,3:0,9:11 - 8:11 - 8:11 - 0:0 - 0:0,0,3,Mkrtchyan Andranik,Diaryan Aleksandr,fiurst,Diaryan Aleksandr - Mkrtchyan Andranik,58,33,25,-8,8,20,19,19,0,0,-2,-3,-3,0,0,-8,11:9 - 11:8 - 11:8 - 0:0 - 0:0
15739178,2023-12-14 11:15:00,Soghomonyan Hrayr - Papyan Karen,1:3,12:10 - 11:9 - 7:11 - 11:6 - 0:0,3,1,Soghomonyan Hrayr,Papyan Karen,fiurst,Papyan Karen - Soghomonyan Hrayr,77,36,41,5,-5,22,20,18,17,0,2,2,-4,5,0,5,10:12 - 9:11 - 11:7 - 6:11 - 0:0
15739176,2023-12-14 11:00:00,Rafayelyan Edgar - Mkrtchyan Andranik,0:3,11:7 - 12:10 - 11:9 - 0:0 - 0:0,3,0,Rafayelyan Edgar,Mkrtchyan Andranik,fiurst,Mkrtchyan Andranik - Rafayelyan Edgar,60,26,34,8,-8,18,22,20,0,0,4,2,2,0,0,8,7:11 - 10:12 - 9:11 - 0:0 - 0:0
15739150,2023-12-14 10:45:00,Diaryan Aleksandr - Papyan Karen,3:0,11:7 - 11:6 - 11:4 - 0:0 - 0:0,3,0,Diaryan Aleksandr,Papyan Karen,fiurst,Diaryan Aleksandr - Papyan Karen,50,33,17,-16,16,18,17,15,0,0,-4,-5,-7,0,0,-16,11:7 - 11:6 - 11:4 - 0:0 - 0:0
15739148,2023-12-14 10:30:00,Soghomonyan Hrayr - Rafayelyan Edgar,3:0,3:11 - 6:11 - 6:11 - 0:0 - 0:0,0,3,Soghomonyan Hrayr,Rafayelyan Edgar,fiurst,Rafayelyan Edgar - Soghomonyan Hrayr,48,33,15,-18,18,14,17,17,0,0,-8,-5,-5,0,0,-18,11:3 - 11:6 - 11:6 - 0:0 - 0:0
15739146,2023-12-14 10:15:00,Papyan Karen - Mkrtchyan Andranik,3:0,3:11 - 4:11 - 12:14 - 0:0 - 0:0,0,3,Papyan Karen,Mkrtchyan Andranik,fiurst,Mkrtchyan Andranik - Papyan Karen,55,36,19,-17,17,14,15,26,0,0,-8,-7,-2,0,0,-17,11:3 - 11:4 - 14:12 - 0:0 - 0:0
15739138,2023-12-14 10:00:00,Diaryan Aleksandr - Soghomonyan Hrayr,3:0,11:6 - 11:7 - 11:4 - 0:0 - 0:0,3,0,Diaryan Aleksandr,Soghomonyan Hrayr,fiurst,Diaryan Aleksandr - Soghomonyan Hrayr,50,33,17,-16,16,17,18,15,0,0,-5,-4,-7,0,0,-16,11:6 - 11:7 - 11:4 - 0:0 - 0:0
15721083,2023-12-13 17:35:00,Darbinyan Armen - Avakimyan Davit,3:2,4:11 - 7:11 - 12:10 - 12:10 - 3:11,2,3,Darbinyan Armen,Avakimyan Davit,fiurst,Avakimyan Davit - Darbinyan Armen,91,53,38,-15,15,15,18,22,22,14,-7,-4,2,2,-8,-15,11:4 - 11:7 - 10:12 - 10:12 - 11:3
15721074,2023-12-13 17:15:00,Soghomonyan Hrayr - Gevorgyan Hayk,1:3,11:6 - 4:11 - 14:12 - 11:5 - 0:0,3,1,Soghomonyan Hrayr,Gevorgyan Hayk,fiurst,Gevorgyan Hayk - Soghomonyan Hrayr,74,34,40,6,-6,17,15,26,16,0,5,-7,2,6,0,6,6:11 - 11:4 - 12:14 - 5:11 - 0:0
15721067,2023-12-13 17:05:00,Petrosyan Davit - Darbinyan Armen,3:2,10:12 - 12:10 - 8:11 - 11:6 - 9:11,2,3,Petrosyan Davit,Darbinyan Armen,fiurst,Darbinyan Armen - Petrosyan Davit,100,50,50,0,0,22,22,19,17,20,-2,2,-3,5,-2,0,12:10 - 10:12 - 11:8 - 6:11 - 11:9
15721063,2023-12-13 16:45:00,Soghomonyan Hrayr - Avakimyan Davit,3:0,6:11 - 7:11 - 8:11 - 0:0 - 0:0,0,3,Soghomonyan Hrayr,Avakimyan Davit,fiurst,Avakimyan Davit - Soghomonyan Hrayr,54,33,21,-12,12,17,18,19,0,0,-5,-4,-3,0,0,-12,11:6 - 11:7 - 11:8 - 0:0 - 0:0
15721059,2023-12-13 16:30:00,Gevorgyan Hayk - Petrosyan Davit,3:0,13:11 - 11:5 - 11:7 - 0:0 - 0:0,3,0,Gevorgyan Hayk,Petrosyan Davit,fiurst,Gevorgyan Hayk - Petrosyan Davit,58,35,23,-12,12,24,16,18,0,0,-2,-6,-4,0,0,-12,13:11 - 11:5 - 11:7 - 0:0 - 0:0
15721057,2023-12-13 16:15:00,Darbinyan Armen - Soghomonyan Hrayr,0:3,6:11 - 6:11 - 9:11 - 0:0 - 0:0,0,3,Darbinyan Armen,Soghomonyan Hrayr,fiurst,Darbinyan Armen - Soghomonyan Hrayr,54,21,33,12,-12,17,17,20,0,0,5,5,2,0,0,12,6:11 - 6:11 - 9:11 - 0:0 - 0:0
15721053,2023-12-13 16:00:00,Avakimyan Davit - Petrosyan Davit,3:0,11:4 - 12:10 - 11:9 - 0:0 - 0:0,3,0,Avakimyan Davit,Petrosyan Davit,fiurst,Avakimyan Davit - Petrosyan Davit,57,34,23,-11,11,15,22,20,0,0,-7,-2,-2,0,0,-11,11:4 - 12:10 - 11:9 - 0:0 - 0:0
15720854,2023-12-13 15:45:00,Gevorgyan Hayk - Darbinyan Armen,1:3,11:5 - 11:9 - 10:12 - 11:6 - 0:0,3,1,Gevorgyan Hayk,Darbinyan Armen,fiurst,Darbinyan Armen - Gevorgyan Hayk,75,32,43,11,-11,16,20,22,17,0,6,2,-2,5,0,11,5:11 - 9:11 - 12:10 - 6:11 - 0:0
15720852,2023-12-13 15:40:00,Petrosyan Davit - Soghomonyan Hrayr,0:3,10:12 - 5:11 - 4:11 - 0:0 - 0:0,0,3,Petrosyan Davit,Soghomonyan Hrayr,fiurst,Petrosyan Davit - Soghomonyan Hrayr,53,19,34,15,-15,22,16,15,0,0,2,6,7,0,0,15,10:12 - 5:11 - 4:11 - 0:0 - 0:0
15720844,2023-12-13 15:35:00,Avakimyan Davit - Gevorgyan Hayk,3:0,11:6 - 11:9 - 15:13 - 0:0 - 0:0,3,0,Avakimyan Davit,Gevorgyan Hayk,fiurst,Avakimyan Davit - Gevorgyan Hayk,65,37,28,-9,9,17,20,28,0,0,-5,-2,-2,0,0,-9,11:6 - 11:9 - 15:13 - 0:0 - 0:0
15720831,2023-12-13 15:10:00,Soghomonyan Hrayr - Diaryan Aleksandr,3:1,10:12 - 9:11 - 11:6 - 3:11 - 0:0,1,3,Soghomonyan Hrayr,Diaryan Aleksandr,fiurst,Diaryan Aleksandr - Soghomonyan Hrayr,73,40,33,-7,7,22,20,17,14,0,-2,-2,5,-8,0,-7,12:10 - 11:9 - 6:11 - 11:3 - 0:0
15720832,2023-12-13 15:05:00,Nazaryan Mushegh - Mkrtchyan Andranik,0:3,11:4 - 11:6 - 11:7 - 0:0 - 0:0,3,0,Nazaryan Mushegh,Mkrtchyan Andranik,fiurst,Mkrtchyan Andranik - Nazaryan Mushegh,50,17,33,16,-16,15,17,18,0,0,7,5,4,0,0,16,4:11 - 6:11 - 7:11 - 0:0 - 0:0
15720830,2023-12-13 14:45:00,Arutyunov Ruben - Nazaryan Mushegh,0:3,9:11 - 7:11 - 7:11 - 0:0 - 0:0,0,3,Arutyunov Ruben,Nazaryan Mushegh,fiurst,Arutyunov Ruben - Nazaryan Mushegh,56,23,33,10,-10,20,18,18,0,0,2,4,4,0,0,10,9:11 - 7:11 - 7:11 - 0:0 - 0:0
15720829,2023-12-13 14:25:00,Mkrtchyan Andranik - Soghomonyan Hrayr,2:3,14:12 - 9:11 - 11:6 - 5:11 - 11:13,2,3,Mkrtchyan Andranik,Soghomonyan Hrayr,fiurst,Mkrtchyan Andranik - Soghomonyan Hrayr,103,50,53,3,-3,26,20,17,16,24,-2,2,-5,6,2,3,14:12 - 9:11 - 11:6 - 5:11 - 11:13
15720818,2023-12-13 14:20:00,Arutyunov Ruben - Diaryan Aleksandr,0:3,8:11 - 4:11 - 8:11 - 0:0 - 0:0,0,3,Arutyunov Ruben,Diaryan Aleksandr,fiurst,Arutyunov Ruben - Diaryan Aleksandr,53,20,33,13,-13,19,15,19,0,0,3,7,3,0,0,13,8:11 - 4:11 - 8:11 - 0:0 - 0:0
15720817,2023-12-13 13:45:00,Nazaryan Mushegh - Soghomonyan Hrayr,1:3,8:11 - 10:12 - 11:9 - 9:11 - 0:0,1,3,Nazaryan Mushegh,Soghomonyan Hrayr,fiurst,Nazaryan Mushegh - Soghomonyan Hrayr,81,38,43,5,-5,19,22,20,20,0,3,2,-2,2,0,5,8:11 - 10:12 - 11:9 - 9:11 - 0:0
15720815,2023-12-13 13:40:00,Mkrtchyan Andranik - Arutyunov Ruben,3:2,11:9 - 5:11 - 5:11 - 14:12 - 8:11,2,3,Mkrtchyan Andranik,Arutyunov Ruben,fiurst,Arutyunov Ruben - Mkrtchyan Andranik,97,54,43,-11,11,20,16,16,26,19,2,-6,-6,2,-3,-11,9:11 - 11:5 - 11:5 - 12:14 - 11:8
15720805,2023-12-13 13:20:00,Diaryan Aleksandr - Nazaryan Mushegh,3:1,5:11 - 11:5 - 11:9 - 11:6 - 0:0,3,1,Diaryan Aleksandr,Nazaryan Mushegh,fiurst,Diaryan Aleksandr - Nazaryan Mushegh,69,38,31,-7,7,16,16,20,17,0,6,-6,-2,-5,0,-7,5:11 - 11:5 - 11:9 - 11:6 - 0:0
15720801,2023-12-13 13:00:00,Soghomonyan Hrayr - Arutyunov Ruben,3:2,11:6 - 11:9 - 9:11 - 6:11 - 9:11,2,3,Soghomonyan Hrayr,Arutyunov Ruben,fiurst,Arutyunov Ruben - Soghomonyan Hrayr,94,48,46,-2,2,17,20,20,17,20,5,2,-2,-5,-2,-2,6:11 - 9:11 - 11:9 - 11:6 - 11:9
15720798,2023-12-13 12:45:00,Diaryan Aleksandr - Mkrtchyan Andranik,3:1,11:5 - 10:12 - 11:9 - 11:6 - 0:0,3,1,Diaryan Aleksandr,Mkrtchyan Andranik,fiurst,Diaryan Aleksandr - Mkrtchyan Andranik,75,43,32,-11,11,16,22,20,17,0,-6,2,-2,-5,0,-11,11:5 - 10:12 - 11:9 - 11:6 - 0:0
15720797,2023-12-13 12:20:00,Nazaryan Mushegh - Arutyunov Ruben,0:3,11:6 - 11:9 - 15:13 - 0:0 - 0:0,3,0,Nazaryan Mushegh,Arutyunov Ruben,fiurst,Arutyunov Ruben - Nazaryan Mushegh,65,28,37,9,-9,17,20,28,0,0,5,2,2,0,0,9,6:11 - 9:11 - 13:15 - 0:0 - 0:0
15720794,2023-12-13 12:00:00,Diaryan Aleksandr - Soghomonyan Hrayr,3:1,10:12 - 11:6 - 12:10 - 11:8 - 0:0,3,1,Diaryan Aleksandr,Soghomonyan Hrayr,fiurst,Diaryan Aleksandr - Soghomonyan Hrayr,80,44,36,-8,8,22,17,22,19,0,2,-5,-2,-3,0,-8,10:12 - 11:6 - 12:10 - 11:8 - 0:0
15720791,2023-12-13 11:50:00,Mkrtchyan Andranik - Nazaryan Mushegh,1:3,3:11 - 5:11 - 11:8 - 6:11 - 0:0,1,3,Mkrtchyan Andranik,Nazaryan Mushegh,fiurst,Mkrtchyan Andranik - Nazaryan Mushegh,66,25,41,16,-16,14,16,19,17,0,8,6,-3,5,0,16,3:11 - 5:11 - 11:8 - 6:11 - 0:0
15720789,2023-12-13 11:30:00,Diaryan Aleksandr - Arutyunov Ruben,0:3,11:5 - 11:1 - 11:2 - 0:0 - 0:0,3,0,Diaryan Aleksandr,Arutyunov Ruben,fiurst,Arutyunov Ruben - Diaryan Aleksandr,41,8,33,25,-25,16,12,13,0,0,6,10,9,0,0,25,5:11 - 1:11 - 2:11 - 0:0 - 0:0
15720788,2023-12-13 11:15:00,Soghomonyan Hrayr - Mkrtchyan Andranik,1:3,11:4 - 8:11 - 11:8 - 11:9 - 0:0,3,1,Soghomonyan Hrayr,Mkrtchyan Andranik,fiurst,Mkrtchyan Andranik - Soghomonyan Hrayr,73,32,41,9,-9,15,19,19,20,0,7,-3,3,2,0,9,4:11 - 11:8 - 8:11 - 9:11 - 0:0
15720775,2023-12-13 11:00:00,Nazaryan Mushegh - Diaryan Aleksandr,3:1,15:13 - 10:12 - 7:11 - 7:11 - 0:0,1,3,Nazaryan Mushegh,Diaryan Aleksandr,fiurst,Diaryan Aleksandr - Nazaryan Mushegh,86,47,39,-8,8,28,22,18,18,0,2,-2,-4,-4,0,-8,13:15 - 12:10 - 11:7 - 11:7 - 0:0
15720773,2023-12-13 10:45:00,Arutyunov Ruben - Mkrtchyan Andranik,1:3,11:5 - 7:11 - 9:11 - 5:11 - 0:0,1,3,Arutyunov Ruben,Mkrtchyan Andranik,fiurst,Arutyunov Ruben - Mkrtchyan Andranik,70,32,38,6,-6,16,18,20,16,0,-6,4,2,6,0,6,11:5 - 7:11 - 9:11 - 5:11 - 0:0
15720772,2023-12-13 10:30:00,Soghomonyan Hrayr - Nazaryan Mushegh,3:2,11:8 - 7:11 - 11:6 - 7:11 - 7:11,2,3,Soghomonyan Hrayr,Nazaryan Mushegh,fiurst,Nazaryan Mushegh - Soghomonyan Hrayr,90,47,43,-4,4,19,18,17,18,18,3,-4,5,-4,-4,-4,8:11 - 11:7 - 6:11 - 11:7 - 11:7
15720771,2023-12-13 10:15:00,Mkrtchyan Andranik - Diaryan Aleksandr,3:0,9:11 - 6:11 - 6:11 - 0:0 - 0:0,0,3,Mkrtchyan Andranik,Diaryan Aleksandr,fiurst,Diaryan Aleksandr - Mkrtchyan Andranik,54,33,21,-12,12,20,17,17,0,0,-2,-5,-5,0,0,-12,11:9 - 11:6 - 11:6 - 0:0 - 0:0
15720769,2023-12-13 10:00:00,Arutyunov Ruben - Soghomonyan Hrayr,3:0,11:5 - 11:6 - 11:9 - 0:0 - 0:0,3,0,Arutyunov Ruben,Soghomonyan Hrayr,fiurst,Arutyunov Ruben - Soghomonyan Hrayr,53,33,20,-13,13,16,17,20,0,0,-6,-5,-2,0,0,-13,11:5 - 11:6 - 11:9 - 0:0 - 0:0
15701710,2023-12-12 17:30:00,Darbinyan Armen - Gevorgyan Gegham,0:3,6:11 - 4:11 - 5:11 - 0:0 - 0:0,0,3,Darbinyan Armen,Gevorgyan Gegham,fiurst,Darbinyan Armen - Gevorgyan Gegham,48,15,33,18,-18,17,15,16,0,0,5,7,6,0,0,18,6:11 - 4:11 - 5:11 - 0:0 - 0:0
15701706,2023-12-12 17:15:00,Avakimyan Davit - Petrosyan Davit,3:0,11:7 - 11:9 - 11:3 - 0:0 - 0:0,3,0,Avakimyan Davit,Petrosyan Davit,fiurst,Avakimyan Davit - Petrosyan Davit,52,33,19,-14,14,18,20,14,0,0,-4,-2,-8,0,0,-14,11:7 - 11:9 - 11:3 - 0:0 - 0:0
15701702,2023-12-12 17:05:00,Grigoryan Erik - Darbinyan Armen,0:3,11:4 - 11:3 - 11:8 - 0:0 - 0:0,3,0,Grigoryan Erik,Darbinyan Armen,fiurst,Darbinyan Armen - Grigoryan Erik,48,15,33,18,-18,15,14,19,0,0,7,8,3,0,0,18,4:11 - 3:11 - 8:11 - 0:0 - 0:0
15701697,2023-12-12 16:45:00,Avakimyan Davit - Gevorgyan Gegham,3:0,11:3 - 11:9 - 11:4 - 0:0 - 0:0,3,0,Avakimyan Davit,Gevorgyan Gegham,fiurst,Avakimyan Davit - Gevorgyan Gegham,49,33,16,-17,17,14,20,15,0,0,-8,-2,-7,0,0,-17,11:3 - 11:9 - 11:4 - 0:0 - 0:0
15701679,2023-12-12 16:30:00,Petrosyan Davit - Grigoryan Erik,3:1,4:11 - 11:9 - 3:11 - 6:11 - 0:0,1,3,Petrosyan Davit,Grigoryan Erik,fiurst,Grigoryan Erik - Petrosyan Davit,66,42,24,-18,18,15,20,14,17,0,-7,2,-8,-5,0,-18,11:4 - 9:11 - 11:3 - 11:6 - 0:0
15701676,2023-12-12 16:15:00,Darbinyan Armen - Avakimyan Davit,3:1,6:11 - 11:9 - 9:11 - 9:11 - 0:0,1,3,Darbinyan Armen,Avakimyan Davit,fiurst,Avakimyan Davit - Darbinyan Armen,77,42,35,-7,7,17,20,20,20,0,-5,2,-2,-2,0,-7,11:6 - 9:11 - 11:9 - 11:9 - 0:0
15701671,2023-12-12 16:00:00,Gevorgyan Gegham - Grigoryan Erik,3:2,11:9 - 9:11 - 11:3 - 8:11 - 11:5,3,2,Gevorgyan Gegham,Grigoryan Erik,fiurst,Gevorgyan Gegham - Grigoryan Erik,89,50,39,-11,11,20,20,14,19,16,-2,2,-8,3,-6,-11,11:9 - 9:11 - 11:3 - 8:11 - 11:5
15701668,2023-12-12 15:45:00,Petrosyan Davit - Darbinyan Armen,0:3,11:0 - 11:7 - 11:3 - 0:0 - 0:0,3,0,Petrosyan Davit,Darbinyan Armen,fiurst,Darbinyan Armen - Petrosyan Davit,43,10,33,23,-23,11,18,14,0,0,11,4,8,0,0,23,0:11 - 7:11 - 3:11 - 0:0 - 0:0
15701664,2023-12-12 15:30:00,Grigoryan Erik - Avakimyan Davit,3:0,9:11 - 8:11 - 4:11 - 0:0 - 0:0,0,3,Grigoryan Erik,Avakimyan Davit,fiurst,Avakimyan Davit - Grigoryan Erik,54,33,21,-12,12,20,19,15,0,0,-2,-3,-7,0,0,-12,11:9 - 11:8 - 11:4 - 0:0 - 0:0
15701662,2023-12-12 15:15:00,Gevorgyan Gegham - Petrosyan Davit,3:2,11:9 - 11:8 - 9:11 - 4:11 - 11:5,3,2,Gevorgyan Gegham,Petrosyan Davit,fiurst,Gevorgyan Gegham - Petrosyan Davit,90,46,44,-2,2,20,19,20,15,16,-2,-3,2,7,-6,-2,11:9 - 11:8 - 9:11 - 4:11 - 11:5
15701624,2023-12-12 15:00:00,Arutyunov Ruben - Diaryan Aleksandr,0:3,6:11 - 2:11 - 10:12 - 0:0 - 0:0,0,3,Arutyunov Ruben,Diaryan Aleksandr,fiurst,Arutyunov Ruben - Diaryan Aleksandr,52,18,34,16,-16,17,13,22,0,0,5,9,2,0,0,16,6:11 - 2:11 - 10:12 - 0:0 - 0:0
15701620,2023-12-12 14:45:00,Nazaryan Mushegh - Mkrtchyan Andranik,3:1,11:5 - 6:11 - 7:11 - 7:11 - 0:0,1,3,Nazaryan Mushegh,Mkrtchyan Andranik,fiurst,Mkrtchyan Andranik - Nazaryan Mushegh,69,38,31,-7,7,16,17,18,18,0,6,-5,-4,-4,0,-7,5:11 - 11:6 - 11:7 - 11:7 - 0:0
15701619,2023-12-12 14:30:00,Soghomonyan Hrayr - Arutyunov Ruben,3:2,9:11 - 11:9 - 11:4 - 6:11 - 6:11,2,3,Soghomonyan Hrayr,Arutyunov Ruben,fiurst,Arutyunov Ruben - Soghomonyan Hrayr,89,46,43,-3,3,20,20,15,17,17,-2,2,7,-5,-5,-3,11:9 - 9:11 - 4:11 - 11:6 - 11:6
15701615,2023-12-12 14:15:00,Diaryan Aleksandr - Nazaryan Mushegh,3:0,11:5 - 11:4 - 11:6 - 0:0 - 0:0,3,0,Diaryan Aleksandr,Nazaryan Mushegh,fiurst,Diaryan Aleksandr - Nazaryan Mushegh,48,33,15,-18,18,16,15,17,0,0,-6,-7,-5,0,0,-18,11:5 - 11:4 - 11:6 - 0:0 - 0:0
15701613,2023-12-12 14:10:00,Soghomonyan Hrayr - Mkrtchyan Andranik,0:3,11:8 - 11:6 - 11:5 - 0:0 - 0:0,3,0,Soghomonyan Hrayr,Mkrtchyan Andranik,fiurst,Mkrtchyan Andranik - Soghomonyan Hrayr,52,19,33,14,-14,19,17,16,0,0,3,5,6,0,0,14,8:11 - 6:11 - 5:11 - 0:0 - 0:0
15701611,2023-12-12 13:45:00,Arutyunov Ruben - Nazaryan Mushegh,0:3,4:11 - 6:11 - 8:11 - 0:0 - 0:0,0,3,Arutyunov Ruben,Nazaryan Mushegh,fiurst,Arutyunov Ruben - Nazaryan Mushegh,51,18,33,15,-15,15,17,19,0,0,7,5,3,0,0,15,4:11 - 6:11 - 8:11 - 0:0 - 0:0
15701597,2023-12-12 13:35:00,Diaryan Aleksandr - Soghomonyan Hrayr,3:1,11:3 - 10:12 - 11:4 - 11:9 - 0:0,3,1,Diaryan Aleksandr,Soghomonyan Hrayr,fiurst,Diaryan Aleksandr - Soghomonyan Hrayr,71,43,28,-15,15,14,22,15,20,0,-8,2,-7,-2,0,-15,11:3 - 10:12 - 11:4 - 11:9 - 0:0
15701595,2023-12-12 13:15:00,Mkrtchyan Andranik - Arutyunov Ruben,1:3,9:11 - 11:7 - 11:6 - 11:5 - 0:0,3,1,Mkrtchyan Andranik,Arutyunov Ruben,fiurst,Arutyunov Ruben - Mkrtchyan Andranik,71,29,42,13,-13,20,18,17,16,0,-2,4,5,6,0,13,11:9 - 7:11 - 6:11 - 5:11 - 0:0
15701593,2023-12-12 13:00:00,Nazaryan Mushegh - Soghomonyan Hrayr,2:3,8:11 - 11:8 - 9:11 - 11:7 - 9:11,2,3,Nazaryan Mushegh,Soghomonyan Hrayr,fiurst,Nazaryan Mushegh - Soghomonyan Hrayr,96,48,48,0,0,19,19,20,18,20,3,-3,2,-4,2,0,8:11 - 11:8 - 9:11 - 11:7 - 9:11
15701589,2023-12-12 12:45:00,Mkrtchyan Andranik - Diaryan Aleksandr,3:0,7:11 - 3:11 - 1:11 - 0:0 - 0:0,0,3,Mkrtchyan Andranik,Diaryan Aleksandr,fiurst,Diaryan Aleksandr - Mkrtchyan Andranik,44,33,11,-22,22,18,14,12,0,0,-4,-8,-10,0,0,-22,11:7 - 11:3 - 11:1 - 0:0 - 0:0
15701570,2023-12-12 12:15:00,Arutyunov Ruben - Soghomonyan Hrayr,0:3,9:11 - 7:11 - 7:11 - 0:0 - 0:0,0,3,Arutyunov Ruben,Soghomonyan Hrayr,fiurst,Arutyunov Ruben - Soghomonyan Hrayr,56,23,33,10,-10,20,18,18,0,0,2,4,4,0,0,10,9:11 - 7:11 - 7:11 - 0:0 - 0:0
15701568,2023-12-12 12:10:00,Mkrtchyan Andranik - Nazaryan Mushegh,0:3,7:11 - 7:11 - 9:11 - 0:0 - 0:0,0,3,Mkrtchyan Andranik,Nazaryan Mushegh,fiurst,Mkrtchyan Andranik - Nazaryan Mushegh,56,23,33,10,-10,18,18,20,0,0,4,4,2,0,0,10,7:11 - 7:11 - 9:11 - 0:0 - 0:0
15701562,2023-12-12 11:45:00,Diaryan Aleksandr - Arutyunov Ruben,0:3,11:3 - 11:8 - 11:4 - 0:0 - 0:0,3,0,Diaryan Aleksandr,Arutyunov Ruben,fiurst,Arutyunov Ruben - Diaryan Aleksandr,48,15,33,18,-18,14,19,15,0,0,8,3,7,0,0,18,3:11 - 8:11 - 4:11 - 0:0 - 0:0
15701560,2023-12-12 11:30:00,Mkrtchyan Andranik - Soghomonyan Hrayr,2:3,8:11 - 11:3 - 4:11 - 13:11 - 6:11,2,3,Mkrtchyan Andranik,Soghomonyan Hrayr,fiurst,Mkrtchyan Andranik - Soghomonyan Hrayr,89,42,47,5,-5,19,14,15,24,17,3,-8,7,-2,5,5,8:11 - 11:3 - 4:11 - 13:11 - 6:11
15701559,2023-12-12 11:15:00,Nazaryan Mushegh - Diaryan Aleksandr,3:0,6:11 - 8:11 - 13:15 - 0:0 - 0:0,0,3,Nazaryan Mushegh,Diaryan Aleksandr,fiurst,Diaryan Aleksandr - Nazaryan Mushegh,64,37,27,-10,10,17,19,28,0,0,-5,-3,-2,0,0,-10,11:6 - 11:8 - 15:13 - 0:0 - 0:0
15701557,2023-12-12 11:00:00,Arutyunov Ruben - Mkrtchyan Andranik,3:0,11:5 - 11:8 - 11:6 - 0:0 - 0:0,3,0,Arutyunov Ruben,Mkrtchyan Andranik,fiurst,Arutyunov Ruben - Mkrtchyan Andranik,52,33,19,-14,14,16,19,17,0,0,-6,-3,-5,0,0,-14,11:5 - 11:8 - 11:6 - 0:0 - 0:0
15701556,2023-12-12 10:45:00,Soghomonyan Hrayr - Diaryan Aleksandr,3:0,3:11 - 5:11 - 1:11 - 0:0 - 0:0,0,3,Soghomonyan Hrayr,Diaryan Aleksandr,fiurst,Diaryan Aleksandr - Soghomonyan Hrayr,42,33,9,-24,24,14,16,12,0,0,-8,-6,-10,0,0,-24,11:3 - 11:5 - 11:1 - 0:0 - 0:0
15701543,2023-12-12 10:30:00,Nazaryan Mushegh - Arutyunov Ruben,0:3,12:10 - 13:11 - 11:4 - 0:0 - 0:0,3,0,Nazaryan Mushegh,Arutyunov Ruben,fiurst,Arutyunov Ruben - Nazaryan Mushegh,61,25,36,11,-11,22,24,15,0,0,2,2,7,0,0,11,10:12 - 11:13 - 4:11 - 0:0 - 0:0
15701541,2023-12-12 10:15:00,Diaryan Aleksandr - Mkrtchyan Andranik,3:0,11:6 - 11:4 - 11:7 - 0:0 - 0:0,3,0,Diaryan Aleksandr,Mkrtchyan Andranik,fiurst,Diaryan Aleksandr - Mkrtchyan Andranik,50,33,17,-16,16,17,15,18,0,0,-5,-7,-4,0,0,-16,11:6 - 11:4 - 11:7 - 0:0 - 0:0
15701538,2023-12-12 10:00:00,Soghomonyan Hrayr - Nazaryan Mushegh,1:3,12:10 - 5:11 - 11:9 - 11:6 - 0:0,3,1,Soghomonyan Hrayr,Nazaryan Mushegh,fiurst,Nazaryan Mushegh - Soghomonyan Hrayr,75,36,39,3,-3,22,16,20,17,0,2,-6,2,5,0,3,10:12 - 11:5 - 9:11 - 6:11 - 0:0
15683173,2023-12-11 17:40:00,Gevorgyan Gegham - Petrosyan Davit,1:3,11:4 - 4:11 - 5:11 - 8:11 - 0:0,1,3,Gevorgyan Gegham,Petrosyan Davit,fiurst,Gevorgyan Gegham - Petrosyan Davit,65,28,37,9,-9,15,15,16,19,0,-7,7,6,3,0,9,11:4 - 4:11 - 5:11 - 8:11 - 0:0
15683163,2023-12-11 17:15:00,Avakimyan Davit - Grigoryan Erik,3:0,11:9 - 11:7 - 11:6 - 0:0 - 0:0,3,0,Avakimyan Davit,Grigoryan Erik,fiurst,Avakimyan Davit - Grigoryan Erik,55,33,22,-11,11,20,18,17,0,0,-2,-4,-5,0,0,-11,11:9 - 11:7 - 11:6 - 0:0 - 0:0
15683160,2023-12-11 17:05:00,Gevorgyan Hayk - Gevorgyan Gegham,3:2,12:14 - 11:7 - 8:11 - 11:8 - 6:11,2,3,Gevorgyan Hayk,Gevorgyan Gegham,fiurst,Gevorgyan Gegham - Gevorgyan Hayk,99,51,48,-3,3,26,18,19,19,17,-2,4,-3,3,-5,-3,14:12 - 7:11 - 11:8 - 8:11 - 11:6
15683159,2023-12-11 16:45:00,Avakimyan Davit - Petrosyan Davit,1:3,9:11 - 11:9 - 9:11 - 12:14 - 0:0,1,3,Avakimyan Davit,Petrosyan Davit,fiurst,Avakimyan Davit - Petrosyan Davit,86,41,45,4,-4,20,20,20,26,0,2,-2,2,2,0,4,9:11 - 11:9 - 9:11 - 12:14 - 0:0
15683156,2023-12-11 16:35:00,Grigoryan Erik - Gevorgyan Hayk,3:0,6:11 - 3:11 - 10:12 - 0:0 - 0:0,0,3,Grigoryan Erik,Gevorgyan Hayk,fiurst,Gevorgyan Hayk - Grigoryan Erik,53,34,19,-15,15,17,14,22,0,0,-5,-8,-2,0,0,-15,11:6 - 11:3 - 12:10 - 0:0 - 0:0
15683150,2023-12-11 16:15:00,Gevorgyan Gegham - Avakimyan Davit,3:0,9:11 - 6:11 - 4:11 - 0:0 - 0:0,0,3,Gevorgyan Gegham,Avakimyan Davit,fiurst,Avakimyan Davit - Gevorgyan Gegham,52,33,19,-14,14,20,17,15,0,0,-2,-5,-7,0,0,-14,11:9 - 11:6 - 11:4 - 0:0 - 0:0
15683146,2023-12-11 16:00:00,Petrosyan Davit - Gevorgyan Hayk,2:3,4:11 - 13:11 - 11:3 - 6:11 - 12:10,3,2,Petrosyan Davit,Gevorgyan Hayk,fiurst,Gevorgyan Hayk - Petrosyan Davit,92,46,46,0,0,15,24,14,17,22,-7,2,8,-5,2,0,11:4 - 11:13 - 3:11 - 11:6 - 10:12
15683144,2023-12-11 15:50:00,Grigoryan Erik - Gevorgyan Gegham,3:2,11:3 - 11:7 - 5:11 - 2:11 - 10:12,2,3,Grigoryan Erik,Gevorgyan Gegham,fiurst,Gevorgyan Gegham - Grigoryan Erik,83,44,39,-5,5,14,18,16,13,22,8,4,-6,-9,-2,-5,3:11 - 7:11 - 11:5 - 11:2 - 12:10
15682845,2023-12-11 15:30:00,Petrosyan Davit - Grigoryan Erik,3:1,11:3 - 7:11 - 9:11 - 7:11 - 0:0,1,3,Petrosyan Davit,Grigoryan Erik,fiurst,Grigoryan Erik - Petrosyan Davit,70,36,34,-2,2,14,18,20,18,0,8,-4,-2,-4,0,-2,3:11 - 11:7 - 11:9 - 11:7 - 0:0
15683134,2023-12-11 15:30:00,Gevorgyan Hayk - Avakimyan Davit,1:3,7:11 - 12:10 - 11:6 - 14:12 - 0:0,3,1,Gevorgyan Hayk,Avakimyan Davit,fiurst,Avakimyan Davit - Gevorgyan Hayk,83,39,44,5,-5,18,22,17,26,0,-4,2,5,2,0,5,11:7 - 10:12 - 6:11 - 12:14 - 0:0
15682838,2023-12-11 15:10:00,Arutyunov Ruben - Diaryan Aleksandr,0:3,5:11 - 11:13 - 10:12 - 0:0 - 0:0,0,3,Arutyunov Ruben,Diaryan Aleksandr,fiurst,Arutyunov Ruben - Diaryan Aleksandr,62,26,36,10,-10,16,24,22,0,0,6,2,2,0,0,10,5:11 - 11:13 - 10:12 - 0:0 - 0:0
15682840,2023-12-11 15:05:00,Mkrtchyan Andranik - Soghomonyan Hrayr,1:3,3:11 - 11:8 - 4:11 - 3:11 - 0:0,1,3,Mkrtchyan Andranik,Soghomonyan Hrayr,fiurst,Mkrtchyan Andranik - Soghomonyan Hrayr,62,21,41,20,-20,14,19,15,14,0,8,-3,7,8,0,20,3:11 - 11:8 - 4:11 - 3:11 - 0:0
15682821,2023-12-11 14:35:00,Rafayelyan Edgar - Mkrtchyan Andranik,0:3,11:5 - 11:6 - 11:6 - 0:0 - 0:0,3,0,Rafayelyan Edgar,Mkrtchyan Andranik,fiurst,Mkrtchyan Andranik - Rafayelyan Edgar,50,17,33,16,-16,16,17,17,0,0,6,5,5,0,0,16,5:11 - 6:11 - 6:11 - 0:0 - 0:0
15682815,2023-12-11 14:35:00,Soghomonyan Hrayr - Arutyunov Ruben,2:3,12:10 - 9:11 - 6:11 - 13:11 - 11:6,3,2,Soghomonyan Hrayr,Arutyunov Ruben,fiurst,Arutyunov Ruben - Soghomonyan Hrayr,100,49,51,2,-2,22,20,17,24,17,2,-2,-5,2,5,2,10:12 - 11:9 - 11:6 - 11:13 - 6:11
15682811,2023-12-11 14:00:00,Rafayelyan Edgar - Diaryan Aleksandr,3:2,6:11 - 12:10 - 7:11 - 13:11 - 8:11,2,3,Rafayelyan Edgar,Diaryan Aleksandr,fiurst,Diaryan Aleksandr - Rafayelyan Edgar,100,54,46,-8,8,17,22,18,24,19,-5,2,-4,2,-3,-8,11:6 - 10:12 - 11:7 - 11:13 - 11:8
15682809,2023-12-11 13:50:00,Mkrtchyan Andranik - Arutyunov Ruben,3:2,11:9 - 11:7 - 9:11 - 9:11 - 9:11,2,3,Mkrtchyan Andranik,Arutyunov Ruben,fiurst,Arutyunov Ruben - Mkrtchyan Andranik,98,49,49,0,0,20,18,20,20,20,2,4,-2,-2,-2,0,9:11 - 7:11 - 11:9 - 11:9 - 11:9
15682806,2023-12-11 13:30:00,Soghomonyan Hrayr - Rafayelyan Edgar,3:0,4:11 - 10:12 - 10:12 - 0:0 - 0:0,0,3,Soghomonyan Hrayr,Rafayelyan Edgar,fiurst,Rafayelyan Edgar - Soghomonyan Hrayr,59,35,24,-11,11,15,22,22,0,0,-7,-2,-2,0,0,-11,11:4 - 12:10 - 12:10 - 0:0 - 0:0
15682803,2023-12-11 13:15:00,Diaryan Aleksandr - Mkrtchyan Andranik,3:1,10:12 - 11:6 - 11:8 - 11:4 - 0:0,3,1,Diaryan Aleksandr,Mkrtchyan Andranik,fiurst,Diaryan Aleksandr - Mkrtchyan Andranik,73,43,30,-13,13,22,17,19,15,0,2,-5,-3,-7,0,-13,10:12 - 11:6 - 11:8 - 11:4 - 0:0
15682799,2023-12-11 13:00:00,Arutyunov Ruben - Rafayelyan Edgar,0:3,9:11 - 4:11 - 4:11 - 0:0 - 0:0,0,3,Arutyunov Ruben,Rafayelyan Edgar,fiurst,Arutyunov Ruben - Rafayelyan Edgar,50,17,33,16,-16,20,15,15,0,0,2,7,7,0,0,16,9:11 - 4:11 - 4:11 - 0:0 - 0:0
15682797,2023-12-11 12:50:00,Diaryan Aleksandr - Soghomonyan Hrayr,3:0,11:8 - 11:8 - 11:4 - 0:0 - 0:0,3,0,Diaryan Aleksandr,Soghomonyan Hrayr,fiurst,Diaryan Aleksandr - Soghomonyan Hrayr,53,33,20,-13,13,19,19,15,0,0,-3,-3,-7,0,0,-13,11:8 - 11:8 - 11:4 - 0:0 - 0:0
15682795,2023-12-11 12:20:00,Mkrtchyan Andranik - Rafayelyan Edgar,0:3,8:11 - 9:11 - 5:11 - 0:0 - 0:0,0,3,Mkrtchyan Andranik,Rafayelyan Edgar,fiurst,Mkrtchyan Andranik - Rafayelyan Edgar,55,22,33,11,-11,19,20,16,0,0,3,2,6,0,0,11,8:11 - 9:11 - 5:11 - 0:0 - 0:0
15682791,2023-12-11 12:10:00,Diaryan Aleksandr - Arutyunov Ruben,0:3,11:9 - 11:5 - 11:8 - 0:0 - 0:0,3,0,Diaryan Aleksandr,Arutyunov Ruben,fiurst,Arutyunov Ruben - Diaryan Aleksandr,55,22,33,11,-11,20,16,19,0,0,2,6,3,0,0,11,9:11 - 5:11 - 8:11 - 0:0 - 0:0
15682786,2023-12-11 11:45:00,Soghomonyan Hrayr - Mkrtchyan Andranik,2:3,11:8 - 6:11 - 8:11 - 11:5 - 11:7,3,2,Soghomonyan Hrayr,Mkrtchyan Andranik,fiurst,Mkrtchyan Andranik - Soghomonyan Hrayr,89,42,47,5,-5,19,17,19,16,18,3,-5,-3,6,4,5,8:11 - 11:6 - 11:8 - 5:11 - 7:11
15682777,2023-12-11 11:30:00,Diaryan Aleksandr - Rafayelyan Edgar,2:3,4:11 - 11:9 - 7:11 - 11:8 - 7:11,2,3,Diaryan Aleksandr,Rafayelyan Edgar,fiurst,Diaryan Aleksandr - Rafayelyan Edgar,90,40,50,10,-10,15,20,18,19,18,7,-2,4,-3,4,10,4:11 - 11:9 - 7:11 - 11:8 - 7:11
15682764,2023-12-11 11:15:00,Arutyunov Ruben - Soghomonyan Hrayr,0:3,7:11 - 11:13 - 8:11 - 0:0 - 0:0,0,3,Arutyunov Ruben,Soghomonyan Hrayr,fiurst,Arutyunov Ruben - Soghomonyan Hrayr,61,26,35,9,-9,18,24,19,0,0,4,2,3,0,0,9,7:11 - 11:13 - 8:11 - 0:0 - 0:0
15682760,2023-12-11 11:00:00,Mkrtchyan Andranik - Diaryan Aleksandr,3:0,5:11 - 6:11 - 10:12 - 0:0 - 0:0,0,3,Mkrtchyan Andranik,Diaryan Aleksandr,fiurst,Diaryan Aleksandr - Mkrtchyan Andranik,55,34,21,-13,13,16,17,22,0,0,-6,-5,-2,0,0,-13,11:5 - 11:6 - 12:10 - 0:0 - 0:0
15682756,2023-12-11 10:45:00,Rafayelyan Edgar - Soghomonyan Hrayr,3:0,11:3 - 11:7 - 13:11 - 0:0 - 0:0,3,0,Rafayelyan Edgar,Soghomonyan Hrayr,fiurst,Rafayelyan Edgar - Soghomonyan Hrayr,56,35,21,-14,14,14,18,24,0,0,-8,-4,-2,0,0,-14,11:3 - 11:7 - 13:11 - 0:0 - 0:0
15682753,2023-12-11 10:30:00,Arutyunov Ruben - Mkrtchyan Andranik,3:0,12:10 - 11:8 - 11:5 - 0:0 - 0:0,3,0,Arutyunov Ruben,Mkrtchyan Andranik,fiurst,Arutyunov Ruben - Mkrtchyan Andranik,57,34,23,-11,11,22,19,16,0,0,-2,-3,-6,0,0,-11,12:10 - 11:8 - 11:5 - 0:0 - 0:0
15682732,2023-12-11 10:15:00,Soghomonyan Hrayr - Diaryan Aleksandr,3:1,9:11 - 12:10 - 6:11 - 7:11 - 0:0,1,3,Soghomonyan Hrayr,Diaryan Aleksandr,fiurst,Diaryan Aleksandr - Soghomonyan Hrayr,77,43,34,-9,9,20,22,17,18,0,-2,2,-5,-4,0,-9,11:9 - 10:12 - 11:6 - 11:7 - 0:0
15682727,2023-12-11 10:00:00,Rafayelyan Edgar - Arutyunov Ruben,0:3,12:10 - 11:9 - 11:3 - 0:0 - 0:0,3,0,Rafayelyan Edgar,Arutyunov Ruben,fiurst,Arutyunov Ruben - Rafayelyan Edgar,56,22,34,12,-12,22,20,14,0,0,2,2,8,0,0,12,10:12 - 9:11 - 3:11 - 0:0 - 0:0
15662772,2023-12-10 17:30:00,Grigoryan Erik - Darbinyan Armen,0:3,11:4 - 11:7 - 11:8 - 0:0 - 0:0,3,0,Grigoryan Erik,Darbinyan Armen,fiurst,Darbinyan Armen - Grigoryan Erik,52,19,33,14,-14,15,18,19,0,0,7,4,3,0,0,14,4:11 - 7:11 - 8:11 - 0:0 - 0:0
15662765,2023-12-10 17:15:00,Gevorgyan Hayk - Petrosyan Davit,3:0,13:11 - 11:9 - 11:9 - 0:0 - 0:0,3,0,Gevorgyan Hayk,Petrosyan Davit,fiurst,Gevorgyan Hayk - Petrosyan Davit,64,35,29,-6,6,24,20,20,0,0,-2,-2,-2,0,0,-6,13:11 - 11:9 - 11:9 - 0:0 - 0:0
15662762,2023-12-10 17:00:00,Gevorgyan Gegham - Grigoryan Erik,0:3,9:11 - 10:12 - 6:11 - 0:0 - 0:0,0,3,Gevorgyan Gegham,Grigoryan Erik,fiurst,Gevorgyan Gegham - Grigoryan Erik,59,25,34,9,-9,20,22,17,0,0,2,2,5,0,0,9,9:11 - 10:12 - 6:11 - 0:0 - 0:0
15662761,2023-12-10 16:45:00,Gevorgyan Hayk - Darbinyan Armen,0:3,11:5 - 11:9 - 11:2 - 0:0 - 0:0,3,0,Gevorgyan Hayk,Darbinyan Armen,fiurst,Darbinyan Armen - Gevorgyan Hayk,49,16,33,17,-17,16,20,13,0,0,6,2,9,0,0,17,5:11 - 9:11 - 2:11 - 0:0 - 0:0
15662759,2023-12-10 16:30:00,Petrosyan Davit - Gevorgyan Gegham,0:3,13:11 - 11:5 - 11:9 - 0:0 - 0:0,3,0,Petrosyan Davit,Gevorgyan Gegham,fiurst,Gevorgyan Gegham - Petrosyan Davit,60,25,35,10,-10,24,16,20,0,0,2,6,2,0,0,10,11:13 - 5:11 - 9:11 - 0:0 - 0:0
15662747,2023-12-10 16:15:00,Grigoryan Erik - Gevorgyan Hayk,1:3,11:8 - 2:11 - 11:4 - 11:8 - 0:0,3,1,Grigoryan Erik,Gevorgyan Hayk,fiurst,Gevorgyan Hayk - Grigoryan Erik,66,31,35,4,-4,19,13,15,19,0,3,-9,7,3,0,4,8:11 - 11:2 - 4:11 - 8:11 - 0:0
15662746,2023-12-10 16:00:00,Darbinyan Armen - Gevorgyan Gegham,0:3,6:11 - 3:11 - 7:11 - 0:0 - 0:0,0,3,Darbinyan Armen,Gevorgyan Gegham,fiurst,Darbinyan Armen - Gevorgyan Gegham,49,16,33,17,-17,17,14,18,0,0,5,8,4,0,0,17,6:11 - 3:11 - 7:11 - 0:0 - 0:0
15662745,2023-12-10 15:45:00,Petrosyan Davit - Grigoryan Erik,0:3,11:7 - 11:8 - 11:9 - 0:0 - 0:0,3,0,Petrosyan Davit,Grigoryan Erik,fiurst,Grigoryan Erik - Petrosyan Davit,57,24,33,9,-9,18,19,20,0,0,4,3,2,0,0,9,7:11 - 8:11 - 9:11 - 0:0 - 0:0
15662742,2023-12-10 15:30:00,Gevorgyan Gegham - Gevorgyan Hayk,1:3,7:11 - 11:9 - 10:12 - 10:12 - 0:0,1,3,Gevorgyan Gegham,Gevorgyan Hayk,fiurst,Gevorgyan Gegham - Gevorgyan Hayk,82,38,44,6,-6,18,20,22,22,0,4,-2,2,2,0,6,7:11 - 11:9 - 10:12 - 10:12 - 0:0
15662739,2023-12-10 15:15:00,Darbinyan Armen - Petrosyan Davit,0:3,3:11 - 7:11 - 11:13 - 0:0 - 0:0,0,3,Darbinyan Armen,Petrosyan Davit,fiurst,Darbinyan Armen - Petrosyan Davit,56,21,35,14,-14,14,18,24,0,0,8,4,2,0,0,14,3:11 - 7:11 - 11:13 - 0:0 - 0:0
15662733,2023-12-10 15:00:00,Nazaryan Mushegh - Diaryan Aleksandr,3:0,4:11 - 6:11 - 5:11 - 0:0 - 0:0,0,3,Nazaryan Mushegh,Diaryan Aleksandr,fiurst,Diaryan Aleksandr - Nazaryan Mushegh,48,33,15,-18,18,15,17,16,0,0,-7,-5,-6,0,0,-18,11:4 - 11:6 - 11:5 - 0:0 - 0:0
15662732,2023-12-10 14:50:00,Rafayelyan Edgar - Nikoghosyan Narek,1:3,5:11 - 13:11 - 11:2 - 11:8 - 0:0,3,1,Rafayelyan Edgar,Nikoghosyan Narek,fiurst,Nikoghosyan Narek - Rafayelyan Edgar,72,32,40,8,-8,16,24,13,19,0,-6,2,9,3,0,8,11:5 - 11:13 - 2:11 - 8:11 - 0:0
15662731,2023-12-10 14:30:00,Soghomonyan Hrayr - Nazaryan Mushegh,3:1,11:9 - 5:11 - 7:11 - 9:11 - 0:0,1,3,Soghomonyan Hrayr,Nazaryan Mushegh,fiurst,Nazaryan Mushegh - Soghomonyan Hrayr,74,42,32,-10,10,20,16,18,20,0,2,-6,-4,-2,0,-10,9:11 - 11:5 - 11:7 - 11:9 - 0:0
15662729,2023-12-10 14:25:00,Diaryan Aleksandr - Rafayelyan Edgar,0:3,5:11 - 5:11 - 7:11 - 0:0 - 0:0,0,3,Diaryan Aleksandr,Rafayelyan Edgar,fiurst,Diaryan Aleksandr - Rafayelyan Edgar,50,17,33,16,-16,16,16,18,0,0,6,6,4,0,0,16,5:11 - 5:11 - 7:11 - 0:0 - 0:0
15662693,2023-12-10 14:05:00,Nazaryan Mushegh - Rafayelyan Edgar,1:3,7:11 - 11:7 - 6:11 - 7:11 - 0:0,1,3,Nazaryan Mushegh,Rafayelyan Edgar,fiurst,Nazaryan Mushegh - Rafayelyan Edgar,71,31,40,9,-9,18,18,17,18,0,4,-4,5,4,0,9,7:11 - 11:7 - 6:11 - 7:11 - 0:0
15662699,2023-12-10 14:05:00,Soghomonyan Hrayr - Nikoghosyan Narek,3:2,6:11 - 11:8 - 11:5 - 10:12 - 6:11,2,3,Soghomonyan Hrayr,Nikoghosyan Narek,fiurst,Nikoghosyan Narek - Soghomonyan Hrayr,91,47,44,-3,3,17,19,16,22,17,-5,3,6,-2,-5,-3,11:6 - 8:11 - 5:11 - 12:10 - 11:6
15662692,2023-12-10 13:35:00,Diaryan Aleksandr - Soghomonyan Hrayr,3:0,11:9 - 13:11 - 11:1 - 0:0 - 0:0,3,0,Diaryan Aleksandr,Soghomonyan Hrayr,fiurst,Diaryan Aleksandr - Soghomonyan Hrayr,56,35,21,-14,14,20,24,12,0,0,-2,-2,-10,0,0,-14,11:9 - 13:11 - 11:1 - 0:0 - 0:0
15662691,2023-12-10 13:30:00,Nikoghosyan Narek - Nazaryan Mushegh,2:3,8:11 - 11:7 - 11:5 - 9:11 - 11:3,3,2,Nikoghosyan Narek,Nazaryan Mushegh,fiurst,Nazaryan Mushegh - Nikoghosyan Narek,87,37,50,13,-13,19,18,16,20,14,-3,4,6,-2,8,13,11:8 - 7:11 - 5:11 - 11:9 - 3:11
15662690,2023-12-10 13:00:00,Rafayelyan Edgar - Soghomonyan Hrayr,3:1,11:5 - 11:7 - 9:11 - 11:7 - 0:0,3,1,Rafayelyan Edgar,Soghomonyan Hrayr,fiurst,Rafayelyan Edgar - Soghomonyan Hrayr,72,42,30,-12,12,16,18,20,18,0,-6,-4,2,-4,0,-12,11:5 - 11:7 - 9:11 - 11:7 - 0:0
15662687,2023-12-10 12:55:00,Nikoghosyan Narek - Diaryan Aleksandr,3:1,8:11 - 11:5 - 7:11 - 10:12 - 0:0,1,3,Nikoghosyan Narek,Diaryan Aleksandr,fiurst,Diaryan Aleksandr - Nikoghosyan Narek,75,39,36,-3,3,19,16,18,22,0,-3,6,-4,-2,0,-3,11:8 - 5:11 - 11:7 - 12:10 - 0:0
15662686,2023-12-10 12:15:00,Nazaryan Mushegh - Soghomonyan Hrayr,3:1,11:7 - 7:11 - 11:5 - 11:8 - 0:0,3,1,Nazaryan Mushegh,Soghomonyan Hrayr,fiurst,Nazaryan Mushegh - Soghomonyan Hrayr,71,40,31,-9,9,18,18,16,19,0,-4,4,-6,-3,0,-9,11:7 - 7:11 - 11:5 - 11:8 - 0:0
15662683,2023-12-10 12:00:00,Nikoghosyan Narek - Rafayelyan Edgar,3:2,12:10 - 11:9 - 11:13 - 5:11 - 12:10,3,2,Nikoghosyan Narek,Rafayelyan Edgar,fiurst,Nikoghosyan Narek - Rafayelyan Edgar,104,51,53,2,-2,22,20,24,16,22,-2,-2,2,6,-2,2,12:10 - 11:9 - 11:13 - 5:11 - 12:10
15662681,2023-12-10 11:50:00,Diaryan Aleksandr - Nazaryan Mushegh,3:0,11:8 - 11:7 - 11:2 - 0:0 - 0:0,3,0,Diaryan Aleksandr,Nazaryan Mushegh,fiurst,Diaryan Aleksandr - Nazaryan Mushegh,50,33,17,-16,16,19,18,13,0,0,-3,-4,-9,0,0,-16,11:8 - 11:7 - 11:2 - 0:0 - 0:0
15662677,2023-12-10 11:30:00,Nikoghosyan Narek - Soghomonyan Hrayr,3:0,11:3 - 11:6 - 11:7 - 0:0 - 0:0,3,0,Nikoghosyan Narek,Soghomonyan Hrayr,fiurst,Nikoghosyan Narek - Soghomonyan Hrayr,49,33,16,-17,17,14,17,18,0,0,-8,-5,-4,0,0,-17,11:3 - 11:6 - 11:7 - 0:0 - 0:0
15662668,2023-12-10 11:15:00,Rafayelyan Edgar - Diaryan Aleksandr,3:2,9:11 - 4:11 - 11:8 - 11:2 - 9:11,2,3,Rafayelyan Edgar,Diaryan Aleksandr,fiurst,Diaryan Aleksandr - Rafayelyan Edgar,87,43,44,1,-1,20,15,19,13,20,-2,-7,3,9,-2,1,11:9 - 11:4 - 8:11 - 2:11 - 11:9
15662664,2023-12-10 11:00:00,Nazaryan Mushegh - Nikoghosyan Narek,1:3,8:11 - 6:11 - 11:8 - 9:11 - 0:0,1,3,Nazaryan Mushegh,Nikoghosyan Narek,fiurst,Nazaryan Mushegh - Nikoghosyan Narek,75,34,41,7,-7,19,17,19,20,0,3,5,-3,2,0,7,8:11 - 6:11 - 11:8 - 9:11 - 0:0
15662662,2023-12-10 10:45:00,Soghomonyan Hrayr - Diaryan Aleksandr,3:0,2:11 - 8:11 - 3:11 - 0:0 - 0:0,0,3,Soghomonyan Hrayr,Diaryan Aleksandr,fiurst,Diaryan Aleksandr - Soghomonyan Hrayr,46,33,13,-20,20,13,19,14,0,0,-9,-3,-8,0,0,-20,11:2 - 11:8 - 11:3 - 0:0 - 0:0
15662659,2023-12-10 10:30:00,Rafayelyan Edgar - Nazaryan Mushegh,1:3,11:4 - 11:7 - 8:11 - 11:8 - 0:0,3,1,Rafayelyan Edgar,Nazaryan Mushegh,fiurst,Nazaryan Mushegh - Rafayelyan Edgar,71,30,41,11,-11,15,18,19,19,0,7,4,-3,3,0,11,4:11 - 7:11 - 11:8 - 8:11 - 0:0
15662658,2023-12-10 10:15:00,Diaryan Aleksandr - Nikoghosyan Narek,3:1,11:4 - 7:11 - 11:4 - 11:2 - 0:0,3,1,Diaryan Aleksandr,Nikoghosyan Narek,fiurst,Diaryan Aleksandr - Nikoghosyan Narek,61,40,21,-19,19,15,18,15,13,0,-7,4,-7,-9,0,-19,11:4 - 7:11 - 11:4 - 11:2 - 0:0
15662657,2023-12-10 10:00:00,Soghomonyan Hrayr - Rafayelyan Edgar,3:0,5:11 - 8:11 - 6:11 - 0:0 - 0:0,0,3,Soghomonyan Hrayr,Rafayelyan Edgar,fiurst,Rafayelyan Edgar - Soghomonyan Hrayr,52,33,19,-14,14,16,19,17,0,0,-6,-3,-5,0,0,-14,11:5 - 11:8 - 11:6 - 0:0 - 0:0
15645911,2023-12-09 17:30:00,Gevorgyan Hayk - Grigoryan Erik,2:3,8:11 - 11:6 - 8:11 - 11:8 - 4:11,2,3,Gevorgyan Hayk,Grigoryan Erik,fiurst,Gevorgyan Hayk - Grigoryan Erik,89,42,47,5,-5,19,17,19,19,15,3,-5,3,-3,7,5,8:11 - 11:6 - 8:11 - 11:8 - 4:11
15645910,2023-12-09 17:15:00,Gevorgyan Gegham - Darbinyan Armen,0:3,11:5 - 11:4 - 11:3 - 0:0 - 0:0,3,0,Gevorgyan Gegham,Darbinyan Armen,fiurst,Darbinyan Armen - Gevorgyan Gegham,45,12,33,21,-21,16,15,14,0,0,6,7,8,0,0,21,5:11 - 4:11 - 3:11 - 0:0 - 0:0
15645907,2023-12-09 17:00:00,Avakimyan Davit - Gevorgyan Hayk,0:3,3:11 - 12:14 - 6:11 - 0:0 - 0:0,0,3,Avakimyan Davit,Gevorgyan Hayk,fiurst,Avakimyan Davit - Gevorgyan Hayk,57,21,36,15,-15,14,26,17,0,0,8,2,5,0,0,15,3:11 - 12:14 - 6:11 - 0:0 - 0:0
15645903,2023-12-09 16:50:00,Gevorgyan Gegham - Grigoryan Erik,3:1,11:4 - 11:8 - 8:11 - 11:9 - 0:0,3,1,Gevorgyan Gegham,Grigoryan Erik,fiurst,Gevorgyan Gegham - Grigoryan Erik,73,41,32,-9,9,15,19,19,20,0,-7,-3,3,-2,0,-9,11:4 - 11:8 - 8:11 - 11:9 - 0:0
15645876,2023-12-09 16:30:00,Darbinyan Armen - Avakimyan Davit,1:3,11:7 - 11:9 - 3:11 - 11:6 - 0:0,3,1,Darbinyan Armen,Avakimyan Davit,fiurst,Avakimyan Davit - Darbinyan Armen,69,33,36,3,-3,18,20,14,17,0,4,2,-8,5,0,3,7:11 - 9:11 - 11:3 - 6:11 - 0:0
15645872,2023-12-09 16:15:00,Gevorgyan Hayk - Gevorgyan Gegham,2:3,11:5 - 7:11 - 11:2 - 11:13 - 11:9,3,2,Gevorgyan Hayk,Gevorgyan Gegham,fiurst,Gevorgyan Gegham - Gevorgyan Hayk,91,40,51,11,-11,16,18,13,24,20,6,-4,9,-2,2,11,5:11 - 11:7 - 2:11 - 13:11 - 9:11
15645870,2023-12-09 16:00:00,Grigoryan Erik - Avakimyan Davit,3:1,6:11 - 6:11 - 11:8 - 9:11 - 0:0,1,3,Grigoryan Erik,Avakimyan Davit,fiurst,Avakimyan Davit - Grigoryan Erik,73,41,32,-9,9,17,17,19,20,0,-5,-5,3,-2,0,-9,11:6 - 11:6 - 8:11 - 11:9 - 0:0
15645868,2023-12-09 15:45:00,Darbinyan Armen - Gevorgyan Hayk,0:3,4:11 - 7:11 - 4:11 - 0:0 - 0:0,0,3,Darbinyan Armen,Gevorgyan Hayk,fiurst,Darbinyan Armen - Gevorgyan Hayk,48,15,33,18,-18,15,18,15,0,0,7,4,7,0,0,18,4:11 - 7:11 - 4:11 - 0:0 - 0:0
15645866,2023-12-09 15:40:00,Grigoryan Erik - Darbinyan Armen,0:3,11:6 - 11:4 - 11:8 - 0:0 - 0:0,3,0,Grigoryan Erik,Darbinyan Armen,fiurst,Darbinyan Armen - Grigoryan Erik,51,18,33,15,-15,17,15,19,0,0,5,7,3,0,0,15,6:11 - 4:11 - 8:11 - 0:0 - 0:0
15645867,2023-12-09 15:30:00,Avakimyan Davit - Gevorgyan Gegham,3:2,11:6 - 12:14 - 11:7 - 5:11 - 11:8,3,2,Avakimyan Davit,Gevorgyan Gegham,fiurst,Avakimyan Davit - Gevorgyan Gegham,96,50,46,-4,4,17,26,18,16,19,-5,2,-4,6,-3,-4,11:6 - 12:14 - 11:7 - 5:11 - 11:8
15645851,2023-12-09 15:15:00,Soghomonyan Hrayr - Mkrtchyan Andranik,2:3,11:3 - 11:4 - 6:11 - 8:11 - 11:2,3,2,Soghomonyan Hrayr,Mkrtchyan Andranik,fiurst,Mkrtchyan Andranik - Soghomonyan Hrayr,78,31,47,16,-16,14,15,17,19,13,8,7,-5,-3,9,16,3:11 - 4:11 - 11:6 - 11:8 - 2:11
15645853,2023-12-09 15:10:00,Arutyunov Ruben - Nikoghosyan Narek,0:3,5:11 - 8:11 - 8:11 - 0:0 - 0:0,0,3,Arutyunov Ruben,Nikoghosyan Narek,fiurst,Arutyunov Ruben - Nikoghosyan Narek,54,21,33,12,-12,16,19,19,0,0,6,3,3,0,0,12,5:11 - 8:11 - 8:11 - 0:0 - 0:0
15645847,2023-12-09 14:50:00,Nazaryan Mushegh - Arutyunov Ruben,0:3,13:11 - 11:5 - 11:6 - 0:0 - 0:0,3,0,Nazaryan Mushegh,Arutyunov Ruben,fiurst,Arutyunov Ruben - Nazaryan Mushegh,57,22,35,13,-13,24,16,17,0,0,2,6,5,0,0,13,11:13 - 5:11 - 6:11 - 0:0 - 0:0
15645842,2023-12-09 14:45:00,Nikoghosyan Narek - Soghomonyan Hrayr,3:1,10:12 - 11:5 - 12:10 - 11:7 - 0:0,3,1,Nikoghosyan Narek,Soghomonyan Hrayr,fiurst,Nikoghosyan Narek - Soghomonyan Hrayr,78,44,34,-10,10,22,16,22,18,0,2,-6,-2,-4,0,-10,10:12 - 11:5 - 12:10 - 11:7 - 0:0
15645839,2023-12-09 14:10:00,Arutyunov Ruben - Soghomonyan Hrayr,3:2,7:11 - 11:7 - 12:14 - 12:10 - 11:6,3,2,Arutyunov Ruben,Soghomonyan Hrayr,fiurst,Arutyunov Ruben - Soghomonyan Hrayr,101,53,48,-5,5,18,18,26,22,17,4,-4,2,-2,-5,-5,7:11 - 11:7 - 12:14 - 12:10 - 11:6
15645840,2023-12-09 14:00:00,Nazaryan Mushegh - Mkrtchyan Andranik,3:1,8:11 - 11:8 - 6:11 - 4:11 - 0:0,1,3,Nazaryan Mushegh,Mkrtchyan Andranik,fiurst,Mkrtchyan Andranik - Nazaryan Mushegh,70,41,29,-12,12,19,19,17,15,0,-3,3,-5,-7,0,-12,11:8 - 8:11 - 11:6 - 11:4 - 0:0
15645826,2023-12-09 13:40:00,Nikoghosyan Narek - Nazaryan Mushegh,0:3,11:5 - 11:7 - 11:5 - 0:0 - 0:0,3,0,Nikoghosyan Narek,Nazaryan Mushegh,fiurst,Nazaryan Mushegh - Nikoghosyan Narek,50,17,33,16,-16,16,18,16,0,0,6,4,6,0,0,16,5:11 - 7:11 - 5:11 - 0:0 - 0:0
15645823,2023-12-09 13:25:00,Mkrtchyan Andranik - Arutyunov Ruben,3:1,11:6 - 7:11 - 9:11 - 8:11 - 0:0,1,3,Mkrtchyan Andranik,Arutyunov Ruben,fiurst,Arutyunov Ruben - Mkrtchyan Andranik,74,39,35,-4,4,17,18,20,19,0,5,-4,-2,-3,0,-4,6:11 - 11:7 - 11:9 - 11:8 - 0:0
15645821,2023-12-09 13:05:00,Soghomonyan Hrayr - Nazaryan Mushegh,3:2,11:7 - 7:11 - 11:8 - 8:11 - 11:13,2,3,Soghomonyan Hrayr,Nazaryan Mushegh,fiurst,Nazaryan Mushegh - Soghomonyan Hrayr,98,50,48,-2,2,18,18,19,19,24,4,-4,3,-3,-2,-2,7:11 - 11:7 - 8:11 - 11:8 - 13:11
15645818,2023-12-09 12:55:00,Mkrtchyan Andranik - Nikoghosyan Narek,0:3,10:12 - 7:11 - 15:17 - 0:0 - 0:0,0,3,Mkrtchyan Andranik,Nikoghosyan Narek,fiurst,Mkrtchyan Andranik - Nikoghosyan Narek,72,32,40,8,-8,22,18,32,0,0,2,4,2,0,0,8,10:12 - 7:11 - 15:17 - 0:0 - 0:0
15645816,2023-12-09 12:25:00,Arutyunov Ruben - Nazaryan Mushegh,3:2,2:11 - 11:7 - 3:11 - 11:3 - 11:6,3,2,Arutyunov Ruben,Nazaryan Mushegh,fiurst,Arutyunov Ruben - Nazaryan Mushegh,76,38,38,0,0,13,18,14,14,17,9,-4,8,-8,-5,0,2:11 - 11:7 - 3:11 - 11:3 - 11:6
15645803,2023-12-09 12:00:00,Mkrtchyan Andranik - Soghomonyan Hrayr,2:3,11:9 - 12:10 - 7:11 - 9:11 - 8:11,2,3,Mkrtchyan Andranik,Soghomonyan Hrayr,fiurst,Mkrtchyan Andranik - Soghomonyan Hrayr,99,47,52,5,-5,20,22,18,20,19,-2,-2,4,2,3,5,11:9 - 12:10 - 7:11 - 9:11 - 8:11
15645797,2023-12-09 11:45:00,Nikoghosyan Narek - Arutyunov Ruben,2:3,12:10 - 11:8 - 9:11 - 10:12 - 11:7,3,2,Nikoghosyan Narek,Arutyunov Ruben,fiurst,Arutyunov Ruben - Nikoghosyan Narek,101,48,53,5,-5,22,19,20,22,18,2,3,-2,-2,4,5,10:12 - 8:11 - 11:9 - 12:10 - 7:11
15645794,2023-12-09 11:35:00,Mkrtchyan Andranik - Nazaryan Mushegh,3:0,11:8 - 11:7 - 11:6 - 0:0 - 0:0,3,0,Mkrtchyan Andranik,Nazaryan Mushegh,fiurst,Mkrtchyan Andranik - Nazaryan Mushegh,54,33,21,-12,12,19,18,17,0,0,-3,-4,-5,0,0,-12,11:8 - 11:7 - 11:6 - 0:0 - 0:0
15645791,2023-12-09 11:15:00,Soghomonyan Hrayr - Nikoghosyan Narek,0:3,11:8 - 11:4 - 11:2 - 0:0 - 0:0,3,0,Soghomonyan Hrayr,Nikoghosyan Narek,fiurst,Nikoghosyan Narek - Soghomonyan Hrayr,47,14,33,19,-19,19,15,13,0,0,3,7,9,0,0,19,8:11 - 4:11 - 2:11 - 0:0 - 0:0
15645790,2023-12-09 11:10:00,Arutyunov Ruben - Mkrtchyan Andranik,3:0,11:7 - 11:8 - 11:1 - 0:0 - 0:0,3,0,Arutyunov Ruben,Mkrtchyan Andranik,fiurst,Arutyunov Ruben - Mkrtchyan Andranik,49,33,16,-17,17,18,19,12,0,0,-4,-3,-10,0,0,-17,11:7 - 11:8 - 11:1 - 0:0 - 0:0
15645736,2023-12-09 10:45:00,Nazaryan Mushegh - Nikoghosyan Narek,0:3,6:11 - 10:12 - 6:11 - 0:0 - 0:0,0,3,Nazaryan Mushegh,Nikoghosyan Narek,fiurst,Nazaryan Mushegh - Nikoghosyan Narek,56,22,34,12,-12,17,22,17,0,0,5,2,5,0,0,12,6:11 - 10:12 - 6:11 - 0:0 - 0:0
15645714,2023-12-09 10:30:00,Soghomonyan Hrayr - Arutyunov Ruben,3:1,11:8 - 9:11 - 8:11 - 7:11 - 0:0,1,3,Soghomonyan Hrayr,Arutyunov Ruben,fiurst,Arutyunov Ruben - Soghomonyan Hrayr,76,41,35,-6,6,19,20,19,18,0,3,-2,-3,-4,0,-6,8:11 - 11:9 - 11:8 - 11:7 - 0:0
15645709,2023-12-09 10:15:00,Nikoghosyan Narek - Mkrtchyan Andranik,2:3,9:11 - 12:10 - 11:4 - 11:13 - 11:9,3,2,Nikoghosyan Narek,Mkrtchyan Andranik,fiurst,Mkrtchyan Andranik - Nikoghosyan Narek,101,47,54,7,-7,20,22,15,24,20,-2,2,7,-2,2,7,11:9 - 10:12 - 4:11 - 13:11 - 9:11
15645701,2023-12-09 10:00:00,Nazaryan Mushegh - Soghomonyan Hrayr,2:3,11:6 - 8:11 - 8:11 - 11:9 - 9:11,2,3,Nazaryan Mushegh,Soghomonyan Hrayr,fiurst,Nazaryan Mushegh - Soghomonyan Hrayr,95,47,48,1,-1,17,19,19,20,20,-5,3,3,-2,2,1,11:6 - 8:11 - 8:11 - 11:9 - 9:11
15625836,2023-12-08 17:30:00,Darbinyan Armen - Gevorgyan Gegham,0:3,6:11 - 1:11 - 5:11 - 0:0 - 0:0,0,3,Darbinyan Armen,Gevorgyan Gegham,fiurst,Darbinyan Armen - Gevorgyan Gegham,45,12,33,21,-21,17,12,16,0,0,5,10,6,0,0,21,6:11 - 1:11 - 5:11 - 0:0 - 0:0
15625834,2023-12-08 17:15:00,Avakimyan Davit - Petrosyan Davit,3:2,13:11 - 10:12 - 12:14 - 12:10 - 12:10,3,2,Avakimyan Davit,Petrosyan Davit,fiurst,Avakimyan Davit - Petrosyan Davit,116,59,57,-2,2,24,22,26,22,22,-2,2,2,-2,-2,-2,13:11 - 10:12 - 12:14 - 12:10 - 12:10
15625833,2023-12-08 17:05:00,Grigoryan Erik - Darbinyan Armen,0:3,11:9 - 11:9 - 11:7 - 0:0 - 0:0,3,0,Grigoryan Erik,Darbinyan Armen,fiurst,Darbinyan Armen - Grigoryan Erik,58,25,33,8,-8,20,20,18,0,0,2,2,4,0,0,8,9:11 - 9:11 - 7:11 - 0:0 - 0:0
15625832,2023-12-08 16:45:00,Avakimyan Davit - Gevorgyan Gegham,3:1,9:11 - 11:9 - 11:4 - 11:9 - 0:0,3,1,Avakimyan Davit,Gevorgyan Gegham,fiurst,Avakimyan Davit - Gevorgyan Gegham,75,42,33,-9,9,20,20,15,20,0,2,-2,-7,-2,0,-9,9:11 - 11:9 - 11:4 - 11:9 - 0:0
15625821,2023-12-08 16:30:00,Petrosyan Davit - Grigoryan Erik,2:3,5:11 - 11:8 - 11:5 - 8:11 - 11:5,3,2,Petrosyan Davit,Grigoryan Erik,fiurst,Grigoryan Erik - Petrosyan Davit,86,40,46,6,-6,16,19,16,19,16,-6,3,6,-3,6,6,11:5 - 8:11 - 5:11 - 11:8 - 5:11
15625820,2023-12-08 16:15:00,Darbinyan Armen - Avakimyan Davit,3:0,9:11 - 4:11 - 6:11 - 0:0 - 0:0,0,3,Darbinyan Armen,Avakimyan Davit,fiurst,Avakimyan Davit - Darbinyan Armen,52,33,19,-14,14,20,15,17,0,0,-2,-7,-5,0,0,-14,11:9 - 11:4 - 11:6 - 0:0 - 0:0
15625816,2023-12-08 16:00:00,Gevorgyan Gegham - Grigoryan Erik,3:0,11:8 - 11:5 - 12:10 - 0:0 - 0:0,3,0,Gevorgyan Gegham,Grigoryan Erik,fiurst,Gevorgyan Gegham - Grigoryan Erik,57,34,23,-11,11,19,16,22,0,0,-3,-6,-2,0,0,-11,11:8 - 11:5 - 12:10 - 0:0 - 0:0
15625815,2023-12-08 15:45:00,Petrosyan Davit - Darbinyan Armen,0:3,11:9 - 11:4 - 11:8 - 0:0 - 0:0,3,0,Petrosyan Davit,Darbinyan Armen,fiurst,Darbinyan Armen - Petrosyan Davit,54,21,33,12,-12,20,15,19,0,0,2,7,3,0,0,12,9:11 - 4:11 - 8:11 - 0:0 - 0:0
15625812,2023-12-08 15:30:00,Grigoryan Erik - Avakimyan Davit,3:0,6:11 - 8:11 - 5:11 - 0:0 - 0:0,0,3,Grigoryan Erik,Avakimyan Davit,fiurst,Avakimyan Davit - Grigoryan Erik,52,33,19,-14,14,17,19,16,0,0,-5,-3,-6,0,0,-14,11:6 - 11:8 - 11:5 - 0:0 - 0:0
15625810,2023-12-08 15:15:00,Gevorgyan Gegham - Petrosyan Davit,0:3,3:11 - 7:11 - 6:11 - 0:0 - 0:0,0,3,Gevorgyan Gegham,Petrosyan Davit,fiurst,Gevorgyan Gegham - Petrosyan Davit,49,16,33,17,-17,14,18,17,0,0,8,4,5,0,0,17,3:11 - 7:11 - 6:11 - 0:0 - 0:0
15625805,2023-12-08 15:05:00,Diaryan Aleksandr - Rafayelyan Edgar,3:1,11:8 - 11:6 - 8:11 - 11:8 - 0:0,3,1,Diaryan Aleksandr,Rafayelyan Edgar,fiurst,Diaryan Aleksandr - Rafayelyan Edgar,74,41,33,-8,8,19,17,19,19,0,-3,-5,3,-3,0,-8,11:8 - 11:6 - 8:11 - 11:8 - 0:0
15625803,2023-12-08 14:45:00,Arutyunov Ruben - Nazaryan Mushegh,3:2,7:11 - 12:10 - 9:11 - 11:4 - 11:9,3,2,Arutyunov Ruben,Nazaryan Mushegh,fiurst,Arutyunov Ruben - Nazaryan Mushegh,95,50,45,-5,5,18,22,20,15,20,4,-2,2,-7,-2,-5,7:11 - 12:10 - 9:11 - 11:4 - 11:9
15625802,2023-12-08 14:35:00,Mkrtchyan Andranik - Diaryan Aleksandr,3:0,10:12 - 4:11 - 2:11 - 0:0 - 0:0,0,3,Mkrtchyan Andranik,Diaryan Aleksandr,fiurst,Diaryan Aleksandr - Mkrtchyan Andranik,50,34,16,-18,18,22,15,13,0,0,-2,-7,-9,0,0,-18,12:10 - 11:4 - 11:2 - 0:0 - 0:0
15625798,2023-12-08 14:15:00,Mkrtchyan Andranik - Nazaryan Mushegh,1:3,11:7 - 7:11 - 7:11 - 9:11 - 0:0,1,3,Mkrtchyan Andranik,Nazaryan Mushegh,fiurst,Mkrtchyan Andranik - Nazaryan Mushegh,74,34,40,6,-6,18,18,18,20,0,-4,4,4,2,0,6,11:7 - 7:11 - 7:11 - 9:11 - 0:0
15625799,2023-12-08 14:15:00,Rafayelyan Edgar - Arutyunov Ruben,3:0,10:12 - 7:11 - 9:11 - 0:0 - 0:0,0,3,Rafayelyan Edgar,Arutyunov Ruben,fiurst,Arutyunov Ruben - Rafayelyan Edgar,60,34,26,-8,8,22,18,20,0,0,-2,-4,-2,0,0,-8,12:10 - 11:7 - 11:9 - 0:0 - 0:0
15625786,2023-12-08 13:45:00,Diaryan Aleksandr - Arutyunov Ruben,0:3,11:7 - 11:4 - 11:4 - 0:0 - 0:0,3,0,Diaryan Aleksandr,Arutyunov Ruben,fiurst,Arutyunov Ruben - Diaryan Aleksandr,48,15,33,18,-18,18,15,15,0,0,4,7,7,0,0,18,7:11 - 4:11 - 4:11 - 0:0 - 0:0
15625781,2023-12-08 13:35:00,Rafayelyan Edgar - Mkrtchyan Andranik,2:3,9:11 - 8:11 - 11:6 - 15:13 - 11:5,3,2,Rafayelyan Edgar,Mkrtchyan Andranik,fiurst,Mkrtchyan Andranik - Rafayelyan Edgar,100,46,54,8,-8,20,19,17,28,16,-2,-3,5,2,6,8,11:9 - 11:8 - 6:11 - 13:15 - 5:11
15625780,2023-12-08 13:15:00,Nazaryan Mushegh - Diaryan Aleksandr,3:0,6:11 - 7:11 - 6:11 - 0:0 - 0:0,0,3,Nazaryan Mushegh,Diaryan Aleksandr,fiurst,Diaryan Aleksandr - Nazaryan Mushegh,52,33,19,-14,14,17,18,17,0,0,-5,-4,-5,0,0,-14,11:6 - 11:7 - 11:6 - 0:0 - 0:0
15625776,2023-12-08 13:00:00,Arutyunov Ruben - Mkrtchyan Andranik,3:1,11:9 - 13:11 - 8:11 - 11:9 - 0:0,3,1,Arutyunov Ruben,Mkrtchyan Andranik,fiurst,Arutyunov Ruben - Mkrtchyan Andranik,83,43,40,-3,3,20,24,19,20,0,-2,-2,3,-2,0,-3,11:9 - 13:11 - 8:11 - 11:9 - 0:0
15625775,2023-12-08 12:45:00,Nazaryan Mushegh - Rafayelyan Edgar,1:3,8:11 - 11:9 - 5:11 - 7:11 - 0:0,1,3,Nazaryan Mushegh,Rafayelyan Edgar,fiurst,Nazaryan Mushegh - Rafayelyan Edgar,73,31,42,11,-11,19,20,16,18,0,3,-2,6,4,0,11,8:11 - 11:9 - 5:11 - 7:11 - 0:0
15625773,2023-12-08 12:15:00,Mkrtchyan Andranik - Diaryan Aleksandr,3:0,3:11 - 10:12 - 8:11 - 0:0 - 0:0,0,3,Mkrtchyan Andranik,Diaryan Aleksandr,fiurst,Diaryan Aleksandr - Mkrtchyan Andranik,55,34,21,-13,13,14,22,19,0,0,-8,-2,-3,0,0,-13,11:3 - 12:10 - 11:8 - 0:0 - 0:0
15625772,2023-12-08 12:00:00,Nazaryan Mushegh - Arutyunov Ruben,3:2,9:11 - 12:10 - 11:4 - 8:11 - 8:11,2,3,Nazaryan Mushegh,Arutyunov Ruben,fiurst,Arutyunov Ruben - Nazaryan Mushegh,95,47,48,1,-1,20,22,15,19,19,-2,2,7,-3,-3,1,11:9 - 10:12 - 4:11 - 11:8 - 11:8
15625766,2023-12-08 11:50:00,Rafayelyan Edgar - Diaryan Aleksandr,3:0,6:11 - 4:11 - 2:11 - 0:0 - 0:0,0,3,Rafayelyan Edgar,Diaryan Aleksandr,fiurst,Diaryan Aleksandr - Rafayelyan Edgar,45,33,12,-21,21,17,15,13,0,0,-5,-7,-9,0,0,-21,11:6 - 11:4 - 11:2 - 0:0 - 0:0
15625748,2023-12-08 11:30:00,Nazaryan Mushegh - Mkrtchyan Andranik,0:3,13:11 - 11:8 - 12:10 - 0:0 - 0:0,3,0,Nazaryan Mushegh,Mkrtchyan Andranik,fiurst,Mkrtchyan Andranik - Nazaryan Mushegh,65,29,36,7,-7,24,19,22,0,0,2,3,2,0,0,7,11:13 - 8:11 - 10:12 - 0:0 - 0:0
15625746,2023-12-08 11:15:00,Arutyunov Ruben - Rafayelyan Edgar,0:3,4:11 - 8:11 - 8:11 - 0:0 - 0:0,0,3,Arutyunov Ruben,Rafayelyan Edgar,fiurst,Arutyunov Ruben - Rafayelyan Edgar,53,20,33,13,-13,15,19,19,0,0,7,3,3,0,0,13,4:11 - 8:11 - 8:11 - 0:0 - 0:0
15625745,2023-12-08 11:00:00,Diaryan Aleksandr - Nazaryan Mushegh,3:0,11:2 - 11:8 - 11:2 - 0:0 - 0:0,3,0,Diaryan Aleksandr,Nazaryan Mushegh,fiurst,Diaryan Aleksandr - Nazaryan Mushegh,45,33,12,-21,21,13,19,13,0,0,-9,-3,-9,0,0,-21,11:2 - 11:8 - 11:2 - 0:0 - 0:0
15625744,2023-12-08 10:45:00,Mkrtchyan Andranik - Rafayelyan Edgar,0:3,7:11 - 9:11 - 7:11 - 0:0 - 0:0,0,3,Mkrtchyan Andranik,Rafayelyan Edgar,fiurst,Mkrtchyan Andranik - Rafayelyan Edgar,56,23,33,10,-10,18,20,18,0,0,4,2,4,0,0,10,7:11 - 9:11 - 7:11 - 0:0 - 0:0
15625741,2023-12-08 10:40:00,Arutyunov Ruben - Diaryan Aleksandr,0:3,4:11 - 10:12 - 15:17 - 0:0 - 0:0,0,3,Arutyunov Ruben,Diaryan Aleksandr,fiurst,Arutyunov Ruben - Diaryan Aleksandr,69,29,40,11,-11,15,22,32,0,0,7,2,2,0,0,11,4:11 - 10:12 - 15:17 - 0:0 - 0:0
15625740,2023-12-08 10:15:00,Rafayelyan Edgar - Nazaryan Mushegh,1:3,11:5 - 9:11 - 11:9 - 11:3 - 0:0,3,1,Rafayelyan Edgar,Nazaryan Mushegh,fiurst,Nazaryan Mushegh - Rafayelyan Edgar,70,28,42,14,-14,16,20,20,14,0,6,-2,2,8,0,14,5:11 - 11:9 - 9:11 - 3:11 - 0:0
15625739,2023-12-08 10:00:00,Mkrtchyan Andranik - Arutyunov Ruben,3:1,16:14 - 8:11 - 6:11 - 9:11 - 0:0,1,3,Mkrtchyan Andranik,Arutyunov Ruben,fiurst,Arutyunov Ruben - Mkrtchyan Andranik,86,47,39,-8,8,30,19,17,20,0,2,-3,-5,-2,0,-8,14:16 - 11:8 - 11:6 - 11:9 - 0:0
15607856,2023-12-07 17:30:00,Mkrtchyan Andranik - Avakimyan Davit,1:3,11:7 - 7:11 - 11:4 - 11:8 - 0:0,3,1,Mkrtchyan Andranik,Avakimyan Davit,fiurst,Avakimyan Davit - Mkrtchyan Andranik,70,30,40,10,-10,18,18,15,19,0,4,-4,7,3,0,10,7:11 - 11:7 - 4:11 - 8:11 - 0:0
15607853,2023-12-07 17:25:00,Gevorgyan Gegham - Petrosyan Davit,1:3,9:11 - 2:11 - 14:12 - 6:11 - 0:0,1,3,Gevorgyan Gegham,Petrosyan Davit,fiurst,Gevorgyan Gegham - Petrosyan Davit,76,31,45,14,-14,20,13,26,17,0,2,9,-2,5,0,14,9:11 - 2:11 - 14:12 - 6:11 - 0:0
15607851,2023-12-07 17:00:00,Gevorgyan Hayk - Mkrtchyan Andranik,1:3,11:3 - 11:13 - 5:11 - 6:11 - 0:0,1,3,Gevorgyan Hayk,Mkrtchyan Andranik,fiurst,Gevorgyan Hayk - Mkrtchyan Andranik,71,33,38,5,-5,14,24,16,17,0,-8,2,6,5,0,5,11:3 - 11:13 - 5:11 - 6:11 - 0:0
15607848,2023-12-07 16:50:00,Gevorgyan Gegham - Avakimyan Davit,3:2,6:11 - 14:12 - 11:5 - 8:11 - 9:11,2,3,Gevorgyan Gegham,Avakimyan Davit,fiurst,Avakimyan Davit - Gevorgyan Gegham,98,50,48,-2,2,17,26,16,19,20,-5,2,6,-3,-2,-2,11:6 - 12:14 - 5:11 - 11:8 - 11:9
15607847,2023-12-07 16:35:00,Petrosyan Davit - Gevorgyan Hayk,3:0,4:11 - 3:11 - 6:11 - 0:0 - 0:0,0,3,Petrosyan Davit,Gevorgyan Hayk,fiurst,Gevorgyan Hayk - Petrosyan Davit,46,33,13,-20,20,15,14,17,0,0,-7,-8,-5,0,0,-20,11:4 - 11:3 - 11:6 - 0:0 - 0:0
15607828,2023-12-07 16:20:00,Mkrtchyan Andranik - Gevorgyan Gegham,0:3,11:6 - 11:9 - 11:6 - 0:0 - 0:0,3,0,Mkrtchyan Andranik,Gevorgyan Gegham,fiurst,Gevorgyan Gegham - Mkrtchyan Andranik,54,21,33,12,-12,17,20,17,0,0,5,2,5,0,0,12,6:11 - 9:11 - 6:11 - 0:0 - 0:0
15607827,2023-12-07 16:10:00,Avakimyan Davit - Gevorgyan Hayk,0:3,10:12 - 7:11 - 4:11 - 0:0 - 0:0,0,3,Avakimyan Davit,Gevorgyan Hayk,fiurst,Avakimyan Davit - Gevorgyan Hayk,55,21,34,13,-13,22,18,15,0,0,2,4,7,0,0,13,10:12 - 7:11 - 4:11 - 0:0 - 0:0
15607825,2023-12-07 16:00:00,Petrosyan Davit - Mkrtchyan Andranik,3:0,8:11 - 7:11 - 9:11 - 0:0 - 0:0,0,3,Petrosyan Davit,Mkrtchyan Andranik,fiurst,Mkrtchyan Andranik - Petrosyan Davit,57,33,24,-9,9,19,18,20,0,0,-3,-4,-2,0,0,-9,11:8 - 11:7 - 11:9 - 0:0 - 0:0
15607822,2023-12-07 15:45:00,Avakimyan Davit - Petrosyan Davit,3:0,11:8 - 11:4 - 11:4 - 0:0 - 0:0,3,0,Avakimyan Davit,Petrosyan Davit,fiurst,Avakimyan Davit - Petrosyan Davit,49,33,16,-17,17,19,15,15,0,0,-3,-7,-7,0,0,-17,11:8 - 11:4 - 11:4 - 0:0 - 0:0
15607823,2023-12-07 15:45:00,Gevorgyan Hayk - Gevorgyan Gegham,3:0,2:11 - 5:11 - 8:11 - 0:0 - 0:0,0,3,Gevorgyan Hayk,Gevorgyan Gegham,fiurst,Gevorgyan Gegham - Gevorgyan Hayk,48,33,15,-18,18,13,16,19,0,0,-9,-6,-3,0,0,-18,11:2 - 11:5 - 11:8 - 0:0 - 0:0
15607820,2023-12-07 15:20:00,Soghomonyan Hrayr - Rafayelyan Edgar,3:0,7:11 - 4:11 - 6:11 - 0:0 - 0:0,0,3,Soghomonyan Hrayr,Rafayelyan Edgar,fiurst,Rafayelyan Edgar - Soghomonyan Hrayr,50,33,17,-16,16,18,15,17,0,0,-4,-7,-5,0,0,-16,11:7 - 11:4 - 11:6 - 0:0 - 0:0
15607821,2023-12-07 15:20:00,Nikoghosyan Narek - Mkrtchyan Andranik,1:3,8:11 - 11:8 - 11:9 - 11:6 - 0:0,3,1,Nikoghosyan Narek,Mkrtchyan Andranik,fiurst,Mkrtchyan Andranik - Nikoghosyan Narek,75,34,41,7,-7,19,19,20,17,0,-3,3,2,5,0,7,11:8 - 8:11 - 9:11 - 6:11 - 0:0
15607815,2023-12-07 14:45:00,Diaryan Aleksandr - Nikoghosyan Narek,1:3,11:8 - 9:11 - 8:11 - 6:11 - 0:0,1,3,Diaryan Aleksandr,Nikoghosyan Narek,fiurst,Diaryan Aleksandr - Nikoghosyan Narek,75,34,41,7,-7,19,20,19,17,0,-3,2,3,5,0,7,11:8 - 9:11 - 8:11 - 6:11 - 0:0
15607807,2023-12-07 14:40:00,Mkrtchyan Andranik - Soghomonyan Hrayr,2:3,3:11 - 10:12 - 11:8 - 12:10 - 5:11,2,3,Mkrtchyan Andranik,Soghomonyan Hrayr,fiurst,Mkrtchyan Andranik - Soghomonyan Hrayr,93,41,52,11,-11,14,22,19,22,16,8,2,-3,-2,6,11,3:11 - 10:12 - 11:8 - 12:10 - 5:11
15607803,2023-12-07 14:10:00,Nikoghosyan Narek - Soghomonyan Hrayr,3:2,11:6 - 8:11 - 11:7 - 7:11 - 11:8,3,2,Nikoghosyan Narek,Soghomonyan Hrayr,fiurst,Nikoghosyan Narek - Soghomonyan Hrayr,91,48,43,-5,5,17,19,18,18,19,-5,3,-4,4,-3,-5,11:6 - 8:11 - 11:7 - 7:11 - 11:8
15607804,2023-12-07 14:00:00,Diaryan Aleksandr - Rafayelyan Edgar,3:2,7:11 - 11:6 - 11:6 - 10:12 - 11:6,3,2,Diaryan Aleksandr,Rafayelyan Edgar,fiurst,Diaryan Aleksandr - Rafayelyan Edgar,91,50,41,-9,9,18,17,17,22,17,4,-5,-5,2,-5,-9,7:11 - 11:6 - 11:6 - 10:12 - 11:6
15607800,2023-12-07 13:50:00,Mkrtchyan Andranik - Diaryan Aleksandr,3:0,4:11 - 5:11 - 5:11 - 0:0 - 0:0,0,3,Mkrtchyan Andranik,Diaryan Aleksandr,fiurst,Diaryan Aleksandr - Mkrtchyan Andranik,47,33,14,-19,19,15,16,16,0,0,-7,-6,-6,0,0,-19,11:4 - 11:5 - 11:5 - 0:0 - 0:0
15607798,2023-12-07 13:40:00,Rafayelyan Edgar - Nikoghosyan Narek,0:3,11:8 - 11:3 - 11:4 - 0:0 - 0:0,3,0,Rafayelyan Edgar,Nikoghosyan Narek,fiurst,Nikoghosyan Narek - Rafayelyan Edgar,48,15,33,18,-18,19,14,15,0,0,3,8,7,0,0,18,8:11 - 3:11 - 4:11 - 0:0 - 0:0
15607795,2023-12-07 13:15:00,Rafayelyan Edgar - Mkrtchyan Andranik,1:3,11:7 - 11:6 - 6:11 - 12:10 - 0:0,3,1,Rafayelyan Edgar,Mkrtchyan Andranik,fiurst,Mkrtchyan Andranik - Rafayelyan Edgar,74,34,40,6,-6,18,17,17,22,0,4,5,-5,2,0,6,7:11 - 6:11 - 11:6 - 10:12 - 0:0
15607797,2023-12-07 13:00:00,Soghomonyan Hrayr - Diaryan Aleksandr,3:0,5:11 - 5:11 - 6:11 - 0:0 - 0:0,0,3,Soghomonyan Hrayr,Diaryan Aleksandr,fiurst,Diaryan Aleksandr - Soghomonyan Hrayr,49,33,16,-17,17,16,16,17,0,0,-6,-6,-5,0,0,-17,11:5 - 11:5 - 11:6 - 0:0 - 0:0
15607794,2023-12-07 12:50:00,Nikoghosyan Narek - Diaryan Aleksandr,1:3,11:6 - 7:11 - 11:3 - 11:4 - 0:0,3,1,Nikoghosyan Narek,Diaryan Aleksandr,fiurst,Diaryan Aleksandr - Nikoghosyan Narek,64,24,40,16,-16,17,18,14,15,0,5,-4,8,7,0,16,6:11 - 11:7 - 3:11 - 4:11 - 0:0
15607778,2023-12-07 12:20:00,Mkrtchyan Andranik - Nikoghosyan Narek,2:3,7:11 - 11:13 - 11:9 - 11:6 - 3:11,2,3,Mkrtchyan Andranik,Nikoghosyan Narek,fiurst,Mkrtchyan Andranik - Nikoghosyan Narek,93,43,50,7,-7,18,24,20,17,14,4,2,-2,-5,8,7,7:11 - 11:13 - 11:9 - 11:6 - 3:11
15607788,2023-12-07 12:15:00,Rafayelyan Edgar - Soghomonyan Hrayr,3:0,11:3 - 11:3 - 11:4 - 0:0 - 0:0,3,0,Rafayelyan Edgar,Soghomonyan Hrayr,fiurst,Rafayelyan Edgar - Soghomonyan Hrayr,43,33,10,-23,23,14,14,15,0,0,-8,-8,-7,0,0,-23,11:3 - 11:3 - 11:4 - 0:0 - 0:0
15607775,2023-12-07 11:40:00,Soghomonyan Hrayr - Mkrtchyan Andranik,2:3,9:11 - 11:5 - 11:9 - 6:11 - 13:11,3,2,Soghomonyan Hrayr,Mkrtchyan Andranik,fiurst,Mkrtchyan Andranik - Soghomonyan Hrayr,97,47,50,3,-3,20,16,20,17,24,-2,6,2,-5,2,3,11:9 - 5:11 - 9:11 - 11:6 - 11:13
15607777,2023-12-07 11:40:00,Rafayelyan Edgar - Diaryan Aleksandr,3:2,11:8 - 5:11 - 11:8 - 10:12 - 9:11,2,3,Rafayelyan Edgar,Diaryan Aleksandr,fiurst,Diaryan Aleksandr - Rafayelyan Edgar,96,50,46,-4,4,19,16,19,22,20,3,-6,3,-2,-2,-4,8:11 - 11:5 - 8:11 - 12:10 - 11:9
15607774,2023-12-07 11:05:00,Nikoghosyan Narek - Rafayelyan Edgar,0:3,7:11 - 8:11 - 9:11 - 0:0 - 0:0,0,3,Nikoghosyan Narek,Rafayelyan Edgar,fiurst,Nikoghosyan Narek - Rafayelyan Edgar,57,24,33,9,-9,18,19,20,0,0,4,3,2,0,0,9,7:11 - 8:11 - 9:11 - 0:0 - 0:0
15607773,2023-12-07 11:00:00,Diaryan Aleksandr - Mkrtchyan Andranik,3:2,9:11 - 11:6 - 16:18 - 11:1 - 11:2,3,2,Diaryan Aleksandr,Mkrtchyan Andranik,fiurst,Diaryan Aleksandr - Mkrtchyan Andranik,96,58,38,-20,20,20,17,34,12,13,2,-5,2,-10,-9,-20,9:11 - 11:6 - 16:18 - 11:1 - 11:2
15607772,2023-12-07 10:30:00,Soghomonyan Hrayr - Nikoghosyan Narek,3:1,15:17 - 11:8 - 9:11 - 8:11 - 0:0,1,3,Soghomonyan Hrayr,Nikoghosyan Narek,fiurst,Nikoghosyan Narek - Soghomonyan Hrayr,90,47,43,-4,4,32,19,20,19,0,-2,3,-2,-3,0,-4,17:15 - 8:11 - 11:9 - 11:8 - 0:0
15607770,2023-12-07 10:15:00,Mkrtchyan Andranik - Rafayelyan Edgar,2:3,11:9 - 11:6 - 2:11 - 4:11 - 9:11,2,3,Mkrtchyan Andranik,Rafayelyan Edgar,fiurst,Mkrtchyan Andranik - Rafayelyan Edgar,85,37,48,11,-11,20,17,13,15,20,-2,-5,9,7,2,11,11:9 - 11:6 - 2:11 - 4:11 - 9:11
15607768,2023-12-07 10:00:00,Diaryan Aleksandr - Soghomonyan Hrayr,3:0,11:6 - 11:7 - 11:5 - 0:0 - 0:0,3,0,Diaryan Aleksandr,Soghomonyan Hrayr,fiurst,Diaryan Aleksandr - Soghomonyan Hrayr,51,33,18,-15,15,17,18,16,0,0,-5,-4,-6,0,0,-15,11:6 - 11:7 - 11:5 - 0:0 - 0:0
15587989,2023-12-06 17:30:00,Darbinyan Armen - Gevorgyan Hayk,0:3,3:11 - 5:11 - 4:11 - 0:0 - 0:0,0,3,Darbinyan Armen,Gevorgyan Hayk,fiurst,Darbinyan Armen - Gevorgyan Hayk,45,12,33,21,-21,14,16,15,0,0,8,6,7,0,0,21,3:11 - 5:11 - 4:11 - 0:0 - 0:0
15587988,2023-12-06 17:20:00,Grigoryan Erik - Avakimyan Davit,3:1,7:11 - 11:7 - 8:11 - 5:11 - 0:0,1,3,Grigoryan Erik,Avakimyan Davit,fiurst,Avakimyan Davit - Grigoryan Erik,71,40,31,-9,9,18,18,19,16,0,-4,4,-3,-6,0,-9,11:7 - 7:11 - 11:8 - 11:5 - 0:0
15587984,2023-12-06 17:00:00,Petrosyan Davit - Darbinyan Armen,0:3,11:5 - 11:9 - 11:5 - 0:0 - 0:0,3,0,Petrosyan Davit,Darbinyan Armen,fiurst,Darbinyan Armen - Petrosyan Davit,52,19,33,14,-14,16,20,16,0,0,6,2,6,0,0,14,5:11 - 9:11 - 5:11 - 0:0 - 0:0
15587983,2023-12-06 16:45:00,Grigoryan Erik - Gevorgyan Hayk,3:2,11:8 - 11:8 - 11:13 - 7:11 - 11:13,2,3,Grigoryan Erik,Gevorgyan Hayk,fiurst,Gevorgyan Hayk - Grigoryan Erik,104,53,51,-2,2,19,19,24,18,24,3,3,-2,-4,-2,-2,8:11 - 8:11 - 13:11 - 11:7 - 13:11
15587979,2023-12-06 16:30:00,Avakimyan Davit - Petrosyan Davit,3:1,10:12 - 21:19 - 11:9 - 11:6 - 0:0,3,1,Avakimyan Davit,Petrosyan Davit,fiurst,Avakimyan Davit - Petrosyan Davit,99,53,46,-7,7,22,40,20,17,0,2,-2,-2,-5,0,-7,10:12 - 21:19 - 11:9 - 11:6 - 0:0
15587969,2023-12-06 16:15:00,Darbinyan Armen - Grigoryan Erik,1:3,7:11 - 4:11 - 11:9 - 3:11 - 0:0,1,3,Darbinyan Armen,Grigoryan Erik,fiurst,Darbinyan Armen - Grigoryan Erik,67,25,42,17,-17,18,15,20,14,0,4,7,-2,8,0,17,7:11 - 4:11 - 11:9 - 3:11 - 0:0
15587968,2023-12-06 16:00:00,Gevorgyan Hayk - Petrosyan Davit,3:1,11:9 - 14:12 - 2:11 - 11:5 - 0:0,3,1,Gevorgyan Hayk,Petrosyan Davit,fiurst,Gevorgyan Hayk - Petrosyan Davit,75,38,37,-1,1,20,26,13,16,0,-2,-2,9,-6,0,-1,11:9 - 14:12 - 2:11 - 11:5 - 0:0
15587967,2023-12-06 15:45:00,Avakimyan Davit - Darbinyan Armen,3:0,11:3 - 11:9 - 11:5 - 0:0 - 0:0,3,0,Avakimyan Davit,Darbinyan Armen,fiurst,Avakimyan Davit - Darbinyan Armen,50,33,17,-16,16,14,20,16,0,0,-8,-2,-6,0,0,-16,11:3 - 11:9 - 11:5 - 0:0 - 0:0
15587966,2023-12-06 15:30:00,Petrosyan Davit - Grigoryan Erik,0:3,11:6 - 11:9 - 11:6 - 0:0 - 0:0,3,0,Petrosyan Davit,Grigoryan Erik,fiurst,Grigoryan Erik - Petrosyan Davit,54,21,33,12,-12,17,20,17,0,0,5,2,5,0,0,12,6:11 - 9:11 - 6:11 - 0:0 - 0:0
15587964,2023-12-06 15:25:00,Gevorgyan Hayk - Avakimyan Davit,0:3,11:9 - 13:11 - 11:4 - 0:0 - 0:0,3,0,Gevorgyan Hayk,Avakimyan Davit,fiurst,Avakimyan Davit - Gevorgyan Hayk,59,24,35,11,-11,20,24,15,0,0,2,2,7,0,0,11,9:11 - 11:13 - 4:11 - 0:0 - 0:0
15587961,2023-12-06 15:00:00,Nazaryan Mushegh - Rafayelyan Edgar,1:3,3:11 - 11:5 - 5:11 - 8:11 - 0:0,1,3,Nazaryan Mushegh,Rafayelyan Edgar,fiurst,Nazaryan Mushegh - Rafayelyan Edgar,65,27,38,11,-11,14,16,16,19,0,8,-6,6,3,0,11,3:11 - 11:5 - 5:11 - 8:11 - 0:0
15587960,2023-12-06 14:55:00,Soghomonyan Hrayr - Nikoghosyan Narek,2:3,6:11 - 11:6 - 11:7 - 4:11 - 11:9,3,2,Soghomonyan Hrayr,Nikoghosyan Narek,fiurst,Nikoghosyan Narek - Soghomonyan Hrayr,87,44,43,-1,1,17,17,18,15,20,-5,5,4,-7,2,-1,11:6 - 6:11 - 7:11 - 11:4 - 9:11
15587959,2023-12-06 14:40:00,Arutyunov Ruben - Nazaryan Mushegh,1:3,5:11 - 13:11 - 7:11 - 9:11 - 0:0,1,3,Arutyunov Ruben,Nazaryan Mushegh,fiurst,Arutyunov Ruben - Nazaryan Mushegh,78,34,44,10,-10,16,24,18,20,0,6,-2,4,2,0,10,5:11 - 13:11 - 7:11 - 9:11 - 0:0
15587958,2023-12-06 14:25:00,Rafayelyan Edgar - Soghomonyan Hrayr,3:0,11:4 - 12:10 - 11:3 - 0:0 - 0:0,3,0,Rafayelyan Edgar,Soghomonyan Hrayr,fiurst,Rafayelyan Edgar - Soghomonyan Hrayr,51,34,17,-17,17,15,22,14,0,0,-7,-2,-8,0,0,-17,11:4 - 12:10 - 11:3 - 0:0 - 0:0
15587955,2023-12-06 14:05:00,Arutyunov Ruben - Nikoghosyan Narek,3:1,11:6 - 5:11 - 11:9 - 11:5 - 0:0,3,1,Arutyunov Ruben,Nikoghosyan Narek,fiurst,Arutyunov Ruben - Nikoghosyan Narek,69,38,31,-7,7,17,16,20,16,0,-5,6,-2,-6,0,-7,11:6 - 5:11 - 11:9 - 11:5 - 0:0
15587944,2023-12-06 13:45:00,Nazaryan Mushegh - Soghomonyan Hrayr,2:3,11:8 - 9:11 - 11:7 - 8:11 - 7:11,2,3,Nazaryan Mushegh,Soghomonyan Hrayr,fiurst,Nazaryan Mushegh - Soghomonyan Hrayr,94,46,48,2,-2,19,20,18,19,18,-3,2,-4,3,4,2,11:8 - 9:11 - 11:7 - 8:11 - 7:11
15587943,2023-12-06 13:40:00,Rafayelyan Edgar - Arutyunov Ruben,0:3,11:9 - 11:4 - 11:9 - 0:0 - 0:0,3,0,Rafayelyan Edgar,Arutyunov Ruben,fiurst,Arutyunov Ruben - Rafayelyan Edgar,55,22,33,11,-11,20,15,20,0,0,2,7,2,0,0,11,9:11 - 4:11 - 9:11 - 0:0 - 0:0
15587940,2023-12-06 13:15:00,Nikoghosyan Narek - Nazaryan Mushegh,0:3,11:4 - 11:6 - 11:9 - 0:0 - 0:0,3,0,Nikoghosyan Narek,Nazaryan Mushegh,fiurst,Nazaryan Mushegh - Nikoghosyan Narek,52,19,33,14,-14,15,17,20,0,0,7,5,2,0,0,14,4:11 - 6:11 - 9:11 - 0:0 - 0:0
15587937,2023-12-06 13:05:00,Soghomonyan Hrayr - Arutyunov Ruben,1:3,9:11 - 11:7 - 13:11 - 11:9 - 0:0,3,1,Soghomonyan Hrayr,Arutyunov Ruben,fiurst,Arutyunov Ruben - Soghomonyan Hrayr,82,38,44,6,-6,20,18,24,20,0,-2,4,2,2,0,6,11:9 - 7:11 - 11:13 - 9:11 - 0:0
15587933,2023-12-06 12:55:00,Nikoghosyan Narek - Rafayelyan Edgar,3:2,4:11 - 11:6 - 11:3 - 7:11 - 11:4,3,2,Nikoghosyan Narek,Rafayelyan Edgar,fiurst,Nikoghosyan Narek - Rafayelyan Edgar,79,44,35,-9,9,15,17,14,18,15,7,-5,-8,4,-7,-9,4:11 - 11:6 - 11:3 - 7:11 - 11:4
15587930,2023-12-06 12:15:00,Nazaryan Mushegh - Arutyunov Ruben,2:3,7:11 - 11:6 - 11:4 - 5:11 - 11:8,3,2,Nazaryan Mushegh,Arutyunov Ruben,fiurst,Arutyunov Ruben - Nazaryan Mushegh,85,40,45,5,-5,18,17,15,16,19,-4,5,7,-6,3,5,11:7 - 6:11 - 4:11 - 11:5 - 8:11
15587929,2023-12-06 12:10:00,Nikoghosyan Narek - Soghomonyan Hrayr,3:2,9:11 - 6:11 - 11:6 - 11:7 - 11:9,3,2,Nikoghosyan Narek,Soghomonyan Hrayr,fiurst,Nikoghosyan Narek - Soghomonyan Hrayr,92,48,44,-4,4,20,17,17,18,20,2,5,-5,-4,-2,-4,9:11 - 6:11 - 11:6 - 11:7 - 11:9
15587928,2023-12-06 11:45:00,Rafayelyan Edgar - Nazaryan Mushegh,0:3,11:7 - 11:4 - 11:3 - 0:0 - 0:0,3,0,Rafayelyan Edgar,Nazaryan Mushegh,fiurst,Nazaryan Mushegh - Rafayelyan Edgar,47,14,33,19,-19,18,15,14,0,0,4,7,8,0,0,19,7:11 - 4:11 - 3:11 - 0:0 - 0:0
15587917,2023-12-06 11:30:00,Nikoghosyan Narek - Arutyunov Ruben,2:3,11:3 - 6:11 - 6:11 - 12:10 - 11:8,3,2,Nikoghosyan Narek,Arutyunov Ruben,fiurst,Arutyunov Ruben - Nikoghosyan Narek,89,43,46,3,-3,14,17,17,22,19,8,-5,-5,2,3,3,3:11 - 11:6 - 11:6 - 10:12 - 8:11
15587912,2023-12-06 11:15:00,Soghomonyan Hrayr - Rafayelyan Edgar,3:0,9:11 - 9:11 - 6:11 - 0:0 - 0:0,0,3,Soghomonyan Hrayr,Rafayelyan Edgar,fiurst,Rafayelyan Edgar - Soghomonyan Hrayr,57,33,24,-9,9,20,20,17,0,0,-2,-2,-5,0,0,-9,11:9 - 11:9 - 11:6 - 0:0 - 0:0
15587903,2023-12-06 11:00:00,Nazaryan Mushegh - Nikoghosyan Narek,1:3,8:11 - 7:11 - 11:8 - 6:11 - 0:0,1,3,Nazaryan Mushegh,Nikoghosyan Narek,fiurst,Nazaryan Mushegh - Nikoghosyan Narek,73,32,41,9,-9,19,18,19,17,0,3,4,-3,5,0,9,8:11 - 7:11 - 11:8 - 6:11 - 0:0
15587902,2023-12-06 10:45:00,Arutyunov Ruben - Rafayelyan Edgar,0:3,5:11 - 8:11 - 8:11 - 0:0 - 0:0,0,3,Arutyunov Ruben,Rafayelyan Edgar,fiurst,Arutyunov Ruben - Rafayelyan Edgar,54,21,33,12,-12,16,19,19,0,0,6,3,3,0,0,12,5:11 - 8:11 - 8:11 - 0:0 - 0:0
15587901,2023-12-06 10:35:00,Soghomonyan Hrayr - Nazaryan Mushegh,3:0,7:11 - 11:13 - 8:11 - 0:0 - 0:0,0,3,Soghomonyan Hrayr,Nazaryan Mushegh,fiurst,Nazaryan Mushegh - Soghomonyan Hrayr,61,35,26,-9,9,18,24,19,0,0,-4,-2,-3,0,0,-9,11:7 - 13:11 - 11:8 - 0:0 - 0:0
15587900,2023-12-06 10:15:00,Rafayelyan Edgar - Nikoghosyan Narek,3:1,8:11 - 11:4 - 4:11 - 8:11 - 0:0,1,3,Rafayelyan Edgar,Nikoghosyan Narek,fiurst,Nikoghosyan Narek - Rafayelyan Edgar,68,37,31,-6,6,19,15,15,19,0,-3,7,-7,-3,0,-6,11:8 - 4:11 - 11:4 - 11:8 - 0:0
15587899,2023-12-06 10:00:00,Arutyunov Ruben - Soghomonyan Hrayr,3:1,14:12 - 11:8 - 9:11 - 11:6 - 0:0,3,1,Arutyunov Ruben,Soghomonyan Hrayr,fiurst,Arutyunov Ruben - Soghomonyan Hrayr,82,45,37,-8,8,26,19,20,17,0,-2,-3,2,-5,0,-8,14:12 - 11:8 - 9:11 - 11:6 - 0:0
15569688,2023-12-05 17:30:00,Grigoryan Erik - Petrosyan Davit,3:1,11:7 - 12:14 - 11:6 - 11:7 - 0:0,3,1,Grigoryan Erik,Petrosyan Davit,fiurst,Grigoryan Erik - Petrosyan Davit,79,45,34,-11,11,18,26,17,18,0,-4,2,-5,-4,0,-11,11:7 - 12:14 - 11:6 - 11:7 - 0:0
15569687,2023-12-05 17:15:00,Gevorgyan Gegham - Gevorgyan Hayk,0:3,4:11 - 9:11 - 6:11 - 0:0 - 0:0,0,3,Gevorgyan Gegham,Gevorgyan Hayk,fiurst,Gevorgyan Gegham - Gevorgyan Hayk,52,19,33,14,-14,15,20,17,0,0,7,2,5,0,0,14,4:11 - 9:11 - 6:11 - 0:0 - 0:0
15569685,2023-12-05 17:00:00,Avakimyan Davit - Grigoryan Erik,3:0,11:7 - 11:8 - 11:5 - 0:0 - 0:0,3,0,Avakimyan Davit,Grigoryan Erik,fiurst,Avakimyan Davit - Grigoryan Erik,53,33,20,-13,13,18,19,16,0,0,-4,-3,-6,0,0,-13,11:7 - 11:8 - 11:5 - 0:0 - 0:0
15569670,2023-12-05 16:45:00,Gevorgyan Gegham - Petrosyan Davit,1:3,11:4 - 1:11 - 7:11 - 6:11 - 0:0,1,3,Gevorgyan Gegham,Petrosyan Davit,fiurst,Gevorgyan Gegham - Petrosyan Davit,62,25,37,12,-12,15,12,18,17,0,-7,10,4,5,0,12,11:4 - 1:11 - 7:11 - 6:11 - 0:0
15569667,2023-12-05 16:30:00,Gevorgyan Hayk - Avakimyan Davit,0:3,11:5 - 11:7 - 11:7 - 0:0 - 0:0,3,0,Gevorgyan Hayk,Avakimyan Davit,fiurst,Avakimyan Davit - Gevorgyan Hayk,52,19,33,14,-14,16,18,18,0,0,6,4,4,0,0,14,5:11 - 7:11 - 7:11 - 0:0 - 0:0
15569665,2023-12-05 16:15:00,Grigoryan Erik - Gevorgyan Gegham,3:0,1:11 - 6:11 - 7:11 - 0:0 - 0:0,0,3,Grigoryan Erik,Gevorgyan Gegham,fiurst,Gevorgyan Gegham - Grigoryan Erik,47,33,14,-19,19,12,17,18,0,0,-10,-5,-4,0,0,-19,11:1 - 11:6 - 11:7 - 0:0 - 0:0
15569664,2023-12-05 16:00:00,Petrosyan Davit - Avakimyan Davit,2:3,11:7 - 7:11 - 12:10 - 7:11 - 11:9,3,2,Petrosyan Davit,Avakimyan Davit,fiurst,Avakimyan Davit - Petrosyan Davit,96,48,48,0,0,18,18,22,18,20,4,-4,2,-4,2,0,7:11 - 11:7 - 10:12 - 11:7 - 9:11
15569661,2023-12-05 16:00:00,Gevorgyan Hayk - Grigoryan Erik,3:0,11:7 - 11:9 - 11:7 - 0:0 - 0:0,3,0,Gevorgyan Hayk,Grigoryan Erik,fiurst,Gevorgyan Hayk - Grigoryan Erik,56,33,23,-10,10,18,20,18,0,0,-4,-2,-4,0,0,-10,11:7 - 11:9 - 11:7 - 0:0 - 0:0
15569660,2023-12-05 15:35:00,Avakimyan Davit - Gevorgyan Gegham,3:1,11:4 - 11:5 - 2:11 - 11:3 - 0:0,3,1,Avakimyan Davit,Gevorgyan Gegham,fiurst,Avakimyan Davit - Gevorgyan Gegham,58,35,23,-12,12,15,16,13,14,0,-7,-6,9,-8,0,-12,11:4 - 11:5 - 2:11 - 11:3 - 0:0
15587730,2023-12-05 15:20:00,Gevorgyan Hayk - Petrosyan Davit,2:3,11:13 - 8:11 - 11:4 - 12:10 - 10:12,2,3,Gevorgyan Hayk,Petrosyan Davit,fiurst,Gevorgyan Hayk - Petrosyan Davit,102,52,50,-2,2,24,19,15,22,22,2,3,-7,-2,2,-2,11:13 - 8:11 - 11:4 - 12:10 - 10:12
15569656,2023-12-05 15:10:00,Diaryan Aleksandr - Arutyunov Ruben,1:3,9:11 - 11:4 - 11:8 - 11:4 - 0:0,3,1,Diaryan Aleksandr,Arutyunov Ruben,fiurst,Arutyunov Ruben - Diaryan Aleksandr,69,27,42,15,-15,20,15,19,15,0,-2,7,3,7,0,15,11:9 - 4:11 - 8:11 - 4:11 - 0:0
15569658,2023-12-05 15:10:00,Petrosyan Davit - Gevorgyan Hayk,0:0,0:0 - 0:0 - 0:0 - 0:0 - 0:0,0,0,Petrosyan Davit,Gevorgyan Hayk,fiurst,Gevorgyan Hayk - Petrosyan Davit,0,0,0,0,0,0,0,0,0,0,0,0,0,0,0,0,0:0 - 0:0 - 0:0 - 0:0 - 0:0
15569645,2023-12-05 14:45:00,Mkrtchyan Andranik - Nazaryan Mushegh,2:3,12:14 - 11:8 - 4:11 - 11:9 - 5:11,2,3,Mkrtchyan Andranik,Nazaryan Mushegh,fiurst,Mkrtchyan Andranik - Nazaryan Mushegh,96,43,53,10,-10,26,19,15,20,16,2,-3,7,-2,6,10,12:14 - 11:8 - 4:11 - 11:9 - 5:11
15569643,2023-12-05 14:30:00,Nikoghosyan Narek - Diaryan Aleksandr,2:3,11:7 - 8:11 - 11:4 - 4:11 - 11:8,3,2,Nikoghosyan Narek,Diaryan Aleksandr,fiurst,Diaryan Aleksandr - Nikoghosyan Narek,86,41,45,4,-4,18,19,15,15,19,4,-3,7,-7,3,4,7:11 - 11:8 - 4:11 - 11:4 - 8:11
15569642,2023-12-05 14:20:00,Arutyunov Ruben - Mkrtchyan Andranik,3:1,8:11 - 11:5 - 11:4 - 11:4 - 0:0,3,1,Arutyunov Ruben,Mkrtchyan Andranik,fiurst,Arutyunov Ruben - Mkrtchyan Andranik,65,41,24,-17,17,19,16,15,15,0,3,-6,-7,-7,0,-17,8:11 - 11:5 - 11:4 - 11:4 - 0:0
15569641,2023-12-05 14:05:00,Nikoghosyan Narek - Nazaryan Mushegh,1:3,11:3 - 4:11 - 11:8 - 11:7 - 0:0,3,1,Nikoghosyan Narek,Nazaryan Mushegh,fiurst,Nazaryan Mushegh - Nikoghosyan Narek,66,29,37,8,-8,14,15,19,18,0,8,-7,3,4,0,8,3:11 - 11:4 - 8:11 - 7:11 - 0:0
15569640,2023-12-05 13:50:00,Diaryan Aleksandr - Mkrtchyan Andranik,3:0,11:6 - 11:6 - 12:10 - 0:0 - 0:0,3,0,Diaryan Aleksandr,Mkrtchyan Andranik,fiurst,Diaryan Aleksandr - Mkrtchyan Andranik,56,34,22,-12,12,17,17,22,0,0,-5,-5,-2,0,0,-12,11:6 - 11:6 - 12:10 - 0:0 - 0:0
15586395,2023-12-05 13:40:00,Nikoghosyan Narek - Arutyunov Ruben,0:3,11:7 - 11:8 - 11:6 - 0:0 - 0:0,3,0,Nikoghosyan Narek,Arutyunov Ruben,fiurst,Arutyunov Ruben - Nikoghosyan Narek,54,21,33,12,-12,18,19,17,0,0,4,3,5,0,0,12,7:11 - 8:11 - 6:11 - 0:0 - 0:0
15569637,2023-12-05 13:30:00,Arutyunov Ruben - Nikoghosyan Narek,0:0,0:0 - 0:0 - 0:0 - 0:0 - 0:0,0,0,Arutyunov Ruben,Nikoghosyan Narek,fiurst,Arutyunov Ruben - Nikoghosyan Narek,0,0,0,0,0,0,0,0,0,0,0,0,0,0,0,0,0:0 - 0:0 - 0:0 - 0:0 - 0:0
15569636,2023-12-05 13:20:00,Nazaryan Mushegh - Diaryan Aleksandr,2:3,3:11 - 11:9 - 5:11 - 11:7 - 12:10,3,2,Nazaryan Mushegh,Diaryan Aleksandr,fiurst,Diaryan Aleksandr - Nazaryan Mushegh,90,48,42,-6,6,14,20,16,18,22,-8,2,-6,4,2,-6,11:3 - 9:11 - 11:5 - 7:11 - 10:12
15569635,2023-12-05 13:10:00,Mkrtchyan Andranik - Nikoghosyan Narek,1:3,14:12 - 3:11 - 4:11 - 4:11 - 0:0,1,3,Mkrtchyan Andranik,Nikoghosyan Narek,fiurst,Mkrtchyan Andranik - Nikoghosyan Narek,70,25,45,20,-20,26,14,15,15,0,-2,8,7,7,0,20,14:12 - 3:11 - 4:11 - 4:11 - 0:0
15569633,2023-12-05 12:50:00,Nazaryan Mushegh - Arutyunov Ruben,0:3,12:10 - 11:8 - 11:9 - 0:0 - 0:0,3,0,Nazaryan Mushegh,Arutyunov Ruben,fiurst,Arutyunov Ruben - Nazaryan Mushegh,61,27,34,7,-7,22,19,20,0,0,2,3,2,0,0,7,10:12 - 8:11 - 9:11 - 0:0 - 0:0
15569632,2023-12-05 12:20:00,Diaryan Aleksandr - Nikoghosyan Narek,3:2,11:7 - 6:11 - 11:4 - 9:11 - 11:5,3,2,Diaryan Aleksandr,Nikoghosyan Narek,fiurst,Diaryan Aleksandr - Nikoghosyan Narek,86,48,38,-10,10,18,17,15,20,16,-4,5,-7,2,-6,-10,11:7 - 6:11 - 11:4 - 9:11 - 11:5
15569621,2023-12-05 12:10:00,Nazaryan Mushegh - Mkrtchyan Andranik,0:3,11:3 - 11:9 - 11:9 - 0:0 - 0:0,3,0,Nazaryan Mushegh,Mkrtchyan Andranik,fiurst,Mkrtchyan Andranik - Nazaryan Mushegh,54,21,33,12,-12,14,20,20,0,0,8,2,2,0,0,12,3:11 - 9:11 - 9:11 - 0:0 - 0:0
15569617,2023-12-05 11:45:00,Arutyunov Ruben - Diaryan Aleksandr,1:3,7:11 - 9:11 - 11:9 - 8:11 - 0:0,1,3,Arutyunov Ruben,Diaryan Aleksandr,fiurst,Arutyunov Ruben - Diaryan Aleksandr,77,35,42,7,-7,18,20,20,19,0,4,2,-2,3,0,7,7:11 - 9:11 - 11:9 - 8:11 - 0:0
15569615,2023-12-05 11:35:00,Nazaryan Mushegh - Nikoghosyan Narek,3:1,11:9 - 7:11 - 11:2 - 11:9 - 0:0,3,1,Nazaryan Mushegh,Nikoghosyan Narek,fiurst,Nazaryan Mushegh - Nikoghosyan Narek,71,40,31,-9,9,20,18,13,20,0,-2,4,-9,-2,0,-9,11:9 - 7:11 - 11:2 - 11:9 - 0:0
15569611,2023-12-05 11:15:00,Mkrtchyan Andranik - Arutyunov Ruben,3:0,9:11 - 9:11 - 7:11 - 0:0 - 0:0,0,3,Mkrtchyan Andranik,Arutyunov Ruben,fiurst,Arutyunov Ruben - Mkrtchyan Andranik,58,33,25,-8,8,20,20,18,0,0,-2,-2,-4,0,0,-8,11:9 - 11:9 - 11:7 - 0:0 - 0:0
15569606,2023-12-05 11:00:00,Diaryan Aleksandr - Nazaryan Mushegh,3:1,11:7 - 11:4 - 9:11 - 11:6 - 0:0,3,1,Diaryan Aleksandr,Nazaryan Mushegh,fiurst,Diaryan Aleksandr - Nazaryan Mushegh,70,42,28,-14,14,18,15,20,17,0,-4,-7,2,-5,0,-14,11:7 - 11:4 - 9:11 - 11:6 - 0:0
15569598,2023-12-05 10:50:00,Nikoghosyan Narek - Arutyunov Ruben,3:0,5:11 - 3:11 - 5:11 - 0:0 - 0:0,0,3,Nikoghosyan Narek,Arutyunov Ruben,fiurst,Arutyunov Ruben - Nikoghosyan Narek,46,33,13,-20,20,16,14,16,0,0,-6,-8,-6,0,0,-20,11:5 - 11:3 - 11:5 - 0:0 - 0:0
15569592,2023-12-05 10:30:00,Mkrtchyan Andranik - Diaryan Aleksandr,3:0,9:11 - 6:11 - 5:11 - 0:0 - 0:0,0,3,Mkrtchyan Andranik,Diaryan Aleksandr,fiurst,Diaryan Aleksandr - Mkrtchyan Andranik,53,33,20,-13,13,20,17,16,0,0,-2,-5,-6,0,0,-13,11:9 - 11:6 - 11:5 - 0:0 - 0:0
15569582,2023-12-05 10:15:00,Arutyunov Ruben - Nazaryan Mushegh,1:3,12:10 - 9:11 - 6:11 - 9:11 - 0:0,1,3,Arutyunov Ruben,Nazaryan Mushegh,fiurst,Arutyunov Ruben - Nazaryan Mushegh,79,36,43,7,-7,22,20,17,20,0,-2,2,5,2,0,7,12:10 - 9:11 - 6:11 - 9:11 - 0:0
15569581,2023-12-05 10:00:00,Nikoghosyan Narek - Mkrtchyan Andranik,1:3,11:5 - 9:11 - 11:7 - 11:6 - 0:0,3,1,Nikoghosyan Narek,Mkrtchyan Andranik,fiurst,Mkrtchyan Andranik - Nikoghosyan Narek,71,29,42,13,-13,16,20,18,17,0,6,-2,4,5,0,13,5:11 - 11:9 - 7:11 - 6:11 - 0:0
15546107,2023-12-04 17:30:00,Darbinyan Armen - Gevorgyan Gegham,0:3,5:11 - 6:11 - 6:11 - 0:0 - 0:0,0,3,Darbinyan Armen,Gevorgyan Gegham,fiurst,Darbinyan Armen - Gevorgyan Gegham,50,17,33,16,-16,16,17,17,0,0,6,5,5,0,0,16,5:11 - 6:11 - 6:11 - 0:0 - 0:0
15546106,2023-12-04 17:15:00,Grigoryan Erik - Petrosyan Davit,1:3,11:9 - 4:11 - 6:11 - 6:11 - 0:0,1,3,Grigoryan Erik,Petrosyan Davit,fiurst,Grigoryan Erik - Petrosyan Davit,69,27,42,15,-15,20,15,17,17,0,-2,7,5,5,0,15,11:9 - 4:11 - 6:11 - 6:11 - 0:0
15546103,2023-12-04 17:10:00,Gevorgyan Hayk - Darbinyan Armen,0:3,11:4 - 11:8 - 11:4 - 0:0 - 0:0,3,0,Gevorgyan Hayk,Darbinyan Armen,fiurst,Darbinyan Armen - Gevorgyan Hayk,49,16,33,17,-17,15,19,15,0,0,7,3,7,0,0,17,4:11 - 8:11 - 4:11 - 0:0 - 0:0
15546094,2023-12-04 16:45:00,Grigoryan Erik - Gevorgyan Gegham,3:2,11:9 - 3:11 - 7:11 - 11:8 - 7:11,2,3,Grigoryan Erik,Gevorgyan Gegham,fiurst,Gevorgyan Gegham - Grigoryan Erik,89,50,39,-11,11,20,14,18,19,18,2,-8,-4,3,-4,-11,9:11 - 11:3 - 11:7 - 8:11 - 11:7
15546084,2023-12-04 16:40:00,Petrosyan Davit - Gevorgyan Hayk,2:3,8:11 - 11:5 - 7:11 - 11:6 - 11:9,3,2,Petrosyan Davit,Gevorgyan Hayk,fiurst,Gevorgyan Hayk - Petrosyan Davit,90,42,48,6,-6,19,16,18,17,20,-3,6,-4,5,2,6,11:8 - 5:11 - 11:7 - 6:11 - 9:11
15546070,2023-12-04 16:15:00,Gevorgyan Gegham - Gevorgyan Hayk,0:3,8:11 - 6:11 - 6:11 - 0:0 - 0:0,0,3,Gevorgyan Gegham,Gevorgyan Hayk,fiurst,Gevorgyan Gegham - Gevorgyan Hayk,53,20,33,13,-13,19,17,17,0,0,3,5,5,0,0,13,8:11 - 6:11 - 6:11 - 0:0 - 0:0
15546081,2023-12-04 16:15:00,Darbinyan Armen - Grigoryan Erik,0:3,4:11 - 5:11 - 5:11 - 0:0 - 0:0,0,3,Darbinyan Armen,Grigoryan Erik,fiurst,Darbinyan Armen - Grigoryan Erik,47,14,33,19,-19,15,16,16,0,0,7,6,6,0,0,19,4:11 - 5:11 - 5:11 - 0:0 - 0:0
15546067,2023-12-04 15:45:00,Petrosyan Davit - Darbinyan Armen,0:3,11:3 - 11:3 - 11:2 - 0:0 - 0:0,3,0,Petrosyan Davit,Darbinyan Armen,fiurst,Darbinyan Armen - Petrosyan Davit,41,8,33,25,-25,14,14,13,0,0,8,8,9,0,0,25,3:11 - 3:11 - 2:11 - 0:0 - 0:0
15546063,2023-12-04 15:35:00,Gevorgyan Hayk - Grigoryan Erik,3:2,14:12 - 9:11 - 11:8 - 8:11 - 13:11,3,2,Gevorgyan Hayk,Grigoryan Erik,fiurst,Gevorgyan Hayk - Grigoryan Erik,108,55,53,-2,2,26,20,19,19,24,-2,2,-3,3,-2,-2,14:12 - 9:11 - 11:8 - 8:11 - 13:11
15546062,2023-12-04 15:15:00,Gevorgyan Gegham - Petrosyan Davit,1:3,10:12 - 8:11 - 11:5 - 4:11 - 0:0,1,3,Gevorgyan Gegham,Petrosyan Davit,fiurst,Gevorgyan Gegham - Petrosyan Davit,72,33,39,6,-6,22,19,16,15,0,2,3,-6,7,0,6,10:12 - 8:11 - 11:5 - 4:11 - 0:0
15546060,2023-12-04 15:00:00,Soghomonyan Hrayr - Mkrtchyan Andranik,3:2,11:9 - 11:5 - 8:11 - 7:11 - 8:11,2,3,Soghomonyan Hrayr,Mkrtchyan Andranik,fiurst,Mkrtchyan Andranik - Soghomonyan Hrayr,92,47,45,-2,2,20,16,19,18,19,2,6,-3,-4,-3,-2,9:11 - 5:11 - 11:8 - 11:7 - 11:8
15546059,2023-12-04 14:50:00,Arutyunov Ruben - Diaryan Aleksandr,0:3,6:11 - 5:11 - 5:11 - 0:0 - 0:0,0,3,Arutyunov Ruben,Diaryan Aleksandr,fiurst,Arutyunov Ruben - Diaryan Aleksandr,49,16,33,17,-17,17,16,16,0,0,5,6,6,0,0,17,6:11 - 5:11 - 5:11 - 0:0 - 0:0
15546058,2023-12-04 14:35:00,Rafayelyan Edgar - Soghomonyan Hrayr,3:0,11:5 - 11:5 - 11:6 - 0:0 - 0:0,3,0,Rafayelyan Edgar,Soghomonyan Hrayr,fiurst,Rafayelyan Edgar - Soghomonyan Hrayr,49,33,16,-17,17,16,16,17,0,0,-6,-6,-5,0,0,-17,11:5 - 11:5 - 11:6 - 0:0 - 0:0
15546046,2023-12-04 14:15:00,Mkrtchyan Andranik - Arutyunov Ruben,3:1,9:11 - 13:11 - 10:12 - 6:11 - 0:0,1,3,Mkrtchyan Andranik,Arutyunov Ruben,fiurst,Arutyunov Ruben - Mkrtchyan Andranik,83,45,38,-7,7,20,24,22,17,0,-2,2,-2,-5,0,-7,11:9 - 11:13 - 12:10 - 11:6 - 0:0
15546045,2023-12-04 14:00:00,Rafayelyan Edgar - Diaryan Aleksandr,0:3,11:5 - 13:11 - 11:8 - 0:0 - 0:0,3,0,Rafayelyan Edgar,Diaryan Aleksandr,fiurst,Diaryan Aleksandr - Rafayelyan Edgar,59,24,35,11,-11,16,24,19,0,0,6,2,3,0,0,11,5:11 - 11:13 - 8:11 - 0:0 - 0:0
15546044,2023-12-04 13:45:00,Soghomonyan Hrayr - Arutyunov Ruben,0:3,11:9 - 12:10 - 11:7 - 0:0 - 0:0,3,0,Soghomonyan Hrayr,Arutyunov Ruben,fiurst,Arutyunov Ruben - Soghomonyan Hrayr,60,26,34,8,-8,20,22,18,0,0,2,2,4,0,0,8,9:11 - 10:12 - 7:11 - 0:0 - 0:0
15546042,2023-12-04 13:30:00,Mkrtchyan Andranik - Rafayelyan Edgar,1:3,11:6 - 9:11 - 9:11 - 9:11 - 0:0,1,3,Mkrtchyan Andranik,Rafayelyan Edgar,fiurst,Mkrtchyan Andranik - Rafayelyan Edgar,77,38,39,1,-1,17,20,20,20,0,-5,2,2,2,0,1,11:6 - 9:11 - 9:11 - 9:11 - 0:0
15546040,2023-12-04 13:15:00,Diaryan Aleksandr - Soghomonyan Hrayr,0:3,7:11 - 6:11 - 5:11 - 0:0 - 0:0,0,3,Diaryan Aleksandr,Soghomonyan Hrayr,fiurst,Diaryan Aleksandr - Soghomonyan Hrayr,51,18,33,15,-15,18,17,16,0,0,4,5,6,0,0,15,7:11 - 6:11 - 5:11 - 0:0 - 0:0
15546039,2023-12-04 13:00:00,Arutyunov Ruben - Rafayelyan Edgar,0:3,4:11 - 6:11 - 5:11 - 0:0 - 0:0,0,3,Arutyunov Ruben,Rafayelyan Edgar,fiurst,Arutyunov Ruben - Rafayelyan Edgar,48,15,33,18,-18,15,17,16,0,0,7,5,6,0,0,18,4:11 - 6:11 - 5:11 - 0:0 - 0:0
15546037,2023-12-04 12:45:00,Diaryan Aleksandr - Mkrtchyan Andranik,3:1,11:8 - 11:2 - 8:11 - 11:7 - 0:0,3,1,Diaryan Aleksandr,Mkrtchyan Andranik,fiurst,Diaryan Aleksandr - Mkrtchyan Andranik,69,41,28,-13,13,19,13,19,18,0,-3,-9,3,-4,0,-13,11:8 - 11:2 - 8:11 - 11:7 - 0:0
15546036,2023-12-04 12:20:00,Soghomonyan Hrayr - Rafayelyan Edgar,3:0,7:11 - 7:11 - 5:11 - 0:0 - 0:0,0,3,Soghomonyan Hrayr,Rafayelyan Edgar,fiurst,Rafayelyan Edgar - Soghomonyan Hrayr,52,33,19,-14,14,18,18,16,0,0,-4,-4,-6,0,0,-14,11:7 - 11:7 - 11:5 - 0:0 - 0:0
15546028,2023-12-04 12:10:00,Diaryan Aleksandr - Arutyunov Ruben,0:3,11:8 - 11:3 - 11:7 - 0:0 - 0:0,3,0,Diaryan Aleksandr,Arutyunov Ruben,fiurst,Arutyunov Ruben - Diaryan Aleksandr,51,18,33,15,-15,19,14,18,0,0,3,8,4,0,0,15,8:11 - 3:11 - 7:11 - 0:0 - 0:0
15546008,2023-12-04 11:45:00,Mkrtchyan Andranik - Soghomonyan Hrayr,0:3,8:11 - 7:11 - 8:11 - 0:0 - 0:0,0,3,Mkrtchyan Andranik,Soghomonyan Hrayr,fiurst,Mkrtchyan Andranik - Soghomonyan Hrayr,56,23,33,10,-10,19,18,19,0,0,3,4,3,0,0,10,8:11 - 7:11 - 8:11 - 0:0 - 0:0
15546001,2023-12-04 11:30:00,Diaryan Aleksandr - Rafayelyan Edgar,3:2,14:16 - 5:11 - 11:6 - 12:10 - 11:6,3,2,Diaryan Aleksandr,Rafayelyan Edgar,fiurst,Diaryan Aleksandr - Rafayelyan Edgar,102,53,49,-4,4,30,16,17,22,17,2,6,-5,-2,-5,-4,14:16 - 5:11 - 11:6 - 12:10 - 11:6
15546000,2023-12-04 11:15:00,Arutyunov Ruben - Mkrtchyan Andranik,3:2,6:11 - 5:11 - 11:6 - 11:7 - 11:3,3,2,Arutyunov Ruben,Mkrtchyan Andranik,fiurst,Arutyunov Ruben - Mkrtchyan Andranik,82,44,38,-6,6,17,16,17,18,14,5,6,-5,-4,-8,-6,6:11 - 5:11 - 11:6 - 11:7 - 11:3
15545998,2023-12-04 11:00:00,Soghomonyan Hrayr - Diaryan Aleksandr,3:0,9:11 - 9:11 - 4:11 - 0:0 - 0:0,0,3,Soghomonyan Hrayr,Diaryan Aleksandr,fiurst,Diaryan Aleksandr - Soghomonyan Hrayr,55,33,22,-11,11,20,20,15,0,0,-2,-2,-7,0,0,-11,11:9 - 11:9 - 11:4 - 0:0 - 0:0
15545995,2023-12-04 10:45:00,Rafayelyan Edgar - Mkrtchyan Andranik,1:3,9:11 - 11:9 - 11:9 - 11:9 - 0:0,3,1,Rafayelyan Edgar,Mkrtchyan Andranik,fiurst,Mkrtchyan Andranik - Rafayelyan Edgar,80,38,42,4,-4,20,20,20,20,0,-2,2,2,2,0,4,11:9 - 9:11 - 9:11 - 9:11 - 0:0
15545958,2023-12-04 10:30:00,Arutyunov Ruben - Soghomonyan Hrayr,1:3,8:11 - 5:11 - 11:8 - 8:11 - 0:0,1,3,Arutyunov Ruben,Soghomonyan Hrayr,fiurst,Arutyunov Ruben - Soghomonyan Hrayr,73,32,41,9,-9,19,16,19,19,0,3,6,-3,3,0,9,8:11 - 5:11 - 11:8 - 8:11 - 0:0
15545956,2023-12-04 10:15:00,Mkrtchyan Andranik - Diaryan Aleksandr,3:0,5:11 - 8:11 - 2:11 - 0:0 - 0:0,0,3,Mkrtchyan Andranik,Diaryan Aleksandr,fiurst,Diaryan Aleksandr - Mkrtchyan Andranik,48,33,15,-18,18,16,19,13,0,0,-6,-3,-9,0,0,-18,11:5 - 11:8 - 11:2 - 0:0 - 0:0
15545952,2023-12-04 10:00:00,Rafayelyan Edgar - Arutyunov Ruben,0:3,11:9 - 11:7 - 11:5 - 0:0 - 0:0,3,0,Rafayelyan Edgar,Arutyunov Ruben,fiurst,Arutyunov Ruben - Rafayelyan Edgar,54,21,33,12,-12,20,18,16,0,0,2,4,6,0,0,12,9:11 - 7:11 - 5:11 - 0:0 - 0:0
15533451,2023-12-03 17:30:00,Petrosyan Davit - Grigoryan Erik,0:3,11:6 - 11:6 - 12:10 - 0:0 - 0:0,3,0,Petrosyan Davit,Grigoryan Erik,fiurst,Grigoryan Erik - Petrosyan Davit,56,22,34,12,-12,17,17,22,0,0,5,5,2,0,0,12,6:11 - 6:11 - 10:12 - 0:0 - 0:0
15533440,2023-12-03 17:15:00,Darbinyan Armen - Gevorgyan Gegham,0:3,3:11 - 4:11 - 7:11 - 0:0 - 0:0,0,3,Darbinyan Armen,Gevorgyan Gegham,fiurst,Darbinyan Armen - Gevorgyan Gegham,47,14,33,19,-19,14,15,18,0,0,8,7,4,0,0,19,3:11 - 4:11 - 7:11 - 0:0 - 0:0
15533439,2023-12-03 17:00:00,Gevorgyan Hayk - Petrosyan Davit,3:1,8:11 - 11:4 - 11:6 - 11:2 - 0:0,3,1,Gevorgyan Hayk,Petrosyan Davit,fiurst,Gevorgyan Hayk - Petrosyan Davit,64,41,23,-18,18,19,15,17,13,0,3,-7,-5,-9,0,-18,8:11 - 11:4 - 11:6 - 11:2 - 0:0
15533438,2023-12-03 16:45:00,Darbinyan Armen - Grigoryan Erik,0:3,7:11 - 3:11 - 9:11 - 0:0 - 0:0,0,3,Darbinyan Armen,Grigoryan Erik,fiurst,Darbinyan Armen - Grigoryan Erik,52,19,33,14,-14,18,14,20,0,0,4,8,2,0,0,14,7:11 - 3:11 - 9:11 - 0:0 - 0:0
15533437,2023-12-03 16:30:00,Gevorgyan Gegham - Gevorgyan Hayk,2:3,11:8 - 2:11 - 16:14 - 9:11 - 3:11,2,3,Gevorgyan Gegham,Gevorgyan Hayk,fiurst,Gevorgyan Gegham - Gevorgyan Hayk,96,41,55,14,-14,19,13,30,20,14,-3,9,-2,2,8,14,11:8 - 2:11 - 16:14 - 9:11 - 3:11
15533434,2023-12-03 16:15:00,Petrosyan Davit - Darbinyan Armen,0:3,11:6 - 11:5 - 11:3 - 0:0 - 0:0,3,0,Petrosyan Davit,Darbinyan Armen,fiurst,Darbinyan Armen - Petrosyan Davit,47,14,33,19,-19,17,16,14,0,0,5,6,8,0,0,19,6:11 - 5:11 - 3:11 - 0:0 - 0:0
15533431,2023-12-03 16:00:00,Grigoryan Erik - Gevorgyan Hayk,3:1,4:11 - 8:11 - 11:6 - 7:11 - 0:0,1,3,Grigoryan Erik,Gevorgyan Hayk,fiurst,Gevorgyan Hayk - Grigoryan Erik,69,39,30,-9,9,15,19,17,18,0,-7,-3,5,-4,0,-9,11:4 - 11:8 - 6:11 - 11:7 - 0:0
15533424,2023-12-03 15:45:00,Gevorgyan Gegham - Petrosyan Davit,1:3,11:8 - 5:11 - 8:11 - 7:11 - 0:0,1,3,Gevorgyan Gegham,Petrosyan Davit,fiurst,Gevorgyan Gegham - Petrosyan Davit,72,31,41,10,-10,19,16,19,18,0,-3,6,3,4,0,10,11:8 - 5:11 - 8:11 - 7:11 - 0:0
15533423,2023-12-03 15:30:00,Gevorgyan Hayk - Darbinyan Armen,0:3,11:9 - 11:7 - 11:7 - 0:0 - 0:0,3,0,Gevorgyan Hayk,Darbinyan Armen,fiurst,Darbinyan Armen - Gevorgyan Hayk,56,23,33,10,-10,20,18,18,0,0,2,4,4,0,0,10,9:11 - 7:11 - 7:11 - 0:0 - 0:0
15533408,2023-12-03 15:15:00,Grigoryan Erik - Gevorgyan Gegham,1:3,11:2 - 3:11 - 11:8 - 11:9 - 0:0,3,1,Grigoryan Erik,Gevorgyan Gegham,fiurst,Gevorgyan Gegham - Grigoryan Erik,66,30,36,6,-6,13,14,19,20,0,9,-8,3,2,0,6,2:11 - 11:3 - 8:11 - 9:11 - 0:0
15533405,2023-12-03 15:00:00,Diaryan Aleksandr - Rafayelyan Edgar,1:3,10:12 - 11:6 - 4:11 - 2:11 - 0:0,1,3,Diaryan Aleksandr,Rafayelyan Edgar,fiurst,Diaryan Aleksandr - Rafayelyan Edgar,67,27,40,13,-13,22,17,15,13,0,2,-5,7,9,0,13,10:12 - 11:6 - 4:11 - 2:11 - 0:0
15533401,2023-12-03 14:45:00,Soghomonyan Hrayr - Nikoghosyan Narek,3:1,5:11 - 11:9 - 5:11 - 7:11 - 0:0,1,3,Soghomonyan Hrayr,Nikoghosyan Narek,fiurst,Nikoghosyan Narek - Soghomonyan Hrayr,70,42,28,-14,14,16,20,16,18,0,-6,2,-6,-4,0,-14,11:5 - 9:11 - 11:5 - 11:7 - 0:0
15533397,2023-12-03 14:40:00,Nazaryan Mushegh - Diaryan Aleksandr,3:0,6:11 - 6:11 - 9:11 - 0:0 - 0:0,0,3,Nazaryan Mushegh,Diaryan Aleksandr,fiurst,Diaryan Aleksandr - Nazaryan Mushegh,54,33,21,-12,12,17,17,20,0,0,-5,-5,-2,0,0,-12,11:6 - 11:6 - 11:9 - 0:0 - 0:0
15533394,2023-12-03 14:30:00,Rafayelyan Edgar - Soghomonyan Hrayr,3:0,11:8 - 11:8 - 11:6 - 0:0 - 0:0,3,0,Rafayelyan Edgar,Soghomonyan Hrayr,fiurst,Rafayelyan Edgar - Soghomonyan Hrayr,55,33,22,-11,11,19,19,17,0,0,-3,-3,-5,0,0,-11,11:8 - 11:8 - 11:6 - 0:0 - 0:0
15533389,2023-12-03 14:05:00,Nazaryan Mushegh - Nikoghosyan Narek,1:3,11:7 - 3:11 - 7:11 - 6:11 - 0:0,1,3,Nazaryan Mushegh,Nikoghosyan Narek,fiurst,Nazaryan Mushegh - Nikoghosyan Narek,67,27,40,13,-13,18,14,18,17,0,-4,8,4,5,0,13,11:7 - 3:11 - 7:11 - 6:11 - 0:0
15533381,2023-12-03 13:55:00,Diaryan Aleksandr - Soghomonyan Hrayr,3:1,11:5 - 11:6 - 9:11 - 11:8 - 0:0,3,1,Diaryan Aleksandr,Soghomonyan Hrayr,fiurst,Diaryan Aleksandr - Soghomonyan Hrayr,72,42,30,-12,12,16,17,20,19,0,-6,-5,2,-3,0,-12,11:5 - 11:6 - 9:11 - 11:8 - 0:0
15533379,2023-12-03 13:40:00,Rafayelyan Edgar - Nazaryan Mushegh,1:3,9:11 - 11:9 - 11:6 - 11:7 - 0:0,3,1,Rafayelyan Edgar,Nazaryan Mushegh,fiurst,Nazaryan Mushegh - Rafayelyan Edgar,75,33,42,9,-9,20,20,17,18,0,-2,2,5,4,0,9,11:9 - 9:11 - 6:11 - 7:11 - 0:0
15533378,2023-12-03 13:20:00,Nikoghosyan Narek - Diaryan Aleksandr,3:2,7:11 - 11:6 - 11:3 - 8:11 - 9:11,2,3,Nikoghosyan Narek,Diaryan Aleksandr,fiurst,Diaryan Aleksandr - Nikoghosyan Narek,88,42,46,4,-4,18,17,14,19,20,-4,5,8,-3,-2,4,11:7 - 6:11 - 3:11 - 11:8 - 11:9
15533376,2023-12-03 13:00:00,Soghomonyan Hrayr - Nazaryan Mushegh,1:3,10:12 - 11:8 - 13:11 - 11:8 - 0:0,3,1,Soghomonyan Hrayr,Nazaryan Mushegh,fiurst,Nazaryan Mushegh - Soghomonyan Hrayr,84,39,45,6,-6,22,19,24,19,0,-2,3,2,3,0,6,12:10 - 8:11 - 11:13 - 8:11 - 0:0
15533375,2023-12-03 12:45:00,Nikoghosyan Narek - Rafayelyan Edgar,1:3,11:7 - 4:11 - 6:11 - 4:11 - 0:0,1,3,Nikoghosyan Narek,Rafayelyan Edgar,fiurst,Nikoghosyan Narek - Rafayelyan Edgar,65,25,40,15,-15,18,15,17,15,0,-4,7,5,7,0,15,11:7 - 4:11 - 6:11 - 4:11 - 0:0
15533373,2023-12-03 12:15:00,Diaryan Aleksandr - Nazaryan Mushegh,3:1,8:11 - 11:8 - 11:7 - 11:4 - 0:0,3,1,Diaryan Aleksandr,Nazaryan Mushegh,fiurst,Diaryan Aleksandr - Nazaryan Mushegh,71,41,30,-11,11,19,19,18,15,0,3,-3,-4,-7,0,-11,8:11 - 11:8 - 11:7 - 11:4 - 0:0
15533372,2023-12-03 12:10:00,Nikoghosyan Narek - Soghomonyan Hrayr,3:0,11:7 - 11:9 - 12:10 - 0:0 - 0:0,3,0,Nikoghosyan Narek,Soghomonyan Hrayr,fiurst,Nikoghosyan Narek - Soghomonyan Hrayr,60,34,26,-8,8,18,20,22,0,0,-4,-2,-2,0,0,-8,11:7 - 11:9 - 12:10 - 0:0 - 0:0
15533371,2023-12-03 11:45:00,Rafayelyan Edgar - Diaryan Aleksandr,3:0,4:11 - 6:11 - 10:12 - 0:0 - 0:0,0,3,Rafayelyan Edgar,Diaryan Aleksandr,fiurst,Diaryan Aleksandr - Rafayelyan Edgar,54,34,20,-14,14,15,17,22,0,0,-7,-5,-2,0,0,-14,11:4 - 11:6 - 12:10 - 0:0 - 0:0
15533370,2023-12-03 11:40:00,Nikoghosyan Narek - Nazaryan Mushegh,1:3,11:5 - 11:6 - 10:12 - 11:6 - 0:0,3,1,Nikoghosyan Narek,Nazaryan Mushegh,fiurst,Nazaryan Mushegh - Nikoghosyan Narek,72,29,43,14,-14,16,17,22,17,0,6,5,-2,5,0,14,5:11 - 6:11 - 12:10 - 6:11 - 0:0
15533364,2023-12-03 11:15:00,Soghomonyan Hrayr - Rafayelyan Edgar,3:0,7:11 - 9:11 - 0:11 - 0:0 - 0:0,0,3,Soghomonyan Hrayr,Rafayelyan Edgar,fiurst,Rafayelyan Edgar - Soghomonyan Hrayr,49,33,16,-17,17,18,20,11,0,0,-4,-2,-11,0,0,-17,11:7 - 11:9 - 11:0 - 0:0 - 0:0
15533357,2023-12-03 11:00:00,Diaryan Aleksandr - Nikoghosyan Narek,2:3,11:8 - 11:6 - 10:12 - 9:11 - 7:11,2,3,Diaryan Aleksandr,Nikoghosyan Narek,fiurst,Diaryan Aleksandr - Nikoghosyan Narek,96,48,48,0,0,19,17,22,20,18,-3,-5,2,2,4,0,11:8 - 11:6 - 10:12 - 9:11 - 7:11
15533352,2023-12-03 10:45:00,Nazaryan Mushegh - Rafayelyan Edgar,2:3,5:11 - 11:8 - 11:8 - 6:11 - 8:11,2,3,Nazaryan Mushegh,Rafayelyan Edgar,fiurst,Nazaryan Mushegh - Rafayelyan Edgar,90,41,49,8,-8,16,19,19,17,19,6,-3,-3,5,3,8,5:11 - 11:8 - 11:8 - 6:11 - 8:11
15533351,2023-12-03 10:30:00,Soghomonyan Hrayr - Diaryan Aleksandr,3:1,11:5 - 5:11 - 7:11 - 3:11 - 0:0,1,3,Soghomonyan Hrayr,Diaryan Aleksandr,fiurst,Diaryan Aleksandr - Soghomonyan Hrayr,64,38,26,-12,12,16,16,18,14,0,6,-6,-4,-8,0,-12,5:11 - 11:5 - 11:7 - 11:3 - 0:0
15533349,2023-12-03 10:15:00,Rafayelyan Edgar - Nikoghosyan Narek,3:2,7:11 - 8:11 - 11:4 - 11:5 - 1:11,2,3,Rafayelyan Edgar,Nikoghosyan Narek,fiurst,Nikoghosyan Narek - Rafayelyan Edgar,80,42,38,-4,4,18,19,15,16,12,-4,-3,7,6,-10,-4,11:7 - 11:8 - 4:11 - 5:11 - 11:1
15533348,2023-12-03 10:00:00,Nazaryan Mushegh - Soghomonyan Hrayr,3:1,11:7 - 8:11 - 11:5 - 11:7 - 0:0,3,1,Nazaryan Mushegh,Soghomonyan Hrayr,fiurst,Nazaryan Mushegh - Soghomonyan Hrayr,71,41,30,-11,11,18,19,16,18,0,-4,3,-6,-4,0,-11,11:7 - 8:11 - 11:5 - 11:7 - 0:0
15510115,2023-12-02 17:30:00,Grigoryan Erik - Darbinyan Armen,0:3,11:6 - 11:7 - 11:6 - 0:0 - 0:0,3,0,Grigoryan Erik,Darbinyan Armen,fiurst,Darbinyan Armen - Grigoryan Erik,52,19,33,14,-14,17,18,17,0,0,5,4,5,0,0,14,6:11 - 7:11 - 6:11 - 0:0 - 0:0
15510107,2023-12-02 17:15:00,Gevorgyan Hayk - Avakimyan Davit,3:0,10:12 - 6:11 - 10:12 - 0:0 - 0:0,0,3,Gevorgyan Hayk,Avakimyan Davit,fiurst,Avakimyan Davit - Gevorgyan Hayk,61,35,26,-9,9,22,17,22,0,0,-2,-5,-2,0,0,-9,12:10 - 11:6 - 12:10 - 0:0 - 0:0
15510104,2023-12-02 17:00:00,Gevorgyan Gegham - Grigoryan Erik,3:1,11:4 - 8:11 - 11:9 - 11:4 - 0:0,3,1,Gevorgyan Gegham,Grigoryan Erik,fiurst,Gevorgyan Gegham - Grigoryan Erik,69,41,28,-13,13,15,19,20,15,0,-7,3,-2,-7,0,-13,11:4 - 8:11 - 11:9 - 11:4 - 0:0
15510102,2023-12-02 16:50:00,Gevorgyan Hayk - Darbinyan Armen,1:3,11:8 - 11:5 - 5:11 - 11:6 - 0:0,3,1,Gevorgyan Hayk,Darbinyan Armen,fiurst,Darbinyan Armen - Gevorgyan Hayk,68,30,38,8,-8,19,16,16,17,0,3,6,-6,5,0,8,8:11 - 5:11 - 11:5 - 6:11 - 0:0
15510082,2023-12-02 16:30:00,Grigoryan Erik - Gevorgyan Hayk,3:0,5:11 - 9:11 - 5:11 - 0:0 - 0:0,0,3,Grigoryan Erik,Gevorgyan Hayk,fiurst,Gevorgyan Hayk - Grigoryan Erik,52,33,19,-14,14,16,20,16,0,0,-6,-2,-6,0,0,-14,11:5 - 11:9 - 11:5 - 0:0 - 0:0
15510097,2023-12-02 16:30:00,Avakimyan Davit - Gevorgyan Gegham,3:1,11:6 - 7:11 - 12:10 - 11:7 - 0:0,3,1,Avakimyan Davit,Gevorgyan Gegham,fiurst,Avakimyan Davit - Gevorgyan Gegham,75,41,34,-7,7,17,18,22,18,0,-5,4,-2,-4,0,-7,11:6 - 7:11 - 12:10 - 11:7 - 0:0
15508523,2023-12-02 16:05:00,Darbinyan Armen - Gevorgyan Gegham,0:3,8:11 - 4:11 - 4:11 - 0:0 - 0:0,0,3,Darbinyan Armen,Gevorgyan Gegham,fiurst,Darbinyan Armen - Gevorgyan Gegham,49,16,33,17,-17,19,15,15,0,0,3,7,7,0,0,17,8:11 - 4:11 - 4:11 - 0:0 - 0:0
15508518,2023-12-02 15:50:00,Avakimyan Davit - Grigoryan Erik,2:3,9:11 - 6:11 - 11:8 - 12:10 - 13:15,2,3,Avakimyan Davit,Grigoryan Erik,fiurst,Avakimyan Davit - Grigoryan Erik,106,51,55,4,-4,20,17,19,22,28,2,5,-3,-2,2,4,9:11 - 6:11 - 11:8 - 12:10 - 13:15
15508508,2023-12-02 15:30:00,Gevorgyan Gegham - Gevorgyan Hayk,2:3,6:11 - 3:11 - 11:3 - 11:8 - 7:11,2,3,Gevorgyan Gegham,Gevorgyan Hayk,fiurst,Gevorgyan Gegham - Gevorgyan Hayk,82,38,44,6,-6,17,14,14,19,18,5,8,-8,-3,4,6,6:11 - 3:11 - 11:3 - 11:8 - 7:11
15508504,2023-12-02 15:25:00,Darbinyan Armen - Avakimyan Davit,3:1,11:6 - 10:12 - 12:14 - 8:11 - 0:0,1,3,Darbinyan Armen,Avakimyan Davit,fiurst,Avakimyan Davit - Darbinyan Armen,84,43,41,-2,2,17,22,26,19,0,5,-2,-2,-3,0,-2,6:11 - 12:10 - 14:12 - 11:8 - 0:0
15508499,2023-12-02 15:05:00,Nazaryan Mushegh - Arutyunov Ruben,1:3,11:8 - 6:11 - 11:7 - 11:7 - 0:0,3,1,Nazaryan Mushegh,Arutyunov Ruben,fiurst,Arutyunov Ruben - Nazaryan Mushegh,72,33,39,6,-6,19,17,18,18,0,3,-5,4,4,0,6,8:11 - 11:6 - 7:11 - 7:11 - 0:0
15508500,2023-12-02 15:05:00,Nikoghosyan Narek - Papyan Karen,3:2,11:9 - 11:5 - 9:11 - 9:11 - 12:10,3,2,Nikoghosyan Narek,Papyan Karen,fiurst,Nikoghosyan Narek - Papyan Karen,98,52,46,-6,6,20,16,20,20,22,-2,-6,2,2,-2,-6,11:9 - 11:5 - 9:11 - 9:11 - 12:10
15508483,2023-12-02 14:45:00,Papyan Karen - Nazaryan Mushegh,3:0,4:11 - 6:11 - 8:11 - 0:0 - 0:0,0,3,Papyan Karen,Nazaryan Mushegh,fiurst,Nazaryan Mushegh - Papyan Karen,51,33,18,-15,15,15,17,19,0,0,-7,-5,-3,0,0,-15,11:4 - 11:6 - 11:8 - 0:0 - 0:0
15508494,2023-12-02 14:45:00,Soghomonyan Hrayr - Nikoghosyan Narek,0:3,11:6 - 11:8 - 11:6 - 0:0 - 0:0,3,0,Soghomonyan Hrayr,Nikoghosyan Narek,fiurst,Nikoghosyan Narek - Soghomonyan Hrayr,53,20,33,13,-13,17,19,17,0,0,5,3,5,0,0,13,6:11 - 8:11 - 6:11 - 0:0 - 0:0
15508482,2023-12-02 14:10:00,Soghomonyan Hrayr - Arutyunov Ruben,3:2,9:11 - 7:11 - 11:7 - 11:8 - 4:11,2,3,Soghomonyan Hrayr,Arutyunov Ruben,fiurst,Arutyunov Ruben - Soghomonyan Hrayr,90,48,42,-6,6,20,18,18,19,15,-2,-4,4,3,-7,-6,11:9 - 11:7 - 7:11 - 8:11 - 11:4
15508479,2023-12-02 14:10:00,Nikoghosyan Narek - Nazaryan Mushegh,3:2,10:12 - 7:11 - 11:3 - 11:7 - 9:11,2,3,Nikoghosyan Narek,Nazaryan Mushegh,fiurst,Nazaryan Mushegh - Nikoghosyan Narek,92,44,48,4,-4,22,18,14,18,20,-2,-4,8,4,-2,4,12:10 - 11:7 - 3:11 - 7:11 - 11:9
15508473,2023-12-02 13:35:00,Papyan Karen - Soghomonyan Hrayr,3:0,12:10 - 11:7 - 12:10 - 0:0 - 0:0,3,0,Papyan Karen,Soghomonyan Hrayr,fiurst,Papyan Karen - Soghomonyan Hrayr,62,35,27,-8,8,22,18,22,0,0,-2,-4,-2,0,0,-8,12:10 - 11:7 - 12:10 - 0:0 - 0:0
15508471,2023-12-02 13:25:00,Arutyunov Ruben - Nikoghosyan Narek,2:3,11:8 - 7:11 - 11:9 - 8:11 - 9:11,2,3,Arutyunov Ruben,Nikoghosyan Narek,fiurst,Arutyunov Ruben - Nikoghosyan Narek,96,46,50,4,-4,19,18,20,19,20,-3,4,-2,3,2,4,11:8 - 7:11 - 11:9 - 8:11 - 9:11
15508469,2023-12-02 13:00:00,Nazaryan Mushegh - Soghomonyan Hrayr,1:3,10:12 - 11:9 - 9:11 - 7:11 - 0:0,1,3,Nazaryan Mushegh,Soghomonyan Hrayr,fiurst,Nazaryan Mushegh - Soghomonyan Hrayr,80,37,43,6,-6,22,20,20,18,0,2,-2,2,4,0,6,10:12 - 11:9 - 9:11 - 7:11 - 0:0
15508458,2023-12-02 12:45:00,Arutyunov Ruben - Papyan Karen,2:3,13:11 - 13:15 - 5:11 - 11:3 - 10:12,2,3,Arutyunov Ruben,Papyan Karen,fiurst,Arutyunov Ruben - Papyan Karen,104,52,52,0,0,24,28,16,14,22,-2,2,6,-8,2,0,13:11 - 13:15 - 5:11 - 11:3 - 10:12
15508456,2023-12-02 12:15:00,Nikoghosyan Narek - Soghomonyan Hrayr,3:0,11:7 - 11:9 - 11:7 - 0:0 - 0:0,3,0,Nikoghosyan Narek,Soghomonyan Hrayr,fiurst,Nikoghosyan Narek - Soghomonyan Hrayr,56,33,23,-10,10,18,20,18,0,0,-4,-2,-4,0,0,-10,11:7 - 11:9 - 11:7 - 0:0 - 0:0
15508451,2023-12-02 12:10:00,Arutyunov Ruben - Nazaryan Mushegh,1:3,11:6 - 8:11 - 7:11 - 4:11 - 0:0,1,3,Arutyunov Ruben,Nazaryan Mushegh,fiurst,Arutyunov Ruben - Nazaryan Mushegh,69,30,39,9,-9,17,19,18,15,0,-5,3,4,7,0,9,11:6 - 8:11 - 7:11 - 4:11 - 0:0
15508450,2023-12-02 11:55:00,Papyan Karen - Nikoghosyan Narek,0:3,12:10 - 11:8 - 11:6 - 0:0 - 0:0,3,0,Papyan Karen,Nikoghosyan Narek,fiurst,Nikoghosyan Narek - Papyan Karen,58,24,34,10,-10,22,19,17,0,0,2,3,5,0,0,10,10:12 - 8:11 - 6:11 - 0:0 - 0:0
15508438,2023-12-02 11:40:00,Arutyunov Ruben - Soghomonyan Hrayr,0:3,9:11 - 9:11 - 11:13 - 0:0 - 0:0,0,3,Arutyunov Ruben,Soghomonyan Hrayr,fiurst,Arutyunov Ruben - Soghomonyan Hrayr,64,29,35,6,-6,20,20,24,0,0,2,2,2,0,0,6,9:11 - 9:11 - 11:13 - 0:0 - 0:0
15508437,2023-12-02 11:25:00,Nazaryan Mushegh - Papyan Karen,3:1,11:3 - 3:11 - 11:7 - 11:9 - 0:0,3,1,Nazaryan Mushegh,Papyan Karen,fiurst,Nazaryan Mushegh - Papyan Karen,66,36,30,-6,6,14,14,18,20,0,-8,8,-4,-2,0,-6,11:3 - 3:11 - 11:7 - 11:9 - 0:0
15508433,2023-12-02 11:00:00,Nikoghosyan Narek - Arutyunov Ruben,2:3,11:5 - 6:11 - 7:11 - 11:2 - 11:8,3,2,Nikoghosyan Narek,Arutyunov Ruben,fiurst,Arutyunov Ruben - Nikoghosyan Narek,83,37,46,9,-9,16,17,18,13,19,6,-5,-4,9,3,9,5:11 - 11:6 - 11:7 - 2:11 - 8:11
15508394,2023-12-02 10:50:00,Soghomonyan Hrayr - Papyan Karen,2:3,11:6 - 7:11 - 22:20 - 9:11 - 11:5,3,2,Soghomonyan Hrayr,Papyan Karen,fiurst,Papyan Karen - Soghomonyan Hrayr,113,53,60,7,-7,17,18,42,20,16,5,-4,2,-2,6,7,6:11 - 11:7 - 20:22 - 11:9 - 5:11
15508393,2023-12-02 10:30:00,Nazaryan Mushegh - Nikoghosyan Narek,1:3,5:11 - 8:11 - 11:9 - 5:11 - 0:0,1,3,Nazaryan Mushegh,Nikoghosyan Narek,fiurst,Nazaryan Mushegh - Nikoghosyan Narek,71,29,42,13,-13,16,19,20,16,0,6,3,-2,6,0,13,5:11 - 8:11 - 11:9 - 5:11 - 0:0
15508381,2023-12-02 10:15:00,Papyan Karen - Arutyunov Ruben,3:2,11:7 - 11:8 - 8:11 - 9:11 - 3:11,2,3,Papyan Karen,Arutyunov Ruben,fiurst,Arutyunov Ruben - Papyan Karen,90,48,42,-6,6,18,19,19,20,14,4,3,-3,-2,-8,-6,7:11 - 8:11 - 11:8 - 11:9 - 11:3
15508378,2023-12-02 10:05:00,Soghomonyan Hrayr - Nazaryan Mushegh,3:0,8:11 - 9:11 - 6:11 - 0:0 - 0:0,0,3,Soghomonyan Hrayr,Nazaryan Mushegh,fiurst,Nazaryan Mushegh - Soghomonyan Hrayr,56,33,23,-10,10,19,20,17,0,0,-3,-2,-5,0,0,-10,11:8 - 11:9 - 11:6 - 0:0 - 0:0
15494357,2023-12-01 17:30:00,Darbinyan Armen - Avakimyan Davit,3:0,7:11 - 7:11 - 9:11 - 0:0 - 0:0,0,3,Darbinyan Armen,Avakimyan Davit,fiurst,Avakimyan Davit - Darbinyan Armen,56,33,23,-10,10,18,18,20,0,0,-4,-4,-2,0,0,-10,11:7 - 11:7 - 11:9 - 0:0 - 0:0
15494351,2023-12-01 17:20:00,Gevorgyan Hayk - Gevorgyan Gegham,2:3,11:4 - 6:11 - 11:5 - 6:11 - 11:9,3,2,Gevorgyan Hayk,Gevorgyan Gegham,fiurst,Gevorgyan Gegham - Gevorgyan Hayk,85,40,45,5,-5,15,17,16,17,20,7,-5,6,-5,2,5,4:11 - 11:6 - 5:11 - 11:6 - 9:11
15494341,2023-12-01 17:00:00,Petrosyan Davit - Darbinyan Armen,0:3,11:8 - 11:3 - 11:4 - 0:0 - 0:0,3,0,Petrosyan Davit,Darbinyan Armen,fiurst,Darbinyan Armen - Petrosyan Davit,48,15,33,18,-18,19,14,15,0,0,3,8,7,0,0,18,8:11 - 3:11 - 4:11 - 0:0 - 0:0
15494330,2023-12-01 16:45:00,Gevorgyan Hayk - Avakimyan Davit,2:3,7:11 - 11:9 - 11:7 - 8:11 - 15:13,3,2,Gevorgyan Hayk,Avakimyan Davit,fiurst,Avakimyan Davit - Gevorgyan Hayk,103,51,52,1,-1,18,20,18,19,28,-4,2,4,-3,2,1,11:7 - 9:11 - 7:11 - 11:8 - 13:15
15494329,2023-12-01 16:30:00,Gevorgyan Gegham - Petrosyan Davit,2:3,12:10 - 5:11 - 11:3 - 6:11 - 9:11,2,3,Gevorgyan Gegham,Petrosyan Davit,fiurst,Gevorgyan Gegham - Petrosyan Davit,89,43,46,3,-3,22,16,14,17,20,-2,6,-8,5,2,3,12:10 - 5:11 - 11:3 - 6:11 - 9:11
15494328,2023-12-01 16:15:00,Darbinyan Armen - Gevorgyan Hayk,0:3,8:11 - 2:11 - 8:11 - 0:0 - 0:0,0,3,Darbinyan Armen,Gevorgyan Hayk,fiurst,Darbinyan Armen - Gevorgyan Hayk,51,18,33,15,-15,19,13,19,0,0,3,9,3,0,0,15,8:11 - 2:11 - 8:11 - 0:0 - 0:0
15494325,2023-12-01 16:00:00,Avakimyan Davit - Petrosyan Davit,3:0,11:9 - 11:6 - 11:5 - 0:0 - 0:0,3,0,Avakimyan Davit,Petrosyan Davit,fiurst,Avakimyan Davit - Petrosyan Davit,53,33,20,-13,13,20,17,16,0,0,-2,-5,-6,0,0,-13,11:9 - 11:6 - 11:5 - 0:0 - 0:0
15494324,2023-12-01 15:45:00,Gevorgyan Gegham - Darbinyan Armen,0:3,11:7 - 11:6 - 11:6 - 0:0 - 0:0,3,0,Gevorgyan Gegham,Darbinyan Armen,fiurst,Darbinyan Armen - Gevorgyan Gegham,52,19,33,14,-14,18,17,17,0,0,4,5,5,0,0,14,7:11 - 6:11 - 6:11 - 0:0 - 0:0
15494323,2023-12-01 15:30:00,Petrosyan Davit - Gevorgyan Hayk,3:0,6:11 - 8:11 - 6:11 - 0:0 - 0:0,0,3,Petrosyan Davit,Gevorgyan Hayk,fiurst,Gevorgyan Hayk - Petrosyan Davit,53,33,20,-13,13,17,19,17,0,0,-5,-3,-5,0,0,-13,11:6 - 11:8 - 11:6 - 0:0 - 0:0
15494310,2023-12-01 15:20:00,Avakimyan Davit - Gevorgyan Gegham,3:1,11:9 - 18:16 - 9:11 - 11:4 - 0:0,3,1,Avakimyan Davit,Gevorgyan Gegham,fiurst,Avakimyan Davit - Gevorgyan Gegham,89,49,40,-9,9,20,34,20,15,0,-2,-2,2,-7,0,-9,11:9 - 18:16 - 9:11 - 11:4 - 0:0
15494308,2023-12-01 15:00:00,Papyan Karen - Nazaryan Mushegh,0:3,12:10 - 11:6 - 11:6 - 0:0 - 0:0,3,0,Papyan Karen,Nazaryan Mushegh,fiurst,Nazaryan Mushegh - Papyan Karen,56,22,34,12,-12,22,17,17,0,0,2,5,5,0,0,12,10:12 - 6:11 - 6:11 - 0:0 - 0:0
15494307,2023-12-01 14:50:00,Soghomonyan Hrayr - Rafayelyan Edgar,3:2,6:11 - 11:9 - 12:14 - 11:9 - 10:12,2,3,Soghomonyan Hrayr,Rafayelyan Edgar,fiurst,Rafayelyan Edgar - Soghomonyan Hrayr,105,55,50,-5,5,17,20,26,20,22,-5,2,-2,2,-2,-5,11:6 - 9:11 - 14:12 - 9:11 - 12:10
15494305,2023-12-01 14:30:00,Arutyunov Ruben - Papyan Karen,3:0,12:10 - 11:3 - 11:5 - 0:0 - 0:0,3,0,Arutyunov Ruben,Papyan Karen,fiurst,Arutyunov Ruben - Papyan Karen,52,34,18,-16,16,22,14,16,0,0,-2,-8,-6,0,0,-16,12:10 - 11:3 - 11:5 - 0:0 - 0:0
15494301,2023-12-01 14:15:00,Nazaryan Mushegh - Soghomonyan Hrayr,1:3,8:11 - 11:8 - 7:11 - 9:11 - 0:0,1,3,Nazaryan Mushegh,Soghomonyan Hrayr,fiurst,Nazaryan Mushegh - Soghomonyan Hrayr,76,35,41,6,-6,19,19,18,20,0,3,-3,4,2,0,6,8:11 - 11:8 - 7:11 - 9:11 - 0:0
15494298,2023-12-01 14:00:00,Arutyunov Ruben - Rafayelyan Edgar,0:3,10:12 - 8:11 - 3:11 - 0:0 - 0:0,0,3,Arutyunov Ruben,Rafayelyan Edgar,fiurst,Arutyunov Ruben - Rafayelyan Edgar,55,21,34,13,-13,22,19,14,0,0,2,3,8,0,0,13,10:12 - 8:11 - 3:11 - 0:0 - 0:0
15494281,2023-12-01 13:45:00,Papyan Karen - Soghomonyan Hrayr,0:3,10:12 - 6:11 - 6:11 - 0:0 - 0:0,0,3,Papyan Karen,Soghomonyan Hrayr,fiurst,Papyan Karen - Soghomonyan Hrayr,56,22,34,12,-12,22,17,17,0,0,2,5,5,0,0,12,10:12 - 6:11 - 6:11 - 0:0 - 0:0
15494279,2023-12-01 13:30:00,Nazaryan Mushegh - Arutyunov Ruben,0:3,11:3 - 13:11 - 11:8 - 0:0 - 0:0,3,0,Nazaryan Mushegh,Arutyunov Ruben,fiurst,Arutyunov Ruben - Nazaryan Mushegh,57,22,35,13,-13,14,24,19,0,0,8,2,3,0,0,13,3:11 - 11:13 - 8:11 - 0:0 - 0:0
15494276,2023-12-01 13:15:00,Rafayelyan Edgar - Papyan Karen,0:3,11:7 - 11:8 - 11:7 - 0:0 - 0:0,3,0,Rafayelyan Edgar,Papyan Karen,fiurst,Papyan Karen - Rafayelyan Edgar,55,22,33,11,-11,18,19,18,0,0,4,3,4,0,0,11,7:11 - 8:11 - 7:11 - 0:0 - 0:0
15494264,2023-12-01 13:00:00,Soghomonyan Hrayr - Arutyunov Ruben,3:0,6:11 - 7:11 - 10:12 - 0:0 - 0:0,0,3,Soghomonyan Hrayr,Arutyunov Ruben,fiurst,Arutyunov Ruben - Soghomonyan Hrayr,57,34,23,-11,11,17,18,22,0,0,-5,-4,-2,0,0,-11,11:6 - 11:7 - 12:10 - 0:0 - 0:0
15494263,2023-12-01 12:45:00,Rafayelyan Edgar - Nazaryan Mushegh,0:3,13:11 - 11:5 - 11:5 - 0:0 - 0:0,3,0,Rafayelyan Edgar,Nazaryan Mushegh,fiurst,Nazaryan Mushegh - Rafayelyan Edgar,56,21,35,14,-14,24,16,16,0,0,2,6,6,0,0,14,11:13 - 5:11 - 5:11 - 0:0 - 0:0
15494260,2023-12-01 12:15:00,Papyan Karen - Arutyunov Ruben,1:3,15:13 - 6:11 - 11:7 - 11:9 - 0:0,3,1,Papyan Karen,Arutyunov Ruben,fiurst,Arutyunov Ruben - Papyan Karen,83,40,43,3,-3,28,17,18,20,0,2,-5,4,2,0,3,13:15 - 11:6 - 7:11 - 9:11 - 0:0
15494258,2023-12-01 12:00:00,Rafayelyan Edgar - Soghomonyan Hrayr,3:0,11:8 - 11:5 - 11:4 - 0:0 - 0:0,3,0,Rafayelyan Edgar,Soghomonyan Hrayr,fiurst,Rafayelyan Edgar - Soghomonyan Hrayr,50,33,17,-16,16,19,16,15,0,0,-3,-6,-7,0,0,-16,11:8 - 11:5 - 11:4 - 0:0 - 0:0
15494256,2023-12-01 11:55:00,Nazaryan Mushegh - Papyan Karen,3:0,11:4 - 12:10 - 11:7 - 0:0 - 0:0,3,0,Nazaryan Mushegh,Papyan Karen,fiurst,Nazaryan Mushegh - Papyan Karen,55,34,21,-13,13,15,22,18,0,0,-7,-2,-4,0,0,-13,11:4 - 12:10 - 11:7 - 0:0 - 0:0
15494254,2023-12-01 11:30:00,Rafayelyan Edgar - Arutyunov Ruben,1:3,11:3 - 10:12 - 11:7 - 11:8 - 0:0,3,1,Rafayelyan Edgar,Arutyunov Ruben,fiurst,Arutyunov Ruben - Rafayelyan Edgar,73,30,43,13,-13,14,22,18,19,0,8,-2,4,3,0,13,3:11 - 12:10 - 7:11 - 8:11 - 0:0
15494252,2023-12-01 11:20:00,Soghomonyan Hrayr - Nazaryan Mushegh,3:2,7:11 - 11:6 - 8:11 - 11:6 - 9:11,2,3,Soghomonyan Hrayr,Nazaryan Mushegh,fiurst,Nazaryan Mushegh - Soghomonyan Hrayr,91,45,46,1,-1,18,17,19,17,20,-4,5,-3,5,-2,1,11:7 - 6:11 - 11:8 - 6:11 - 11:9
15494250,2023-12-01 11:00:00,Papyan Karen - Rafayelyan Edgar,0:3,7:11 - 7:11 - 9:11 - 0:0 - 0:0,0,3,Papyan Karen,Rafayelyan Edgar,fiurst,Papyan Karen - Rafayelyan Edgar,56,23,33,10,-10,18,18,20,0,0,4,4,2,0,0,10,7:11 - 7:11 - 9:11 - 0:0 - 0:0
15494237,2023-12-01 10:45:00,Arutyunov Ruben - Nazaryan Mushegh,3:0,11:9 - 11:9 - 12:10 - 0:0 - 0:0,3,0,Arutyunov Ruben,Nazaryan Mushegh,fiurst,Arutyunov Ruben - Nazaryan Mushegh,62,34,28,-6,6,20,20,22,0,0,-2,-2,-2,0,0,-6,11:9 - 11:9 - 12:10 - 0:0 - 0:0
15494232,2023-12-01 10:30:00,Soghomonyan Hrayr - Papyan Karen,3:0,7:11 - 5:11 - 9:11 - 0:0 - 0:0,0,3,Soghomonyan Hrayr,Papyan Karen,fiurst,Papyan Karen - Soghomonyan Hrayr,54,33,21,-12,12,18,16,20,0,0,-4,-6,-2,0,0,-12,11:7 - 11:5 - 11:9 - 0:0 - 0:0
15494231,2023-12-01 10:15:00,Nazaryan Mushegh - Rafayelyan Edgar,1:3,6:11 - 11:9 - 4:11 - 8:11 - 0:0,1,3,Nazaryan Mushegh,Rafayelyan Edgar,fiurst,Nazaryan Mushegh - Rafayelyan Edgar,71,29,42,13,-13,17,20,15,19,0,5,-2,7,3,0,13,6:11 - 11:9 - 4:11 - 8:11 - 0:0
15494228,2023-12-01 10:00:00,Arutyunov Ruben - Soghomonyan Hrayr,3:1,8:11 - 11:5 - 11:3 - 11:3 - 0:0,3,1,Arutyunov Ruben,Soghomonyan Hrayr,fiurst,Arutyunov Ruben - Soghomonyan Hrayr,63,41,22,-19,19,19,16,14,14,0,3,-6,-8,-8,0,-19,8:11 - 11:5 - 11:3 - 11:3 - 0:0
15471289,2023-11-30 17:30:00,Darbinyan Armen - Gevorgyan Hayk,1:3,4:11 - 11:4 - 10:12 - 4:11 - 0:0,1,3,Darbinyan Armen,Gevorgyan Hayk,fiurst,Darbinyan Armen - Gevorgyan Hayk,67,29,38,9,-9,15,15,22,15,0,7,-7,2,7,0,9,4:11 - 11:4 - 10:12 - 4:11 - 0:0
15471278,2023-11-30 17:15:00,Petrosyan Davit - Avakimyan Davit,3:2,11:9 - 13:11 - 4:11 - 3:11 - 6:11,2,3,Petrosyan Davit,Avakimyan Davit,fiurst,Avakimyan Davit - Petrosyan Davit,90,53,37,-16,16,20,24,15,14,17,2,2,-7,-8,-5,-16,9:11 - 11:13 - 11:4 - 11:3 - 11:6
15471275,2023-11-30 17:00:00,Grigoryan Erik - Darbinyan Armen,3:2,12:10 - 10:12 - 8:11 - 13:11 - 9:11,2,3,Grigoryan Erik,Darbinyan Armen,fiurst,Darbinyan Armen - Grigoryan Erik,107,55,52,-3,3,22,22,19,24,20,2,-2,-3,2,-2,-3,10:12 - 12:10 - 11:8 - 11:13 - 11:9
15471252,2023-11-30 16:45:00,Petrosyan Davit - Gevorgyan Hayk,3:2,11:9 - 11:9 - 7:11 - 10:12 - 7:11,2,3,Petrosyan Davit,Gevorgyan Hayk,fiurst,Gevorgyan Hayk - Petrosyan Davit,98,52,46,-6,6,20,20,18,22,18,2,2,-4,-2,-4,-6,9:11 - 9:11 - 11:7 - 12:10 - 11:7
15471250,2023-11-30 16:35:00,Avakimyan Davit - Grigoryan Erik,3:0,11:9 - 11:9 - 11:8 - 0:0 - 0:0,3,0,Avakimyan Davit,Grigoryan Erik,fiurst,Avakimyan Davit - Grigoryan Erik,59,33,26,-7,7,20,20,19,0,0,-2,-2,-3,0,0,-7,11:9 - 11:9 - 11:8 - 0:0 - 0:0
15471242,2023-11-30 16:15:00,Darbinyan Armen - Petrosyan Davit,1:3,2:11 - 5:11 - 11:8 - 5:11 - 0:0,1,3,Darbinyan Armen,Petrosyan Davit,fiurst,Darbinyan Armen - Petrosyan Davit,64,23,41,18,-18,13,16,19,16,0,9,6,-3,6,0,18,2:11 - 5:11 - 11:8 - 5:11 - 0:0
15471236,2023-11-30 16:00:00,Gevorgyan Hayk - Grigoryan Erik,3:1,8:11 - 11:7 - 13:11 - 11:9 - 0:0,3,1,Gevorgyan Hayk,Grigoryan Erik,fiurst,Gevorgyan Hayk - Grigoryan Erik,81,43,38,-5,5,19,18,24,20,0,3,-4,-2,-2,0,-5,8:11 - 11:7 - 13:11 - 11:9 - 0:0
15471229,2023-11-30 15:45:00,Avakimyan Davit - Darbinyan Armen,3:1,9:11 - 11:7 - 11:6 - 11:5 - 0:0,3,1,Avakimyan Davit,Darbinyan Armen,fiurst,Avakimyan Davit - Darbinyan Armen,71,42,29,-13,13,20,18,17,16,0,2,-4,-5,-6,0,-13,9:11 - 11:7 - 11:6 - 11:5 - 0:0
15471224,2023-11-30 15:30:00,Grigoryan Erik - Petrosyan Davit,1:3,7:11 - 8:11 - 11:9 - 9:11 - 0:0,1,3,Grigoryan Erik,Petrosyan Davit,fiurst,Grigoryan Erik - Petrosyan Davit,77,35,42,7,-7,18,19,20,20,0,4,3,-2,2,0,7,7:11 - 8:11 - 11:9 - 9:11 - 0:0
15471223,2023-11-30 15:15:00,Gevorgyan Hayk - Avakimyan Davit,3:2,4:11 - 11:8 - 11:3 - 11:13 - 8:11,2,3,Gevorgyan Hayk,Avakimyan Davit,fiurst,Avakimyan Davit - Gevorgyan Hayk,91,46,45,-1,1,15,19,14,24,19,-7,3,8,-2,-3,-1,11:4 - 8:11 - 3:11 - 13:11 - 11:8
15471217,2023-11-30 15:00:00,Soghomonyan Hrayr - Arutyunov Ruben,3:2,11:6 - 7:11 - 13:11 - 3:11 - 6:11,2,3,Soghomonyan Hrayr,Arutyunov Ruben,fiurst,Arutyunov Ruben - Soghomonyan Hrayr,90,50,40,-10,10,17,18,24,14,17,5,-4,2,-8,-5,-10,6:11 - 11:7 - 11:13 - 11:3 - 11:6
15471216,2023-11-30 14:45:00,Rafayelyan Edgar - Nazaryan Mushegh,0:3,11:7 - 11:8 - 11:6 - 0:0 - 0:0,3,0,Rafayelyan Edgar,Nazaryan Mushegh,fiurst,Nazaryan Mushegh - Rafayelyan Edgar,54,21,33,12,-12,18,19,17,0,0,4,3,5,0,0,12,7:11 - 8:11 - 6:11 - 0:0 - 0:0
15471214,2023-11-30 14:30:00,Nikoghosyan Narek - Soghomonyan Hrayr,3:0,11:8 - 11:8 - 11:4 - 0:0 - 0:0,3,0,Nikoghosyan Narek,Soghomonyan Hrayr,fiurst,Nikoghosyan Narek - Soghomonyan Hrayr,53,33,20,-13,13,19,19,15,0,0,-3,-3,-7,0,0,-13,11:8 - 11:8 - 11:4 - 0:0 - 0:0
15471213,2023-11-30 14:25:00,Arutyunov Ruben - Rafayelyan Edgar,0:3,8:11 - 8:11 - 9:11 - 0:0 - 0:0,0,3,Arutyunov Ruben,Rafayelyan Edgar,fiurst,Arutyunov Ruben - Rafayelyan Edgar,58,25,33,8,-8,19,19,20,0,0,3,3,2,0,0,8,8:11 - 8:11 - 9:11 - 0:0 - 0:0
15471201,2023-11-30 14:10:00,Nikoghosyan Narek - Nazaryan Mushegh,0:3,11:4 - 13:11 - 11:7 - 0:0 - 0:0,3,0,Nikoghosyan Narek,Nazaryan Mushegh,fiurst,Nazaryan Mushegh - Nikoghosyan Narek,57,22,35,13,-13,15,24,18,0,0,7,2,4,0,0,13,4:11 - 11:13 - 7:11 - 0:0 - 0:0
15471197,2023-11-30 13:45:00,Soghomonyan Hrayr - Rafayelyan Edgar,3:2,13:11 - 8:11 - 8:11 - 12:10 - 6:11,2,3,Soghomonyan Hrayr,Rafayelyan Edgar,fiurst,Rafayelyan Edgar - Soghomonyan Hrayr,101,54,47,-7,7,24,19,19,22,17,2,-3,-3,2,-5,-7,11:13 - 11:8 - 11:8 - 10:12 - 11:6
15471192,2023-11-30 13:30:00,Arutyunov Ruben - Nikoghosyan Narek,3:1,11:9 - 11:9 - 5:11 - 11:8 - 0:0,3,1,Arutyunov Ruben,Nikoghosyan Narek,fiurst,Arutyunov Ruben - Nikoghosyan Narek,75,38,37,-1,1,20,20,16,19,0,-2,-2,6,-3,0,-1,11:9 - 11:9 - 5:11 - 11:8 - 0:0
15471187,2023-11-30 13:15:00,Nazaryan Mushegh - Soghomonyan Hrayr,3:0,11:7 - 15:13 - 11:7 - 0:0 - 0:0,3,0,Nazaryan Mushegh,Soghomonyan Hrayr,fiurst,Nazaryan Mushegh - Soghomonyan Hrayr,64,37,27,-10,10,18,28,18,0,0,-4,-2,-4,0,0,-10,11:7 - 15:13 - 11:7 - 0:0 - 0:0
15471185,2023-11-30 13:00:00,Rafayelyan Edgar - Nikoghosyan Narek,3:1,11:13 - 6:11 - 11:9 - 8:11 - 0:0,1,3,Rafayelyan Edgar,Nikoghosyan Narek,fiurst,Nikoghosyan Narek - Rafayelyan Edgar,80,44,36,-8,8,24,17,20,19,0,-2,-5,2,-3,0,-8,13:11 - 11:6 - 9:11 - 11:8 - 0:0
15471183,2023-11-30 12:45:00,Nazaryan Mushegh - Arutyunov Ruben,1:3,11:3 - 8:11 - 11:9 - 11:4 - 0:0,3,1,Nazaryan Mushegh,Arutyunov Ruben,fiurst,Arutyunov Ruben - Nazaryan Mushegh,68,27,41,14,-14,14,19,20,15,0,8,-3,2,7,0,14,3:11 - 11:8 - 9:11 - 4:11 - 0:0
15471170,2023-11-30 12:15:00,Soghomonyan Hrayr - Nikoghosyan Narek,3:0,7:11 - 7:11 - 7:11 - 0:0 - 0:0,0,3,Soghomonyan Hrayr,Nikoghosyan Narek,fiurst,Nikoghosyan Narek - Soghomonyan Hrayr,54,33,21,-12,12,18,18,18,0,0,-4,-4,-4,0,0,-12,11:7 - 11:7 - 11:7 - 0:0 - 0:0
15471165,2023-11-30 12:00:00,Nazaryan Mushegh - Rafayelyan Edgar,3:0,11:3 - 11:5 - 11:9 - 0:0 - 0:0,3,0,Nazaryan Mushegh,Rafayelyan Edgar,fiurst,Nazaryan Mushegh - Rafayelyan Edgar,50,33,17,-16,16,14,16,20,0,0,-8,-6,-2,0,0,-16,11:3 - 11:5 - 11:9 - 0:0 - 0:0
15471163,2023-11-30 11:50:00,Arutyunov Ruben - Soghomonyan Hrayr,3:0,14:12 - 11:5 - 11:5 - 0:0 - 0:0,3,0,Arutyunov Ruben,Soghomonyan Hrayr,fiurst,Arutyunov Ruben - Soghomonyan Hrayr,58,36,22,-14,14,26,16,16,0,0,-2,-6,-6,0,0,-14,14:12 - 11:5 - 11:5 - 0:0 - 0:0
15471159,2023-11-30 11:30:00,Nazaryan Mushegh - Nikoghosyan Narek,0:3,4:11 - 10:12 - 8:11 - 0:0 - 0:0,0,3,Nazaryan Mushegh,Nikoghosyan Narek,fiurst,Nazaryan Mushegh - Nikoghosyan Narek,56,22,34,12,-12,15,22,19,0,0,7,2,3,0,0,12,4:11 - 10:12 - 8:11 - 0:0 - 0:0
15471154,2023-11-30 11:15:00,Rafayelyan Edgar - Arutyunov Ruben,1:3,11:3 - 9:11 - 11:5 - 11:2 - 0:0,3,1,Rafayelyan Edgar,Arutyunov Ruben,fiurst,Arutyunov Ruben - Rafayelyan Edgar,63,21,42,21,-21,14,20,16,13,0,8,-2,6,9,0,21,3:11 - 11:9 - 5:11 - 2:11 - 0:0
15471150,2023-11-30 11:00:00,Soghomonyan Hrayr - Nazaryan Mushegh,1:3,7:11 - 11:9 - 11:6 - 11:9 - 0:0,3,1,Soghomonyan Hrayr,Nazaryan Mushegh,fiurst,Nazaryan Mushegh - Soghomonyan Hrayr,75,35,40,5,-5,18,20,17,20,0,-4,2,5,2,0,5,11:7 - 9:11 - 6:11 - 9:11 - 0:0
15471147,2023-11-30 10:45:00,Nikoghosyan Narek - Arutyunov Ruben,1:3,11:8 - 7:11 - 11:3 - 11:4 - 0:0,3,1,Nikoghosyan Narek,Arutyunov Ruben,fiurst,Arutyunov Ruben - Nikoghosyan Narek,66,26,40,14,-14,19,18,14,15,0,3,-4,8,7,0,14,8:11 - 11:7 - 3:11 - 4:11 - 0:0
15471145,2023-11-30 10:30:00,Rafayelyan Edgar - Soghomonyan Hrayr,3:1,11:13 - 11:5 - 11:5 - 11:6 - 0:0,3,1,Rafayelyan Edgar,Soghomonyan Hrayr,fiurst,Rafayelyan Edgar - Soghomonyan Hrayr,73,44,29,-15,15,24,16,16,17,0,2,-6,-6,-5,0,-15,11:13 - 11:5 - 11:5 - 11:6 - 0:0
15471127,2023-11-30 10:15:00,Arutyunov Ruben - Nazaryan Mushegh,3:1,11:8 - 11:13 - 11:9 - 11:6 - 0:0,3,1,Arutyunov Ruben,Nazaryan Mushegh,fiurst,Arutyunov Ruben - Nazaryan Mushegh,80,44,36,-8,8,19,24,20,17,0,-3,2,-2,-5,0,-8,11:8 - 11:13 - 11:9 - 11:6 - 0:0
15471117,2023-11-30 10:00:00,Nikoghosyan Narek - Rafayelyan Edgar,3:1,11:9 - 11:8 - 10:12 - 11:7 - 0:0,3,1,Nikoghosyan Narek,Rafayelyan Edgar,fiurst,Nikoghosyan Narek - Rafayelyan Edgar,79,43,36,-7,7,20,19,22,18,0,-2,-3,2,-4,0,-7,11:9 - 11:8 - 10:12 - 11:7 - 0:0
15458899,2023-11-29 17:30:00,Gevorgyan Hayk - Petrosyan Davit,2:3,6:11 - 12:14 - 11:8 - 11:5 - 8:11,2,3,Gevorgyan Hayk,Petrosyan Davit,fiurst,Gevorgyan Hayk - Petrosyan Davit,97,48,49,1,-1,17,26,19,16,19,5,2,-3,-6,3,1,6:11 - 12:14 - 11:8 - 11:5 - 8:11
15458898,2023-11-29 17:15:00,Gevorgyan Gegham - Grigoryan Erik,3:1,13:11 - 11:9 - 8:11 - 11:4 - 0:0,3,1,Gevorgyan Gegham,Grigoryan Erik,fiurst,Gevorgyan Gegham - Grigoryan Erik,78,43,35,-8,8,24,20,19,15,0,-2,-2,3,-7,0,-8,13:11 - 11:9 - 8:11 - 11:4 - 0:0
15458892,2023-11-29 17:00:00,Avakimyan Davit - Gevorgyan Hayk,3:2,9:11 - 11:9 - 8:11 - 11:7 - 11:9,3,2,Avakimyan Davit,Gevorgyan Hayk,fiurst,Avakimyan Davit - Gevorgyan Hayk,97,50,47,-3,3,20,20,19,18,20,2,-2,3,-4,-2,-3,9:11 - 11:9 - 8:11 - 11:7 - 11:9
15458886,2023-11-29 16:45:00,Gevorgyan Gegham - Petrosyan Davit,3:1,11:8 - 11:7 - 8:11 - 11:5 - 0:0,3,1,Gevorgyan Gegham,Petrosyan Davit,fiurst,Gevorgyan Gegham - Petrosyan Davit,72,41,31,-10,10,19,18,19,16,0,-3,-4,3,-6,0,-10,11:8 - 11:7 - 8:11 - 11:5 - 0:0
15458885,2023-11-29 16:30:00,Grigoryan Erik - Avakimyan Davit,3:2,11:13 - 12:10 - 11:9 - 12:14 - 6:11,2,3,Grigoryan Erik,Avakimyan Davit,fiurst,Avakimyan Davit - Grigoryan Erik,109,57,52,-5,5,24,22,20,26,17,-2,2,2,-2,-5,-5,13:11 - 10:12 - 9:11 - 14:12 - 11:6
15458884,2023-11-29 16:15:00,Gevorgyan Hayk - Gevorgyan Gegham,0:3,11:6 - 14:12 - 11:8 - 0:0 - 0:0,3,0,Gevorgyan Hayk,Gevorgyan Gegham,fiurst,Gevorgyan Gegham - Gevorgyan Hayk,62,26,36,10,-10,17,26,19,0,0,5,2,3,0,0,10,6:11 - 12:14 - 8:11 - 0:0 - 0:0
15458881,2023-11-29 16:00:00,Petrosyan Davit - Avakimyan Davit,3:0,6:11 - 5:11 - 4:11 - 0:0 - 0:0,0,3,Petrosyan Davit,Avakimyan Davit,fiurst,Avakimyan Davit - Petrosyan Davit,48,33,15,-18,18,17,16,15,0,0,-5,-6,-7,0,0,-18,11:6 - 11:5 - 11:4 - 0:0 - 0:0
15458879,2023-11-29 15:45:00,Grigoryan Erik - Gevorgyan Hayk,3:0,6:11 - 9:11 - 7:11 - 0:0 - 0:0,0,3,Grigoryan Erik,Gevorgyan Hayk,fiurst,Gevorgyan Hayk - Grigoryan Erik,55,33,22,-11,11,17,20,18,0,0,-5,-2,-4,0,0,-11,11:6 - 11:9 - 11:7 - 0:0 - 0:0
15458877,2023-11-29 15:30:00,Avakimyan Davit - Gevorgyan Gegham,3:0,11:5 - 11:6 - 11:7 - 0:0 - 0:0,3,0,Avakimyan Davit,Gevorgyan Gegham,fiurst,Avakimyan Davit - Gevorgyan Gegham,51,33,18,-15,15,16,17,18,0,0,-6,-5,-4,0,0,-15,11:5 - 11:6 - 11:7 - 0:0 - 0:0
15458874,2023-11-29 15:15:00,Petrosyan Davit - Grigoryan Erik,3:1,11:7 - 6:11 - 2:11 - 6:11 - 0:0,1,3,Petrosyan Davit,Grigoryan Erik,fiurst,Grigoryan Erik - Petrosyan Davit,65,40,25,-15,15,18,17,13,17,0,4,-5,-9,-5,0,-15,7:11 - 11:6 - 11:2 - 11:6 - 0:0
15458863,2023-11-29 15:00:00,Nikoghosyan Narek - Nazaryan Mushegh,1:3,7:11 - 11:8 - 11:7 - 11:5 - 0:0,3,1,Nikoghosyan Narek,Nazaryan Mushegh,fiurst,Nazaryan Mushegh - Nikoghosyan Narek,71,31,40,9,-9,18,19,18,16,0,-4,3,4,6,0,9,11:7 - 8:11 - 7:11 - 5:11 - 0:0
15458862,2023-11-29 14:45:00,Arutyunov Ruben - Soghomonyan Hrayr,3:0,11:6 - 11:9 - 11:3 - 0:0 - 0:0,3,0,Arutyunov Ruben,Soghomonyan Hrayr,fiurst,Arutyunov Ruben - Soghomonyan Hrayr,51,33,18,-15,15,17,20,14,0,0,-5,-2,-8,0,0,-15,11:6 - 11:9 - 11:3 - 0:0 - 0:0
15458861,2023-11-29 14:30:00,Rafayelyan Edgar - Nikoghosyan Narek,0:3,11:3 - 11:5 - 11:6 - 0:0 - 0:0,3,0,Rafayelyan Edgar,Nikoghosyan Narek,fiurst,Nikoghosyan Narek - Rafayelyan Edgar,47,14,33,19,-19,14,16,17,0,0,8,6,5,0,0,19,3:11 - 5:11 - 6:11 - 0:0 - 0:0
15458860,2023-11-29 14:15:00,Nazaryan Mushegh - Arutyunov Ruben,1:3,11:8 - 8:11 - 11:8 - 11:9 - 0:0,3,1,Nazaryan Mushegh,Arutyunov Ruben,fiurst,Arutyunov Ruben - Nazaryan Mushegh,77,36,41,5,-5,19,19,19,20,0,3,-3,3,2,0,5,8:11 - 11:8 - 8:11 - 9:11 - 0:0
15458859,2023-11-29 14:00:00,Rafayelyan Edgar - Soghomonyan Hrayr,3:0,11:3 - 11:4 - 11:3 - 0:0 - 0:0,3,0,Rafayelyan Edgar,Soghomonyan Hrayr,fiurst,Rafayelyan Edgar - Soghomonyan Hrayr,43,33,10,-23,23,14,15,14,0,0,-8,-7,-8,0,0,-23,11:3 - 11:4 - 11:3 - 0:0 - 0:0
15458852,2023-11-29 13:45:00,Nikoghosyan Narek - Arutyunov Ruben,0:3,11:8 - 13:11 - 11:9 - 0:0 - 0:0,3,0,Nikoghosyan Narek,Arutyunov Ruben,fiurst,Arutyunov Ruben - Nikoghosyan Narek,63,28,35,7,-7,19,24,20,0,0,3,2,2,0,0,7,8:11 - 11:13 - 9:11 - 0:0 - 0:0
15458850,2023-11-29 13:30:00,Nazaryan Mushegh - Rafayelyan Edgar,0:3,9:11 - 5:11 - 8:11 - 0:0 - 0:0,0,3,Nazaryan Mushegh,Rafayelyan Edgar,fiurst,Nazaryan Mushegh - Rafayelyan Edgar,55,22,33,11,-11,20,16,19,0,0,2,6,3,0,0,11,9:11 - 5:11 - 8:11 - 0:0 - 0:0
15458848,2023-11-29 13:15:00,Soghomonyan Hrayr - Nikoghosyan Narek,3:0,6:11 - 6:11 - 8:11 - 0:0 - 0:0,0,3,Soghomonyan Hrayr,Nikoghosyan Narek,fiurst,Nikoghosyan Narek - Soghomonyan Hrayr,53,33,20,-13,13,17,17,19,0,0,-5,-5,-3,0,0,-13,11:6 - 11:6 - 11:8 - 0:0 - 0:0
15458847,2023-11-29 13:00:00,Arutyunov Ruben - Rafayelyan Edgar,0:3,1:11 - 6:11 - 8:11 - 0:0 - 0:0,0,3,Arutyunov Ruben,Rafayelyan Edgar,fiurst,Arutyunov Ruben - Rafayelyan Edgar,48,15,33,18,-18,12,17,19,0,0,10,5,3,0,0,18,1:11 - 6:11 - 8:11 - 0:0 - 0:0
15458835,2023-11-29 12:50:00,Soghomonyan Hrayr - Nazaryan Mushegh,1:3,5:11 - 11:8 - 11:9 - 11:8 - 0:0,3,1,Soghomonyan Hrayr,Nazaryan Mushegh,fiurst,Nazaryan Mushegh - Soghomonyan Hrayr,74,36,38,2,-2,16,19,20,19,0,-6,3,2,3,0,2,11:5 - 8:11 - 9:11 - 8:11 - 0:0
15458834,2023-11-29 12:15:00,Nikoghosyan Narek - Rafayelyan Edgar,0:3,6:11 - 8:11 - 9:11 - 0:0 - 0:0,0,3,Nikoghosyan Narek,Rafayelyan Edgar,fiurst,Nikoghosyan Narek - Rafayelyan Edgar,56,23,33,10,-10,17,19,20,0,0,5,3,2,0,0,10,6:11 - 8:11 - 9:11 - 0:0 - 0:0
15458833,2023-11-29 12:00:00,Soghomonyan Hrayr - Arutyunov Ruben,3:1,9:11 - 11:9 - 8:11 - 9:11 - 0:0,1,3,Soghomonyan Hrayr,Arutyunov Ruben,fiurst,Arutyunov Ruben - Soghomonyan Hrayr,79,42,37,-5,5,20,20,19,20,0,-2,2,-3,-2,0,-5,11:9 - 9:11 - 11:8 - 11:9 - 0:0
15458828,2023-11-29 11:45:00,Nazaryan Mushegh - Nikoghosyan Narek,0:3,4:11 - 6:11 - 7:11 - 0:0 - 0:0,0,3,Nazaryan Mushegh,Nikoghosyan Narek,fiurst,Nazaryan Mushegh - Nikoghosyan Narek,50,17,33,16,-16,15,17,18,0,0,7,5,4,0,0,16,4:11 - 6:11 - 7:11 - 0:0 - 0:0
15458826,2023-11-29 11:30:00,Soghomonyan Hrayr - Rafayelyan Edgar,3:0,7:11 - 7:11 - 5:11 - 0:0 - 0:0,0,3,Soghomonyan Hrayr,Rafayelyan Edgar,fiurst,Rafayelyan Edgar - Soghomonyan Hrayr,52,33,19,-14,14,18,18,16,0,0,-4,-4,-6,0,0,-14,11:7 - 11:7 - 11:5 - 0:0 - 0:0
15458825,2023-11-29 11:15:00,Arutyunov Ruben - Nazaryan Mushegh,0:3,7:11 - 6:11 - 11:13 - 0:0 - 0:0,0,3,Arutyunov Ruben,Nazaryan Mushegh,fiurst,Arutyunov Ruben - Nazaryan Mushegh,59,24,35,11,-11,18,17,24,0,0,4,5,2,0,0,11,7:11 - 6:11 - 11:13 - 0:0 - 0:0
15458822,2023-11-29 11:05:00,Nikoghosyan Narek - Soghomonyan Hrayr,3:0,11:5 - 11:7 - 11:7 - 0:0 - 0:0,3,0,Nikoghosyan Narek,Soghomonyan Hrayr,fiurst,Nikoghosyan Narek - Soghomonyan Hrayr,52,33,19,-14,14,16,18,18,0,0,-6,-4,-4,0,0,-14,11:5 - 11:7 - 11:7 - 0:0 - 0:0
15458821,2023-11-29 10:45:00,Rafayelyan Edgar - Nazaryan Mushegh,0:3,11:5 - 11:7 - 11:1 - 0:0 - 0:0,3,0,Rafayelyan Edgar,Nazaryan Mushegh,fiurst,Nazaryan Mushegh - Rafayelyan Edgar,46,13,33,20,-20,16,18,12,0,0,6,4,10,0,0,20,5:11 - 7:11 - 1:11 - 0:0 - 0:0
15458819,2023-11-29 10:30:00,Arutyunov Ruben - Nikoghosyan Narek,1:3,11:6 - 10:12 - 5:11 - 8:11 - 0:0,1,3,Arutyunov Ruben,Nikoghosyan Narek,fiurst,Arutyunov Ruben - Nikoghosyan Narek,74,34,40,6,-6,17,22,16,19,0,-5,2,6,3,0,6,11:6 - 10:12 - 5:11 - 8:11 - 0:0
15458818,2023-11-29 10:15:00,Nazaryan Mushegh - Soghomonyan Hrayr,3:0,11:9 - 11:9 - 11:8 - 0:0 - 0:0,3,0,Nazaryan Mushegh,Soghomonyan Hrayr,fiurst,Nazaryan Mushegh - Soghomonyan Hrayr,59,33,26,-7,7,20,20,19,0,0,-2,-2,-3,0,0,-7,11:9 - 11:9 - 11:8 - 0:0 - 0:0
15458807,2023-11-29 10:00:00,Rafayelyan Edgar - Arutyunov Ruben,0:3,11:7 - 11:6 - 11:9 - 0:0 - 0:0,3,0,Rafayelyan Edgar,Arutyunov Ruben,fiurst,Arutyunov Ruben - Rafayelyan Edgar,55,22,33,11,-11,18,17,20,0,0,4,5,2,0,0,11,7:11 - 6:11 - 9:11 - 0:0 - 0:0
15439669,2023-11-28 17:25:00,Darbinyan Armen - Gevorgyan Gegham,0:3,9:11 - 4:11 - 7:11 - 0:0 - 0:0,0,3,Darbinyan Armen,Gevorgyan Gegham,fiurst,Darbinyan Armen - Gevorgyan Gegham,53,20,33,13,-13,20,15,18,0,0,2,7,4,0,0,13,9:11 - 4:11 - 7:11 - 0:0 - 0:0
15439667,2023-11-28 17:20:00,Grigoryan Erik - Gevorgyan Hayk,3:1,11:8 - 6:11 - 6:11 - 4:11 - 0:0,1,3,Grigoryan Erik,Gevorgyan Hayk,fiurst,Gevorgyan Hayk - Grigoryan Erik,68,41,27,-14,14,19,17,17,15,0,3,-5,-5,-7,0,-14,8:11 - 11:6 - 11:6 - 11:4 - 0:0
15439664,2023-11-28 17:00:00,Petrosyan Davit - Darbinyan Armen,0:3,11:5 - 11:5 - 11:1 - 0:0 - 0:0,3,0,Petrosyan Davit,Darbinyan Armen,fiurst,Darbinyan Armen - Petrosyan Davit,44,11,33,22,-22,16,16,12,0,0,6,6,10,0,0,22,5:11 - 5:11 - 1:11 - 0:0 - 0:0
15439653,2023-11-28 16:45:00,Grigoryan Erik - Gevorgyan Gegham,3:1,6:11 - 11:7 - 7:11 - 6:11 - 0:0,1,3,Grigoryan Erik,Gevorgyan Gegham,fiurst,Gevorgyan Gegham - Grigoryan Erik,70,40,30,-10,10,17,18,18,17,0,-5,4,-4,-5,0,-10,11:6 - 7:11 - 11:7 - 11:6 - 0:0
15439649,2023-11-28 16:30:00,Gevorgyan Hayk - Petrosyan Davit,3:0,11:8 - 11:9 - 11:7 - 0:0 - 0:0,3,0,Gevorgyan Hayk,Petrosyan Davit,fiurst,Gevorgyan Hayk - Petrosyan Davit,57,33,24,-9,9,19,20,18,0,0,-3,-2,-4,0,0,-9,11:8 - 11:9 - 11:7 - 0:0 - 0:0
15439646,2023-11-28 16:15:00,Darbinyan Armen - Grigoryan Erik,1:3,11:13 - 6:11 - 11:5 - 2:11 - 0:0,1,3,Darbinyan Armen,Grigoryan Erik,fiurst,Darbinyan Armen - Grigoryan Erik,70,30,40,10,-10,24,17,16,13,0,2,5,-6,9,0,10,11:13 - 6:11 - 11:5 - 2:11 - 0:0
15439643,2023-11-28 16:00:00,Gevorgyan Gegham - Petrosyan Davit,3:0,11:3 - 11:7 - 11:6 - 0:0 - 0:0,3,0,Gevorgyan Gegham,Petrosyan Davit,fiurst,Gevorgyan Gegham - Petrosyan Davit,49,33,16,-17,17,14,18,17,0,0,-8,-4,-5,0,0,-17,11:3 - 11:7 - 11:6 - 0:0 - 0:0
15439642,2023-11-28 15:50:00,Gevorgyan Hayk - Darbinyan Armen,0:3,11:3 - 11:6 - 11:6 - 0:0 - 0:0,3,0,Gevorgyan Hayk,Darbinyan Armen,fiurst,Darbinyan Armen - Gevorgyan Hayk,48,15,33,18,-18,14,17,17,0,0,8,5,5,0,0,18,3:11 - 6:11 - 6:11 - 0:0 - 0:0
15439639,2023-11-28 15:30:00,Petrosyan Davit - Grigoryan Erik,0:3,11:7 - 11:7 - 11:8 - 0:0 - 0:0,3,0,Petrosyan Davit,Grigoryan Erik,fiurst,Grigoryan Erik - Petrosyan Davit,55,22,33,11,-11,18,18,19,0,0,4,4,3,0,0,11,7:11 - 7:11 - 8:11 - 0:0 - 0:0
15439638,2023-11-28 15:20:00,Gevorgyan Gegham - Gevorgyan Hayk,0:3,7:11 - 1:11 - 11:13 - 0:0 - 0:0,0,3,Gevorgyan Gegham,Gevorgyan Hayk,fiurst,Gevorgyan Gegham - Gevorgyan Hayk,54,19,35,16,-16,18,12,24,0,0,4,10,2,0,0,16,7:11 - 1:11 - 11:13 - 0:0 - 0:0
15439623,2023-11-28 15:00:00,Papyan Karen - Rafayelyan Edgar,3:2,11:9 - 11:7 - 9:11 - 9:11 - 12:10,3,2,Papyan Karen,Rafayelyan Edgar,fiurst,Papyan Karen - Rafayelyan Edgar,100,52,48,-4,4,20,18,20,20,22,-2,-4,2,2,-2,-4,11:9 - 11:7 - 9:11 - 9:11 - 12:10
15439619,2023-11-28 14:30:00,Nazaryan Mushegh - Papyan Karen,3:1,11:4 - 13:11 - 8:11 - 11:9 - 0:0,3,1,Nazaryan Mushegh,Papyan Karen,fiurst,Nazaryan Mushegh - Papyan Karen,78,43,35,-8,8,15,24,19,20,0,-7,-2,3,-2,0,-8,11:4 - 13:11 - 8:11 - 11:9 - 0:0
15439606,2023-11-28 14:15:00,Rafayelyan Edgar - Nikoghosyan Narek,3:1,4:11 - 8:11 - 12:10 - 7:11 - 0:0,1,3,Rafayelyan Edgar,Nikoghosyan Narek,fiurst,Nikoghosyan Narek - Rafayelyan Edgar,74,43,31,-12,12,15,19,22,18,0,-7,-3,2,-4,0,-12,11:4 - 11:8 - 10:12 - 11:7 - 0:0
15439601,2023-11-28 13:50:00,Papyan Karen - Nikoghosyan Narek,3:2,14:12 - 11:9 - 5:11 - 10:12 - 6:11,2,3,Papyan Karen,Nikoghosyan Narek,fiurst,Nikoghosyan Narek - Papyan Karen,101,55,46,-9,9,26,20,16,22,17,2,2,-6,-2,-5,-9,12:14 - 9:11 - 11:5 - 12:10 - 11:6
15439598,2023-11-28 13:30:00,Rafayelyan Edgar - Nazaryan Mushegh,0:3,11:8 - 11:7 - 11:8 - 0:0 - 0:0,3,0,Rafayelyan Edgar,Nazaryan Mushegh,fiurst,Nazaryan Mushegh - Rafayelyan Edgar,56,23,33,10,-10,19,18,19,0,0,3,4,3,0,0,10,8:11 - 7:11 - 8:11 - 0:0 - 0:0
15439596,2023-11-28 13:15:00,Mkrtchyan Andranik - Papyan Karen,0:3,4:11 - 4:11 - 6:11 - 0:0 - 0:0,0,3,Mkrtchyan Andranik,Papyan Karen,fiurst,Mkrtchyan Andranik - Papyan Karen,47,14,33,19,-19,15,15,17,0,0,7,7,5,0,0,19,4:11 - 4:11 - 6:11 - 0:0 - 0:0
15439595,2023-11-28 13:00:00,Nikoghosyan Narek - Nazaryan Mushegh,3:1,11:8 - 6:11 - 4:11 - 6:11 - 0:0,1,3,Nikoghosyan Narek,Nazaryan Mushegh,fiurst,Nazaryan Mushegh - Nikoghosyan Narek,68,41,27,-14,14,19,17,15,17,0,3,-5,-7,-5,0,-14,8:11 - 11:6 - 11:4 - 11:6 - 0:0
15439583,2023-11-28 12:45:00,Mkrtchyan Andranik - Rafayelyan Edgar,0:3,7:11 - 6:11 - 3:11 - 0:0 - 0:0,0,3,Mkrtchyan Andranik,Rafayelyan Edgar,fiurst,Mkrtchyan Andranik - Rafayelyan Edgar,49,16,33,17,-17,18,17,14,0,0,4,5,8,0,0,17,7:11 - 6:11 - 3:11 - 0:0 - 0:0
15439581,2023-11-28 12:15:00,Papyan Karen - Nazaryan Mushegh,1:3,11:9 - 10:12 - 11:9 - 11:6 - 0:0,3,1,Papyan Karen,Nazaryan Mushegh,fiurst,Nazaryan Mushegh - Papyan Karen,79,36,43,7,-7,20,22,20,17,0,2,-2,2,5,0,7,9:11 - 12:10 - 9:11 - 6:11 - 0:0
15439579,2023-11-28 12:05:00,Mkrtchyan Andranik - Nikoghosyan Narek,0:3,3:11 - 6:11 - 4:11 - 0:0 - 0:0,0,3,Mkrtchyan Andranik,Nikoghosyan Narek,fiurst,Mkrtchyan Andranik - Nikoghosyan Narek,46,13,33,20,-20,14,17,15,0,0,8,5,7,0,0,20,3:11 - 6:11 - 4:11 - 0:0 - 0:0
15439563,2023-11-28 11:45:00,Rafayelyan Edgar - Papyan Karen,0:3,12:10 - 11:7 - 11:8 - 0:0 - 0:0,3,0,Rafayelyan Edgar,Papyan Karen,fiurst,Papyan Karen - Rafayelyan Edgar,59,25,34,9,-9,22,18,19,0,0,2,4,3,0,0,9,10:12 - 7:11 - 8:11 - 0:0 - 0:0
15439560,2023-11-28 11:35:00,Mkrtchyan Andranik - Nazaryan Mushegh,0:3,7:11 - 8:11 - 7:11 - 0:0 - 0:0,0,3,Mkrtchyan Andranik,Nazaryan Mushegh,fiurst,Mkrtchyan Andranik - Nazaryan Mushegh,55,22,33,11,-11,18,19,18,0,0,4,3,4,0,0,11,7:11 - 8:11 - 7:11 - 0:0 - 0:0
15439558,2023-11-28 11:15:00,Nikoghosyan Narek - Rafayelyan Edgar,1:3,9:11 - 10:12 - 11:3 - 7:11 - 0:0,1,3,Nikoghosyan Narek,Rafayelyan Edgar,fiurst,Nikoghosyan Narek - Rafayelyan Edgar,74,37,37,0,0,20,22,14,18,0,2,2,-8,4,0,0,9:11 - 10:12 - 11:3 - 7:11 - 0:0
15439555,2023-11-28 11:00:00,Papyan Karen - Mkrtchyan Andranik,0:3,11:5 - 11:3 - 11:9 - 0:0 - 0:0,3,0,Papyan Karen,Mkrtchyan Andranik,fiurst,Mkrtchyan Andranik - Papyan Karen,50,17,33,16,-16,16,14,20,0,0,6,8,2,0,0,16,5:11 - 3:11 - 9:11 - 0:0 - 0:0
15439553,2023-11-28 10:45:00,Nazaryan Mushegh - Rafayelyan Edgar,0:3,7:11 - 9:11 - 7:11 - 0:0 - 0:0,0,3,Nazaryan Mushegh,Rafayelyan Edgar,fiurst,Nazaryan Mushegh - Rafayelyan Edgar,56,23,33,10,-10,18,20,18,0,0,4,2,4,0,0,10,7:11 - 9:11 - 7:11 - 0:0 - 0:0
15439541,2023-11-28 10:30:00,Nikoghosyan Narek - Papyan Karen,2:3,6:11 - 11:9 - 11:1 - 10:12 - 5:11,2,3,Nikoghosyan Narek,Papyan Karen,fiurst,Nikoghosyan Narek - Papyan Karen,87,43,44,1,-1,17,20,12,22,16,5,-2,-10,2,6,1,6:11 - 11:9 - 11:1 - 10:12 - 5:11
15439534,2023-11-28 10:15:00,Rafayelyan Edgar - Mkrtchyan Andranik,0:3,11:5 - 11:3 - 11:6 - 0:0 - 0:0,3,0,Rafayelyan Edgar,Mkrtchyan Andranik,fiurst,Mkrtchyan Andranik - Rafayelyan Edgar,47,14,33,19,-19,16,14,17,0,0,6,8,5,0,0,19,5:11 - 3:11 - 6:11 - 0:0 - 0:0
15439530,2023-11-28 10:00:00,Nazaryan Mushegh - Nikoghosyan Narek,1:3,7:11 - 11:7 - 6:11 - 5:11 - 0:0,1,3,Nazaryan Mushegh,Nikoghosyan Narek,fiurst,Nazaryan Mushegh - Nikoghosyan Narek,69,29,40,11,-11,18,18,17,16,0,4,-4,5,6,0,11,7:11 - 11:7 - 6:11 - 5:11 - 0:0
15421040,2023-11-27 17:30:00,Darbinyan Armen - Grigoryan Erik,3:0,12:10 - 13:11 - 12:10 - 0:0 - 0:0,3,0,Darbinyan Armen,Grigoryan Erik,fiurst,Darbinyan Armen - Grigoryan Erik,68,37,31,-6,6,22,24,22,0,0,-2,-2,-2,0,0,-6,12:10 - 13:11 - 12:10 - 0:0 - 0:0
15421032,2023-11-27 17:15:00,Avakimyan Davit - Petrosyan Davit,3:1,11:7 - 11:6 - 9:11 - 11:8 - 0:0,3,1,Avakimyan Davit,Petrosyan Davit,fiurst,Avakimyan Davit - Petrosyan Davit,74,42,32,-10,10,18,17,20,19,0,-4,-5,2,-3,0,-10,11:7 - 11:6 - 9:11 - 11:8 - 0:0
15421000,2023-11-27 17:10:00,Gevorgyan Gegham - Darbinyan Armen,0:3,11:2 - 11:5 - 11:7 - 0:0 - 0:0,3,0,Gevorgyan Gegham,Darbinyan Armen,fiurst,Darbinyan Armen - Gevorgyan Gegham,47,14,33,19,-19,13,16,18,0,0,9,6,4,0,0,19,2:11 - 5:11 - 7:11 - 0:0 - 0:0
15420990,2023-11-27 16:45:00,Avakimyan Davit - Grigoryan Erik,3:0,14:12 - 11:9 - 11:6 - 0:0 - 0:0,3,0,Avakimyan Davit,Grigoryan Erik,fiurst,Avakimyan Davit - Grigoryan Erik,63,36,27,-9,9,26,20,17,0,0,-2,-2,-5,0,0,-9,14:12 - 11:9 - 11:6 - 0:0 - 0:0
15420989,2023-11-27 16:30:00,Petrosyan Davit - Gevorgyan Gegham,1:3,6:11 - 11:5 - 11:8 - 11:8 - 0:0,3,1,Petrosyan Davit,Gevorgyan Gegham,fiurst,Gevorgyan Gegham - Petrosyan Davit,71,32,39,7,-7,17,16,19,19,0,-5,6,3,3,0,7,11:6 - 5:11 - 8:11 - 8:11 - 0:0
15420978,2023-11-27 16:15:00,Darbinyan Armen - Avakimyan Davit,3:0,5:11 - 7:11 - 8:11 - 0:0 - 0:0,0,3,Darbinyan Armen,Avakimyan Davit,fiurst,Avakimyan Davit - Darbinyan Armen,53,33,20,-13,13,16,18,19,0,0,-6,-4,-3,0,0,-13,11:5 - 11:7 - 11:8 - 0:0 - 0:0
15420974,2023-11-27 16:05:00,Grigoryan Erik - Gevorgyan Gegham,3:0,7:11 - 7:11 - 9:11 - 0:0 - 0:0,0,3,Grigoryan Erik,Gevorgyan Gegham,fiurst,Gevorgyan Gegham - Grigoryan Erik,56,33,23,-10,10,18,18,20,0,0,-4,-4,-2,0,0,-10,11:7 - 11:7 - 11:9 - 0:0 - 0:0
15420971,2023-11-27 15:45:00,Petrosyan Davit - Darbinyan Armen,0:3,11:6 - 11:5 - 11:3 - 0:0 - 0:0,3,0,Petrosyan Davit,Darbinyan Armen,fiurst,Darbinyan Armen - Petrosyan Davit,47,14,33,19,-19,17,16,14,0,0,5,6,8,0,0,19,6:11 - 5:11 - 3:11 - 0:0 - 0:0
15420970,2023-11-27 15:30:00,Gevorgyan Gegham - Avakimyan Davit,3:0,9:11 - 9:11 - 8:11 - 0:0 - 0:0,0,3,Gevorgyan Gegham,Avakimyan Davit,fiurst,Avakimyan Davit - Gevorgyan Gegham,59,33,26,-7,7,20,20,19,0,0,-2,-2,-3,0,0,-7,11:9 - 11:9 - 11:8 - 0:0 - 0:0
15420932,2023-11-27 15:15:00,Grigoryan Erik - Petrosyan Davit,2:3,7:11 - 11:9 - 5:11 - 11:5 - 11:13,2,3,Grigoryan Erik,Petrosyan Davit,fiurst,Grigoryan Erik - Petrosyan Davit,94,45,49,4,-4,18,20,16,16,24,4,-2,6,-6,2,4,7:11 - 11:9 - 5:11 - 11:5 - 11:13
15420928,2023-11-27 15:00:00,Arutyunov Ruben - Soghomonyan Hrayr,3:1,11:5 - 11:2 - 8:11 - 11:5 - 0:0,3,1,Arutyunov Ruben,Soghomonyan Hrayr,fiurst,Arutyunov Ruben - Soghomonyan Hrayr,64,41,23,-18,18,16,13,19,16,0,-6,-9,3,-6,0,-18,11:5 - 11:2 - 8:11 - 11:5 - 0:0
15420927,2023-11-27 14:45:00,Papyan Karen - Rafayelyan Edgar,0:3,8:11 - 8:11 - 7:11 - 0:0 - 0:0,0,3,Papyan Karen,Rafayelyan Edgar,fiurst,Papyan Karen - Rafayelyan Edgar,56,23,33,10,-10,19,19,18,0,0,3,3,4,0,0,10,8:11 - 8:11 - 7:11 - 0:0 - 0:0
15420924,2023-11-27 14:30:00,Mkrtchyan Andranik - Arutyunov Ruben,2:3,5:11 - 11:3 - 11:4 - 8:11 - 11:7,3,2,Mkrtchyan Andranik,Arutyunov Ruben,fiurst,Arutyunov Ruben - Mkrtchyan Andranik,82,36,46,10,-10,16,14,15,19,18,-6,8,7,-3,4,10,11:5 - 3:11 - 4:11 - 11:8 - 7:11
15420913,2023-11-27 14:20:00,Soghomonyan Hrayr - Papyan Karen,3:0,8:11 - 13:15 - 6:11 - 0:0 - 0:0,0,3,Soghomonyan Hrayr,Papyan Karen,fiurst,Papyan Karen - Soghomonyan Hrayr,64,37,27,-10,10,19,28,17,0,0,-3,-2,-5,0,0,-10,11:8 - 15:13 - 11:6 - 0:0 - 0:0
15420912,2023-11-27 14:15:00,Mkrtchyan Andranik - Rafayelyan Edgar,0:3,9:11 - 3:11 - 9:11 - 0:0 - 0:0,0,3,Mkrtchyan Andranik,Rafayelyan Edgar,fiurst,Mkrtchyan Andranik - Rafayelyan Edgar,54,21,33,12,-12,20,14,20,0,0,2,8,2,0,0,12,9:11 - 3:11 - 9:11 - 0:0 - 0:0
15420911,2023-11-27 13:45:00,Arutyunov Ruben - Papyan Karen,3:0,11:4 - 11:2 - 11:5 - 0:0 - 0:0,3,0,Arutyunov Ruben,Papyan Karen,fiurst,Arutyunov Ruben - Papyan Karen,44,33,11,-22,22,15,13,16,0,0,-7,-9,-6,0,0,-22,11:4 - 11:2 - 11:5 - 0:0 - 0:0
15420910,2023-11-27 13:30:00,Soghomonyan Hrayr - Mkrtchyan Andranik,2:3,13:15 - 11:7 - 11:13 - 14:12 - 12:10,3,2,Soghomonyan Hrayr,Mkrtchyan Andranik,fiurst,Mkrtchyan Andranik - Soghomonyan Hrayr,118,57,61,4,-4,28,18,24,26,22,-2,4,-2,2,2,4,15:13 - 7:11 - 13:11 - 12:14 - 10:12
15420908,2023-11-27 13:15:00,Rafayelyan Edgar - Arutyunov Ruben,1:3,6:11 - 11:4 - 12:10 - 11:4 - 0:0,3,1,Rafayelyan Edgar,Arutyunov Ruben,fiurst,Arutyunov Ruben - Rafayelyan Edgar,69,29,40,11,-11,17,15,22,15,0,-5,7,2,7,0,11,11:6 - 4:11 - 10:12 - 4:11 - 0:0
15420905,2023-11-27 13:00:00,Papyan Karen - Mkrtchyan Andranik,0:3,11:8 - 11:6 - 11:6 - 0:0 - 0:0,3,0,Papyan Karen,Mkrtchyan Andranik,fiurst,Mkrtchyan Andranik - Papyan Karen,53,20,33,13,-13,19,17,17,0,0,3,5,5,0,0,13,8:11 - 6:11 - 6:11 - 0:0 - 0:0
15420904,2023-11-27 12:45:00,Rafayelyan Edgar - Soghomonyan Hrayr,3:0,11:6 - 11:6 - 11:2 - 0:0 - 0:0,3,0,Rafayelyan Edgar,Soghomonyan Hrayr,fiurst,Rafayelyan Edgar - Soghomonyan Hrayr,47,33,14,-19,19,17,17,13,0,0,-5,-5,-9,0,0,-19,11:6 - 11:6 - 11:2 - 0:0 - 0:0
15420901,2023-11-27 12:25:00,Arutyunov Ruben - Mkrtchyan Andranik,3:2,11:6 - 9:11 - 6:11 - 11:6 - 11:6,3,2,Arutyunov Ruben,Mkrtchyan Andranik,fiurst,Arutyunov Ruben - Mkrtchyan Andranik,88,48,40,-8,8,17,20,17,17,17,-5,2,5,-5,-5,-8,11:6 - 9:11 - 6:11 - 11:6 - 11:6
15420900,2023-11-27 12:05:00,Rafayelyan Edgar - Papyan Karen,1:3,11:9 - 5:11 - 11:9 - 11:7 - 0:0,3,1,Rafayelyan Edgar,Papyan Karen,fiurst,Papyan Karen - Rafayelyan Edgar,74,36,38,2,-2,20,16,20,18,0,2,-6,2,4,0,2,9:11 - 11:5 - 9:11 - 7:11 - 0:0
15420888,2023-11-27 11:45:00,Rafayelyan Edgar - Mkrtchyan Andranik,0:3,11:7 - 11:5 - 11:8 - 0:0 - 0:0,3,0,Rafayelyan Edgar,Mkrtchyan Andranik,fiurst,Mkrtchyan Andranik - Rafayelyan Edgar,53,20,33,13,-13,18,16,19,0,0,4,6,3,0,0,13,7:11 - 5:11 - 8:11 - 0:0 - 0:0
15420889,2023-11-27 11:45:00,Soghomonyan Hrayr - Arutyunov Ruben,1:3,11:7 - 3:11 - 11:7 - 11:7 - 0:0,3,1,Soghomonyan Hrayr,Arutyunov Ruben,fiurst,Arutyunov Ruben - Soghomonyan Hrayr,68,32,36,4,-4,18,14,18,18,0,4,-8,4,4,0,4,7:11 - 11:3 - 7:11 - 7:11 - 0:0
15420883,2023-11-27 11:15:00,Papyan Karen - Soghomonyan Hrayr,3:0,11:9 - 19:17 - 13:11 - 0:0 - 0:0,3,0,Papyan Karen,Soghomonyan Hrayr,fiurst,Papyan Karen - Soghomonyan Hrayr,80,43,37,-6,6,20,36,24,0,0,-2,-2,-2,0,0,-6,11:9 - 19:17 - 13:11 - 0:0 - 0:0
15420882,2023-11-27 11:05:00,Arutyunov Ruben - Rafayelyan Edgar,2:3,9:11 - 10:12 - 11:7 - 12:10 - 11:13,2,3,Arutyunov Ruben,Rafayelyan Edgar,fiurst,Arutyunov Ruben - Rafayelyan Edgar,106,53,53,0,0,20,22,18,22,24,2,2,-4,-2,2,0,9:11 - 10:12 - 11:7 - 12:10 - 11:13
15420879,2023-11-27 10:45:00,Mkrtchyan Andranik - Soghomonyan Hrayr,1:3,6:11 - 11:8 - 5:11 - 5:11 - 0:0,1,3,Mkrtchyan Andranik,Soghomonyan Hrayr,fiurst,Mkrtchyan Andranik - Soghomonyan Hrayr,68,27,41,14,-14,17,19,16,16,0,5,-3,6,6,0,14,6:11 - 11:8 - 5:11 - 5:11 - 0:0
15420876,2023-11-27 10:30:00,Papyan Karen - Arutyunov Ruben,3:2,11:8 - 8:11 - 11:5 - 6:11 - 7:11,2,3,Papyan Karen,Arutyunov Ruben,fiurst,Arutyunov Ruben - Papyan Karen,89,46,43,-3,3,19,19,16,17,18,3,-3,6,-5,-4,-3,8:11 - 11:8 - 5:11 - 11:6 - 11:7
15420872,2023-11-27 10:15:00,Soghomonyan Hrayr - Rafayelyan Edgar,3:0,10:12 - 9:11 - 10:12 - 0:0 - 0:0,0,3,Soghomonyan Hrayr,Rafayelyan Edgar,fiurst,Rafayelyan Edgar - Soghomonyan Hrayr,64,35,29,-6,6,22,20,22,0,0,-2,-2,-2,0,0,-6,12:10 - 11:9 - 12:10 - 0:0 - 0:0
15420871,2023-11-27 10:05:00,Mkrtchyan Andranik - Papyan Karen,0:3,5:11 - 12:14 - 12:14 - 0:0 - 0:0,0,3,Mkrtchyan Andranik,Papyan Karen,fiurst,Mkrtchyan Andranik - Papyan Karen,68,29,39,10,-10,16,26,26,0,0,6,2,2,0,0,10,5:11 - 12:14 - 12:14 - 0:0 - 0:0
15402654,2023-11-26 17:30:00,Gevorgyan Hayk - Avakimyan Davit,2:3,12:10 - 11:5 - 9:11 - 12:14 - 11:8,3,2,Gevorgyan Hayk,Avakimyan Davit,fiurst,Avakimyan Davit - Gevorgyan Hayk,103,48,55,7,-7,22,16,20,26,19,2,6,-2,-2,3,7,10:12 - 5:11 - 11:9 - 14:12 - 8:11
15402653,2023-11-26 17:15:00,Darbinyan Armen - Gevorgyan Gegham,0:3,5:11 - 4:11 - 4:11 - 0:0 - 0:0,0,3,Darbinyan Armen,Gevorgyan Gegham,fiurst,Darbinyan Armen - Gevorgyan Gegham,46,13,33,20,-20,16,15,15,0,0,6,7,7,0,0,20,5:11 - 4:11 - 4:11 - 0:0 - 0:0
15402650,2023-11-26 17:00:00,Grigoryan Erik - Gevorgyan Hayk,0:3,11:9 - 11:8 - 11:9 - 0:0 - 0:0,3,0,Grigoryan Erik,Gevorgyan Hayk,fiurst,Gevorgyan Hayk - Grigoryan Erik,59,26,33,7,-7,20,19,20,0,0,2,3,2,0,0,7,9:11 - 8:11 - 9:11 - 0:0 - 0:0
15402649,2023-11-26 16:45:00,Darbinyan Armen - Avakimyan Davit,0:3,11:9 - 11:7 - 11:8 - 0:0 - 0:0,3,0,Darbinyan Armen,Avakimyan Davit,fiurst,Avakimyan Davit - Darbinyan Armen,57,24,33,9,-9,20,18,19,0,0,2,4,3,0,0,9,9:11 - 7:11 - 8:11 - 0:0 - 0:0
15402647,2023-11-26 16:30:00,Gevorgyan Gegham - Grigoryan Erik,3:0,11:9 - 11:5 - 11:8 - 0:0 - 0:0,3,0,Gevorgyan Gegham,Grigoryan Erik,fiurst,Gevorgyan Gegham - Grigoryan Erik,55,33,22,-11,11,20,16,19,0,0,-2,-6,-3,0,0,-11,11:9 - 11:5 - 11:8 - 0:0 - 0:0
15402641,2023-11-26 16:15:00,Gevorgyan Hayk - Darbinyan Armen,0:3,11:6 - 11:7 - 11:1 - 0:0 - 0:0,3,0,Gevorgyan Hayk,Darbinyan Armen,fiurst,Darbinyan Armen - Gevorgyan Hayk,47,14,33,19,-19,17,18,12,0,0,5,4,10,0,0,19,6:11 - 7:11 - 1:11 - 0:0 - 0:0
15402640,2023-11-26 16:00:00,Avakimyan Davit - Grigoryan Erik,3:1,5:11 - 13:11 - 11:5 - 11:9 - 0:0,3,1,Avakimyan Davit,Grigoryan Erik,fiurst,Avakimyan Davit - Grigoryan Erik,76,40,36,-4,4,16,24,16,20,0,6,-2,-6,-2,0,-4,5:11 - 13:11 - 11:5 - 11:9 - 0:0
15402637,2023-11-26 15:45:00,Gevorgyan Gegham - Gevorgyan Hayk,0:3,8:11 - 6:11 - 5:11 - 0:0 - 0:0,0,3,Gevorgyan Gegham,Gevorgyan Hayk,fiurst,Gevorgyan Gegham - Gevorgyan Hayk,52,19,33,14,-14,19,17,16,0,0,3,5,6,0,0,14,8:11 - 6:11 - 5:11 - 0:0 - 0:0
15402636,2023-11-26 15:30:00,Grigoryan Erik - Darbinyan Armen,3:1,6:11 - 9:11 - 11:4 - 3:11 - 0:0,1,3,Grigoryan Erik,Darbinyan Armen,fiurst,Darbinyan Armen - Grigoryan Erik,66,37,29,-8,8,17,20,15,14,0,-5,-2,7,-8,0,-8,11:6 - 11:9 - 4:11 - 11:3 - 0:0
15402635,2023-11-26 15:15:00,Avakimyan Davit - Gevorgyan Gegham,3:1,11:8 - 11:7 - 11:13 - 11:5 - 0:0,3,1,Avakimyan Davit,Gevorgyan Gegham,fiurst,Avakimyan Davit - Gevorgyan Gegham,77,44,33,-11,11,19,18,24,16,0,-3,-4,2,-6,0,-11,11:8 - 11:7 - 11:13 - 11:5 - 0:0
15402629,2023-11-26 15:00:00,Nazaryan Mushegh - Papyan Karen,2:3,11:8 - 11:9 - 14:16 - 4:11 - 8:11,2,3,Nazaryan Mushegh,Papyan Karen,fiurst,Nazaryan Mushegh - Papyan Karen,103,48,55,7,-7,19,20,30,15,19,-3,-2,2,7,3,7,11:8 - 11:9 - 14:16 - 4:11 - 8:11
15402619,2023-11-26 14:50:00,Nikoghosyan Narek - Arutyunov Ruben,3:0,4:11 - 7:11 - 8:11 - 0:0 - 0:0,0,3,Nikoghosyan Narek,Arutyunov Ruben,fiurst,Arutyunov Ruben - Nikoghosyan Narek,52,33,19,-14,14,15,18,19,0,0,-7,-4,-3,0,0,-14,11:4 - 11:7 - 11:8 - 0:0 - 0:0
15402618,2023-11-26 14:40:00,Soghomonyan Hrayr - Nazaryan Mushegh,3:1,7:11 - 11:6 - 6:11 - 9:11 - 0:0,1,3,Soghomonyan Hrayr,Nazaryan Mushegh,fiurst,Nazaryan Mushegh - Soghomonyan Hrayr,72,39,33,-6,6,18,17,17,20,0,-4,5,-5,-2,0,-6,11:7 - 6:11 - 11:6 - 11:9 - 0:0
15402612,2023-11-26 14:15:00,Papyan Karen - Nikoghosyan Narek,0:3,11:7 - 11:9 - 11:8 - 0:0 - 0:0,3,0,Papyan Karen,Nikoghosyan Narek,fiurst,Nikoghosyan Narek - Papyan Karen,57,24,33,9,-9,18,20,19,0,0,4,2,3,0,0,9,7:11 - 9:11 - 8:11 - 0:0 - 0:0
15402610,2023-11-26 14:00:00,Soghomonyan Hrayr - Arutyunov Ruben,2:3,10:12 - 9:11 - 11:8 - 11:6 - 11:3,3,2,Soghomonyan Hrayr,Arutyunov Ruben,fiurst,Arutyunov Ruben - Soghomonyan Hrayr,92,40,52,12,-12,22,20,19,17,14,-2,-2,3,5,8,12,12:10 - 11:9 - 8:11 - 6:11 - 3:11
15402609,2023-11-26 13:50:00,Nazaryan Mushegh - Nikoghosyan Narek,3:0,11:9 - 11:9 - 11:9 - 0:0 - 0:0,3,0,Nazaryan Mushegh,Nikoghosyan Narek,fiurst,Nazaryan Mushegh - Nikoghosyan Narek,60,33,27,-6,6,20,20,20,0,0,-2,-2,-2,0,0,-6,11:9 - 11:9 - 11:9 - 0:0 - 0:0
15402595,2023-11-26 13:35:00,Papyan Karen - Soghomonyan Hrayr,0:3,9:11 - 4:11 - 5:11 - 0:0 - 0:0,0,3,Papyan Karen,Soghomonyan Hrayr,fiurst,Papyan Karen - Soghomonyan Hrayr,51,18,33,15,-15,20,15,16,0,0,2,7,6,0,0,15,9:11 - 4:11 - 5:11 - 0:0 - 0:0
15402593,2023-11-26 13:25:00,Arutyunov Ruben - Nazaryan Mushegh,1:3,11:8 - 2:11 - 9:11 - 4:11 - 0:0,1,3,Arutyunov Ruben,Nazaryan Mushegh,fiurst,Arutyunov Ruben - Nazaryan Mushegh,67,26,41,15,-15,19,13,20,15,0,-3,9,2,7,0,15,11:8 - 2:11 - 9:11 - 4:11 - 0:0
15402591,2023-11-26 13:00:00,Nikoghosyan Narek - Soghomonyan Hrayr,3:1,11:6 - 7:11 - 11:6 - 11:7 - 0:0,3,1,Nikoghosyan Narek,Soghomonyan Hrayr,fiurst,Nikoghosyan Narek - Soghomonyan Hrayr,70,40,30,-10,10,17,18,17,18,0,-5,4,-5,-4,0,-10,11:6 - 7:11 - 11:6 - 11:7 - 0:0
15402588,2023-11-26 12:45:00,Arutyunov Ruben - Papyan Karen,3:2,3:11 - 11:4 - 11:3 - 4:11 - 11:9,3,2,Arutyunov Ruben,Papyan Karen,fiurst,Arutyunov Ruben - Papyan Karen,78,40,38,-2,2,14,15,14,15,20,8,-7,-8,7,-2,-2,3:11 - 11:4 - 11:3 - 4:11 - 11:9
15402585,2023-11-26 12:20:00,Nazaryan Mushegh - Soghomonyan Hrayr,0:3,9:11 - 9:11 - 10:12 - 0:0 - 0:0,0,3,Nazaryan Mushegh,Soghomonyan Hrayr,fiurst,Nazaryan Mushegh - Soghomonyan Hrayr,62,28,34,6,-6,20,20,22,0,0,2,2,2,0,0,6,9:11 - 9:11 - 10:12 - 0:0 - 0:0
15402582,2023-11-26 12:10:00,Arutyunov Ruben - Nikoghosyan Narek,3:2,11:9 - 5:11 - 1:11 - 11:8 - 11:5,3,2,Arutyunov Ruben,Nikoghosyan Narek,fiurst,Arutyunov Ruben - Nikoghosyan Narek,83,39,44,5,-5,20,16,12,19,16,-2,6,10,-3,-6,5,11:9 - 5:11 - 1:11 - 11:8 - 11:5
15402571,2023-11-26 11:45:00,Papyan Karen - Nazaryan Mushegh,2:3,11:9 - 8:11 - 9:11 - 11:6 - 11:8,3,2,Papyan Karen,Nazaryan Mushegh,fiurst,Nazaryan Mushegh - Papyan Karen,95,45,50,5,-5,20,19,20,17,19,2,-3,-2,5,3,5,9:11 - 11:8 - 11:9 - 6:11 - 8:11
15402570,2023-11-26 11:40:00,Arutyunov Ruben - Soghomonyan Hrayr,3:0,14:12 - 11:8 - 11:6 - 0:0 - 0:0,3,0,Arutyunov Ruben,Soghomonyan Hrayr,fiurst,Arutyunov Ruben - Soghomonyan Hrayr,62,36,26,-10,10,26,19,17,0,0,-2,-3,-5,0,0,-10,14:12 - 11:8 - 11:6 - 0:0 - 0:0
15402568,2023-11-26 11:15:00,Nikoghosyan Narek - Papyan Karen,3:0,11:3 - 16:14 - 11:9 - 0:0 - 0:0,3,0,Nikoghosyan Narek,Papyan Karen,fiurst,Nikoghosyan Narek - Papyan Karen,64,38,26,-12,12,14,30,20,0,0,-8,-2,-2,0,0,-12,11:3 - 16:14 - 11:9 - 0:0 - 0:0
15402563,2023-11-26 11:00:00,Nazaryan Mushegh - Arutyunov Ruben,3:2,7:11 - 11:7 - 5:11 - 11:9 - 9:11,2,3,Nazaryan Mushegh,Arutyunov Ruben,fiurst,Arutyunov Ruben - Nazaryan Mushegh,92,49,43,-6,6,18,18,16,20,20,-4,4,-6,2,-2,-6,11:7 - 7:11 - 11:5 - 9:11 - 11:9
15402561,2023-11-26 10:45:00,Soghomonyan Hrayr - Papyan Karen,2:3,11:13 - 7:11 - 11:8 - 11:9 - 11:5,3,2,Soghomonyan Hrayr,Papyan Karen,fiurst,Papyan Karen - Soghomonyan Hrayr,97,46,51,5,-5,24,18,19,20,16,-2,-4,3,2,6,5,13:11 - 11:7 - 8:11 - 9:11 - 5:11
15402559,2023-11-26 10:30:00,Nikoghosyan Narek - Nazaryan Mushegh,1:3,13:11 - 11:6 - 9:11 - 11:5 - 0:0,3,1,Nikoghosyan Narek,Nazaryan Mushegh,fiurst,Nazaryan Mushegh - Nikoghosyan Narek,77,33,44,11,-11,24,17,20,16,0,2,5,-2,6,0,11,11:13 - 6:11 - 11:9 - 5:11 - 0:0
15402552,2023-11-26 10:15:00,Papyan Karen - Arutyunov Ruben,3:2,5:11 - 11:9 - 6:11 - 11:9 - 7:11,2,3,Papyan Karen,Arutyunov Ruben,fiurst,Arutyunov Ruben - Papyan Karen,91,51,40,-11,11,16,20,17,20,18,-6,2,-5,2,-4,-11,11:5 - 9:11 - 11:6 - 9:11 - 11:7
15402539,2023-11-26 10:00:00,Soghomonyan Hrayr - Nikoghosyan Narek,3:0,8:11 - 9:11 - 3:11 - 0:0 - 0:0,0,3,Soghomonyan Hrayr,Nikoghosyan Narek,fiurst,Nikoghosyan Narek - Soghomonyan Hrayr,53,33,20,-13,13,19,20,14,0,0,-3,-2,-8,0,0,-13,11:8 - 11:9 - 11:3 - 0:0 - 0:0
15381333,2023-11-25 17:35:00,Avakimyan Davit - Darbinyan Armen,3:2,11:6 - 10:12 - 11:6 - 9:11 - 11:3,3,2,Avakimyan Davit,Darbinyan Armen,fiurst,Avakimyan Davit - Darbinyan Armen,90,52,38,-14,14,17,22,17,20,14,-5,2,-5,2,-8,-14,11:6 - 10:12 - 11:6 - 9:11 - 11:3
15381282,2023-11-25 17:20:00,Gevorgyan Gegham - Avakimyan Davit,3:0,10:12 - 7:11 - 8:11 - 0:0 - 0:0,0,3,Gevorgyan Gegham,Avakimyan Davit,fiurst,Avakimyan Davit - Gevorgyan Gegham,59,34,25,-9,9,22,18,19,0,0,-2,-4,-3,0,0,-9,12:10 - 11:7 - 11:8 - 0:0 - 0:0
15381328,2023-11-25 17:15:00,Gevorgyan Hayk - Petrosyan Davit,3:0,11:7 - 11:8 - 13:11 - 0:0 - 0:0,3,0,Gevorgyan Hayk,Petrosyan Davit,fiurst,Gevorgyan Hayk - Petrosyan Davit,61,35,26,-9,9,18,19,24,0,0,-4,-3,-2,0,0,-9,11:7 - 11:8 - 13:11 - 0:0 - 0:0
15381281,2023-11-25 16:45:00,Gevorgyan Hayk - Darbinyan Armen,2:3,9:11 - 11:9 - 8:11 - 11:6 - 11:8,3,2,Gevorgyan Hayk,Darbinyan Armen,fiurst,Darbinyan Armen - Gevorgyan Hayk,95,45,50,5,-5,20,20,19,17,19,-2,2,-3,5,3,5,11:9 - 9:11 - 11:8 - 6:11 - 8:11
15381280,2023-11-25 16:40:00,Petrosyan Davit - Gevorgyan Gegham,1:3,19:17 - 9:11 - 11:8 - 11:5 - 0:0,3,1,Petrosyan Davit,Gevorgyan Gegham,fiurst,Gevorgyan Gegham - Petrosyan Davit,91,41,50,9,-9,36,20,19,16,0,2,-2,3,6,0,9,17:19 - 11:9 - 8:11 - 5:11 - 0:0
15381278,2023-11-25 16:15:00,Avakimyan Davit - Gevorgyan Hayk,2:3,11:8 - 6:11 - 6:11 - 11:5 - 5:11,2,3,Avakimyan Davit,Gevorgyan Hayk,fiurst,Avakimyan Davit - Gevorgyan Hayk,85,39,46,7,-7,19,17,17,16,16,-3,5,5,-6,6,7,11:8 - 6:11 - 6:11 - 11:5 - 5:11
15381265,2023-11-25 16:10:00,Darbinyan Armen - Gevorgyan Gegham,1:3,7:11 - 8:11 - 11:9 - 9:11 - 0:0,1,3,Darbinyan Armen,Gevorgyan Gegham,fiurst,Darbinyan Armen - Gevorgyan Gegham,77,35,42,7,-7,18,19,20,20,0,4,3,-2,2,0,7,7:11 - 8:11 - 11:9 - 9:11 - 0:0
15381264,2023-11-25 15:45:00,Petrosyan Davit - Avakimyan Davit,3:0,4:11 - 5:11 - 10:12 - 0:0 - 0:0,0,3,Petrosyan Davit,Avakimyan Davit,fiurst,Avakimyan Davit - Petrosyan Davit,53,34,19,-15,15,15,16,22,0,0,-7,-6,-2,0,0,-15,11:4 - 11:5 - 12:10 - 0:0 - 0:0
15381261,2023-11-25 15:30:00,Gevorgyan Gegham - Gevorgyan Hayk,2:3,10:12 - 7:11 - 12:10 - 11:7 - 15:17,2,3,Gevorgyan Gegham,Gevorgyan Hayk,fiurst,Gevorgyan Gegham - Gevorgyan Hayk,112,55,57,2,-2,22,18,22,18,32,2,4,-2,-4,2,2,10:12 - 7:11 - 12:10 - 11:7 - 15:17
15381258,2023-11-25 15:15:00,Darbinyan Armen - Petrosyan Davit,1:3,3:11 - 11:13 - 11:8 - 4:11 - 0:0,1,3,Darbinyan Armen,Petrosyan Davit,fiurst,Darbinyan Armen - Petrosyan Davit,72,29,43,14,-14,14,24,19,15,0,8,2,-3,7,0,14,3:11 - 11:13 - 11:8 - 4:11 - 0:0
15381255,2023-11-25 15:00:00,Mkrtchyan Andranik - Nikoghosyan Narek,2:3,3:11 - 11:9 - 11:7 - 7:11 - 7:11,2,3,Mkrtchyan Andranik,Nikoghosyan Narek,fiurst,Mkrtchyan Andranik - Nikoghosyan Narek,88,39,49,10,-10,14,20,18,18,18,8,-2,-4,4,4,10,3:11 - 11:9 - 11:7 - 7:11 - 7:11
15381252,2023-11-25 14:45:00,Soghomonyan Hrayr - Papyan Karen,0:3,11:2 - 13:11 - 11:4 - 0:0 - 0:0,3,0,Soghomonyan Hrayr,Papyan Karen,fiurst,Papyan Karen - Soghomonyan Hrayr,52,17,35,18,-18,13,24,15,0,0,9,2,7,0,0,18,2:11 - 11:13 - 4:11 - 0:0 - 0:0
15381242,2023-11-25 14:30:00,Rafayelyan Edgar - Mkrtchyan Andranik,0:3,11:4 - 11:9 - 11:6 - 0:0 - 0:0,3,0,Rafayelyan Edgar,Mkrtchyan Andranik,fiurst,Mkrtchyan Andranik - Rafayelyan Edgar,52,19,33,14,-14,15,20,17,0,0,7,2,5,0,0,14,4:11 - 9:11 - 6:11 - 0:0 - 0:0
15381240,2023-11-25 14:20:00,Nikoghosyan Narek - Soghomonyan Hrayr,3:1,11:5 - 8:11 - 11:5 - 11:8 - 0:0,3,1,Nikoghosyan Narek,Soghomonyan Hrayr,fiurst,Nikoghosyan Narek - Soghomonyan Hrayr,70,41,29,-12,12,16,19,16,19,0,-6,3,-6,-3,0,-12,11:5 - 8:11 - 11:5 - 11:8 - 0:0
15381236,2023-11-25 14:05:00,Rafayelyan Edgar - Papyan Karen,0:3,13:11 - 11:5 - 11:8 - 0:0 - 0:0,3,0,Rafayelyan Edgar,Papyan Karen,fiurst,Papyan Karen - Rafayelyan Edgar,59,24,35,11,-11,24,16,19,0,0,2,6,3,0,0,11,11:13 - 5:11 - 8:11 - 0:0 - 0:0
15381232,2023-11-25 13:45:00,Mkrtchyan Andranik - Soghomonyan Hrayr,0:3,7:11 - 8:11 - 6:11 - 0:0 - 0:0,0,3,Mkrtchyan Andranik,Soghomonyan Hrayr,fiurst,Mkrtchyan Andranik - Soghomonyan Hrayr,54,21,33,12,-12,18,19,17,0,0,4,3,5,0,0,12,7:11 - 8:11 - 6:11 - 0:0 - 0:0
15381230,2023-11-25 13:40:00,Nikoghosyan Narek - Rafayelyan Edgar,3:2,9:11 - 11:1 - 3:11 - 11:9 - 11:2,3,2,Nikoghosyan Narek,Rafayelyan Edgar,fiurst,Nikoghosyan Narek - Rafayelyan Edgar,79,45,34,-11,11,20,12,14,20,13,2,-10,8,-2,-9,-11,9:11 - 11:1 - 3:11 - 11:9 - 11:2
15381229,2023-11-25 13:15:00,Papyan Karen - Mkrtchyan Andranik,0:3,12:10 - 14:12 - 11:7 - 0:0 - 0:0,3,0,Papyan Karen,Mkrtchyan Andranik,fiurst,Mkrtchyan Andranik - Papyan Karen,66,29,37,8,-8,22,26,18,0,0,2,2,4,0,0,8,10:12 - 12:14 - 7:11 - 0:0 - 0:0
15381218,2023-11-25 13:00:00,Soghomonyan Hrayr - Rafayelyan Edgar,3:2,8:11 - 11:9 - 11:9 - 7:11 - 9:11,2,3,Soghomonyan Hrayr,Rafayelyan Edgar,fiurst,Rafayelyan Edgar - Soghomonyan Hrayr,97,51,46,-5,5,19,20,20,18,20,-3,2,2,-4,-2,-5,11:8 - 9:11 - 9:11 - 11:7 - 11:9
15381215,2023-11-25 12:45:00,Papyan Karen - Nikoghosyan Narek,3:1,11:3 - 5:11 - 11:13 - 5:11 - 0:0,1,3,Papyan Karen,Nikoghosyan Narek,fiurst,Nikoghosyan Narek - Papyan Karen,70,38,32,-6,6,14,16,24,16,0,8,-6,-2,-6,0,-6,3:11 - 11:5 - 13:11 - 11:5 - 0:0
15381207,2023-11-25 12:15:00,Mkrtchyan Andranik - Rafayelyan Edgar,1:3,11:7 - 4:11 - 5:11 - 2:11 - 0:0,1,3,Mkrtchyan Andranik,Rafayelyan Edgar,fiurst,Mkrtchyan Andranik - Rafayelyan Edgar,62,22,40,18,-18,18,15,16,13,0,-4,7,6,9,0,18,11:7 - 4:11 - 5:11 - 2:11 - 0:0
15381202,2023-11-25 12:00:00,Papyan Karen - Soghomonyan Hrayr,3:1,12:10 - 6:11 - 11:9 - 12:10 - 0:0,3,1,Papyan Karen,Soghomonyan Hrayr,fiurst,Papyan Karen - Soghomonyan Hrayr,81,41,40,-1,1,22,17,20,22,0,-2,5,-2,-2,0,-1,12:10 - 6:11 - 11:9 - 12:10 - 0:0
15381197,2023-11-25 11:45:00,Nikoghosyan Narek - Mkrtchyan Andranik,0:3,11:3 - 11:7 - 11:5 - 0:0 - 0:0,3,0,Nikoghosyan Narek,Mkrtchyan Andranik,fiurst,Mkrtchyan Andranik - Nikoghosyan Narek,48,15,33,18,-18,14,18,16,0,0,8,4,6,0,0,18,3:11 - 7:11 - 5:11 - 0:0 - 0:0
15381195,2023-11-25 11:35:00,Papyan Karen - Rafayelyan Edgar,0:3,6:11 - 10:12 - 5:11 - 0:0 - 0:0,0,3,Papyan Karen,Rafayelyan Edgar,fiurst,Papyan Karen - Rafayelyan Edgar,55,21,34,13,-13,17,22,16,0,0,5,2,6,0,0,13,6:11 - 10:12 - 5:11 - 0:0 - 0:0
15381193,2023-11-25 11:15:00,Soghomonyan Hrayr - Nikoghosyan Narek,3:0,8:11 - 5:11 - 8:11 - 0:0 - 0:0,0,3,Soghomonyan Hrayr,Nikoghosyan Narek,fiurst,Nikoghosyan Narek - Soghomonyan Hrayr,54,33,21,-12,12,19,16,19,0,0,-3,-6,-3,0,0,-12,11:8 - 11:5 - 11:8 - 0:0 - 0:0
15381190,2023-11-25 11:00:00,Mkrtchyan Andranik - Papyan Karen,3:2,5:11 - 10:12 - 13:11 - 11:9 - 11:5,3,2,Mkrtchyan Andranik,Papyan Karen,fiurst,Mkrtchyan Andranik - Papyan Karen,98,50,48,-2,2,16,22,24,20,16,6,2,-2,-2,-6,-2,5:11 - 10:12 - 13:11 - 11:9 - 11:5
15381189,2023-11-25 10:45:00,Rafayelyan Edgar - Nikoghosyan Narek,0:3,11:6 - 11:7 - 11:4 - 0:0 - 0:0,3,0,Rafayelyan Edgar,Nikoghosyan Narek,fiurst,Nikoghosyan Narek - Rafayelyan Edgar,50,17,33,16,-16,17,18,15,0,0,5,4,7,0,0,16,6:11 - 7:11 - 4:11 - 0:0 - 0:0
15381178,2023-11-25 10:30:00,Soghomonyan Hrayr - Mkrtchyan Andranik,1:3,11:4 - 11:9 - 6:11 - 11:8 - 0:0,3,1,Soghomonyan Hrayr,Mkrtchyan Andranik,fiurst,Mkrtchyan Andranik - Soghomonyan Hrayr,71,32,39,7,-7,15,20,17,19,0,7,2,-5,3,0,7,4:11 - 9:11 - 11:6 - 8:11 - 0:0
15381175,2023-11-25 10:15:00,Nikoghosyan Narek - Papyan Karen,3:1,11:5 - 11:7 - 12:14 - 11:8 - 0:0,3,1,Nikoghosyan Narek,Papyan Karen,fiurst,Nikoghosyan Narek - Papyan Karen,79,45,34,-11,11,16,18,26,19,0,-6,-4,2,-3,0,-11,11:5 - 11:7 - 12:14 - 11:8 - 0:0
15381173,2023-11-25 10:00:00,Rafayelyan Edgar - Soghomonyan Hrayr,3:0,11:9 - 11:3 - 12:10 - 0:0 - 0:0,3,0,Rafayelyan Edgar,Soghomonyan Hrayr,fiurst,Rafayelyan Edgar - Soghomonyan Hrayr,56,34,22,-12,12,20,14,22,0,0,-2,-8,-2,0,0,-12,11:9 - 11:3 - 12:10 - 0:0 - 0:0
15361841,2023-11-24 17:30:00,Darbinyan Armen - Gevorgyan Hayk,0:3,1:11 - 7:11 - 6:11 - 0:0 - 0:0,0,3,Darbinyan Armen,Gevorgyan Hayk,fiurst,Darbinyan Armen - Gevorgyan Hayk,47,14,33,19,-19,12,18,17,0,0,10,4,5,0,0,19,1:11 - 7:11 - 6:11 - 0:0 - 0:0
15361837,2023-11-24 17:20:00,Avakimyan Davit - Grigoryan Erik,3:1,9:11 - 11:7 - 11:8 - 11:2 - 0:0,3,1,Avakimyan Davit,Grigoryan Erik,fiurst,Avakimyan Davit - Grigoryan Erik,70,42,28,-14,14,20,18,19,13,0,2,-4,-3,-9,0,-14,9:11 - 11:7 - 11:8 - 11:2 - 0:0
15361823,2023-11-24 17:05:00,Petrosyan Davit - Darbinyan Armen,0:3,11:7 - 16:14 - 11:5 - 0:0 - 0:0,3,0,Petrosyan Davit,Darbinyan Armen,fiurst,Darbinyan Armen - Petrosyan Davit,64,26,38,12,-12,18,30,16,0,0,4,2,6,0,0,12,7:11 - 14:16 - 5:11 - 0:0 - 0:0
15361820,2023-11-24 16:45:00,Avakimyan Davit - Gevorgyan Hayk,0:3,6:11 - 4:11 - 4:11 - 0:0 - 0:0,0,3,Avakimyan Davit,Gevorgyan Hayk,fiurst,Avakimyan Davit - Gevorgyan Hayk,47,14,33,19,-19,17,15,15,0,0,5,7,7,0,0,19,6:11 - 4:11 - 4:11 - 0:0 - 0:0
15361818,2023-11-24 16:40:00,Grigoryan Erik - Petrosyan Davit,1:3,2:11 - 11:6 - 8:11 - 1:11 - 0:0,1,3,Grigoryan Erik,Petrosyan Davit,fiurst,Grigoryan Erik - Petrosyan Davit,61,22,39,17,-17,13,17,19,12,0,9,-5,3,10,0,17,2:11 - 11:6 - 8:11 - 1:11 - 0:0
15361815,2023-11-24 16:15:00,Darbinyan Armen - Avakimyan Davit,3:1,11:9 - 7:11 - 5:11 - 9:11 - 0:0,1,3,Darbinyan Armen,Avakimyan Davit,fiurst,Avakimyan Davit - Darbinyan Armen,74,42,32,-10,10,20,18,16,20,0,2,-4,-6,-2,0,-10,9:11 - 11:7 - 11:5 - 11:9 - 0:0
15361802,2023-11-24 16:05:00,Gevorgyan Hayk - Petrosyan Davit,3:1,12:10 - 11:13 - 11:5 - 19:17 - 0:0,3,1,Gevorgyan Hayk,Petrosyan Davit,fiurst,Gevorgyan Hayk - Petrosyan Davit,98,53,45,-8,8,22,24,16,36,0,-2,2,-6,-2,0,-8,12:10 - 11:13 - 11:5 - 19:17 - 0:0
15361797,2023-11-24 15:45:00,Grigoryan Erik - Darbinyan Armen,1:3,8:11 - 11:9 - 11:7 - 11:9 - 0:0,3,1,Grigoryan Erik,Darbinyan Armen,fiurst,Darbinyan Armen - Grigoryan Erik,77,36,41,5,-5,19,20,18,20,0,-3,2,4,2,0,5,11:8 - 9:11 - 7:11 - 9:11 - 0:0
15361793,2023-11-24 15:40:00,Petrosyan Davit - Avakimyan Davit,0:3,11:6 - 11:6 - 13:11 - 0:0 - 0:0,3,0,Petrosyan Davit,Avakimyan Davit,fiurst,Avakimyan Davit - Petrosyan Davit,58,23,35,12,-12,17,17,24,0,0,5,5,2,0,0,12,6:11 - 6:11 - 11:13 - 0:0 - 0:0
15361789,2023-11-24 15:15:00,Gevorgyan Hayk - Grigoryan Erik,3:0,11:3 - 11:6 - 11:6 - 0:0 - 0:0,3,0,Gevorgyan Hayk,Grigoryan Erik,fiurst,Gevorgyan Hayk - Grigoryan Erik,48,33,15,-18,18,14,17,17,0,0,-8,-5,-5,0,0,-18,11:3 - 11:6 - 11:6 - 0:0 - 0:0
15361787,2023-11-24 15:10:00,Arutyunov Ruben - Rafayelyan Edgar,2:3,7:11 - 11:5 - 11:8 - 9:11 - 5:11,2,3,Arutyunov Ruben,Rafayelyan Edgar,fiurst,Arutyunov Ruben - Rafayelyan Edgar,89,43,46,3,-3,18,16,19,20,16,4,-6,-3,2,6,3,7:11 - 11:5 - 11:8 - 9:11 - 5:11
15361775,2023-11-24 14:50:00,Nazaryan Mushegh - Mkrtchyan Andranik,0:3,11:9 - 11:6 - 12:10 - 0:0 - 0:0,3,0,Nazaryan Mushegh,Mkrtchyan Andranik,fiurst,Mkrtchyan Andranik - Nazaryan Mushegh,59,25,34,9,-9,20,17,22,0,0,2,5,2,0,0,9,9:11 - 6:11 - 10:12 - 0:0 - 0:0
15361772,2023-11-24 14:40:00,Nikoghosyan Narek - Arutyunov Ruben,0:3,11:3 - 11:6 - 12:10 - 0:0 - 0:0,3,0,Nikoghosyan Narek,Arutyunov Ruben,fiurst,Arutyunov Ruben - Nikoghosyan Narek,53,19,34,15,-15,14,17,22,0,0,8,5,2,0,0,15,3:11 - 6:11 - 10:12 - 0:0 - 0:0
15361769,2023-11-24 14:25:00,Rafayelyan Edgar - Nazaryan Mushegh,1:3,11:9 - 7:11 - 11:5 - 11:5 - 0:0,3,1,Rafayelyan Edgar,Nazaryan Mushegh,fiurst,Nazaryan Mushegh - Rafayelyan Edgar,70,30,40,10,-10,20,18,16,16,0,2,-4,6,6,0,10,9:11 - 11:7 - 5:11 - 5:11 - 0:0
15361763,2023-11-24 14:10:00,Nikoghosyan Narek - Mkrtchyan Andranik,2:3,12:10 - 8:11 - 8:11 - 11:9 - 12:10,3,2,Nikoghosyan Narek,Mkrtchyan Andranik,fiurst,Mkrtchyan Andranik - Nikoghosyan Narek,102,51,51,0,0,22,19,19,20,22,2,-3,-3,2,2,0,10:12 - 11:8 - 11:8 - 9:11 - 10:12
15361759,2023-11-24 13:55:00,Arutyunov Ruben - Nazaryan Mushegh,3:1,7:11 - 11:6 - 13:11 - 11:6 - 0:0,3,1,Arutyunov Ruben,Nazaryan Mushegh,fiurst,Arutyunov Ruben - Nazaryan Mushegh,76,42,34,-8,8,18,17,24,17,0,4,-5,-2,-5,0,-8,7:11 - 11:6 - 13:11 - 11:6 - 0:0
15361753,2023-11-24 13:35:00,Rafayelyan Edgar - Nikoghosyan Narek,2:3,3:11 - 11:9 - 11:5 - 10:12 - 11:5,3,2,Rafayelyan Edgar,Nikoghosyan Narek,fiurst,Nikoghosyan Narek - Rafayelyan Edgar,88,42,46,4,-4,14,20,16,22,16,-8,2,6,-2,6,4,11:3 - 9:11 - 5:11 - 12:10 - 5:11
15361744,2023-11-24 13:25:00,Mkrtchyan Andranik - Arutyunov Ruben,3:0,5:11 - 8:11 - 10:12 - 0:0 - 0:0,0,3,Mkrtchyan Andranik,Arutyunov Ruben,fiurst,Arutyunov Ruben - Mkrtchyan Andranik,57,34,23,-11,11,16,19,22,0,0,-6,-3,-2,0,0,-11,11:5 - 11:8 - 12:10 - 0:0 - 0:0
15357790,2023-11-24 13:00:00,Nazaryan Mushegh - Nikoghosyan Narek,1:3,5:11 - 11:8 - 4:11 - 8:11 - 0:0,1,3,Nazaryan Mushegh,Nikoghosyan Narek,fiurst,Nazaryan Mushegh - Nikoghosyan Narek,69,28,41,13,-13,16,19,15,19,0,6,-3,7,3,0,13,5:11 - 11:8 - 4:11 - 8:11 - 0:0
15357788,2023-11-24 12:50:00,Mkrtchyan Andranik - Rafayelyan Edgar,0:3,8:11 - 7:11 - 10:12 - 0:0 - 0:0,0,3,Mkrtchyan Andranik,Rafayelyan Edgar,fiurst,Mkrtchyan Andranik - Rafayelyan Edgar,59,25,34,9,-9,19,18,22,0,0,3,4,2,0,0,9,8:11 - 7:11 - 10:12 - 0:0 - 0:0
15357787,2023-11-24 12:25:00,Arutyunov Ruben - Nikoghosyan Narek,3:1,11:5 - 13:11 - 9:11 - 11:5 - 0:0,3,1,Arutyunov Ruben,Nikoghosyan Narek,fiurst,Arutyunov Ruben - Nikoghosyan Narek,76,44,32,-12,12,16,24,20,16,0,-6,-2,2,-6,0,-12,11:5 - 13:11 - 9:11 - 11:5 - 0:0
15357775,2023-11-24 12:00:00,Mkrtchyan Andranik - Nazaryan Mushegh,0:3,2:11 - 8:11 - 8:11 - 0:0 - 0:0,0,3,Mkrtchyan Andranik,Nazaryan Mushegh,fiurst,Mkrtchyan Andranik - Nazaryan Mushegh,51,18,33,15,-15,13,19,19,0,0,9,3,3,0,0,15,2:11 - 8:11 - 8:11 - 0:0 - 0:0
15357771,2023-11-24 11:55:00,Rafayelyan Edgar - Arutyunov Ruben,1:3,11:9 - 12:14 - 11:4 - 11:2 - 0:0,3,1,Rafayelyan Edgar,Arutyunov Ruben,fiurst,Arutyunov Ruben - Rafayelyan Edgar,74,29,45,16,-16,20,26,15,13,0,2,-2,7,9,0,16,9:11 - 14:12 - 4:11 - 2:11 - 0:0
15357769,2023-11-24 11:30:00,Mkrtchyan Andranik - Nikoghosyan Narek,1:3,4:11 - 12:10 - 8:11 - 4:11 - 0:0,1,3,Mkrtchyan Andranik,Nikoghosyan Narek,fiurst,Mkrtchyan Andranik - Nikoghosyan Narek,71,28,43,15,-15,15,22,19,15,0,7,-2,3,7,0,15,4:11 - 12:10 - 8:11 - 4:11 - 0:0
15357764,2023-11-24 11:25:00,Nazaryan Mushegh - Rafayelyan Edgar,1:3,11:13 - 3:11 - 11:9 - 8:11 - 0:0,1,3,Nazaryan Mushegh,Rafayelyan Edgar,fiurst,Nazaryan Mushegh - Rafayelyan Edgar,77,33,44,11,-11,24,14,20,19,0,2,8,-2,3,0,11,11:13 - 3:11 - 11:9 - 8:11 - 0:0
15357761,2023-11-24 11:00:00,Arutyunov Ruben - Mkrtchyan Andranik,3:1,11:6 - 9:11 - 11:5 - 11:6 - 0:0,3,1,Arutyunov Ruben,Mkrtchyan Andranik,fiurst,Arutyunov Ruben - Mkrtchyan Andranik,70,42,28,-14,14,17,20,16,17,0,-5,2,-6,-5,0,-14,11:6 - 9:11 - 11:5 - 11:6 - 0:0
15357757,2023-11-24 10:45:00,Nikoghosyan Narek - Rafayelyan Edgar,2:3,9:11 - 11:5 - 10:12 - 11:7 - 9:11,2,3,Nikoghosyan Narek,Rafayelyan Edgar,fiurst,Nikoghosyan Narek - Rafayelyan Edgar,96,50,46,-4,4,20,16,22,18,20,2,-6,2,-4,2,-4,9:11 - 11:5 - 10:12 - 11:7 - 9:11
15357746,2023-11-24 10:30:00,Nazaryan Mushegh - Arutyunov Ruben,0:3,11:4 - 11:5 - 13:11 - 0:0 - 0:0,3,0,Nazaryan Mushegh,Arutyunov Ruben,fiurst,Arutyunov Ruben - Nazaryan Mushegh,55,20,35,15,-15,15,16,24,0,0,7,6,2,0,0,15,4:11 - 5:11 - 11:13 - 0:0 - 0:0
15357739,2023-11-24 10:15:00,Rafayelyan Edgar - Mkrtchyan Andranik,0:3,11:5 - 11:7 - 11:7 - 0:0 - 0:0,3,0,Rafayelyan Edgar,Mkrtchyan Andranik,fiurst,Mkrtchyan Andranik - Rafayelyan Edgar,52,19,33,14,-14,16,18,18,0,0,6,4,4,0,0,14,5:11 - 7:11 - 7:11 - 0:0 - 0:0
15357737,2023-11-24 10:00:00,Nikoghosyan Narek - Nazaryan Mushegh,0:3,11:8 - 11:8 - 11:6 - 0:0 - 0:0,3,0,Nikoghosyan Narek,Nazaryan Mushegh,fiurst,Nazaryan Mushegh - Nikoghosyan Narek,55,22,33,11,-11,19,19,17,0,0,3,3,5,0,0,11,8:11 - 8:11 - 6:11 - 0:0 - 0:0
15343287,2023-11-23 17:30:00,Darbinyan Armen - Petrosyan Davit,0:3,9:11 - 5:11 - 11:13 - 0:0 - 0:0,0,3,Darbinyan Armen,Petrosyan Davit,fiurst,Darbinyan Armen - Petrosyan Davit,60,25,35,10,-10,20,16,24,0,0,2,6,2,0,0,10,9:11 - 5:11 - 11:13 - 0:0 - 0:0
15343285,2023-11-23 17:15:00,Grigoryan Erik - Gevorgyan Gegham,3:0,10:12 - 8:11 - 7:11 - 0:0 - 0:0,0,3,Grigoryan Erik,Gevorgyan Gegham,fiurst,Gevorgyan Gegham - Grigoryan Erik,59,34,25,-9,9,22,19,18,0,0,-2,-3,-4,0,0,-9,12:10 - 11:8 - 11:7 - 0:0 - 0:0
15343282,2023-11-23 17:00:00,Avakimyan Davit - Darbinyan Armen,3:0,11:7 - 11:9 - 13:11 - 0:0 - 0:0,3,0,Avakimyan Davit,Darbinyan Armen,fiurst,Avakimyan Davit - Darbinyan Armen,62,35,27,-8,8,18,20,24,0,0,-4,-2,-2,0,0,-8,11:7 - 11:9 - 13:11 - 0:0 - 0:0
15343278,2023-11-23 16:45:00,Grigoryan Erik - Petrosyan Davit,0:3,4:11 - 6:11 - 7:11 - 0:0 - 0:0,0,3,Grigoryan Erik,Petrosyan Davit,fiurst,Grigoryan Erik - Petrosyan Davit,50,17,33,16,-16,15,17,18,0,0,7,5,4,0,0,16,4:11 - 6:11 - 7:11 - 0:0 - 0:0
15343277,2023-11-23 16:30:00,Gevorgyan Gegham - Avakimyan Davit,3:0,8:11 - 7:11 - 7:11 - 0:0 - 0:0,0,3,Gevorgyan Gegham,Avakimyan Davit,fiurst,Avakimyan Davit - Gevorgyan Gegham,55,33,22,-11,11,19,18,18,0,0,-3,-4,-4,0,0,-11,11:8 - 11:7 - 11:7 - 0:0 - 0:0
15343274,2023-11-23 16:15:00,Darbinyan Armen - Grigoryan Erik,3:1,12:10 - 11:9 - 7:11 - 11:7 - 0:0,3,1,Darbinyan Armen,Grigoryan Erik,fiurst,Darbinyan Armen - Grigoryan Erik,78,41,37,-4,4,22,20,18,18,0,-2,-2,4,-4,0,-4,12:10 - 11:9 - 7:11 - 11:7 - 0:0
15343272,2023-11-23 16:00:00,Petrosyan Davit - Avakimyan Davit,3:1,11:9 - 3:11 - 10:12 - 9:11 - 0:0,1,3,Petrosyan Davit,Avakimyan Davit,fiurst,Avakimyan Davit - Petrosyan Davit,76,43,33,-10,10,20,14,22,20,0,2,-8,-2,-2,0,-10,9:11 - 11:3 - 12:10 - 11:9 - 0:0
15343270,2023-11-23 15:55:00,Gevorgyan Gegham - Darbinyan Armen,0:3,12:10 - 11:9 - 11:4 - 0:0 - 0:0,3,0,Gevorgyan Gegham,Darbinyan Armen,fiurst,Darbinyan Armen - Gevorgyan Gegham,57,23,34,11,-11,22,20,15,0,0,2,2,7,0,0,11,10:12 - 9:11 - 4:11 - 0:0 - 0:0
15343259,2023-11-23 15:30:00,Avakimyan Davit - Grigoryan Erik,3:0,11:7 - 11:7 - 11:9 - 0:0 - 0:0,3,0,Avakimyan Davit,Grigoryan Erik,fiurst,Avakimyan Davit - Grigoryan Erik,56,33,23,-10,10,18,18,20,0,0,-4,-4,-2,0,0,-10,11:7 - 11:7 - 11:9 - 0:0 - 0:0
15343257,2023-11-23 15:20:00,Petrosyan Davit - Gevorgyan Gegham,0:3,13:11 - 11:7 - 11:3 - 0:0 - 0:0,3,0,Petrosyan Davit,Gevorgyan Gegham,fiurst,Gevorgyan Gegham - Petrosyan Davit,56,21,35,14,-14,24,18,14,0,0,2,4,8,0,0,14,11:13 - 7:11 - 3:11 - 0:0 - 0:0
15343255,2023-11-23 15:00:00,Soghomonyan Hrayr - Nazaryan Mushegh,3:0,10:12 - 8:11 - 7:11 - 0:0 - 0:0,0,3,Soghomonyan Hrayr,Nazaryan Mushegh,fiurst,Nazaryan Mushegh - Soghomonyan Hrayr,59,34,25,-9,9,22,19,18,0,0,-2,-3,-4,0,0,-9,12:10 - 11:8 - 11:7 - 0:0 - 0:0
15340398,2023-11-23 14:55:00,Rafayelyan Edgar - Diaryan Aleksandr,2:3,6:11 - 11:8 - 11:7 - 7:11 - 11:4,3,2,Rafayelyan Edgar,Diaryan Aleksandr,fiurst,Diaryan Aleksandr - Rafayelyan Edgar,87,41,46,5,-5,17,19,18,18,15,-5,3,4,-4,7,5,11:6 - 8:11 - 7:11 - 11:7 - 4:11
15340386,2023-11-23 14:30:00,Mkrtchyan Andranik - Soghomonyan Hrayr,1:3,9:11 - 11:3 - 6:11 - 7:11 - 0:0,1,3,Mkrtchyan Andranik,Soghomonyan Hrayr,fiurst,Mkrtchyan Andranik - Soghomonyan Hrayr,69,33,36,3,-3,20,14,17,18,0,2,-8,5,4,0,3,9:11 - 11:3 - 6:11 - 7:11 - 0:0
15343248,2023-11-23 14:30:00,Nazaryan Mushegh - Rafayelyan Edgar,0:3,7:11 - 6:11 - 9:11 - 0:0 - 0:0,0,3,Nazaryan Mushegh,Rafayelyan Edgar,fiurst,Nazaryan Mushegh - Rafayelyan Edgar,55,22,33,11,-11,18,17,20,0,0,4,5,2,0,0,11,7:11 - 6:11 - 9:11 - 0:0 - 0:0
15340384,2023-11-23 14:00:00,Mkrtchyan Andranik - Diaryan Aleksandr,3:1,7:11 - 6:11 - 11:8 - 4:11 - 0:0,1,3,Mkrtchyan Andranik,Diaryan Aleksandr,fiurst,Diaryan Aleksandr - Mkrtchyan Andranik,69,41,28,-13,13,18,17,19,15,0,-4,-5,3,-7,0,-13,11:7 - 11:6 - 8:11 - 11:4 - 0:0
15340380,2023-11-23 13:55:00,Soghomonyan Hrayr - Rafayelyan Edgar,3:2,5:11 - 11:4 - 11:7 - 6:11 - 8:11,2,3,Soghomonyan Hrayr,Rafayelyan Edgar,fiurst,Rafayelyan Edgar - Soghomonyan Hrayr,85,44,41,-3,3,16,15,18,17,19,-6,7,4,-5,-3,-3,11:5 - 4:11 - 7:11 - 11:6 - 11:8
15343213,2023-11-23 13:30:00,Nazaryan Mushegh - Mkrtchyan Andranik,3:1,6:11 - 11:8 - 6:11 - 8:11 - 0:0,1,3,Nazaryan Mushegh,Mkrtchyan Andranik,fiurst,Mkrtchyan Andranik - Nazaryan Mushegh,72,41,31,-10,10,17,19,17,19,0,-5,3,-5,-3,0,-10,11:6 - 8:11 - 11:6 - 11:8 - 0:0
15340371,2023-11-23 13:15:00,Diaryan Aleksandr - Soghomonyan Hrayr,3:2,11:3 - 8:11 - 11:4 - 9:11 - 11:8,3,2,Diaryan Aleksandr,Soghomonyan Hrayr,fiurst,Diaryan Aleksandr - Soghomonyan Hrayr,87,50,37,-13,13,14,19,15,20,19,-8,3,-7,2,-3,-13,11:3 - 8:11 - 11:4 - 9:11 - 11:8
15340367,2023-11-23 13:00:00,Rafayelyan Edgar - Mkrtchyan Andranik,1:3,11:6 - 11:2 - 7:11 - 11:9 - 0:0,3,1,Rafayelyan Edgar,Mkrtchyan Andranik,fiurst,Mkrtchyan Andranik - Rafayelyan Edgar,68,28,40,12,-12,17,13,18,20,0,5,9,-4,2,0,12,6:11 - 2:11 - 11:7 - 9:11 - 0:0
15340355,2023-11-23 12:45:00,Diaryan Aleksandr - Nazaryan Mushegh,3:0,11:5 - 11:7 - 13:11 - 0:0 - 0:0,3,0,Diaryan Aleksandr,Nazaryan Mushegh,fiurst,Diaryan Aleksandr - Nazaryan Mushegh,58,35,23,-12,12,16,18,24,0,0,-6,-4,-2,0,0,-12,11:5 - 11:7 - 13:11 - 0:0 - 0:0
15343205,2023-11-23 12:15:00,Soghomonyan Hrayr - Mkrtchyan Andranik,0:3,11:3 - 11:9 - 11:7 - 0:0 - 0:0,3,0,Soghomonyan Hrayr,Mkrtchyan Andranik,fiurst,Mkrtchyan Andranik - Soghomonyan Hrayr,52,19,33,14,-14,14,20,18,0,0,8,2,4,0,0,14,3:11 - 9:11 - 7:11 - 0:0 - 0:0
15343204,2023-11-23 12:00:00,Diaryan Aleksandr - Rafayelyan Edgar,2:3,11:9 - 8:11 - 11:5 - 8:11 - 6:11,2,3,Diaryan Aleksandr,Rafayelyan Edgar,fiurst,Diaryan Aleksandr - Rafayelyan Edgar,91,44,47,3,-3,20,19,16,19,17,-2,3,-6,3,5,3,11:9 - 8:11 - 11:5 - 8:11 - 6:11
15340346,2023-11-23 11:50:00,Nazaryan Mushegh - Soghomonyan Hrayr,1:3,7:11 - 11:6 - 6:11 - 5:11 - 0:0,1,3,Nazaryan Mushegh,Soghomonyan Hrayr,fiurst,Nazaryan Mushegh - Soghomonyan Hrayr,68,29,39,10,-10,18,17,17,16,0,4,-5,5,6,0,10,7:11 - 11:6 - 6:11 - 5:11 - 0:0
15340344,2023-11-23 11:30:00,Diaryan Aleksandr - Mkrtchyan Andranik,3:1,11:2 - 6:11 - 11:4 - 11:2 - 0:0,3,1,Diaryan Aleksandr,Mkrtchyan Andranik,fiurst,Diaryan Aleksandr - Mkrtchyan Andranik,58,39,19,-20,20,13,17,15,13,0,-9,5,-7,-9,0,-20,11:2 - 6:11 - 11:4 - 11:2 - 0:0
15343197,2023-11-23 11:15:00,Rafayelyan Edgar - Nazaryan Mushegh,1:3,8:11 - 11:7 - 11:8 - 12:10 - 0:0,3,1,Rafayelyan Edgar,Nazaryan Mushegh,fiurst,Nazaryan Mushegh - Rafayelyan Edgar,78,36,42,6,-6,19,18,19,22,0,-3,4,3,2,0,6,11:8 - 7:11 - 8:11 - 10:12 - 0:0
15340334,2023-11-23 11:00:00,Soghomonyan Hrayr - Diaryan Aleksandr,3:0,6:11 - 9:11 - 8:11 - 0:0 - 0:0,0,3,Soghomonyan Hrayr,Diaryan Aleksandr,fiurst,Diaryan Aleksandr - Soghomonyan Hrayr,56,33,23,-10,10,17,20,19,0,0,-5,-2,-3,0,0,-10,11:6 - 11:9 - 11:8 - 0:0 - 0:0
15340331,2023-11-23 10:45:00,Mkrtchyan Andranik - Nazaryan Mushegh,1:3,11:8 - 10:12 - 4:11 - 7:11 - 0:0,1,3,Mkrtchyan Andranik,Nazaryan Mushegh,fiurst,Mkrtchyan Andranik - Nazaryan Mushegh,74,32,42,10,-10,19,22,15,18,0,-3,2,7,4,0,10,11:8 - 10:12 - 4:11 - 7:11 - 0:0
15340324,2023-11-23 10:30:00,Rafayelyan Edgar - Soghomonyan Hrayr,3:1,11:7 - 11:13 - 11:8 - 11:1 - 0:0,3,1,Rafayelyan Edgar,Soghomonyan Hrayr,fiurst,Rafayelyan Edgar - Soghomonyan Hrayr,73,44,29,-15,15,18,24,19,12,0,-4,2,-3,-10,0,-15,11:7 - 11:13 - 11:8 - 11:1 - 0:0
15340315,2023-11-23 10:15:00,Nazaryan Mushegh - Diaryan Aleksandr,3:0,7:11 - 10:12 - 7:11 - 0:0 - 0:0,0,3,Nazaryan Mushegh,Diaryan Aleksandr,fiurst,Diaryan Aleksandr - Nazaryan Mushegh,58,34,24,-10,10,18,22,18,0,0,-4,-2,-4,0,0,-10,11:7 - 12:10 - 11:7 - 0:0 - 0:0
15343176,2023-11-23 10:00:00,Mkrtchyan Andranik - Rafayelyan Edgar,0:3,7:11 - 10:12 - 9:11 - 0:0 - 0:0,0,3,Mkrtchyan Andranik,Rafayelyan Edgar,fiurst,Mkrtchyan Andranik - Rafayelyan Edgar,60,26,34,8,-8,18,22,20,0,0,4,2,2,0,0,8,7:11 - 10:12 - 9:11 - 0:0 - 0:0
15324171,2023-11-22 17:30:00,Darbinyan Armen - Gevorgyan Gegham,0:3,8:11 - 3:11 - 4:11 - 0:0 - 0:0,0,3,Darbinyan Armen,Gevorgyan Gegham,fiurst,Darbinyan Armen - Gevorgyan Gegham,48,15,33,18,-18,19,14,15,0,0,3,8,7,0,0,18,8:11 - 3:11 - 4:11 - 0:0 - 0:0
15323766,2023-11-22 17:15:00,Arutyunov Ruben - Petrosyan Davit,3:1,11:13 - 11:5 - 14:12 - 11:7 - 0:0,3,1,Arutyunov Ruben,Petrosyan Davit,fiurst,Arutyunov Ruben - Petrosyan Davit,84,47,37,-10,10,24,16,26,18,0,2,-6,-2,-4,0,-10,11:13 - 11:5 - 14:12 - 11:7 - 0:0
15323755,2023-11-22 17:00:00,Gevorgyan Hayk - Darbinyan Armen,0:3,11:6 - 11:5 - 11:3 - 0:0 - 0:0,3,0,Gevorgyan Hayk,Darbinyan Armen,fiurst,Darbinyan Armen - Gevorgyan Hayk,47,14,33,19,-19,17,16,14,0,0,5,6,8,0,0,19,6:11 - 5:11 - 3:11 - 0:0 - 0:0
15323744,2023-11-22 16:45:00,Arutyunov Ruben - Gevorgyan Gegham,3:0,11:3 - 11:4 - 11:4 - 0:0 - 0:0,3,0,Arutyunov Ruben,Gevorgyan Gegham,fiurst,Arutyunov Ruben - Gevorgyan Gegham,44,33,11,-22,22,14,15,15,0,0,-8,-7,-7,0,0,-22,11:3 - 11:4 - 11:4 - 0:0 - 0:0
15323743,2023-11-22 16:30:00,Petrosyan Davit - Gevorgyan Hayk,3:0,10:12 - 11:13 - 5:11 - 0:0 - 0:0,0,3,Petrosyan Davit,Gevorgyan Hayk,fiurst,Gevorgyan Hayk - Petrosyan Davit,62,36,26,-10,10,22,24,16,0,0,-2,-2,-6,0,0,-10,12:10 - 13:11 - 11:5 - 0:0 - 0:0
15323742,2023-11-22 16:15:00,Darbinyan Armen - Arutyunov Ruben,3:0,8:11 - 3:11 - 5:11 - 0:0 - 0:0,0,3,Darbinyan Armen,Arutyunov Ruben,fiurst,Arutyunov Ruben - Darbinyan Armen,49,33,16,-17,17,19,14,16,0,0,-3,-8,-6,0,0,-17,11:8 - 11:3 - 11:5 - 0:0 - 0:0
15323738,2023-11-22 16:00:00,Gevorgyan Gegham - Gevorgyan Hayk,0:3,6:11 - 8:11 - 7:11 - 0:0 - 0:0,0,3,Gevorgyan Gegham,Gevorgyan Hayk,fiurst,Gevorgyan Gegham - Gevorgyan Hayk,54,21,33,12,-12,17,19,18,0,0,5,3,4,0,0,12,6:11 - 8:11 - 7:11 - 0:0 - 0:0
15323734,2023-11-22 15:50:00,Petrosyan Davit - Darbinyan Armen,2:3,12:10 - 9:11 - 11:13 - 11:6 - 11:3,3,2,Petrosyan Davit,Darbinyan Armen,fiurst,Darbinyan Armen - Petrosyan Davit,97,43,54,11,-11,22,20,24,17,14,2,-2,-2,5,8,11,10:12 - 11:9 - 13:11 - 6:11 - 3:11
15323732,2023-11-22 15:30:00,Gevorgyan Hayk - Arutyunov Ruben,3:1,4:11 - 11:8 - 3:11 - 6:11 - 0:0,1,3,Gevorgyan Hayk,Arutyunov Ruben,fiurst,Arutyunov Ruben - Gevorgyan Hayk,65,41,24,-17,17,15,19,14,17,0,-7,3,-8,-5,0,-17,11:4 - 8:11 - 11:3 - 11:6 - 0:0
15323731,2023-11-22 15:20:00,Gevorgyan Gegham - Petrosyan Davit,1:3,7:11 - 11:8 - 10:12 - 2:11 - 0:0,1,3,Gevorgyan Gegham,Petrosyan Davit,fiurst,Gevorgyan Gegham - Petrosyan Davit,72,30,42,12,-12,18,19,22,13,0,4,-3,2,9,0,12,7:11 - 11:8 - 10:12 - 2:11 - 0:0
15323164,2023-11-22 15:00:00,Rafayelyan Edgar - Diaryan Aleksandr,3:1,11:8 - 10:12 - 9:11 - 9:11 - 0:0,1,3,Rafayelyan Edgar,Diaryan Aleksandr,fiurst,Diaryan Aleksandr - Rafayelyan Edgar,81,42,39,-3,3,19,22,20,20,0,3,-2,-2,-2,0,-3,8:11 - 12:10 - 11:9 - 11:9 - 0:0
15323157,2023-11-22 14:45:00,Soghomonyan Hrayr - Nikoghosyan Narek,3:1,3:11 - 9:11 - 11:6 - 10:12 - 0:0,1,3,Soghomonyan Hrayr,Nikoghosyan Narek,fiurst,Nikoghosyan Narek - Soghomonyan Hrayr,73,40,33,-7,7,14,20,17,22,0,-8,-2,5,-2,0,-7,11:3 - 11:9 - 6:11 - 12:10 - 0:0
15323154,2023-11-22 14:30:00,Papyan Karen - Rafayelyan Edgar,3:1,11:8 - 11:8 - 8:11 - 12:10 - 0:0,3,1,Papyan Karen,Rafayelyan Edgar,fiurst,Papyan Karen - Rafayelyan Edgar,79,42,37,-5,5,19,19,19,22,0,-3,-3,3,-2,0,-5,11:8 - 11:8 - 8:11 - 12:10 - 0:0
15323143,2023-11-22 14:25:00,Diaryan Aleksandr - Soghomonyan Hrayr,3:0,11:7 - 11:9 - 12:10 - 0:0 - 0:0,3,0,Diaryan Aleksandr,Soghomonyan Hrayr,fiurst,Diaryan Aleksandr - Soghomonyan Hrayr,60,34,26,-8,8,18,20,22,0,0,-4,-2,-2,0,0,-8,11:7 - 11:9 - 12:10 - 0:0 - 0:0
15323140,2023-11-22 14:10:00,Rafayelyan Edgar - Soghomonyan Hrayr,3:0,11:3 - 11:8 - 11:7 - 0:0 - 0:0,3,0,Rafayelyan Edgar,Soghomonyan Hrayr,fiurst,Rafayelyan Edgar - Soghomonyan Hrayr,51,33,18,-15,15,14,19,18,0,0,-8,-3,-4,0,0,-15,11:3 - 11:8 - 11:7 - 0:0 - 0:0
15323141,2023-11-22 14:10:00,Papyan Karen - Nikoghosyan Narek,0:3,11:8 - 11:6 - 12:10 - 0:0 - 0:0,3,0,Papyan Karen,Nikoghosyan Narek,fiurst,Nikoghosyan Narek - Papyan Karen,58,24,34,10,-10,19,17,22,0,0,3,5,2,0,0,10,8:11 - 6:11 - 10:12 - 0:0 - 0:0
15323136,2023-11-22 13:30:00,Diaryan Aleksandr - Papyan Karen,3:0,11:7 - 11:5 - 11:2 - 0:0 - 0:0,3,0,Diaryan Aleksandr,Papyan Karen,fiurst,Diaryan Aleksandr - Papyan Karen,47,33,14,-19,19,18,16,13,0,0,-4,-6,-9,0,0,-19,11:7 - 11:5 - 11:2 - 0:0 - 0:0
15323134,2023-11-22 13:30:00,Nikoghosyan Narek - Rafayelyan Edgar,2:3,2:11 - 11:5 - 11:5 - 7:11 - 7:11,2,3,Nikoghosyan Narek,Rafayelyan Edgar,fiurst,Nikoghosyan Narek - Rafayelyan Edgar,81,38,43,5,-5,13,16,16,18,18,9,-6,-6,4,4,5,2:11 - 11:5 - 11:5 - 7:11 - 7:11
15323133,2023-11-22 13:00:00,Soghomonyan Hrayr - Papyan Karen,3:1,10:12 - 9:11 - 13:11 - 11:13 - 0:0,1,3,Soghomonyan Hrayr,Papyan Karen,fiurst,Papyan Karen - Soghomonyan Hrayr,90,47,43,-4,4,22,20,24,24,0,-2,-2,2,-2,0,-4,12:10 - 11:9 - 11:13 - 13:11 - 0:0
15323121,2023-11-22 12:50:00,Nikoghosyan Narek - Diaryan Aleksandr,3:2,11:7 - 7:11 - 7:11 - 13:11 - 11:13,2,3,Nikoghosyan Narek,Diaryan Aleksandr,fiurst,Diaryan Aleksandr - Nikoghosyan Narek,102,53,49,-4,4,18,18,18,24,24,4,-4,-4,2,-2,-4,7:11 - 11:7 - 11:7 - 11:13 - 13:11
15323117,2023-11-22 12:15:00,Rafayelyan Edgar - Papyan Karen,2:3,11:7 - 8:11 - 4:11 - 11:6 - 11:7,3,2,Rafayelyan Edgar,Papyan Karen,fiurst,Papyan Karen - Rafayelyan Edgar,87,42,45,3,-3,18,19,15,17,18,4,-3,-7,5,4,3,7:11 - 11:8 - 11:4 - 6:11 - 7:11
15323116,2023-11-22 12:05:00,Nikoghosyan Narek - Soghomonyan Hrayr,3:0,14:12 - 11:2 - 11:8 - 0:0 - 0:0,3,0,Nikoghosyan Narek,Soghomonyan Hrayr,fiurst,Nikoghosyan Narek - Soghomonyan Hrayr,58,36,22,-14,14,26,13,19,0,0,-2,-9,-3,0,0,-14,14:12 - 11:2 - 11:8 - 0:0 - 0:0
15323111,2023-11-22 11:45:00,Nikoghosyan Narek - Papyan Karen,3:0,12:10 - 11:6 - 11:4 - 0:0 - 0:0,3,0,Nikoghosyan Narek,Papyan Karen,fiurst,Nikoghosyan Narek - Papyan Karen,54,34,20,-14,14,22,17,15,0,0,-2,-5,-7,0,0,-14,12:10 - 11:6 - 11:4 - 0:0 - 0:0
15323114,2023-11-22 11:45:00,Diaryan Aleksandr - Rafayelyan Edgar,3:1,11:9 - 11:6 - 5:11 - 11:6 - 0:0,3,1,Diaryan Aleksandr,Rafayelyan Edgar,fiurst,Diaryan Aleksandr - Rafayelyan Edgar,70,38,32,-6,6,20,17,16,17,0,-2,-5,6,-5,0,-6,11:9 - 11:6 - 5:11 - 11:6 - 0:0
15323107,2023-11-22 11:20:00,Soghomonyan Hrayr - Diaryan Aleksandr,1:3,13:11 - 11:7 - 9:11 - 11:9 - 0:0,3,1,Soghomonyan Hrayr,Diaryan Aleksandr,fiurst,Diaryan Aleksandr - Soghomonyan Hrayr,82,38,44,6,-6,24,18,20,20,0,2,4,-2,2,0,6,11:13 - 7:11 - 11:9 - 9:11 - 0:0
15323104,2023-11-22 11:00:00,Rafayelyan Edgar - Nikoghosyan Narek,3:2,11:6 - 12:10 - 9:11 - 5:11 - 9:11,2,3,Rafayelyan Edgar,Nikoghosyan Narek,fiurst,Nikoghosyan Narek - Rafayelyan Edgar,95,49,46,-3,3,17,22,20,16,20,5,2,-2,-6,-2,-3,6:11 - 10:12 - 11:9 - 11:5 - 11:9
15323102,2023-11-22 10:50:00,Papyan Karen - Diaryan Aleksandr,1:3,11:6 - 5:11 - 11:8 - 11:9 - 0:0,3,1,Papyan Karen,Diaryan Aleksandr,fiurst,Diaryan Aleksandr - Papyan Karen,72,34,38,4,-4,17,16,19,20,0,5,-6,3,2,0,4,6:11 - 11:5 - 8:11 - 9:11 - 0:0
15323099,2023-11-22 10:30:00,Soghomonyan Hrayr - Rafayelyan Edgar,0:3,11:3 - 11:7 - 14:12 - 0:0 - 0:0,3,0,Soghomonyan Hrayr,Rafayelyan Edgar,fiurst,Rafayelyan Edgar - Soghomonyan Hrayr,58,22,36,14,-14,14,18,26,0,0,8,4,2,0,0,14,3:11 - 7:11 - 12:14 - 0:0 - 0:0
15323088,2023-11-22 10:15:00,Diaryan Aleksandr - Nikoghosyan Narek,3:1,11:9 - 13:11 - 10:12 - 11:8 - 0:0,3,1,Diaryan Aleksandr,Nikoghosyan Narek,fiurst,Diaryan Aleksandr - Nikoghosyan Narek,85,45,40,-5,5,20,24,22,19,0,-2,-2,2,-3,0,-5,11:9 - 13:11 - 10:12 - 11:8 - 0:0
15323085,2023-11-22 10:00:00,Papyan Karen - Soghomonyan Hrayr,3:0,11:8 - 11:6 - 11:9 - 0:0 - 0:0,3,0,Papyan Karen,Soghomonyan Hrayr,fiurst,Papyan Karen - Soghomonyan Hrayr,56,33,23,-10,10,19,17,20,0,0,-3,-5,-2,0,0,-10,11:8 - 11:6 - 11:9 - 0:0 - 0:0
15306725,2023-11-21 17:30:00,Gevorgyan Gegham - Grigoryan Erik,3:1,11:7 - 11:7 - 9:11 - 11:7 - 0:0,3,1,Gevorgyan Gegham,Grigoryan Erik,fiurst,Gevorgyan Gegham - Grigoryan Erik,74,42,32,-10,10,18,18,20,18,0,-4,-4,2,-4,0,-10,11:7 - 11:7 - 9:11 - 11:7 - 0:0
15306723,2023-11-21 17:15:00,Avakimyan Davit - Gevorgyan Hayk,3:1,11:7 - 11:5 - 9:11 - 11:7 - 0:0,3,1,Avakimyan Davit,Gevorgyan Hayk,fiurst,Avakimyan Davit - Gevorgyan Hayk,72,42,30,-12,12,18,16,20,18,0,-4,-6,2,-4,0,-12,11:7 - 11:5 - 9:11 - 11:7 - 0:0
15306721,2023-11-21 17:00:00,Arutyunov Ruben - Gevorgyan Gegham,3:0,11:8 - 11:6 - 12:10 - 0:0 - 0:0,3,0,Arutyunov Ruben,Gevorgyan Gegham,fiurst,Arutyunov Ruben - Gevorgyan Gegham,58,34,24,-10,10,19,17,22,0,0,-3,-5,-2,0,0,-10,11:8 - 11:6 - 12:10 - 0:0 - 0:0
15306706,2023-11-21 16:45:00,Avakimyan Davit - Grigoryan Erik,3:1,13:11 - 9:11 - 11:7 - 11:8 - 0:0,3,1,Avakimyan Davit,Grigoryan Erik,fiurst,Avakimyan Davit - Grigoryan Erik,81,44,37,-7,7,24,20,18,19,0,-2,2,-4,-3,0,-7,13:11 - 9:11 - 11:7 - 11:8 - 0:0
15306703,2023-11-21 16:30:00,Gevorgyan Hayk - Arutyunov Ruben,3:0,4:11 - 8:11 - 6:11 - 0:0 - 0:0,0,3,Gevorgyan Hayk,Arutyunov Ruben,fiurst,Arutyunov Ruben - Gevorgyan Hayk,51,33,18,-15,15,15,19,17,0,0,-7,-3,-5,0,0,-15,11:4 - 11:8 - 11:6 - 0:0 - 0:0
15306701,2023-11-21 16:15:00,Gevorgyan Gegham - Avakimyan Davit,3:1,10:12 - 7:11 - 11:9 - 6:11 - 0:0,1,3,Gevorgyan Gegham,Avakimyan Davit,fiurst,Avakimyan Davit - Gevorgyan Gegham,77,43,34,-9,9,22,18,20,17,0,-2,-4,2,-5,0,-9,12:10 - 11:7 - 9:11 - 11:6 - 0:0
15306696,2023-11-21 16:00:00,Grigoryan Erik - Arutyunov Ruben,3:0,8:11 - 5:11 - 6:11 - 0:0 - 0:0,0,3,Grigoryan Erik,Arutyunov Ruben,fiurst,Arutyunov Ruben - Grigoryan Erik,52,33,19,-14,14,19,16,17,0,0,-3,-6,-5,0,0,-14,11:8 - 11:5 - 11:6 - 0:0 - 0:0
15306691,2023-11-21 15:45:00,Gevorgyan Hayk - Gevorgyan Gegham,0:3,11:8 - 15:13 - 11:8 - 0:0 - 0:0,3,0,Gevorgyan Hayk,Gevorgyan Gegham,fiurst,Gevorgyan Gegham - Gevorgyan Hayk,66,29,37,8,-8,19,28,19,0,0,3,2,3,0,0,8,8:11 - 13:15 - 8:11 - 0:0 - 0:0
15306688,2023-11-21 15:30:00,Arutyunov Ruben - Avakimyan Davit,3:0,11:3 - 11:9 - 11:4 - 0:0 - 0:0,3,0,Arutyunov Ruben,Avakimyan Davit,fiurst,Arutyunov Ruben - Avakimyan Davit,49,33,16,-17,17,14,20,15,0,0,-8,-2,-7,0,0,-17,11:3 - 11:9 - 11:4 - 0:0 - 0:0
15306685,2023-11-21 15:15:00,Grigoryan Erik - Gevorgyan Hayk,3:0,6:11 - 9:11 - 5:11 - 0:0 - 0:0,0,3,Grigoryan Erik,Gevorgyan Hayk,fiurst,Gevorgyan Hayk - Grigoryan Erik,53,33,20,-13,13,17,20,16,0,0,-5,-2,-6,0,0,-13,11:6 - 11:9 - 11:5 - 0:0 - 0:0
15306670,2023-11-21 15:00:00,Rafayelyan Edgar - Mkrtchyan Andranik,0:3,11:9 - 11:7 - 11:6 - 0:0 - 0:0,3,0,Rafayelyan Edgar,Mkrtchyan Andranik,fiurst,Mkrtchyan Andranik - Rafayelyan Edgar,55,22,33,11,-11,20,18,17,0,0,2,4,5,0,0,11,9:11 - 7:11 - 6:11 - 0:0 - 0:0
15306669,2023-11-21 14:50:00,Papyan Karen - Nikoghosyan Narek,3:2,3:11 - 12:10 - 7:11 - 15:13 - 3:11,2,3,Papyan Karen,Nikoghosyan Narek,fiurst,Nikoghosyan Narek - Papyan Karen,96,56,40,-16,16,14,22,18,28,14,-8,2,-4,2,-8,-16,11:3 - 10:12 - 11:7 - 13:15 - 11:3
15306667,2023-11-21 14:30:00,Nazaryan Mushegh - Rafayelyan Edgar,0:3,6:11 - 13:15 - 10:12 - 0:0 - 0:0,0,3,Nazaryan Mushegh,Rafayelyan Edgar,fiurst,Nazaryan Mushegh - Rafayelyan Edgar,67,29,38,9,-9,17,28,22,0,0,5,2,2,0,0,9,6:11 - 13:15 - 10:12 - 0:0 - 0:0
15306663,2023-11-21 14:15:00,Mkrtchyan Andranik - Papyan Karen,2:3,4:11 - 11:4 - 11:6 - 10:12 - 5:11,2,3,Mkrtchyan Andranik,Papyan Karen,fiurst,Mkrtchyan Andranik - Papyan Karen,85,41,44,3,-3,15,15,17,22,16,7,-7,-5,2,6,3,4:11 - 11:4 - 11:6 - 10:12 - 5:11
15306647,2023-11-21 14:00:00,Nazaryan Mushegh - Nikoghosyan Narek,1:3,11:2 - 2:11 - 4:11 - 5:11 - 0:0,1,3,Nazaryan Mushegh,Nikoghosyan Narek,fiurst,Nazaryan Mushegh - Nikoghosyan Narek,57,22,35,13,-13,13,13,15,16,0,-9,9,7,6,0,13,11:2 - 2:11 - 4:11 - 5:11 - 0:0
15306631,2023-11-21 13:45:00,Rafayelyan Edgar - Papyan Karen,1:3,11:6 - 11:9 - 5:11 - 11:8 - 0:0,3,1,Rafayelyan Edgar,Papyan Karen,fiurst,Papyan Karen - Rafayelyan Edgar,72,34,38,4,-4,17,20,16,19,0,5,2,-6,3,0,4,6:11 - 9:11 - 11:5 - 8:11 - 0:0
15306624,2023-11-21 13:30:00,Mkrtchyan Andranik - Nazaryan Mushegh,2:3,9:11 - 11:9 - 4:11 - 11:8 - 5:11,2,3,Mkrtchyan Andranik,Nazaryan Mushegh,fiurst,Mkrtchyan Andranik - Nazaryan Mushegh,90,40,50,10,-10,20,20,15,19,16,2,-2,7,-3,6,10,9:11 - 11:9 - 4:11 - 11:8 - 5:11
15306622,2023-11-21 13:20:00,Nikoghosyan Narek - Rafayelyan Edgar,1:3,11:9 - 6:11 - 5:11 - 3:11 - 0:0,1,3,Nikoghosyan Narek,Rafayelyan Edgar,fiurst,Nikoghosyan Narek - Rafayelyan Edgar,67,25,42,17,-17,20,17,16,14,0,-2,5,6,8,0,17,11:9 - 6:11 - 5:11 - 3:11 - 0:0
15306609,2023-11-21 13:00:00,Papyan Karen - Nazaryan Mushegh,3:1,11:5 - 4:11 - 2:11 - 4:11 - 0:0,1,3,Papyan Karen,Nazaryan Mushegh,fiurst,Nazaryan Mushegh - Papyan Karen,59,38,21,-17,17,16,15,13,15,0,6,-7,-9,-7,0,-17,5:11 - 11:4 - 11:2 - 11:4 - 0:0
15306608,2023-11-21 12:45:00,Nikoghosyan Narek - Mkrtchyan Andranik,1:3,6:11 - 11:9 - 11:6 - 11:6 - 0:0,3,1,Nikoghosyan Narek,Mkrtchyan Andranik,fiurst,Mkrtchyan Andranik - Nikoghosyan Narek,71,32,39,7,-7,17,20,17,17,0,-5,2,5,5,0,7,11:6 - 9:11 - 6:11 - 6:11 - 0:0
15306607,2023-11-21 12:15:00,Rafayelyan Edgar - Nazaryan Mushegh,0:3,11:5 - 11:7 - 11:4 - 0:0 - 0:0,3,0,Rafayelyan Edgar,Nazaryan Mushegh,fiurst,Nazaryan Mushegh - Rafayelyan Edgar,49,16,33,17,-17,16,18,15,0,0,6,4,7,0,0,17,5:11 - 7:11 - 4:11 - 0:0 - 0:0
15306595,2023-11-21 12:00:00,Nikoghosyan Narek - Papyan Karen,3:1,11:9 - 9:11 - 11:5 - 11:4 - 0:0,3,1,Nikoghosyan Narek,Papyan Karen,fiurst,Nikoghosyan Narek - Papyan Karen,71,42,29,-13,13,20,20,16,15,0,-2,2,-6,-7,0,-13,11:9 - 9:11 - 11:5 - 11:4 - 0:0
15306594,2023-11-21 11:45:00,Mkrtchyan Andranik - Rafayelyan Edgar,1:3,6:11 - 6:11 - 12:10 - 10:12 - 0:0,1,3,Mkrtchyan Andranik,Rafayelyan Edgar,fiurst,Mkrtchyan Andranik - Rafayelyan Edgar,78,34,44,10,-10,17,17,22,22,0,5,5,-2,2,0,10,6:11 - 6:11 - 12:10 - 10:12 - 0:0
15306590,2023-11-21 11:30:00,Nikoghosyan Narek - Nazaryan Mushegh,0:3,12:10 - 11:4 - 11:7 - 0:0 - 0:0,3,0,Nikoghosyan Narek,Nazaryan Mushegh,fiurst,Nazaryan Mushegh - Nikoghosyan Narek,55,21,34,13,-13,22,15,18,0,0,2,7,4,0,0,13,10:12 - 4:11 - 7:11 - 0:0 - 0:0
15306588,2023-11-21 11:15:00,Papyan Karen - Mkrtchyan Andranik,1:3,11:8 - 11:8 - 8:11 - 11:9 - 0:0,3,1,Papyan Karen,Mkrtchyan Andranik,fiurst,Mkrtchyan Andranik - Papyan Karen,77,36,41,5,-5,19,19,19,20,0,3,3,-3,2,0,5,8:11 - 8:11 - 11:8 - 9:11 - 0:0
15306585,2023-11-21 11:00:00,Rafayelyan Edgar - Nikoghosyan Narek,0:3,11:9 - 11:7 - 11:6 - 0:0 - 0:0,3,0,Rafayelyan Edgar,Nikoghosyan Narek,fiurst,Nikoghosyan Narek - Rafayelyan Edgar,55,22,33,11,-11,20,18,17,0,0,2,4,5,0,0,11,9:11 - 7:11 - 6:11 - 0:0 - 0:0
15306582,2023-11-21 10:45:00,Nazaryan Mushegh - Mkrtchyan Andranik,0:3,12:10 - 11:6 - 11:5 - 0:0 - 0:0,3,0,Nazaryan Mushegh,Mkrtchyan Andranik,fiurst,Mkrtchyan Andranik - Nazaryan Mushegh,55,21,34,13,-13,22,17,16,0,0,2,5,6,0,0,13,10:12 - 6:11 - 5:11 - 0:0 - 0:0
15306577,2023-11-21 10:30:00,Papyan Karen - Rafayelyan Edgar,2:3,3:11 - 11:9 - 5:11 - 15:13 - 10:12,2,3,Papyan Karen,Rafayelyan Edgar,fiurst,Papyan Karen - Rafayelyan Edgar,100,44,56,12,-12,14,20,16,28,22,8,-2,6,-2,2,12,3:11 - 11:9 - 5:11 - 15:13 - 10:12
15306576,2023-11-21 10:15:00,Mkrtchyan Andranik - Nikoghosyan Narek,0:3,7:11 - 9:11 - 8:11 - 0:0 - 0:0,0,3,Mkrtchyan Andranik,Nikoghosyan Narek,fiurst,Mkrtchyan Andranik - Nikoghosyan Narek,57,24,33,9,-9,18,20,19,0,0,4,2,3,0,0,9,7:11 - 9:11 - 8:11 - 0:0 - 0:0
15306574,2023-11-21 10:00:00,Nazaryan Mushegh - Papyan Karen,0:3,8:11 - 9:11 - 5:11 - 0:0 - 0:0,0,3,Nazaryan Mushegh,Papyan Karen,fiurst,Nazaryan Mushegh - Papyan Karen,55,22,33,11,-11,19,20,16,0,0,3,2,6,0,0,11,8:11 - 9:11 - 5:11 - 0:0 - 0:0
15284788,2023-11-20 17:35:00,Arutyunov Ruben - Avakimyan Davit,3:0,11:7 - 11:6 - 11:2 - 0:0 - 0:0,3,0,Arutyunov Ruben,Avakimyan Davit,fiurst,Arutyunov Ruben - Avakimyan Davit,48,33,15,-18,18,18,17,13,0,0,-4,-5,-9,0,0,-18,11:7 - 11:6 - 11:2 - 0:0 - 0:0
15284787,2023-11-20 17:15:00,Petrosyan Davit - Gevorgyan Gegham,0:3,11:9 - 11:7 - 11:6 - 0:0 - 0:0,3,0,Petrosyan Davit,Gevorgyan Gegham,fiurst,Gevorgyan Gegham - Petrosyan Davit,55,22,33,11,-11,20,18,17,0,0,2,4,5,0,0,11,9:11 - 7:11 - 6:11 - 0:0 - 0:0
15284781,2023-11-20 17:05:00,Gevorgyan Hayk - Arutyunov Ruben,3:1,8:11 - 11:9 - 6:11 - 7:11 - 0:0,1,3,Gevorgyan Hayk,Arutyunov Ruben,fiurst,Arutyunov Ruben - Gevorgyan Hayk,74,42,32,-10,10,19,20,17,18,0,-3,2,-5,-4,0,-10,11:8 - 9:11 - 11:6 - 11:7 - 0:0
15284771,2023-11-20 16:45:00,Petrosyan Davit - Avakimyan Davit,3:0,5:11 - 8:11 - 8:11 - 0:0 - 0:0,0,3,Petrosyan Davit,Avakimyan Davit,fiurst,Avakimyan Davit - Petrosyan Davit,54,33,21,-12,12,16,19,19,0,0,-6,-3,-3,0,0,-12,11:5 - 11:8 - 11:8 - 0:0 - 0:0
15284765,2023-11-20 16:30:00,Gevorgyan Gegham - Gevorgyan Hayk,1:3,11:8 - 6:11 - 2:11 - 8:11 - 0:0,1,3,Gevorgyan Gegham,Gevorgyan Hayk,fiurst,Gevorgyan Gegham - Gevorgyan Hayk,68,27,41,14,-14,19,17,13,19,0,-3,5,9,3,0,14,11:8 - 6:11 - 2:11 - 8:11 - 0:0
15284758,2023-11-20 16:15:00,Arutyunov Ruben - Petrosyan Davit,3:0,11:6 - 11:7 - 11:4 - 0:0 - 0:0,3,0,Arutyunov Ruben,Petrosyan Davit,fiurst,Arutyunov Ruben - Petrosyan Davit,50,33,17,-16,16,17,18,15,0,0,-5,-4,-7,0,0,-16,11:6 - 11:7 - 11:4 - 0:0 - 0:0
15284754,2023-11-20 16:05:00,Avakimyan Davit - Gevorgyan Hayk,1:3,8:11 - 11:9 - 11:13 - 4:11 - 0:0,1,3,Avakimyan Davit,Gevorgyan Hayk,fiurst,Avakimyan Davit - Gevorgyan Hayk,78,34,44,10,-10,19,20,24,15,0,3,-2,2,7,0,10,8:11 - 11:9 - 11:13 - 4:11 - 0:0
15284744,2023-11-20 16:00:00,Gevorgyan Gegham - Arutyunov Ruben,3:0,1:11 - 6:11 - 4:11 - 0:0 - 0:0,0,3,Gevorgyan Gegham,Arutyunov Ruben,fiurst,Arutyunov Ruben - Gevorgyan Gegham,44,33,11,-22,22,12,17,15,0,0,-10,-5,-7,0,0,-22,11:1 - 11:6 - 11:4 - 0:0 - 0:0
15284728,2023-11-20 15:35:00,Avakimyan Davit - Gevorgyan Gegham,2:3,11:4 - 11:9 - 3:11 - 8:11 - 12:14,2,3,Avakimyan Davit,Gevorgyan Gegham,fiurst,Avakimyan Davit - Gevorgyan Gegham,94,45,49,4,-4,15,20,14,19,26,-7,-2,8,3,2,4,11:4 - 11:9 - 3:11 - 8:11 - 12:14
15284740,2023-11-20 15:30:00,Gevorgyan Hayk - Petrosyan Davit,3:2,11:6 - 7:11 - 6:11 - 13:11 - 11:8,3,2,Gevorgyan Hayk,Petrosyan Davit,fiurst,Gevorgyan Hayk - Petrosyan Davit,95,48,47,-1,1,17,18,17,24,19,-5,4,5,-2,-3,-1,11:6 - 7:11 - 6:11 - 13:11 - 11:8
15284723,2023-11-20 15:00:00,Papyan Karen - Soghomonyan Hrayr,3:0,11:5 - 11:8 - 11:7 - 0:0 - 0:0,3,0,Papyan Karen,Soghomonyan Hrayr,fiurst,Papyan Karen - Soghomonyan Hrayr,53,33,20,-13,13,16,19,18,0,0,-6,-3,-4,0,0,-13,11:5 - 11:8 - 11:7 - 0:0 - 0:0
15284717,2023-11-20 14:50:00,Mkrtchyan Andranik - Nazaryan Mushegh,3:0,11:4 - 11:7 - 11:5 - 0:0 - 0:0,3,0,Mkrtchyan Andranik,Nazaryan Mushegh,fiurst,Mkrtchyan Andranik - Nazaryan Mushegh,49,33,16,-17,17,15,18,16,0,0,-7,-4,-6,0,0,-17,11:4 - 11:7 - 11:5 - 0:0 - 0:0
15284715,2023-11-20 14:30:00,Diaryan Aleksandr - Papyan Karen,3:0,11:5 - 11:5 - 11:6 - 0:0 - 0:0,3,0,Diaryan Aleksandr,Papyan Karen,fiurst,Diaryan Aleksandr - Papyan Karen,49,33,16,-17,17,16,16,17,0,0,-6,-6,-5,0,0,-17,11:5 - 11:5 - 11:6 - 0:0 - 0:0
15284709,2023-11-20 14:15:00,Soghomonyan Hrayr - Mkrtchyan Andranik,2:3,11:8 - 6:11 - 11:5 - 6:11 - 11:6,3,2,Soghomonyan Hrayr,Mkrtchyan Andranik,fiurst,Mkrtchyan Andranik - Soghomonyan Hrayr,86,41,45,4,-4,19,17,16,17,17,3,-5,6,-5,5,4,8:11 - 11:6 - 5:11 - 11:6 - 6:11
15284702,2023-11-20 14:00:00,Diaryan Aleksandr - Nazaryan Mushegh,3:0,11:5 - 11:2 - 11:5 - 0:0 - 0:0,3,0,Diaryan Aleksandr,Nazaryan Mushegh,fiurst,Diaryan Aleksandr - Nazaryan Mushegh,45,33,12,-21,21,16,13,16,0,0,-6,-9,-6,0,0,-21,11:5 - 11:2 - 11:5 - 0:0 - 0:0
15284696,2023-11-20 13:45:00,Papyan Karen - Mkrtchyan Andranik,3:2,10:12 - 11:9 - 7:11 - 11:6 - 8:11,2,3,Papyan Karen,Mkrtchyan Andranik,fiurst,Mkrtchyan Andranik - Papyan Karen,96,49,47,-2,2,22,20,18,17,19,-2,2,-4,5,-3,-2,12:10 - 9:11 - 11:7 - 6:11 - 11:8
15284690,2023-11-20 13:30:00,Soghomonyan Hrayr - Diaryan Aleksandr,2:3,4:11 - 5:11 - 11:8 - 11:9 - 11:8,3,2,Soghomonyan Hrayr,Diaryan Aleksandr,fiurst,Diaryan Aleksandr - Soghomonyan Hrayr,89,47,42,-5,5,15,16,19,20,19,-7,-6,3,2,3,-5,11:4 - 11:5 - 8:11 - 9:11 - 8:11
15284684,2023-11-20 13:15:00,Nazaryan Mushegh - Papyan Karen,0:3,7:11 - 8:11 - 8:11 - 0:0 - 0:0,0,3,Nazaryan Mushegh,Papyan Karen,fiurst,Nazaryan Mushegh - Papyan Karen,56,23,33,10,-10,18,19,19,0,0,4,3,3,0,0,10,7:11 - 8:11 - 8:11 - 0:0 - 0:0
15284681,2023-11-20 13:00:00,Mkrtchyan Andranik - Diaryan Aleksandr,0:0,0:0 - 0:0 - 0:0 - 0:0 - 0:0,0,0,Mkrtchyan Andranik,Diaryan Aleksandr,fiurst,Diaryan Aleksandr - Mkrtchyan Andranik,0,0,0,0,0,0,0,0,0,0,0,0,0,0,0,0,0:0 - 0:0 - 0:0 - 0:0 - 0:0
15284667,2023-11-20 12:45:00,Nazaryan Mushegh - Soghomonyan Hrayr,3:1,11:9 - 11:6 - 6:11 - 11:5 - 0:0,3,1,Nazaryan Mushegh,Soghomonyan Hrayr,fiurst,Nazaryan Mushegh - Soghomonyan Hrayr,70,39,31,-8,8,20,17,17,16,0,-2,-5,5,-6,0,-8,11:9 - 11:6 - 6:11 - 11:5 - 0:0
15284666,2023-11-20 12:15:00,Papyan Karen - Diaryan Aleksandr,3:0,9:11 - 9:11 - 2:11 - 0:0 - 0:0,0,3,Papyan Karen,Diaryan Aleksandr,fiurst,Diaryan Aleksandr - Papyan Karen,53,33,20,-13,13,20,20,13,0,0,-2,-2,-9,0,0,-13,11:9 - 11:9 - 11:2 - 0:0 - 0:0
15284658,2023-11-20 12:00:00,Soghomonyan Hrayr - Papyan Karen,3:1,7:11 - 11:8 - 8:11 - 6:11 - 0:0,1,3,Soghomonyan Hrayr,Papyan Karen,fiurst,Papyan Karen - Soghomonyan Hrayr,73,41,32,-9,9,18,19,19,17,0,-4,3,-3,-5,0,-9,11:7 - 8:11 - 11:8 - 11:6 - 0:0
15284661,2023-11-20 12:00:00,Nazaryan Mushegh - Mkrtchyan Andranik,0:3,11:7 - 11:9 - 15:13 - 0:0 - 0:0,3,0,Nazaryan Mushegh,Mkrtchyan Andranik,fiurst,Mkrtchyan Andranik - Nazaryan Mushegh,66,29,37,8,-8,18,20,28,0,0,4,2,2,0,0,8,7:11 - 9:11 - 13:15 - 0:0 - 0:0
15284655,2023-11-20 11:35:00,Nazaryan Mushegh - Diaryan Aleksandr,3:0,8:11 - 10:12 - 3:11 - 0:0 - 0:0,0,3,Nazaryan Mushegh,Diaryan Aleksandr,fiurst,Diaryan Aleksandr - Nazaryan Mushegh,55,34,21,-13,13,19,22,14,0,0,-3,-2,-8,0,0,-13,11:8 - 12:10 - 11:3 - 0:0 - 0:0
15284653,2023-11-20 11:25:00,Mkrtchyan Andranik - Soghomonyan Hrayr,3:0,11:5 - 11:9 - 11:8 - 0:0 - 0:0,3,0,Mkrtchyan Andranik,Soghomonyan Hrayr,fiurst,Mkrtchyan Andranik - Soghomonyan Hrayr,55,33,22,-11,11,16,20,19,0,0,-6,-2,-3,0,0,-11,11:5 - 11:9 - 11:8 - 0:0 - 0:0
15284651,2023-11-20 11:05:00,Papyan Karen - Nazaryan Mushegh,1:3,10:12 - 11:4 - 11:7 - 13:11 - 0:0,3,1,Papyan Karen,Nazaryan Mushegh,fiurst,Nazaryan Mushegh - Papyan Karen,79,34,45,11,-11,22,15,18,24,0,-2,7,4,2,0,11,12:10 - 4:11 - 7:11 - 11:13 - 0:0
15284639,2023-11-20 10:50:00,Diaryan Aleksandr - Soghomonyan Hrayr,3:1,4:11 - 11:9 - 11:7 - 11:6 - 0:0,3,1,Diaryan Aleksandr,Soghomonyan Hrayr,fiurst,Diaryan Aleksandr - Soghomonyan Hrayr,70,37,33,-4,4,15,20,18,17,0,7,-2,-4,-5,0,-4,4:11 - 11:9 - 11:7 - 11:6 - 0:0
15284593,2023-11-20 10:30:00,Mkrtchyan Andranik - Papyan Karen,3:2,9:11 - 7:11 - 11:4 - 12:10 - 11:8,3,2,Mkrtchyan Andranik,Papyan Karen,fiurst,Mkrtchyan Andranik - Papyan Karen,94,50,44,-6,6,20,18,15,22,19,2,4,-7,-2,-3,-6,9:11 - 7:11 - 11:4 - 12:10 - 11:8
15284590,2023-11-20 10:15:00,Soghomonyan Hrayr - Nazaryan Mushegh,2:3,11:8 - 7:11 - 10:12 - 11:7 - 11:5,3,2,Soghomonyan Hrayr,Nazaryan Mushegh,fiurst,Nazaryan Mushegh - Soghomonyan Hrayr,93,43,50,7,-7,19,18,22,18,16,3,-4,-2,4,6,7,8:11 - 11:7 - 12:10 - 7:11 - 5:11
15284578,2023-11-20 10:00:00,Diaryan Aleksandr - Mkrtchyan Andranik,3:1,11:7 - 8:11 - 11:4 - 11:5 - 0:0,3,1,Diaryan Aleksandr,Mkrtchyan Andranik,fiurst,Diaryan Aleksandr - Mkrtchyan Andranik,68,41,27,-14,14,18,19,15,16,0,-4,3,-7,-6,0,-14,11:7 - 8:11 - 11:4 - 11:5 - 0:0
15270515,2023-11-19 17:40:00,Petrosyan Davit - Gevorgyan Hayk,3:0,6:11 - 8:11 - 6:11 - 0:0 - 0:0,0,3,Petrosyan Davit,Gevorgyan Hayk,fiurst,Gevorgyan Hayk - Petrosyan Davit,53,33,20,-13,13,17,19,17,0,0,-5,-3,-5,0,0,-13,11:6 - 11:8 - 11:6 - 0:0 - 0:0
15270504,2023-11-19 17:15:00,Darbinyan Armen - Grigoryan Erik,3:0,11:9 - 11:4 - 11:9 - 0:0 - 0:0,3,0,Darbinyan Armen,Grigoryan Erik,fiurst,Darbinyan Armen - Grigoryan Erik,55,33,22,-11,11,20,15,20,0,0,-2,-7,-2,0,0,-11,11:9 - 11:4 - 11:9 - 0:0 - 0:0
15270503,2023-11-19 17:00:00,Gevorgyan Gegham - Petrosyan Davit,3:2,11:9 - 12:10 - 6:11 - 10:12 - 11:5,3,2,Gevorgyan Gegham,Petrosyan Davit,fiurst,Gevorgyan Gegham - Petrosyan Davit,97,50,47,-3,3,20,22,17,22,16,-2,-2,5,2,-6,-3,11:9 - 12:10 - 6:11 - 10:12 - 11:5
15270496,2023-11-19 16:45:00,Darbinyan Armen - Gevorgyan Hayk,0:3,8:11 - 6:11 - 5:11 - 0:0 - 0:0,0,3,Darbinyan Armen,Gevorgyan Hayk,fiurst,Darbinyan Armen - Gevorgyan Hayk,52,19,33,14,-14,19,17,16,0,0,3,5,6,0,0,14,8:11 - 6:11 - 5:11 - 0:0 - 0:0
15270493,2023-11-19 16:30:00,Grigoryan Erik - Gevorgyan Gegham,3:0,3:11 - 5:11 - 14:16 - 0:0 - 0:0,0,3,Grigoryan Erik,Gevorgyan Gegham,fiurst,Gevorgyan Gegham - Grigoryan Erik,60,38,22,-16,16,14,16,30,0,0,-8,-6,-2,0,0,-16,11:3 - 11:5 - 16:14 - 0:0 - 0:0
15270490,2023-11-19 16:15:00,Petrosyan Davit - Darbinyan Armen,0:3,11:5 - 11:9 - 11:6 - 0:0 - 0:0,3,0,Petrosyan Davit,Darbinyan Armen,fiurst,Darbinyan Armen - Petrosyan Davit,53,20,33,13,-13,16,20,17,0,0,6,2,5,0,0,13,5:11 - 9:11 - 6:11 - 0:0 - 0:0
15270480,2023-11-19 16:00:00,Gevorgyan Hayk - Gevorgyan Gegham,0:3,11:9 - 11:5 - 11:9 - 0:0 - 0:0,3,0,Gevorgyan Hayk,Gevorgyan Gegham,fiurst,Gevorgyan Gegham - Gevorgyan Hayk,56,23,33,10,-10,20,16,20,0,0,2,6,2,0,0,10,9:11 - 5:11 - 9:11 - 0:0 - 0:0
15270479,2023-11-19 15:45:00,Grigoryan Erik - Petrosyan Davit,1:3,15:17 - 10:12 - 11:1 - 7:11 - 0:0,1,3,Grigoryan Erik,Petrosyan Davit,fiurst,Grigoryan Erik - Petrosyan Davit,84,43,41,-2,2,32,22,12,18,0,2,2,-10,4,0,-2,15:17 - 10:12 - 11:1 - 7:11 - 0:0
15270471,2023-11-19 15:30:00,Gevorgyan Gegham - Darbinyan Armen,1:3,7:11 - 15:13 - 11:8 - 11:6 - 0:0,3,1,Gevorgyan Gegham,Darbinyan Armen,fiurst,Darbinyan Armen - Gevorgyan Gegham,82,38,44,6,-6,18,28,19,17,0,-4,2,3,5,0,6,11:7 - 13:15 - 8:11 - 6:11 - 0:0
15270467,2023-11-19 15:15:00,Gevorgyan Hayk - Grigoryan Erik,3:1,14:16 - 11:2 - 11:6 - 11:7 - 0:0,3,1,Gevorgyan Hayk,Grigoryan Erik,fiurst,Gevorgyan Hayk - Grigoryan Erik,78,47,31,-16,16,30,13,17,18,0,2,-9,-5,-4,0,-16,14:16 - 11:2 - 11:6 - 11:7 - 0:0
15270455,2023-11-19 14:45:00,Papyan Karen - Nikoghosyan Narek,0:3,15:13 - 11:5 - 15:13 - 0:0 - 0:0,3,0,Papyan Karen,Nikoghosyan Narek,fiurst,Nikoghosyan Narek - Papyan Karen,72,31,41,10,-10,28,16,28,0,0,2,6,2,0,0,10,13:15 - 5:11 - 13:15 - 0:0 - 0:0
15270449,2023-11-19 14:15:00,Diaryan Aleksandr - Papyan Karen,3:0,11:8 - 11:2 - 11:8 - 0:0 - 0:0,3,0,Diaryan Aleksandr,Papyan Karen,fiurst,Diaryan Aleksandr - Papyan Karen,51,33,18,-15,15,19,13,19,0,0,-3,-9,-3,0,0,-15,11:8 - 11:2 - 11:8 - 0:0 - 0:0
15270425,2023-11-19 14:05:00,Soghomonyan Hrayr - Nikoghosyan Narek,3:0,5:11 - 9:11 - 5:11 - 0:0 - 0:0,0,3,Soghomonyan Hrayr,Nikoghosyan Narek,fiurst,Nikoghosyan Narek - Soghomonyan Hrayr,52,33,19,-14,14,16,20,16,0,0,-6,-2,-6,0,0,-14,11:5 - 11:9 - 11:5 - 0:0 - 0:0
15270395,2023-11-19 13:30:00,Diaryan Aleksandr - Soghomonyan Hrayr,3:0,12:10 - 11:6 - 14:12 - 0:0 - 0:0,3,0,Diaryan Aleksandr,Soghomonyan Hrayr,fiurst,Diaryan Aleksandr - Soghomonyan Hrayr,65,37,28,-9,9,22,17,26,0,0,-2,-5,-2,0,0,-9,12:10 - 11:6 - 14:12 - 0:0 - 0:0
15270383,2023-11-19 13:00:00,Papyan Karen - Soghomonyan Hrayr,3:0,11:8 - 11:4 - 11:8 - 0:0 - 0:0,3,0,Papyan Karen,Soghomonyan Hrayr,fiurst,Papyan Karen - Soghomonyan Hrayr,53,33,20,-13,13,19,15,19,0,0,-3,-7,-3,0,0,-13,11:8 - 11:4 - 11:8 - 0:0 - 0:0
15270382,2023-11-19 12:50:00,Nikoghosyan Narek - Diaryan Aleksandr,0:3,11:4 - 11:7 - 13:11 - 0:0 - 0:0,3,0,Nikoghosyan Narek,Diaryan Aleksandr,fiurst,Diaryan Aleksandr - Nikoghosyan Narek,57,22,35,13,-13,15,18,24,0,0,7,4,2,0,0,13,4:11 - 7:11 - 11:13 - 0:0 - 0:0
15270374,2023-11-19 12:00:00,Nikoghosyan Narek - Papyan Karen,3:1,11:6 - 8:11 - 11:5 - 11:6 - 0:0,3,1,Nikoghosyan Narek,Papyan Karen,fiurst,Nikoghosyan Narek - Papyan Karen,69,41,28,-13,13,17,19,16,17,0,-5,3,-6,-5,0,-13,11:6 - 8:11 - 11:5 - 11:6 - 0:0
15270370,2023-11-19 11:30:00,Nikoghosyan Narek - Soghomonyan Hrayr,3:0,11:8 - 11:4 - 11:4 - 0:0 - 0:0,3,0,Nikoghosyan Narek,Soghomonyan Hrayr,fiurst,Nikoghosyan Narek - Soghomonyan Hrayr,49,33,16,-17,17,19,15,15,0,0,-3,-7,-7,0,0,-17,11:8 - 11:4 - 11:4 - 0:0 - 0:0
15270346,2023-11-19 11:15:00,Papyan Karen - Diaryan Aleksandr,3:0,4:11 - 5:11 - 3:11 - 0:0 - 0:0,0,3,Papyan Karen,Diaryan Aleksandr,fiurst,Diaryan Aleksandr - Papyan Karen,45,33,12,-21,21,15,16,14,0,0,-7,-6,-8,0,0,-21,11:4 - 11:5 - 11:3 - 0:0 - 0:0
15270344,2023-11-19 10:55:00,Soghomonyan Hrayr - Diaryan Aleksandr,3:0,5:11 - 2:11 - 6:11 - 0:0 - 0:0,0,3,Soghomonyan Hrayr,Diaryan Aleksandr,fiurst,Diaryan Aleksandr - Soghomonyan Hrayr,46,33,13,-20,20,16,13,17,0,0,-6,-9,-5,0,0,-20,11:5 - 11:2 - 11:6 - 0:0 - 0:0
15270340,2023-11-19 10:15:00,Diaryan Aleksandr - Nikoghosyan Narek,3:2,11:9 - 9:11 - 10:12 - 11:6 - 13:11,3,2,Diaryan Aleksandr,Nikoghosyan Narek,fiurst,Diaryan Aleksandr - Nikoghosyan Narek,103,54,49,-5,5,20,20,22,17,24,-2,2,2,-5,-2,-5,11:9 - 9:11 - 10:12 - 11:6 - 13:11
15270337,2023-11-19 10:00:00,Soghomonyan Hrayr - Papyan Karen,3:0,9:11 - 6:11 - 5:11 - 0:0 - 0:0,0,3,Soghomonyan Hrayr,Papyan Karen,fiurst,Papyan Karen - Soghomonyan Hrayr,53,33,20,-13,13,20,17,16,0,0,-2,-5,-6,0,0,-13,11:9 - 11:6 - 11:5 - 0:0 - 0:0
15245459,2023-11-18 17:30:00,Avakimyan Davit - Darbinyan Armen,3:0,11:5 - 11:8 - 11:1 - 0:0 - 0:0,3,0,Avakimyan Davit,Darbinyan Armen,fiurst,Avakimyan Davit - Darbinyan Armen,47,33,14,-19,19,16,19,12,0,0,-6,-3,-10,0,0,-19,11:5 - 11:8 - 11:1 - 0:0 - 0:0
15245458,2023-11-18 17:15:00,Arutyunov Ruben - Grigoryan Erik,3:0,11:2 - 11:4 - 11:4 - 0:0 - 0:0,3,0,Arutyunov Ruben,Grigoryan Erik,fiurst,Arutyunov Ruben - Grigoryan Erik,43,33,10,-23,23,13,15,15,0,0,-9,-7,-7,0,0,-23,11:2 - 11:4 - 11:4 - 0:0 - 0:0
15245453,2023-11-18 17:00:00,Gevorgyan Hayk - Avakimyan Davit,3:0,8:11 - 5:11 - 7:11 - 0:0 - 0:0,0,3,Gevorgyan Hayk,Avakimyan Davit,fiurst,Avakimyan Davit - Gevorgyan Hayk,53,33,20,-13,13,19,16,18,0,0,-3,-6,-4,0,0,-13,11:8 - 11:5 - 11:7 - 0:0 - 0:0
15245441,2023-11-18 16:45:00,Arutyunov Ruben - Darbinyan Armen,3:1,11:2 - 9:11 - 11:2 - 11:3 - 0:0,3,1,Arutyunov Ruben,Darbinyan Armen,fiurst,Arutyunov Ruben - Darbinyan Armen,60,42,18,-24,24,13,20,13,14,0,-9,2,-9,-8,0,-24,11:2 - 9:11 - 11:2 - 11:3 - 0:0
15245437,2023-11-18 16:30:00,Grigoryan Erik - Gevorgyan Hayk,3:0,6:11 - 6:11 - 8:11 - 0:0 - 0:0,0,3,Grigoryan Erik,Gevorgyan Hayk,fiurst,Gevorgyan Hayk - Grigoryan Erik,53,33,20,-13,13,17,17,19,0,0,-5,-5,-3,0,0,-13,11:6 - 11:6 - 11:8 - 0:0 - 0:0
15245434,2023-11-18 16:15:00,Avakimyan Davit - Arutyunov Ruben,3:0,5:11 - 5:11 - 6:11 - 0:0 - 0:0,0,3,Avakimyan Davit,Arutyunov Ruben,fiurst,Arutyunov Ruben - Avakimyan Davit,49,33,16,-17,17,16,16,17,0,0,-6,-6,-5,0,0,-17,11:5 - 11:5 - 11:6 - 0:0 - 0:0
15245426,2023-11-18 16:00:00,Darbinyan Armen - Gevorgyan Hayk,3:0,11:9 - 11:8 - 11:8 - 0:0 - 0:0,3,0,Darbinyan Armen,Gevorgyan Hayk,fiurst,Darbinyan Armen - Gevorgyan Hayk,58,33,25,-8,8,20,19,19,0,0,-2,-3,-3,0,0,-8,11:9 - 11:8 - 11:8 - 0:0 - 0:0
15245423,2023-11-18 15:45:00,Grigoryan Erik - Avakimyan Davit,3:0,7:11 - 11:13 - 4:11 - 0:0 - 0:0,0,3,Grigoryan Erik,Avakimyan Davit,fiurst,Avakimyan Davit - Grigoryan Erik,57,35,22,-13,13,18,24,15,0,0,-4,-2,-7,0,0,-13,11:7 - 13:11 - 11:4 - 0:0 - 0:0
15245419,2023-11-18 15:30:00,Gevorgyan Hayk - Arutyunov Ruben,3:0,7:11 - 5:11 - 9:11 - 0:0 - 0:0,0,3,Gevorgyan Hayk,Arutyunov Ruben,fiurst,Arutyunov Ruben - Gevorgyan Hayk,54,33,21,-12,12,18,16,20,0,0,-4,-6,-2,0,0,-12,11:7 - 11:5 - 11:9 - 0:0 - 0:0
15245406,2023-11-18 15:20:00,Darbinyan Armen - Grigoryan Erik,2:3,7:11 - 11:9 - 9:11 - 11:3 - 9:11,2,3,Darbinyan Armen,Grigoryan Erik,fiurst,Darbinyan Armen - Grigoryan Erik,92,47,45,-2,2,18,20,20,14,20,4,-2,2,-8,2,-2,7:11 - 11:9 - 9:11 - 11:3 - 9:11
15244915,2023-11-18 15:00:00,Nikoghosyan Narek - Papyan Karen,3:0,11:9 - 11:7 - 12:10 - 0:0 - 0:0,3,0,Nikoghosyan Narek,Papyan Karen,fiurst,Nikoghosyan Narek - Papyan Karen,60,34,26,-8,8,20,18,22,0,0,-2,-4,-2,0,0,-8,11:9 - 11:7 - 12:10 - 0:0 - 0:0
15244912,2023-11-18 14:45:00,Soghomonyan Hrayr - Nazaryan Mushegh,1:3,11:7 - 11:7 - 4:11 - 11:7 - 0:0,3,1,Soghomonyan Hrayr,Nazaryan Mushegh,fiurst,Nazaryan Mushegh - Soghomonyan Hrayr,69,32,37,5,-5,18,18,15,18,0,4,4,-7,4,0,5,7:11 - 7:11 - 11:4 - 7:11 - 0:0
15244911,2023-11-18 14:30:00,Rafayelyan Edgar - Nikoghosyan Narek,1:3,11:5 - 11:5 - 6:11 - 11:9 - 0:0,3,1,Rafayelyan Edgar,Nikoghosyan Narek,fiurst,Nikoghosyan Narek - Rafayelyan Edgar,69,30,39,9,-9,16,16,17,20,0,6,6,-5,2,0,9,5:11 - 5:11 - 11:6 - 9:11 - 0:0
15244907,2023-11-18 14:15:00,Papyan Karen - Soghomonyan Hrayr,3:1,11:9 - 12:10 - 8:11 - 11:9 - 0:0,3,1,Papyan Karen,Soghomonyan Hrayr,fiurst,Papyan Karen - Soghomonyan Hrayr,81,42,39,-3,3,20,22,19,20,0,-2,-2,3,-2,0,-3,11:9 - 12:10 - 8:11 - 11:9 - 0:0
15244904,2023-11-18 14:00:00,Rafayelyan Edgar - Nazaryan Mushegh,1:3,11:9 - 11:7 - 9:11 - 11:3 - 0:0,3,1,Rafayelyan Edgar,Nazaryan Mushegh,fiurst,Nazaryan Mushegh - Rafayelyan Edgar,72,30,42,12,-12,20,18,20,14,0,2,4,-2,8,0,12,9:11 - 7:11 - 11:9 - 3:11 - 0:0
15244902,2023-11-18 13:45:00,Nikoghosyan Narek - Soghomonyan Hrayr,3:1,9:11 - 11:9 - 11:4 - 11:6 - 0:0,3,1,Nikoghosyan Narek,Soghomonyan Hrayr,fiurst,Nikoghosyan Narek - Soghomonyan Hrayr,72,42,30,-12,12,20,20,15,17,0,2,-2,-7,-5,0,-12,9:11 - 11:9 - 11:4 - 11:6 - 0:0
15244899,2023-11-18 13:30:00,Papyan Karen - Rafayelyan Edgar,0:3,8:11 - 5:11 - 7:11 - 0:0 - 0:0,0,3,Papyan Karen,Rafayelyan Edgar,fiurst,Papyan Karen - Rafayelyan Edgar,53,20,33,13,-13,19,16,18,0,0,3,6,4,0,0,13,8:11 - 5:11 - 7:11 - 0:0 - 0:0
15244887,2023-11-18 13:15:00,Nazaryan Mushegh - Nikoghosyan Narek,1:3,4:11 - 8:11 - 11:8 - 5:11 - 0:0,1,3,Nazaryan Mushegh,Nikoghosyan Narek,fiurst,Nazaryan Mushegh - Nikoghosyan Narek,69,28,41,13,-13,15,19,19,16,0,7,3,-3,6,0,13,4:11 - 8:11 - 11:8 - 5:11 - 0:0
15244884,2023-11-18 13:00:00,Soghomonyan Hrayr - Rafayelyan Edgar,3:0,3:11 - 12:14 - 8:11 - 0:0 - 0:0,0,3,Soghomonyan Hrayr,Rafayelyan Edgar,fiurst,Rafayelyan Edgar - Soghomonyan Hrayr,59,36,23,-13,13,14,26,19,0,0,-8,-2,-3,0,0,-13,11:3 - 14:12 - 11:8 - 0:0 - 0:0
15244878,2023-11-18 12:45:00,Nazaryan Mushegh - Papyan Karen,3:2,6:11 - 11:8 - 11:7 - 8:11 - 11:7,3,2,Nazaryan Mushegh,Papyan Karen,fiurst,Nazaryan Mushegh - Papyan Karen,91,47,44,-3,3,17,19,18,19,18,5,-3,-4,3,-4,-3,6:11 - 11:8 - 11:7 - 8:11 - 11:7
15244874,2023-11-18 12:15:00,Nikoghosyan Narek - Rafayelyan Edgar,1:3,12:10 - 6:11 - 2:11 - 5:11 - 0:0,1,3,Nikoghosyan Narek,Rafayelyan Edgar,fiurst,Nikoghosyan Narek - Rafayelyan Edgar,68,25,43,18,-18,22,17,13,16,0,-2,5,9,6,0,18,12:10 - 6:11 - 2:11 - 5:11 - 0:0
15244872,2023-11-18 12:10:00,Nazaryan Mushegh - Soghomonyan Hrayr,3:1,11:7 - 13:11 - 6:11 - 11:7 - 0:0,3,1,Nazaryan Mushegh,Soghomonyan Hrayr,fiurst,Nazaryan Mushegh - Soghomonyan Hrayr,77,41,36,-5,5,18,24,17,18,0,-4,-2,5,-4,0,-5,11:7 - 13:11 - 6:11 - 11:7 - 0:0
15244870,2023-11-18 11:45:00,Papyan Karen - Nikoghosyan Narek,3:0,4:11 - 5:11 - 8:11 - 0:0 - 0:0,0,3,Papyan Karen,Nikoghosyan Narek,fiurst,Nikoghosyan Narek - Papyan Karen,50,33,17,-16,16,15,16,19,0,0,-7,-6,-3,0,0,-16,11:4 - 11:5 - 11:8 - 0:0 - 0:0
15244853,2023-11-18 11:40:00,Nazaryan Mushegh - Rafayelyan Edgar,0:3,7:11 - 2:11 - 4:11 - 0:0 - 0:0,0,3,Nazaryan Mushegh,Rafayelyan Edgar,fiurst,Nazaryan Mushegh - Rafayelyan Edgar,46,13,33,20,-20,18,13,15,0,0,4,9,7,0,0,20,7:11 - 2:11 - 4:11 - 0:0 - 0:0
15244844,2023-11-18 11:15:00,Soghomonyan Hrayr - Papyan Karen,3:0,8:11 - 7:11 - 5:11 - 0:0 - 0:0,0,3,Soghomonyan Hrayr,Papyan Karen,fiurst,Papyan Karen - Soghomonyan Hrayr,53,33,20,-13,13,19,18,16,0,0,-3,-4,-6,0,0,-13,11:8 - 11:7 - 11:5 - 0:0 - 0:0
15244839,2023-11-18 11:05:00,Nikoghosyan Narek - Nazaryan Mushegh,2:3,11:7 - 11:9 - 7:11 - 8:11 - 11:4,3,2,Nikoghosyan Narek,Nazaryan Mushegh,fiurst,Nazaryan Mushegh - Nikoghosyan Narek,90,42,48,6,-6,18,20,18,19,15,4,2,-4,-3,7,6,7:11 - 9:11 - 11:7 - 11:8 - 4:11
15244827,2023-11-18 10:45:00,Rafayelyan Edgar - Papyan Karen,1:3,6:11 - 11:5 - 11:7 - 11:7 - 0:0,3,1,Rafayelyan Edgar,Papyan Karen,fiurst,Papyan Karen - Rafayelyan Edgar,69,30,39,9,-9,17,16,18,18,0,-5,6,4,4,0,9,11:6 - 5:11 - 7:11 - 7:11 - 0:0
15244812,2023-11-18 10:30:00,Soghomonyan Hrayr - Nikoghosyan Narek,3:2,8:11 - 11:2 - 3:11 - 11:6 - 2:11,2,3,Soghomonyan Hrayr,Nikoghosyan Narek,fiurst,Nikoghosyan Narek - Soghomonyan Hrayr,76,41,35,-6,6,19,13,14,17,13,-3,9,-8,5,-9,-6,11:8 - 2:11 - 11:3 - 6:11 - 11:2
15244809,2023-11-18 10:15:00,Papyan Karen - Nazaryan Mushegh,3:0,7:11 - 2:11 - 6:11 - 0:0 - 0:0,0,3,Papyan Karen,Nazaryan Mushegh,fiurst,Nazaryan Mushegh - Papyan Karen,48,33,15,-18,18,18,13,17,0,0,-4,-9,-5,0,0,-18,11:7 - 11:2 - 11:6 - 0:0 - 0:0
15244799,2023-11-18 10:00:00,Rafayelyan Edgar - Soghomonyan Hrayr,3:0,11:6 - 12:10 - 11:8 - 0:0 - 0:0,3,0,Rafayelyan Edgar,Soghomonyan Hrayr,fiurst,Rafayelyan Edgar - Soghomonyan Hrayr,58,34,24,-10,10,17,22,19,0,0,-5,-2,-3,0,0,-10,11:6 - 12:10 - 11:8 - 0:0 - 0:0
15227286,2023-11-17 17:30:00,Darbinyan Armen - Petrosyan Davit,2:3,12:10 - 11:7 - 8:11 - 8:11 - 3:11,2,3,Darbinyan Armen,Petrosyan Davit,fiurst,Darbinyan Armen - Petrosyan Davit,92,42,50,8,-8,22,18,19,19,14,-2,-4,3,3,8,8,12:10 - 11:7 - 8:11 - 8:11 - 3:11
15227285,2023-11-17 17:15:00,Avakimyan Davit - Grigoryan Erik,3:0,11:5 - 11:8 - 11:8 - 0:0 - 0:0,3,0,Avakimyan Davit,Grigoryan Erik,fiurst,Avakimyan Davit - Grigoryan Erik,54,33,21,-12,12,16,19,19,0,0,-6,-3,-3,0,0,-12,11:5 - 11:8 - 11:8 - 0:0 - 0:0
15227284,2023-11-17 17:00:00,Arutyunov Ruben - Darbinyan Armen,3:0,11:6 - 11:5 - 11:5 - 0:0 - 0:0,3,0,Arutyunov Ruben,Darbinyan Armen,fiurst,Arutyunov Ruben - Darbinyan Armen,49,33,16,-17,17,17,16,16,0,0,-5,-6,-6,0,0,-17,11:6 - 11:5 - 11:5 - 0:0 - 0:0
15227281,2023-11-17 16:45:00,Avakimyan Davit - Petrosyan Davit,3:1,11:8 - 6:11 - 12:10 - 11:2 - 0:0,3,1,Avakimyan Davit,Petrosyan Davit,fiurst,Avakimyan Davit - Petrosyan Davit,71,40,31,-9,9,19,17,22,13,0,-3,5,-2,-9,0,-9,11:8 - 6:11 - 12:10 - 11:2 - 0:0
15227278,2023-11-17 16:40:00,Grigoryan Erik - Arutyunov Ruben,3:0,6:11 - 2:11 - 7:11 - 0:0 - 0:0,0,3,Grigoryan Erik,Arutyunov Ruben,fiurst,Arutyunov Ruben - Grigoryan Erik,48,33,15,-18,18,17,13,18,0,0,-5,-9,-4,0,0,-18,11:6 - 11:2 - 11:7 - 0:0 - 0:0
15227274,2023-11-17 16:15:00,Darbinyan Armen - Avakimyan Davit,3:1,11:7 - 1:11 - 7:11 - 5:11 - 0:0,1,3,Darbinyan Armen,Avakimyan Davit,fiurst,Avakimyan Davit - Darbinyan Armen,64,40,24,-16,16,18,12,18,16,0,4,-10,-4,-6,0,-16,7:11 - 11:1 - 11:7 - 11:5 - 0:0
15227273,2023-11-17 16:05:00,Petrosyan Davit - Arutyunov Ruben,3:0,8:11 - 9:11 - 5:11 - 0:0 - 0:0,0,3,Petrosyan Davit,Arutyunov Ruben,fiurst,Arutyunov Ruben - Petrosyan Davit,55,33,22,-11,11,19,20,16,0,0,-3,-2,-6,0,0,-11,11:8 - 11:9 - 11:5 - 0:0 - 0:0
15227261,2023-11-17 15:55:00,Grigoryan Erik - Darbinyan Armen,3:2,11:9 - 8:11 - 15:13 - 10:12 - 7:11,2,3,Grigoryan Erik,Darbinyan Armen,fiurst,Darbinyan Armen - Grigoryan Erik,107,56,51,-5,5,20,19,28,22,18,2,-3,2,-2,-4,-5,9:11 - 11:8 - 13:15 - 12:10 - 11:7
15227259,2023-11-17 15:40:00,Arutyunov Ruben - Avakimyan Davit,3:0,11:4 - 11:8 - 11:8 - 0:0 - 0:0,3,0,Arutyunov Ruben,Avakimyan Davit,fiurst,Arutyunov Ruben - Avakimyan Davit,53,33,20,-13,13,15,19,19,0,0,-7,-3,-3,0,0,-13,11:4 - 11:8 - 11:8 - 0:0 - 0:0
15227255,2023-11-17 15:15:00,Mkrtchyan Andranik - Soghomonyan Hrayr,3:1,11:6 - 12:10 - 7:11 - 11:8 - 0:0,3,1,Mkrtchyan Andranik,Soghomonyan Hrayr,fiurst,Mkrtchyan Andranik - Soghomonyan Hrayr,76,41,35,-6,6,17,22,18,19,0,-5,-2,4,-3,0,-6,11:6 - 12:10 - 7:11 - 11:8 - 0:0
15227257,2023-11-17 15:15:00,Petrosyan Davit - Grigoryan Erik,2:3,8:11 - 11:2 - 9:11 - 11:6 - 11:1,3,2,Petrosyan Davit,Grigoryan Erik,fiurst,Grigoryan Erik - Petrosyan Davit,81,31,50,19,-19,19,13,20,17,12,-3,9,-2,5,10,19,11:8 - 2:11 - 11:9 - 6:11 - 1:11
15227253,2023-11-17 15:00:00,Diaryan Aleksandr - Nikoghosyan Narek,3:2,9:11 - 14:12 - 11:5 - 7:11 - 11:6,3,2,Diaryan Aleksandr,Nikoghosyan Narek,fiurst,Diaryan Aleksandr - Nikoghosyan Narek,97,52,45,-7,7,20,26,16,18,17,2,-2,-6,4,-5,-7,9:11 - 14:12 - 11:5 - 7:11 - 11:6
15227250,2023-11-17 14:50:00,Papyan Karen - Mkrtchyan Andranik,1:3,13:11 - 20:18 - 9:11 - 11:8 - 0:0,3,1,Papyan Karen,Mkrtchyan Andranik,fiurst,Mkrtchyan Andranik - Papyan Karen,101,48,53,5,-5,24,38,20,19,0,2,2,-2,3,0,5,11:13 - 18:20 - 11:9 - 8:11 - 0:0
15227241,2023-11-17 14:35:00,Soghomonyan Hrayr - Diaryan Aleksandr,3:0,3:11 - 8:11 - 7:11 - 0:0 - 0:0,0,3,Soghomonyan Hrayr,Diaryan Aleksandr,fiurst,Diaryan Aleksandr - Soghomonyan Hrayr,51,33,18,-15,15,14,19,18,0,0,-8,-3,-4,0,0,-15,11:3 - 11:8 - 11:7 - 0:0 - 0:0
15227239,2023-11-17 14:20:00,Mkrtchyan Andranik - Diaryan Aleksandr,3:0,7:11 - 6:11 - 6:11 - 0:0 - 0:0,0,3,Mkrtchyan Andranik,Diaryan Aleksandr,fiurst,Diaryan Aleksandr - Mkrtchyan Andranik,52,33,19,-14,14,18,17,17,0,0,-4,-5,-5,0,0,-14,11:7 - 11:6 - 11:6 - 0:0 - 0:0
15227240,2023-11-17 14:15:00,Papyan Karen - Nikoghosyan Narek,3:1,13:11 - 8:11 - 9:11 - 9:11 - 0:0,1,3,Papyan Karen,Nikoghosyan Narek,fiurst,Nikoghosyan Narek - Papyan Karen,83,44,39,-5,5,24,19,20,20,0,2,-3,-2,-2,0,-5,11:13 - 11:8 - 11:9 - 11:9 - 0:0
15227238,2023-11-17 13:40:00,Soghomonyan Hrayr - Papyan Karen,3:0,6:11 - 3:11 - 4:11 - 0:0 - 0:0,0,3,Soghomonyan Hrayr,Papyan Karen,fiurst,Papyan Karen - Soghomonyan Hrayr,46,33,13,-20,20,17,14,15,0,0,-5,-8,-7,0,0,-20,11:6 - 11:3 - 11:4 - 0:0 - 0:0
15227226,2023-11-17 13:30:00,Nikoghosyan Narek - Mkrtchyan Andranik,2:3,12:14 - 11:7 - 11:9 - 12:14 - 15:13,3,2,Nikoghosyan Narek,Mkrtchyan Andranik,fiurst,Mkrtchyan Andranik - Nikoghosyan Narek,118,57,61,4,-4,26,18,20,26,28,-2,4,2,-2,2,4,14:12 - 7:11 - 9:11 - 14:12 - 13:15
15227222,2023-11-17 13:10:00,Diaryan Aleksandr - Papyan Karen,3:1,8:11 - 11:9 - 11:5 - 11:7 - 0:0,3,1,Diaryan Aleksandr,Papyan Karen,fiurst,Diaryan Aleksandr - Papyan Karen,73,41,32,-9,9,19,20,16,18,0,3,-2,-6,-4,0,-9,8:11 - 11:9 - 11:5 - 11:7 - 0:0
15227221,2023-11-17 13:00:00,Nikoghosyan Narek - Soghomonyan Hrayr,3:1,7:11 - 11:3 - 12:10 - 11:6 - 0:0,3,1,Nikoghosyan Narek,Soghomonyan Hrayr,fiurst,Nikoghosyan Narek - Soghomonyan Hrayr,71,41,30,-11,11,18,14,22,17,0,4,-8,-2,-5,0,-11,7:11 - 11:3 - 12:10 - 11:6 - 0:0
15227215,2023-11-17 12:30:00,Mkrtchyan Andranik - Papyan Karen,1:3,8:11 - 7:11 - 11:5 - 14:16 - 0:0,1,3,Mkrtchyan Andranik,Papyan Karen,fiurst,Mkrtchyan Andranik - Papyan Karen,83,40,43,3,-3,19,18,16,30,0,3,4,-6,2,0,3,8:11 - 7:11 - 11:5 - 14:16 - 0:0
15227212,2023-11-17 12:10:00,Nikoghosyan Narek - Diaryan Aleksandr,3:2,7:11 - 11:9 - 3:11 - 11:4 - 5:11,2,3,Nikoghosyan Narek,Diaryan Aleksandr,fiurst,Diaryan Aleksandr - Nikoghosyan Narek,83,46,37,-9,9,18,20,14,15,16,-4,2,-8,7,-6,-9,11:7 - 9:11 - 11:3 - 4:11 - 11:5
15227211,2023-11-17 12:05:00,Soghomonyan Hrayr - Mkrtchyan Andranik,1:3,11:8 - 11:7 - 12:14 - 14:12 - 0:0,3,1,Soghomonyan Hrayr,Mkrtchyan Andranik,fiurst,Mkrtchyan Andranik - Soghomonyan Hrayr,89,41,48,7,-7,19,18,26,26,0,3,4,-2,2,0,7,8:11 - 7:11 - 14:12 - 12:14 - 0:0
15227210,2023-11-17 11:40:00,Nikoghosyan Narek - Papyan Karen,2:3,11:3 - 9:11 - 6:11 - 11:4 - 10:12,2,3,Nikoghosyan Narek,Papyan Karen,fiurst,Nikoghosyan Narek - Papyan Karen,88,47,41,-6,6,14,20,17,15,22,-8,2,5,-7,2,-6,11:3 - 9:11 - 6:11 - 11:4 - 10:12
15227196,2023-11-17 11:15:00,Diaryan Aleksandr - Soghomonyan Hrayr,3:2,5:11 - 11:4 - 6:11 - 11:9 - 11:7,3,2,Diaryan Aleksandr,Soghomonyan Hrayr,fiurst,Diaryan Aleksandr - Soghomonyan Hrayr,86,44,42,-2,2,16,15,17,20,18,6,-7,5,-2,-4,-2,5:11 - 11:4 - 6:11 - 11:9 - 11:7
15227195,2023-11-17 11:00:00,Mkrtchyan Andranik - Nikoghosyan Narek,0:3,10:12 - 10:12 - 8:11 - 0:0 - 0:0,0,3,Mkrtchyan Andranik,Nikoghosyan Narek,fiurst,Mkrtchyan Andranik - Nikoghosyan Narek,63,28,35,7,-7,22,22,19,0,0,2,2,3,0,0,7,10:12 - 10:12 - 8:11 - 0:0 - 0:0
15227190,2023-11-17 10:55:00,Papyan Karen - Soghomonyan Hrayr,2:3,9:11 - 11:6 - 11:13 - 11:9 - 11:13,2,3,Papyan Karen,Soghomonyan Hrayr,fiurst,Papyan Karen - Soghomonyan Hrayr,105,53,52,-1,1,20,17,24,20,24,2,-5,2,-2,2,-1,9:11 - 11:6 - 11:13 - 11:9 - 11:13
15227188,2023-11-17 10:30:00,Diaryan Aleksandr - Mkrtchyan Andranik,3:1,7:11 - 11:2 - 11:6 - 11:6 - 0:0,3,1,Diaryan Aleksandr,Mkrtchyan Andranik,fiurst,Diaryan Aleksandr - Mkrtchyan Andranik,65,40,25,-15,15,18,13,17,17,0,4,-9,-5,-5,0,-15,7:11 - 11:2 - 11:6 - 11:6 - 0:0
15227184,2023-11-17 10:15:00,Soghomonyan Hrayr - Nikoghosyan Narek,3:2,11:13 - 13:11 - 11:7 - 8:11 - 9:11,2,3,Soghomonyan Hrayr,Nikoghosyan Narek,fiurst,Nikoghosyan Narek - Soghomonyan Hrayr,105,53,52,-1,1,24,24,18,19,20,-2,2,4,-3,-2,-1,13:11 - 11:13 - 7:11 - 11:8 - 11:9
15227181,2023-11-17 10:00:00,Papyan Karen - Diaryan Aleksandr,1:3,11:6 - 11:5 - 7:11 - 11:5 - 0:0,3,1,Papyan Karen,Diaryan Aleksandr,fiurst,Diaryan Aleksandr - Papyan Karen,67,27,40,13,-13,17,16,18,16,0,5,6,-4,6,0,13,6:11 - 5:11 - 11:7 - 5:11 - 0:0
15212451,2023-11-16 17:30:00,Darbinyan Armen - Grigoryan Erik,3:1,12:10 - 7:11 - 13:11 - 11:8 - 0:0,3,1,Darbinyan Armen,Grigoryan Erik,fiurst,Darbinyan Armen - Grigoryan Erik,83,43,40,-3,3,22,18,24,19,0,-2,4,-2,-3,0,-3,12:10 - 7:11 - 13:11 - 11:8 - 0:0
15212447,2023-11-16 17:15:00,Gevorgyan Gegham - Avakimyan Davit,3:1,9:11 - 7:11 - 11:9 - 9:11 - 0:0,1,3,Gevorgyan Gegham,Avakimyan Davit,fiurst,Avakimyan Davit - Gevorgyan Gegham,78,42,36,-6,6,20,18,20,20,0,-2,-4,2,-2,0,-6,11:9 - 11:7 - 9:11 - 11:9 - 0:0
15212437,2023-11-16 17:00:00,Petrosyan Davit - Darbinyan Armen,0:3,11:8 - 11:8 - 11:4 - 0:0 - 0:0,3,0,Petrosyan Davit,Darbinyan Armen,fiurst,Darbinyan Armen - Petrosyan Davit,53,20,33,13,-13,19,19,15,0,0,3,3,7,0,0,13,8:11 - 8:11 - 4:11 - 0:0 - 0:0
15212436,2023-11-16 16:45:00,Gevorgyan Gegham - Grigoryan Erik,0:3,7:11 - 8:11 - 10:12 - 0:0 - 0:0,0,3,Gevorgyan Gegham,Grigoryan Erik,fiurst,Gevorgyan Gegham - Grigoryan Erik,59,25,34,9,-9,18,19,22,0,0,4,3,2,0,0,9,7:11 - 8:11 - 10:12 - 0:0 - 0:0
15212425,2023-11-16 16:35:00,Avakimyan Davit - Petrosyan Davit,2:3,10:12 - 11:3 - 11:7 - 9:11 - 10:12,2,3,Avakimyan Davit,Petrosyan Davit,fiurst,Avakimyan Davit - Petrosyan Davit,96,51,45,-6,6,22,14,18,20,22,2,-8,-4,2,2,-6,10:12 - 11:3 - 11:7 - 9:11 - 10:12
15212424,2023-11-16 16:15:00,Darbinyan Armen - Gevorgyan Gegham,0:3,2:11 - 5:11 - 8:11 - 0:0 - 0:0,0,3,Darbinyan Armen,Gevorgyan Gegham,fiurst,Darbinyan Armen - Gevorgyan Gegham,48,15,33,18,-18,13,16,19,0,0,9,6,3,0,0,18,2:11 - 5:11 - 8:11 - 0:0 - 0:0
15212330,2023-11-16 16:00:00,Grigoryan Erik - Petrosyan Davit,1:3,5:11 - 11:8 - 10:12 - 9:11 - 0:0,1,3,Grigoryan Erik,Petrosyan Davit,fiurst,Grigoryan Erik - Petrosyan Davit,77,35,42,7,-7,16,19,22,20,0,6,-3,2,2,0,7,5:11 - 11:8 - 10:12 - 9:11 - 0:0
15212326,2023-11-16 15:45:00,Avakimyan Davit - Darbinyan Armen,3:1,11:6 - 6:11 - 11:6 - 11:8 - 0:0,3,1,Avakimyan Davit,Darbinyan Armen,fiurst,Avakimyan Davit - Darbinyan Armen,70,39,31,-8,8,17,17,17,19,0,-5,5,-5,-3,0,-8,11:6 - 6:11 - 11:6 - 11:8 - 0:0
15212325,2023-11-16 15:30:00,Petrosyan Davit - Gevorgyan Gegham,1:3,12:10 - 11:5 - 5:11 - 13:11 - 0:0,3,1,Petrosyan Davit,Gevorgyan Gegham,fiurst,Gevorgyan Gegham - Petrosyan Davit,78,37,41,4,-4,22,16,16,24,0,2,6,-6,2,0,4,10:12 - 5:11 - 11:5 - 11:13 - 0:0
15212324,2023-11-16 15:20:00,Grigoryan Erik - Avakimyan Davit,3:0,9:11 - 7:11 - 11:13 - 0:0 - 0:0,0,3,Grigoryan Erik,Avakimyan Davit,fiurst,Avakimyan Davit - Grigoryan Erik,62,35,27,-8,8,20,18,24,0,0,-2,-4,-2,0,0,-8,11:9 - 11:7 - 13:11 - 0:0 - 0:0
15212317,2023-11-16 15:00:00,Rafayelyan Edgar - Mkrtchyan Andranik,0:3,13:11 - 11:5 - 11:5 - 0:0 - 0:0,3,0,Rafayelyan Edgar,Mkrtchyan Andranik,fiurst,Mkrtchyan Andranik - Rafayelyan Edgar,56,21,35,14,-14,24,16,16,0,0,2,6,6,0,0,14,11:13 - 5:11 - 5:11 - 0:0 - 0:0
15212312,2023-11-16 14:45:00,Nazaryan Mushegh - Papyan Karen,1:3,12:10 - 7:11 - 5:11 - 6:11 - 0:0,1,3,Nazaryan Mushegh,Papyan Karen,fiurst,Nazaryan Mushegh - Papyan Karen,73,30,43,13,-13,22,18,16,17,0,-2,4,6,5,0,13,12:10 - 7:11 - 5:11 - 6:11 - 0:0
15212311,2023-11-16 14:40:00,Diaryan Aleksandr - Rafayelyan Edgar,0:3,13:15 - 9:11 - 6:11 - 0:0 - 0:0,0,3,Diaryan Aleksandr,Rafayelyan Edgar,fiurst,Diaryan Aleksandr - Rafayelyan Edgar,65,28,37,9,-9,28,20,17,0,0,2,2,5,0,0,9,13:15 - 9:11 - 6:11 - 0:0 - 0:0
15212309,2023-11-16 14:15:00,Mkrtchyan Andranik - Nazaryan Mushegh,3:2,8:11 - 11:8 - 10:12 - 11:6 - 12:10,3,2,Mkrtchyan Andranik,Nazaryan Mushegh,fiurst,Mkrtchyan Andranik - Nazaryan Mushegh,99,52,47,-5,5,19,19,22,17,22,3,-3,2,-5,-2,-5,8:11 - 11:8 - 10:12 - 11:6 - 12:10
15212305,2023-11-16 14:00:00,Diaryan Aleksandr - Papyan Karen,3:1,12:10 - 11:6 - 13:15 - 12:10 - 0:0,3,1,Diaryan Aleksandr,Papyan Karen,fiurst,Diaryan Aleksandr - Papyan Karen,89,48,41,-7,7,22,17,28,22,0,-2,-5,2,-2,0,-7,12:10 - 11:6 - 13:15 - 12:10 - 0:0
15212304,2023-11-16 13:45:00,Rafayelyan Edgar - Nazaryan Mushegh,0:3,11:9 - 11:8 - 11:5 - 0:0 - 0:0,3,0,Rafayelyan Edgar,Nazaryan Mushegh,fiurst,Nazaryan Mushegh - Rafayelyan Edgar,55,22,33,11,-11,20,19,16,0,0,2,3,6,0,0,11,9:11 - 8:11 - 5:11 - 0:0 - 0:0
15212301,2023-11-16 13:30:00,Mkrtchyan Andranik - Diaryan Aleksandr,3:1,2:11 - 12:10 - 9:11 - 4:11 - 0:0,1,3,Mkrtchyan Andranik,Diaryan Aleksandr,fiurst,Diaryan Aleksandr - Mkrtchyan Andranik,70,43,27,-16,16,13,22,20,15,0,-9,2,-2,-7,0,-16,11:2 - 10:12 - 11:9 - 11:4 - 0:0
15212290,2023-11-16 13:20:00,Papyan Karen - Rafayelyan Edgar,3:0,13:11 - 11:9 - 11:6 - 0:0 - 0:0,3,0,Papyan Karen,Rafayelyan Edgar,fiurst,Papyan Karen - Rafayelyan Edgar,61,35,26,-9,9,24,20,17,0,0,-2,-2,-5,0,0,-9,13:11 - 11:9 - 11:6 - 0:0 - 0:0
15212289,2023-11-16 13:00:00,Nazaryan Mushegh - Diaryan Aleksandr,3:0,7:11 - 11:13 - 2:11 - 0:0 - 0:0,0,3,Nazaryan Mushegh,Diaryan Aleksandr,fiurst,Diaryan Aleksandr - Nazaryan Mushegh,55,35,20,-15,15,18,24,13,0,0,-4,-2,-9,0,0,-15,11:7 - 13:11 - 11:2 - 0:0 - 0:0
15212286,2023-11-16 12:45:00,Papyan Karen - Mkrtchyan Andranik,2:3,4:11 - 11:6 - 9:11 - 11:6 - 11:9,3,2,Papyan Karen,Mkrtchyan Andranik,fiurst,Mkrtchyan Andranik - Papyan Karen,89,43,46,3,-3,15,17,20,17,20,-7,5,-2,5,2,3,11:4 - 6:11 - 11:9 - 6:11 - 9:11
15212285,2023-11-16 12:15:00,Rafayelyan Edgar - Diaryan Aleksandr,0:3,11:8 - 11:4 - 11:6 - 0:0 - 0:0,3,0,Rafayelyan Edgar,Diaryan Aleksandr,fiurst,Diaryan Aleksandr - Rafayelyan Edgar,51,18,33,15,-15,19,15,17,0,0,3,7,5,0,0,15,8:11 - 4:11 - 6:11 - 0:0 - 0:0
15212281,2023-11-16 12:00:00,Papyan Karen - Nazaryan Mushegh,1:3,11:5 - 6:11 - 11:8 - 11:4 - 0:0,3,1,Papyan Karen,Nazaryan Mushegh,fiurst,Nazaryan Mushegh - Papyan Karen,67,28,39,11,-11,16,17,19,15,0,6,-5,3,7,0,11,5:11 - 11:6 - 8:11 - 4:11 - 0:0
15212280,2023-11-16 11:55:00,Mkrtchyan Andranik - Rafayelyan Edgar,1:3,12:10 - 2:11 - 3:11 - 9:11 - 0:0,1,3,Mkrtchyan Andranik,Rafayelyan Edgar,fiurst,Mkrtchyan Andranik - Rafayelyan Edgar,69,26,43,17,-17,22,13,14,20,0,-2,9,8,2,0,17,12:10 - 2:11 - 3:11 - 9:11 - 0:0
15212269,2023-11-16 11:30:00,Papyan Karen - Diaryan Aleksandr,3:0,6:11 - 6:11 - 4:11 - 0:0 - 0:0,0,3,Papyan Karen,Diaryan Aleksandr,fiurst,Diaryan Aleksandr - Papyan Karen,49,33,16,-17,17,17,17,15,0,0,-5,-5,-7,0,0,-17,11:6 - 11:6 - 11:4 - 0:0 - 0:0
15212268,2023-11-16 11:15:00,Nazaryan Mushegh - Mkrtchyan Andranik,3:2,8:11 - 11:6 - 11:5 - 11:13 - 8:11,2,3,Nazaryan Mushegh,Mkrtchyan Andranik,fiurst,Mkrtchyan Andranik - Nazaryan Mushegh,95,46,49,3,-3,19,17,16,24,19,-3,5,6,-2,-3,3,11:8 - 6:11 - 5:11 - 13:11 - 11:8
15212265,2023-11-16 11:00:00,Rafayelyan Edgar - Papyan Karen,3:1,8:11 - 8:11 - 11:5 - 7:11 - 0:0,1,3,Rafayelyan Edgar,Papyan Karen,fiurst,Papyan Karen - Rafayelyan Edgar,72,38,34,-4,4,19,19,16,18,0,-3,-3,6,-4,0,-4,11:8 - 11:8 - 5:11 - 11:7 - 0:0
15212260,2023-11-16 10:45:00,Diaryan Aleksandr - Mkrtchyan Andranik,0:3,10:12 - 3:11 - 7:11 - 0:0 - 0:0,0,3,Diaryan Aleksandr,Mkrtchyan Andranik,fiurst,Diaryan Aleksandr - Mkrtchyan Andranik,54,20,34,14,-14,22,14,18,0,0,2,8,4,0,0,14,10:12 - 3:11 - 7:11 - 0:0 - 0:0
15212230,2023-11-16 10:30:00,Nazaryan Mushegh - Rafayelyan Edgar,3:1,10:12 - 11:6 - 11:4 - 12:10 - 0:0,3,1,Nazaryan Mushegh,Rafayelyan Edgar,fiurst,Nazaryan Mushegh - Rafayelyan Edgar,76,44,32,-12,12,22,17,15,22,0,2,-5,-7,-2,0,-12,10:12 - 11:6 - 11:4 - 12:10 - 0:0
15212227,2023-11-16 10:15:00,Mkrtchyan Andranik - Papyan Karen,1:3,6:11 - 8:11 - 11:5 - 7:11 - 0:0,1,3,Mkrtchyan Andranik,Papyan Karen,fiurst,Mkrtchyan Andranik - Papyan Karen,70,32,38,6,-6,17,19,16,18,0,5,3,-6,4,0,6,6:11 - 8:11 - 11:5 - 7:11 - 0:0
15212224,2023-11-16 10:00:00,Diaryan Aleksandr - Nazaryan Mushegh,3:0,11:7 - 11:7 - 13:11 - 0:0 - 0:0,3,0,Diaryan Aleksandr,Nazaryan Mushegh,fiurst,Diaryan Aleksandr - Nazaryan Mushegh,60,35,25,-10,10,18,18,24,0,0,-4,-4,-2,0,0,-10,11:7 - 11:7 - 13:11 - 0:0 - 0:0
15194496,2023-11-15 17:30:00,Darbinyan Armen - Gevorgyan Gegham,0:3,10:12 - 5:11 - 5:11 - 0:0 - 0:0,0,3,Darbinyan Armen,Gevorgyan Gegham,fiurst,Darbinyan Armen - Gevorgyan Gegham,54,20,34,14,-14,22,16,16,0,0,2,6,6,0,0,14,10:12 - 5:11 - 5:11 - 0:0 - 0:0
15194495,2023-11-15 17:15:00,Grigoryan Erik - Petrosyan Davit,2:3,11:8 - 4:11 - 11:5 - 9:11 - 12:14,2,3,Grigoryan Erik,Petrosyan Davit,fiurst,Grigoryan Erik - Petrosyan Davit,96,47,49,2,-2,19,15,16,20,26,-3,7,-6,2,2,2,11:8 - 4:11 - 11:5 - 9:11 - 12:14
15194490,2023-11-15 17:00:00,Avakimyan Davit - Darbinyan Armen,3:0,11:9 - 11:3 - 11:4 - 0:0 - 0:0,3,0,Avakimyan Davit,Darbinyan Armen,fiurst,Avakimyan Davit - Darbinyan Armen,49,33,16,-17,17,20,14,15,0,0,-2,-8,-7,0,0,-17,11:9 - 11:3 - 11:4 - 0:0 - 0:0
15194486,2023-11-15 16:50:00,Grigoryan Erik - Gevorgyan Gegham,3:0,4:11 - 5:11 - 6:11 - 0:0 - 0:0,0,3,Grigoryan Erik,Gevorgyan Gegham,fiurst,Gevorgyan Gegham - Grigoryan Erik,48,33,15,-18,18,15,16,17,0,0,-7,-6,-5,0,0,-18,11:4 - 11:5 - 11:6 - 0:0 - 0:0
15194484,2023-11-15 16:40:00,Petrosyan Davit - Avakimyan Davit,3:2,6:11 - 3:11 - 11:6 - 11:9 - 7:11,2,3,Petrosyan Davit,Avakimyan Davit,fiurst,Avakimyan Davit - Petrosyan Davit,86,48,38,-10,10,17,14,17,20,18,-5,-8,5,2,-4,-10,11:6 - 11:3 - 6:11 - 9:11 - 11:7
15194477,2023-11-15 16:30:00,Darbinyan Armen - Grigoryan Erik,3:1,11:8 - 7:11 - 11:5 - 11:9 - 0:0,3,1,Darbinyan Armen,Grigoryan Erik,fiurst,Darbinyan Armen - Grigoryan Erik,73,40,33,-7,7,19,18,16,20,0,-3,4,-6,-2,0,-7,11:8 - 7:11 - 11:5 - 11:9 - 0:0
15194433,2023-11-15 16:00:00,Gevorgyan Gegham - Avakimyan Davit,1:3,12:10 - 9:11 - 11:9 - 11:9 - 0:0,3,1,Gevorgyan Gegham,Avakimyan Davit,fiurst,Avakimyan Davit - Gevorgyan Gegham,82,39,43,4,-4,22,20,20,20,0,2,-2,2,2,0,4,10:12 - 11:9 - 9:11 - 9:11 - 0:0
15194426,2023-11-15 15:55:00,Petrosyan Davit - Darbinyan Armen,2:3,8:11 - 15:13 - 9:11 - 11:5 - 11:7,3,2,Petrosyan Davit,Darbinyan Armen,fiurst,Darbinyan Armen - Petrosyan Davit,101,47,54,7,-7,19,28,20,16,18,-3,2,-2,6,4,7,11:8 - 13:15 - 11:9 - 5:11 - 7:11
15194425,2023-11-15 15:30:00,Avakimyan Davit - Grigoryan Erik,3:0,11:8 - 11:5 - 11:5 - 0:0 - 0:0,3,0,Avakimyan Davit,Grigoryan Erik,fiurst,Avakimyan Davit - Grigoryan Erik,51,33,18,-15,15,19,16,16,0,0,-3,-6,-6,0,0,-15,11:8 - 11:5 - 11:5 - 0:0 - 0:0
15194422,2023-11-15 15:15:00,Gevorgyan Gegham - Petrosyan Davit,1:3,11:9 - 10:12 - 8:11 - 3:11 - 0:0,1,3,Gevorgyan Gegham,Petrosyan Davit,fiurst,Gevorgyan Gegham - Petrosyan Davit,75,32,43,11,-11,20,22,19,14,0,-2,2,3,8,0,11,11:9 - 10:12 - 8:11 - 3:11 - 0:0
15194094,2023-11-15 15:00:00,Rafayelyan Edgar - Diaryan Aleksandr,0:3,11:9 - 12:10 - 11:8 - 0:0 - 0:0,3,0,Rafayelyan Edgar,Diaryan Aleksandr,fiurst,Diaryan Aleksandr - Rafayelyan Edgar,61,27,34,7,-7,20,22,19,0,0,2,2,3,0,0,7,9:11 - 10:12 - 8:11 - 0:0 - 0:0
15194073,2023-11-15 14:45:00,Mkrtchyan Andranik - Papyan Karen,2:3,10:12 - 11:8 - 11:4 - 8:11 - 9:11,2,3,Mkrtchyan Andranik,Papyan Karen,fiurst,Mkrtchyan Andranik - Papyan Karen,95,49,46,-3,3,22,19,15,19,20,2,-3,-7,3,2,-3,10:12 - 11:8 - 11:4 - 8:11 - 9:11
15194069,2023-11-15 14:30:00,Nikoghosyan Narek - Rafayelyan Edgar,0:3,8:11 - 10:12 - 5:11 - 0:0 - 0:0,0,3,Nikoghosyan Narek,Rafayelyan Edgar,fiurst,Nikoghosyan Narek - Rafayelyan Edgar,57,23,34,11,-11,19,22,16,0,0,3,2,6,0,0,11,8:11 - 10:12 - 5:11 - 0:0 - 0:0
15194066,2023-11-15 14:15:00,Diaryan Aleksandr - Mkrtchyan Andranik,3:0,11:9 - 11:4 - 11:7 - 0:0 - 0:0,3,0,Diaryan Aleksandr,Mkrtchyan Andranik,fiurst,Diaryan Aleksandr - Mkrtchyan Andranik,53,33,20,-13,13,20,15,18,0,0,-2,-7,-4,0,0,-13,11:9 - 11:4 - 11:7 - 0:0 - 0:0
15194063,2023-11-15 14:00:00,Nikoghosyan Narek - Papyan Karen,0:3,6:11 - 8:11 - 8:11 - 0:0 - 0:0,0,3,Nikoghosyan Narek,Papyan Karen,fiurst,Nikoghosyan Narek - Papyan Karen,55,22,33,11,-11,17,19,19,0,0,5,3,3,0,0,11,6:11 - 8:11 - 8:11 - 0:0 - 0:0
15194062,2023-11-15 13:45:00,Rafayelyan Edgar - Mkrtchyan Andranik,0:3,11:4 - 11:7 - 11:3 - 0:0 - 0:0,3,0,Rafayelyan Edgar,Mkrtchyan Andranik,fiurst,Mkrtchyan Andranik - Rafayelyan Edgar,47,14,33,19,-19,15,18,14,0,0,7,4,8,0,0,19,4:11 - 7:11 - 3:11 - 0:0 - 0:0
15194061,2023-11-15 13:40:00,Diaryan Aleksandr - Nikoghosyan Narek,3:0,11:9 - 11:0 - 11:7 - 0:0 - 0:0,3,0,Diaryan Aleksandr,Nikoghosyan Narek,fiurst,Diaryan Aleksandr - Nikoghosyan Narek,49,33,16,-17,17,20,11,18,0,0,-2,-11,-4,0,0,-17,11:9 - 11:0 - 11:7 - 0:0 - 0:0
15194052,2023-11-15 13:20:00,Papyan Karen - Rafayelyan Edgar,0:3,3:11 - 12:14 - 7:11 - 0:0 - 0:0,0,3,Papyan Karen,Rafayelyan Edgar,fiurst,Papyan Karen - Rafayelyan Edgar,58,22,36,14,-14,14,26,18,0,0,8,2,4,0,0,14,3:11 - 12:14 - 7:11 - 0:0 - 0:0
15194041,2023-11-15 13:05:00,Mkrtchyan Andranik - Nikoghosyan Narek,2:3,8:11 - 11:9 - 11:8 - 8:11 - 5:11,2,3,Mkrtchyan Andranik,Nikoghosyan Narek,fiurst,Mkrtchyan Andranik - Nikoghosyan Narek,93,43,50,7,-7,19,20,19,19,16,3,-2,-3,3,6,7,8:11 - 11:9 - 11:8 - 8:11 - 5:11
15194040,2023-11-15 12:45:00,Papyan Karen - Diaryan Aleksandr,1:3,10:12 - 11:9 - 11:9 - 11:9 - 0:0,3,1,Papyan Karen,Diaryan Aleksandr,fiurst,Diaryan Aleksandr - Papyan Karen,82,39,43,4,-4,22,20,20,20,0,-2,2,2,2,0,4,12:10 - 9:11 - 9:11 - 9:11 - 0:0
15194038,2023-11-15 12:15:00,Rafayelyan Edgar - Nikoghosyan Narek,1:3,6:11 - 12:10 - 11:8 - 11:8 - 0:0,3,1,Rafayelyan Edgar,Nikoghosyan Narek,fiurst,Nikoghosyan Narek - Rafayelyan Edgar,77,37,40,3,-3,17,22,19,19,0,-5,2,3,3,0,3,11:6 - 10:12 - 8:11 - 8:11 - 0:0
15194035,2023-11-15 12:00:00,Papyan Karen - Mkrtchyan Andranik,1:3,9:11 - 11:8 - 11:9 - 11:7 - 0:0,3,1,Papyan Karen,Mkrtchyan Andranik,fiurst,Mkrtchyan Andranik - Papyan Karen,77,35,42,7,-7,20,19,20,18,0,-2,3,2,4,0,7,11:9 - 8:11 - 9:11 - 7:11 - 0:0
15194032,2023-11-15 11:45:00,Diaryan Aleksandr - Rafayelyan Edgar,1:3,8:11 - 7:11 - 11:8 - 7:11 - 0:0,1,3,Diaryan Aleksandr,Rafayelyan Edgar,fiurst,Diaryan Aleksandr - Rafayelyan Edgar,74,33,41,8,-8,19,18,19,18,0,3,4,-3,4,0,8,8:11 - 7:11 - 11:8 - 7:11 - 0:0
15194029,2023-11-15 11:30:00,Papyan Karen - Nikoghosyan Narek,2:3,11:7 - 3:11 - 9:11 - 11:9 - 13:11,3,2,Papyan Karen,Nikoghosyan Narek,fiurst,Nikoghosyan Narek - Papyan Karen,96,49,47,-2,2,18,14,20,20,24,4,-8,-2,2,2,-2,7:11 - 11:3 - 11:9 - 9:11 - 11:13
15194027,2023-11-15 11:20:00,Mkrtchyan Andranik - Diaryan Aleksandr,3:0,4:11 - 5:11 - 4:11 - 0:0 - 0:0,0,3,Mkrtchyan Andranik,Diaryan Aleksandr,fiurst,Diaryan Aleksandr - Mkrtchyan Andranik,46,33,13,-20,20,15,16,15,0,0,-7,-6,-7,0,0,-20,11:4 - 11:5 - 11:4 - 0:0 - 0:0
15194015,2023-11-15 11:00:00,Rafayelyan Edgar - Papyan Karen,1:3,11:5 - 10:12 - 12:10 - 13:11 - 0:0,3,1,Rafayelyan Edgar,Papyan Karen,fiurst,Papyan Karen - Rafayelyan Edgar,84,38,46,8,-8,16,22,22,24,0,6,-2,2,2,0,8,5:11 - 12:10 - 10:12 - 11:13 - 0:0
15194014,2023-11-15 10:45:00,Nikoghosyan Narek - Diaryan Aleksandr,1:3,7:11 - 12:10 - 11:7 - 11:5 - 0:0,3,1,Nikoghosyan Narek,Diaryan Aleksandr,fiurst,Diaryan Aleksandr - Nikoghosyan Narek,74,33,41,8,-8,18,22,18,16,0,-4,2,4,6,0,8,11:7 - 10:12 - 7:11 - 5:11 - 0:0
15194012,2023-11-15 10:30:00,Mkrtchyan Andranik - Rafayelyan Edgar,0:3,10:12 - 6:11 - 7:11 - 0:0 - 0:0,0,3,Mkrtchyan Andranik,Rafayelyan Edgar,fiurst,Mkrtchyan Andranik - Rafayelyan Edgar,57,23,34,11,-11,22,17,18,0,0,2,5,4,0,0,11,10:12 - 6:11 - 7:11 - 0:0 - 0:0
15194010,2023-11-15 10:15:00,Diaryan Aleksandr - Papyan Karen,3:1,11:8 - 5:11 - 11:9 - 11:2 - 0:0,3,1,Diaryan Aleksandr,Papyan Karen,fiurst,Diaryan Aleksandr - Papyan Karen,68,38,30,-8,8,19,16,20,13,0,-3,6,-2,-9,0,-8,11:8 - 5:11 - 11:9 - 11:2 - 0:0
15194009,2023-11-15 10:00:00,Nikoghosyan Narek - Mkrtchyan Andranik,1:3,11:3 - 8:11 - 15:13 - 11:4 - 0:0,3,1,Nikoghosyan Narek,Mkrtchyan Andranik,fiurst,Mkrtchyan Andranik - Nikoghosyan Narek,76,31,45,14,-14,14,19,28,15,0,8,-3,2,7,0,14,3:11 - 11:8 - 13:15 - 4:11 - 0:0
15176828,2023-11-14 17:45:00,Gevorgyan Gegham - Darbinyan Armen,0:3,11:5 - 11:5 - 11:8 - 0:0 - 0:0,3,0,Gevorgyan Gegham,Darbinyan Armen,fiurst,Darbinyan Armen - Gevorgyan Gegham,51,18,33,15,-15,16,16,19,0,0,6,6,3,0,0,15,5:11 - 5:11 - 8:11 - 0:0 - 0:0
15176824,2023-11-14 17:30:00,Grigoryan Erik - Avakimyan Davit,3:1,9:11 - 11:8 - 4:11 - 5:11 - 0:0,1,3,Grigoryan Erik,Avakimyan Davit,fiurst,Avakimyan Davit - Grigoryan Erik,70,41,29,-12,12,20,19,15,16,0,-2,3,-7,-6,0,-12,11:9 - 8:11 - 11:4 - 11:5 - 0:0
15176823,2023-11-14 17:00:00,Darbinyan Armen - Avakimyan Davit,3:2,6:11 - 9:11 - 11:9 - 14:12 - 10:12,2,3,Darbinyan Armen,Avakimyan Davit,fiurst,Avakimyan Davit - Darbinyan Armen,105,55,50,-5,5,17,20,20,26,22,-5,-2,2,2,-2,-5,11:6 - 11:9 - 9:11 - 12:14 - 12:10
15176822,2023-11-14 16:55:00,Gevorgyan Gegham - Grigoryan Erik,3:1,16:14 - 11:8 - 4:11 - 11:7 - 0:0,3,1,Gevorgyan Gegham,Grigoryan Erik,fiurst,Gevorgyan Gegham - Grigoryan Erik,82,42,40,-2,2,30,19,15,18,0,-2,-3,7,-4,0,-2,16:14 - 11:8 - 4:11 - 11:7 - 0:0
15176820,2023-11-14 16:45:00,Diaryan Aleksandr - Arutyunov Ruben,1:3,11:6 - 11:6 - 8:11 - 11:5 - 0:0,3,1,Diaryan Aleksandr,Arutyunov Ruben,fiurst,Arutyunov Ruben - Diaryan Aleksandr,69,28,41,13,-13,17,17,19,16,0,5,5,-3,6,0,13,6:11 - 6:11 - 11:8 - 5:11 - 0:0
15176807,2023-11-14 16:15:00,Grigoryan Erik - Darbinyan Armen,3:2,11:4 - 9:11 - 11:7 - 11:13 - 15:17,2,3,Grigoryan Erik,Darbinyan Armen,fiurst,Darbinyan Armen - Grigoryan Erik,109,52,57,5,-5,15,20,18,24,32,7,-2,4,-2,-2,5,4:11 - 11:9 - 7:11 - 13:11 - 17:15
15176808,2023-11-14 16:15:00,Gevorgyan Gegham - Avakimyan Davit,2:3,11:8 - 4:11 - 13:11 - 5:11 - 11:6,3,2,Gevorgyan Gegham,Avakimyan Davit,fiurst,Avakimyan Davit - Gevorgyan Gegham,91,47,44,-3,3,19,15,24,16,17,3,-7,2,-6,5,-3,8:11 - 11:4 - 11:13 - 11:5 - 6:11
15176802,2023-11-14 15:55:00,Darbinyan Armen - Gevorgyan Gegham,1:3,11:9 - 11:13 - 5:11 - 7:11 - 0:0,1,3,Darbinyan Armen,Gevorgyan Gegham,fiurst,Darbinyan Armen - Gevorgyan Gegham,78,34,44,10,-10,20,24,16,18,0,-2,2,6,4,0,10,11:9 - 11:13 - 5:11 - 7:11 - 0:0
15176805,2023-11-14 15:45:00,Mkrtchyan Andranik - Nikoghosyan Narek,0:3,6:11 - 5:11 - 8:11 - 0:0 - 0:0,0,3,Mkrtchyan Andranik,Nikoghosyan Narek,fiurst,Mkrtchyan Andranik - Nikoghosyan Narek,52,19,33,14,-14,17,16,19,0,0,5,6,3,0,0,14,6:11 - 5:11 - 8:11 - 0:0 - 0:0
15176798,2023-11-14 15:15:00,Avakimyan Davit - Grigoryan Erik,3:2,18:20 - 8:11 - 15:13 - 11:5 - 11:3,3,2,Avakimyan Davit,Grigoryan Erik,fiurst,Avakimyan Davit - Grigoryan Erik,115,63,52,-11,11,38,19,28,16,14,2,3,-2,-6,-8,-11,18:20 - 8:11 - 15:13 - 11:5 - 11:3
15176126,2023-11-14 15:05:00,Nikoghosyan Narek - Arutyunov Ruben,0:3,11:5 - 11:4 - 11:8 - 0:0 - 0:0,3,0,Nikoghosyan Narek,Arutyunov Ruben,fiurst,Arutyunov Ruben - Nikoghosyan Narek,50,17,33,16,-16,16,15,19,0,0,6,7,3,0,0,16,5:11 - 4:11 - 8:11 - 0:0 - 0:0
15176125,2023-11-14 14:50:00,Mkrtchyan Andranik - Diaryan Aleksandr,3:0,8:11 - 9:11 - 6:11 - 0:0 - 0:0,0,3,Mkrtchyan Andranik,Diaryan Aleksandr,fiurst,Diaryan Aleksandr - Mkrtchyan Andranik,56,33,23,-10,10,19,20,17,0,0,-3,-2,-5,0,0,-10,11:8 - 11:9 - 11:6 - 0:0 - 0:0
15176124,2023-11-14 14:35:00,Nazaryan Mushegh - Nikoghosyan Narek,1:3,11:5 - 5:11 - 7:11 - 5:11 - 0:0,1,3,Nazaryan Mushegh,Nikoghosyan Narek,fiurst,Nazaryan Mushegh - Nikoghosyan Narek,66,28,38,10,-10,16,16,18,16,0,-6,6,4,6,0,10,11:5 - 5:11 - 7:11 - 5:11 - 0:0
15176115,2023-11-14 14:15:00,Arutyunov Ruben - Mkrtchyan Andranik,3:2,11:9 - 11:6 - 9:11 - 3:11 - 11:6,3,2,Arutyunov Ruben,Mkrtchyan Andranik,fiurst,Arutyunov Ruben - Mkrtchyan Andranik,88,45,43,-2,2,20,17,20,14,17,-2,-5,2,8,-5,-2,11:9 - 11:6 - 9:11 - 3:11 - 11:6
15176103,2023-11-14 14:05:00,Nazaryan Mushegh - Diaryan Aleksandr,2:3,13:11 - 3:11 - 11:7 - 5:11 - 11:5,3,2,Nazaryan Mushegh,Diaryan Aleksandr,fiurst,Diaryan Aleksandr - Nazaryan Mushegh,88,45,43,-2,2,24,14,18,16,16,2,-8,4,-6,6,-2,11:13 - 11:3 - 7:11 - 11:5 - 5:11
15176102,2023-11-14 13:55:00,Nikoghosyan Narek - Mkrtchyan Andranik,0:3,11:6 - 11:5 - 11:6 - 0:0 - 0:0,3,0,Nikoghosyan Narek,Mkrtchyan Andranik,fiurst,Mkrtchyan Andranik - Nikoghosyan Narek,50,17,33,16,-16,17,16,17,0,0,5,6,5,0,0,16,6:11 - 5:11 - 6:11 - 0:0 - 0:0
15176097,2023-11-14 13:30:00,Arutyunov Ruben - Nazaryan Mushegh,2:3,11:7 - 9:11 - 4:11 - 12:10 - 8:11,2,3,Arutyunov Ruben,Nazaryan Mushegh,fiurst,Arutyunov Ruben - Nazaryan Mushegh,94,44,50,6,-6,18,20,15,22,19,-4,2,7,-2,3,6,11:7 - 9:11 - 4:11 - 12:10 - 8:11
15176096,2023-11-14 13:20:00,Diaryan Aleksandr - Nikoghosyan Narek,3:2,4:11 - 12:10 - 11:9 - 9:11 - 11:5,3,2,Diaryan Aleksandr,Nikoghosyan Narek,fiurst,Diaryan Aleksandr - Nikoghosyan Narek,93,47,46,-1,1,15,22,20,20,16,7,-2,-2,2,-6,-1,4:11 - 12:10 - 11:9 - 9:11 - 11:5
15176078,2023-11-14 13:00:00,Mkrtchyan Andranik - Nazaryan Mushegh,0:3,7:11 - 6:11 - 3:11 - 0:0 - 0:0,0,3,Mkrtchyan Andranik,Nazaryan Mushegh,fiurst,Mkrtchyan Andranik - Nazaryan Mushegh,49,16,33,17,-17,18,17,14,0,0,4,5,8,0,0,17,7:11 - 6:11 - 3:11 - 0:0 - 0:0
15176074,2023-11-14 12:45:00,Diaryan Aleksandr - Arutyunov Ruben,2:3,11:6 - 12:10 - 8:11 - 6:11 - 16:14,3,2,Diaryan Aleksandr,Arutyunov Ruben,fiurst,Arutyunov Ruben - Diaryan Aleksandr,105,52,53,1,-1,17,22,19,17,30,5,2,-3,-5,2,1,6:11 - 10:12 - 11:8 - 11:6 - 14:16
15176071,2023-11-14 12:15:00,Nikoghosyan Narek - Nazaryan Mushegh,1:3,11:5 - 11:4 - 8:11 - 11:7 - 0:0,3,1,Nikoghosyan Narek,Nazaryan Mushegh,fiurst,Nazaryan Mushegh - Nikoghosyan Narek,68,27,41,14,-14,16,15,19,18,0,6,7,-3,4,0,14,5:11 - 4:11 - 11:8 - 7:11 - 0:0
15176070,2023-11-14 12:00:00,Diaryan Aleksandr - Mkrtchyan Andranik,3:0,11:3 - 11:5 - 11:8 - 0:0 - 0:0,3,0,Diaryan Aleksandr,Mkrtchyan Andranik,fiurst,Diaryan Aleksandr - Mkrtchyan Andranik,49,33,16,-17,17,14,16,19,0,0,-8,-6,-3,0,0,-17,11:3 - 11:5 - 11:8 - 0:0 - 0:0
15176066,2023-11-14 11:45:00,Arutyunov Ruben - Nikoghosyan Narek,3:0,11:9 - 11:9 - 11:3 - 0:0 - 0:0,3,0,Arutyunov Ruben,Nikoghosyan Narek,fiurst,Arutyunov Ruben - Nikoghosyan Narek,54,33,21,-12,12,20,20,14,0,0,-2,-2,-8,0,0,-12,11:9 - 11:9 - 11:3 - 0:0 - 0:0
15176065,2023-11-14 11:30:00,Diaryan Aleksandr - Nazaryan Mushegh,3:1,5:11 - 11:8 - 11:5 - 11:8 - 0:0,3,1,Diaryan Aleksandr,Nazaryan Mushegh,fiurst,Diaryan Aleksandr - Nazaryan Mushegh,70,38,32,-6,6,16,19,16,19,0,6,-3,-6,-3,0,-6,5:11 - 11:8 - 11:5 - 11:8 - 0:0
15176064,2023-11-14 11:20:00,Mkrtchyan Andranik - Arutyunov Ruben,3:0,10:12 - 9:11 - 8:11 - 0:0 - 0:0,0,3,Mkrtchyan Andranik,Arutyunov Ruben,fiurst,Arutyunov Ruben - Mkrtchyan Andranik,61,34,27,-7,7,22,20,19,0,0,-2,-2,-3,0,0,-7,12:10 - 11:9 - 11:8 - 0:0 - 0:0
15176063,2023-11-14 11:05:00,Nikoghosyan Narek - Diaryan Aleksandr,3:0,7:11 - 7:11 - 9:11 - 0:0 - 0:0,0,3,Nikoghosyan Narek,Diaryan Aleksandr,fiurst,Diaryan Aleksandr - Nikoghosyan Narek,56,33,23,-10,10,18,18,20,0,0,-4,-4,-2,0,0,-10,11:7 - 11:7 - 11:9 - 0:0 - 0:0
15176056,2023-11-14 10:45:00,Nazaryan Mushegh - Arutyunov Ruben,1:3,9:11 - 11:6 - 11:6 - 11:9 - 0:0,3,1,Nazaryan Mushegh,Arutyunov Ruben,fiurst,Arutyunov Ruben - Nazaryan Mushegh,74,32,42,10,-10,20,17,17,20,0,-2,5,5,2,0,10,11:9 - 6:11 - 6:11 - 9:11 - 0:0
15176048,2023-11-14 10:35:00,Mkrtchyan Andranik - Nikoghosyan Narek,1:3,6:11 - 11:8 - 6:11 - 9:11 - 0:0,1,3,Mkrtchyan Andranik,Nikoghosyan Narek,fiurst,Mkrtchyan Andranik - Nikoghosyan Narek,73,32,41,9,-9,17,19,17,20,0,5,-3,5,2,0,9,6:11 - 11:8 - 6:11 - 9:11 - 0:0
15176042,2023-11-14 10:15:00,Arutyunov Ruben - Diaryan Aleksandr,0:3,9:11 - 5:11 - 8:11 - 0:0 - 0:0,0,3,Arutyunov Ruben,Diaryan Aleksandr,fiurst,Arutyunov Ruben - Diaryan Aleksandr,55,22,33,11,-11,20,16,19,0,0,2,6,3,0,0,11,9:11 - 5:11 - 8:11 - 0:0 - 0:0
15176038,2023-11-14 10:00:00,Nazaryan Mushegh - Mkrtchyan Andranik,2:3,9:11 - 11:6 - 11:7 - 5:11 - 11:6,3,2,Nazaryan Mushegh,Mkrtchyan Andranik,fiurst,Mkrtchyan Andranik - Nazaryan Mushegh,88,41,47,6,-6,20,17,18,16,17,-2,5,4,-6,5,6,11:9 - 6:11 - 7:11 - 11:5 - 6:11
15156695,2023-11-13 17:45:00,Gevorgyan Gegham - Avakimyan Davit,3:1,4:11 - 10:12 - 11:9 - 10:12 - 0:0,1,3,Gevorgyan Gegham,Avakimyan Davit,fiurst,Avakimyan Davit - Gevorgyan Gegham,79,44,35,-9,9,15,22,20,22,0,-7,-2,2,-2,0,-9,11:4 - 12:10 - 9:11 - 12:10 - 0:0
15156693,2023-11-13 17:35:00,Grigoryan Erik - Petrosyan Davit,3:2,14:12 - 8:11 - 7:11 - 11:7 - 11:9,3,2,Grigoryan Erik,Petrosyan Davit,fiurst,Grigoryan Erik - Petrosyan Davit,101,51,50,-1,1,26,19,18,18,20,-2,3,4,-4,-2,-1,14:12 - 8:11 - 7:11 - 11:7 - 11:9
15156692,2023-11-13 17:00:00,Avakimyan Davit - Petrosyan Davit,3:0,11:6 - 11:7 - 11:8 - 0:0 - 0:0,3,0,Avakimyan Davit,Petrosyan Davit,fiurst,Avakimyan Davit - Petrosyan Davit,54,33,21,-12,12,17,18,19,0,0,-5,-4,-3,0,0,-12,11:6 - 11:7 - 11:8 - 0:0 - 0:0
15156688,2023-11-13 16:55:00,Gevorgyan Gegham - Grigoryan Erik,3:1,11:9 - 9:11 - 11:6 - 11:9 - 0:0,3,1,Gevorgyan Gegham,Grigoryan Erik,fiurst,Gevorgyan Gegham - Grigoryan Erik,77,42,35,-7,7,20,20,17,20,0,-2,2,-5,-2,0,-7,11:9 - 9:11 - 11:6 - 11:9 - 0:0
15156676,2023-11-13 16:30:00,Rafayelyan Edgar - Papyan Karen,3:2,8:11 - 11:6 - 11:6 - 7:11 - 7:11,2,3,Rafayelyan Edgar,Papyan Karen,fiurst,Papyan Karen - Rafayelyan Edgar,89,45,44,-1,1,19,17,17,18,18,-3,5,5,-4,-4,-1,11:8 - 6:11 - 6:11 - 11:7 - 11:7
15156641,2023-11-13 16:15:00,Gevorgyan Gegham - Petrosyan Davit,2:3,11:7 - 11:6 - 9:11 - 8:11 - 6:11,2,3,Gevorgyan Gegham,Petrosyan Davit,fiurst,Gevorgyan Gegham - Petrosyan Davit,91,45,46,1,-1,18,17,20,19,17,-4,-5,2,3,5,1,11:7 - 11:6 - 9:11 - 8:11 - 6:11
15156632,2023-11-13 16:05:00,Grigoryan Erik - Avakimyan Davit,3:0,6:11 - 7:11 - 8:11 - 0:0 - 0:0,0,3,Grigoryan Erik,Avakimyan Davit,fiurst,Avakimyan Davit - Grigoryan Erik,54,33,21,-12,12,17,18,19,0,0,-5,-4,-3,0,0,-12,11:6 - 11:7 - 11:8 - 0:0 - 0:0
15156626,2023-11-13 15:45:00,Diaryan Aleksandr - Nazaryan Mushegh,3:0,11:5 - 11:6 - 11:8 - 0:0 - 0:0,3,0,Diaryan Aleksandr,Nazaryan Mushegh,fiurst,Diaryan Aleksandr - Nazaryan Mushegh,52,33,19,-14,14,16,17,19,0,0,-6,-5,-3,0,0,-14,11:5 - 11:6 - 11:8 - 0:0 - 0:0
15156623,2023-11-13 15:30:00,Avakimyan Davit - Gevorgyan Gegham,1:3,6:11 - 11:6 - 8:11 - 5:11 - 0:0,1,3,Avakimyan Davit,Gevorgyan Gegham,fiurst,Avakimyan Davit - Gevorgyan Gegham,69,30,39,9,-9,17,17,19,16,0,5,-5,3,6,0,9,6:11 - 11:6 - 8:11 - 5:11 - 0:0
15156610,2023-11-13 15:15:00,Petrosyan Davit - Grigoryan Erik,2:3,11:4 - 7:11 - 8:11 - 11:5 - 14:12,3,2,Petrosyan Davit,Grigoryan Erik,fiurst,Grigoryan Erik - Petrosyan Davit,94,43,51,8,-8,15,18,19,16,26,7,-4,-3,6,2,8,4:11 - 11:7 - 11:8 - 5:11 - 12:14
15156600,2023-11-13 15:00:00,Nazaryan Mushegh - Rafayelyan Edgar,0:3,6:11 - 3:11 - 5:11 - 0:0 - 0:0,0,3,Nazaryan Mushegh,Rafayelyan Edgar,fiurst,Nazaryan Mushegh - Rafayelyan Edgar,47,14,33,19,-19,17,14,16,0,0,5,8,6,0,0,19,6:11 - 3:11 - 5:11 - 0:0 - 0:0
15156598,2023-11-13 14:50:00,Diaryan Aleksandr - Papyan Karen,3:0,11:3 - 11:7 - 12:10 - 0:0 - 0:0,3,0,Diaryan Aleksandr,Papyan Karen,fiurst,Diaryan Aleksandr - Papyan Karen,54,34,20,-14,14,14,18,22,0,0,-8,-4,-2,0,0,-14,11:3 - 11:7 - 12:10 - 0:0 - 0:0
15156597,2023-11-13 14:30:00,Mkrtchyan Andranik - Nazaryan Mushegh,1:3,11:7 - 3:11 - 9:11 - 5:11 - 0:0,1,3,Mkrtchyan Andranik,Nazaryan Mushegh,fiurst,Mkrtchyan Andranik - Nazaryan Mushegh,68,28,40,12,-12,18,14,20,16,0,-4,8,2,6,0,12,11:7 - 3:11 - 9:11 - 5:11 - 0:0
15156596,2023-11-13 14:15:00,Rafayelyan Edgar - Diaryan Aleksandr,2:3,4:11 - 11:6 - 2:11 - 11:8 - 11:8,3,2,Rafayelyan Edgar,Diaryan Aleksandr,fiurst,Diaryan Aleksandr - Rafayelyan Edgar,83,44,39,-5,5,15,17,13,19,19,-7,5,-9,3,3,-5,11:4 - 6:11 - 11:2 - 8:11 - 8:11
15156584,2023-11-13 14:00:00,Mkrtchyan Andranik - Papyan Karen,2:3,7:11 - 11:7 - 4:11 - 11:3 - 8:11,2,3,Mkrtchyan Andranik,Papyan Karen,fiurst,Mkrtchyan Andranik - Papyan Karen,84,41,43,2,-2,18,18,15,14,19,4,-4,7,-8,3,2,7:11 - 11:7 - 4:11 - 11:3 - 8:11
15156581,2023-11-13 13:55:00,Nazaryan Mushegh - Diaryan Aleksandr,3:1,7:11 - 11:9 - 4:11 - 5:11 - 0:0,1,3,Nazaryan Mushegh,Diaryan Aleksandr,fiurst,Diaryan Aleksandr - Nazaryan Mushegh,69,42,27,-15,15,18,20,15,16,0,-4,2,-7,-6,0,-15,11:7 - 9:11 - 11:4 - 11:5 - 0:0
15156580,2023-11-13 13:30:00,Rafayelyan Edgar - Mkrtchyan Andranik,0:3,11:9 - 11:9 - 11:7 - 0:0 - 0:0,3,0,Rafayelyan Edgar,Mkrtchyan Andranik,fiurst,Mkrtchyan Andranik - Rafayelyan Edgar,58,25,33,8,-8,20,20,18,0,0,2,2,4,0,0,8,9:11 - 9:11 - 7:11 - 0:0 - 0:0
15156577,2023-11-13 13:15:00,Papyan Karen - Nazaryan Mushegh,2:3,5:11 - 4:11 - 11:9 - 11:9 - 11:7,3,2,Papyan Karen,Nazaryan Mushegh,fiurst,Nazaryan Mushegh - Papyan Karen,89,47,42,-5,5,16,15,20,20,18,-6,-7,2,2,4,-5,11:5 - 11:4 - 9:11 - 9:11 - 7:11
15156574,2023-11-13 12:55:00,Diaryan Aleksandr - Mkrtchyan Andranik,3:0,11:5 - 11:9 - 11:5 - 0:0 - 0:0,3,0,Diaryan Aleksandr,Mkrtchyan Andranik,fiurst,Diaryan Aleksandr - Mkrtchyan Andranik,52,33,19,-14,14,16,20,16,0,0,-6,-2,-6,0,0,-14,11:5 - 11:9 - 11:5 - 0:0 - 0:0
15156573,2023-11-13 12:45:00,Papyan Karen - Rafayelyan Edgar,3:2,5:11 - 11:8 - 11:3 - 7:11 - 12:10,3,2,Papyan Karen,Rafayelyan Edgar,fiurst,Papyan Karen - Rafayelyan Edgar,89,46,43,-3,3,16,19,14,18,22,6,-3,-8,4,-2,-3,5:11 - 11:8 - 11:3 - 7:11 - 12:10
15156570,2023-11-13 12:15:00,Nazaryan Mushegh - Mkrtchyan Andranik,3:0,13:15 - 12:14 - 7:11 - 0:0 - 0:0,0,3,Nazaryan Mushegh,Mkrtchyan Andranik,fiurst,Mkrtchyan Andranik - Nazaryan Mushegh,72,40,32,-8,8,28,26,18,0,0,-2,-2,-4,0,0,-8,15:13 - 14:12 - 11:7 - 0:0 - 0:0
15156553,2023-11-13 12:00:00,Papyan Karen - Diaryan Aleksandr,2:3,5:11 - 11:5 - 9:11 - 12:10 - 12:10,3,2,Papyan Karen,Diaryan Aleksandr,fiurst,Diaryan Aleksandr - Papyan Karen,96,47,49,2,-2,16,16,20,22,22,-6,6,-2,2,2,2,11:5 - 5:11 - 11:9 - 10:12 - 10:12
15156549,2023-11-13 11:45:00,Rafayelyan Edgar - Nazaryan Mushegh,1:3,11:5 - 6:11 - 11:3 - 11:4 - 0:0,3,1,Rafayelyan Edgar,Nazaryan Mushegh,fiurst,Nazaryan Mushegh - Rafayelyan Edgar,62,23,39,16,-16,16,17,14,15,0,6,-5,8,7,0,16,5:11 - 11:6 - 3:11 - 4:11 - 0:0
15156543,2023-11-13 11:30:00,Papyan Karen - Mkrtchyan Andranik,2:3,12:10 - 9:11 - 4:11 - 14:12 - 11:9,3,2,Papyan Karen,Mkrtchyan Andranik,fiurst,Mkrtchyan Andranik - Papyan Karen,103,53,50,-3,3,22,20,15,26,20,2,-2,-7,2,2,-3,10:12 - 11:9 - 11:4 - 12:14 - 9:11
15156542,2023-11-13 11:15:00,Diaryan Aleksandr - Rafayelyan Edgar,3:0,11:4 - 11:9 - 11:9 - 0:0 - 0:0,3,0,Diaryan Aleksandr,Rafayelyan Edgar,fiurst,Diaryan Aleksandr - Rafayelyan Edgar,55,33,22,-11,11,15,20,20,0,0,-7,-2,-2,0,0,-11,11:4 - 11:9 - 11:9 - 0:0 - 0:0
15156541,2023-11-13 11:00:00,Nazaryan Mushegh - Papyan Karen,3:1,6:11 - 11:8 - 11:3 - 11:4 - 0:0,3,1,Nazaryan Mushegh,Papyan Karen,fiurst,Nazaryan Mushegh - Papyan Karen,65,39,26,-13,13,17,19,14,15,0,5,-3,-8,-7,0,-13,6:11 - 11:8 - 11:3 - 11:4 - 0:0
15156540,2023-11-13 10:45:00,Mkrtchyan Andranik - Rafayelyan Edgar,1:3,11:7 - 5:11 - 5:11 - 8:11 - 0:0,1,3,Mkrtchyan Andranik,Rafayelyan Edgar,fiurst,Mkrtchyan Andranik - Rafayelyan Edgar,69,29,40,11,-11,18,16,16,19,0,-4,6,6,3,0,11,11:7 - 5:11 - 5:11 - 8:11 - 0:0
15156527,2023-11-13 10:30:00,Diaryan Aleksandr - Nazaryan Mushegh,3:0,11:6 - 11:7 - 11:1 - 0:0 - 0:0,3,0,Diaryan Aleksandr,Nazaryan Mushegh,fiurst,Diaryan Aleksandr - Nazaryan Mushegh,47,33,14,-19,19,17,18,12,0,0,-5,-4,-10,0,0,-19,11:6 - 11:7 - 11:1 - 0:0 - 0:0
15156526,2023-11-13 10:15:00,Rafayelyan Edgar - Papyan Karen,0:3,13:11 - 11:7 - 11:4 - 0:0 - 0:0,3,0,Rafayelyan Edgar,Papyan Karen,fiurst,Papyan Karen - Rafayelyan Edgar,57,22,35,13,-13,24,18,15,0,0,2,4,7,0,0,13,11:13 - 7:11 - 4:11 - 0:0 - 0:0
15156524,2023-11-13 10:05:00,Mkrtchyan Andranik - Diaryan Aleksandr,3:0,6:11 - 5:11 - 6:11 - 0:0 - 0:0,0,3,Mkrtchyan Andranik,Diaryan Aleksandr,fiurst,Diaryan Aleksandr - Mkrtchyan Andranik,50,33,17,-16,16,17,16,17,0,0,-5,-6,-5,0,0,-16,11:6 - 11:5 - 11:6 - 0:0 - 0:0
15138161,2023-11-12 17:30:00,Gevorgyan Gegham - Darbinyan Armen,0:3,11:5 - 11:7 - 11:7 - 0:0 - 0:0,3,0,Gevorgyan Gegham,Darbinyan Armen,fiurst,Darbinyan Armen - Gevorgyan Gegham,52,19,33,14,-14,16,18,18,0,0,6,4,4,0,0,14,5:11 - 7:11 - 7:11 - 0:0 - 0:0
15138159,2023-11-12 17:15:00,Grigoryan Erik - Petrosyan Davit,0:3,8:11 - 4:11 - 5:11 - 0:0 - 0:0,0,3,Grigoryan Erik,Petrosyan Davit,fiurst,Grigoryan Erik - Petrosyan Davit,50,17,33,16,-16,19,15,16,0,0,3,7,6,0,0,16,8:11 - 4:11 - 5:11 - 0:0 - 0:0
15138154,2023-11-12 17:00:00,Avakimyan Davit - Gevorgyan Gegham,3:1,11:6 - 11:6 - 11:13 - 11:8 - 0:0,3,1,Avakimyan Davit,Gevorgyan Gegham,fiurst,Avakimyan Davit - Gevorgyan Gegham,77,44,33,-11,11,17,17,24,19,0,-5,-5,2,-3,0,-11,11:6 - 11:6 - 11:13 - 11:8 - 0:0
15138151,2023-11-12 16:45:00,Grigoryan Erik - Darbinyan Armen,1:3,9:11 - 13:11 - 11:4 - 11:7 - 0:0,3,1,Grigoryan Erik,Darbinyan Armen,fiurst,Darbinyan Armen - Grigoryan Erik,77,33,44,11,-11,20,24,15,18,0,-2,2,7,4,0,11,11:9 - 11:13 - 4:11 - 7:11 - 0:0
15138149,2023-11-12 16:30:00,Petrosyan Davit - Avakimyan Davit,3:1,11:4 - 4:11 - 8:11 - 3:11 - 0:0,1,3,Petrosyan Davit,Avakimyan Davit,fiurst,Avakimyan Davit - Petrosyan Davit,63,37,26,-11,11,15,15,19,14,0,7,-7,-3,-8,0,-11,4:11 - 11:4 - 11:8 - 11:3 - 0:0
15138142,2023-11-12 16:15:00,Gevorgyan Gegham - Grigoryan Erik,3:0,11:5 - 11:7 - 11:3 - 0:0 - 0:0,3,0,Gevorgyan Gegham,Grigoryan Erik,fiurst,Gevorgyan Gegham - Grigoryan Erik,48,33,15,-18,18,16,18,14,0,0,-6,-4,-8,0,0,-18,11:5 - 11:7 - 11:3 - 0:0 - 0:0
15138135,2023-11-12 16:00:00,Darbinyan Armen - Avakimyan Davit,3:0,8:11 - 4:11 - 9:11 - 0:0 - 0:0,0,3,Darbinyan Armen,Avakimyan Davit,fiurst,Avakimyan Davit - Darbinyan Armen,54,33,21,-12,12,19,15,20,0,0,-3,-7,-2,0,0,-12,11:8 - 11:4 - 11:9 - 0:0 - 0:0
15138133,2023-11-12 15:45:00,Petrosyan Davit - Gevorgyan Gegham,2:3,11:13 - 11:2 - 5:11 - 11:6 - 11:3,3,2,Petrosyan Davit,Gevorgyan Gegham,fiurst,Gevorgyan Gegham - Petrosyan Davit,84,35,49,14,-14,24,13,16,17,14,-2,9,-6,5,8,14,13:11 - 2:11 - 11:5 - 6:11 - 3:11
15138121,2023-11-12 15:30:00,Avakimyan Davit - Grigoryan Erik,2:3,11:6 - 10:12 - 9:11 - 11:9 - 7:11,2,3,Avakimyan Davit,Grigoryan Erik,fiurst,Avakimyan Davit - Grigoryan Erik,97,48,49,1,-1,17,22,20,20,18,-5,2,2,-2,4,1,11:6 - 10:12 - 9:11 - 11:9 - 7:11
15138119,2023-11-12 15:15:00,Darbinyan Armen - Petrosyan Davit,1:3,7:11 - 11:3 - 7:11 - 7:11 - 0:0,1,3,Darbinyan Armen,Petrosyan Davit,fiurst,Darbinyan Armen - Petrosyan Davit,68,32,36,4,-4,18,14,18,18,0,4,-8,4,4,0,4,7:11 - 11:3 - 7:11 - 7:11 - 0:0
15138116,2023-11-12 15:00:00,Arutyunov Ruben - Papyan Karen,0:3,6:11 - 10:12 - 9:11 - 0:0 - 0:0,0,3,Arutyunov Ruben,Papyan Karen,fiurst,Arutyunov Ruben - Papyan Karen,59,25,34,9,-9,17,22,20,0,0,5,2,2,0,0,9,6:11 - 10:12 - 9:11 - 0:0 - 0:0
15138114,2023-11-12 14:50:00,Nazaryan Mushegh - Rafayelyan Edgar,1:3,8:11 - 8:11 - 11:6 - 5:11 - 0:0,1,3,Nazaryan Mushegh,Rafayelyan Edgar,fiurst,Nazaryan Mushegh - Rafayelyan Edgar,71,32,39,7,-7,19,19,17,16,0,3,3,-5,6,0,7,8:11 - 8:11 - 11:6 - 5:11 - 0:0
15138103,2023-11-12 14:45:00,Nikoghosyan Narek - Arutyunov Ruben,0:3,11:9 - 14:12 - 11:3 - 0:0 - 0:0,3,0,Nikoghosyan Narek,Arutyunov Ruben,fiurst,Arutyunov Ruben - Nikoghosyan Narek,60,24,36,12,-12,20,26,14,0,0,2,2,8,0,0,12,9:11 - 12:14 - 3:11 - 0:0 - 0:0
15138102,2023-11-12 14:20:00,Papyan Karen - Nazaryan Mushegh,3:1,11:13 - 8:11 - 11:4 - 12:14 - 0:0,1,3,Papyan Karen,Nazaryan Mushegh,fiurst,Nazaryan Mushegh - Papyan Karen,84,42,42,0,0,24,19,15,26,0,-2,-3,7,-2,0,0,13:11 - 11:8 - 4:11 - 14:12 - 0:0
15138097,2023-11-12 14:00:00,Arutyunov Ruben - Nazaryan Mushegh,1:3,11:9 - 10:12 - 5:11 - 9:11 - 0:0,1,3,Arutyunov Ruben,Nazaryan Mushegh,fiurst,Arutyunov Ruben - Nazaryan Mushegh,78,35,43,8,-8,20,22,16,20,0,-2,2,6,2,0,8,11:9 - 10:12 - 5:11 - 9:11 - 0:0
15138101,2023-11-12 14:00:00,Nikoghosyan Narek - Rafayelyan Edgar,3:2,11:8 - 10:12 - 11:2 - 7:11 - 11:5,3,2,Nikoghosyan Narek,Rafayelyan Edgar,fiurst,Nikoghosyan Narek - Rafayelyan Edgar,88,50,38,-12,12,19,22,13,18,16,-3,2,-9,4,-6,-12,11:8 - 10:12 - 11:2 - 7:11 - 11:5
15138091,2023-11-12 13:30:00,Rafayelyan Edgar - Arutyunov Ruben,0:3,12:10 - 11:8 - 11:6 - 0:0 - 0:0,3,0,Rafayelyan Edgar,Arutyunov Ruben,fiurst,Arutyunov Ruben - Rafayelyan Edgar,58,24,34,10,-10,22,19,17,0,0,2,3,5,0,0,10,10:12 - 8:11 - 6:11 - 0:0 - 0:0
15138094,2023-11-12 13:30:00,Papyan Karen - Nikoghosyan Narek,3:1,4:11 - 11:8 - 10:12 - 5:11 - 0:0,1,3,Papyan Karen,Nikoghosyan Narek,fiurst,Nikoghosyan Narek - Papyan Karen,72,42,30,-12,12,15,19,22,16,0,-7,3,-2,-6,0,-12,11:4 - 8:11 - 12:10 - 11:5 - 0:0
15138084,2023-11-12 13:10:00,Rafayelyan Edgar - Papyan Karen,1:3,9:11 - 11:8 - 11:3 - 11:4 - 0:0,3,1,Rafayelyan Edgar,Papyan Karen,fiurst,Papyan Karen - Rafayelyan Edgar,68,26,42,16,-16,20,19,14,15,0,-2,3,8,7,0,16,11:9 - 8:11 - 3:11 - 4:11 - 0:0
15138089,2023-11-12 13:10:00,Nazaryan Mushegh - Nikoghosyan Narek,3:1,11:8 - 9:11 - 11:3 - 11:7 - 0:0,3,1,Nazaryan Mushegh,Nikoghosyan Narek,fiurst,Nazaryan Mushegh - Nikoghosyan Narek,71,42,29,-13,13,19,20,14,18,0,-3,2,-8,-4,0,-13,11:8 - 9:11 - 11:3 - 11:7 - 0:0
15138071,2023-11-12 12:40:00,Arutyunov Ruben - Nikoghosyan Narek,2:3,6:11 - 11:8 - 11:7 - 11:13 - 9:11,2,3,Arutyunov Ruben,Nikoghosyan Narek,fiurst,Arutyunov Ruben - Nikoghosyan Narek,98,48,50,2,-2,17,19,18,24,20,5,-3,-4,2,2,2,6:11 - 11:8 - 11:7 - 11:13 - 9:11
15138068,2023-11-12 12:00:00,Rafayelyan Edgar - Nazaryan Mushegh,1:3,11:5 - 11:9 - 9:11 - 11:7 - 0:0,3,1,Rafayelyan Edgar,Nazaryan Mushegh,fiurst,Nazaryan Mushegh - Rafayelyan Edgar,74,32,42,10,-10,16,20,20,18,0,6,2,-2,4,0,10,5:11 - 9:11 - 11:9 - 7:11 - 0:0
15138062,2023-11-12 11:45:00,Rafayelyan Edgar - Nikoghosyan Narek,0:3,11:7 - 11:6 - 11:6 - 0:0 - 0:0,3,0,Rafayelyan Edgar,Nikoghosyan Narek,fiurst,Nikoghosyan Narek - Rafayelyan Edgar,52,19,33,14,-14,18,17,17,0,0,4,5,5,0,0,14,7:11 - 6:11 - 6:11 - 0:0 - 0:0
15138066,2023-11-12 11:45:00,Papyan Karen - Arutyunov Ruben,2:3,11:6 - 17:15 - 5:11 - 18:20 - 11:8,3,2,Papyan Karen,Arutyunov Ruben,fiurst,Arutyunov Ruben - Papyan Karen,122,60,62,2,-2,17,32,16,38,19,5,2,-6,-2,3,2,6:11 - 15:17 - 11:5 - 20:18 - 8:11
15138059,2023-11-12 11:15:00,Nazaryan Mushegh - Papyan Karen,0:3,7:11 - 9:11 - 5:11 - 0:0 - 0:0,0,3,Nazaryan Mushegh,Papyan Karen,fiurst,Nazaryan Mushegh - Papyan Karen,54,21,33,12,-12,18,20,16,0,0,4,2,6,0,0,12,7:11 - 9:11 - 5:11 - 0:0 - 0:0
15138054,2023-11-12 11:10:00,Arutyunov Ruben - Rafayelyan Edgar,2:3,5:11 - 11:5 - 8:11 - 11:6 - 10:12,2,3,Arutyunov Ruben,Rafayelyan Edgar,fiurst,Arutyunov Ruben - Rafayelyan Edgar,90,45,45,0,0,16,16,19,17,22,6,-6,3,-5,2,0,5:11 - 11:5 - 8:11 - 11:6 - 10:12
15138052,2023-11-12 10:45:00,Nikoghosyan Narek - Papyan Karen,0:3,10:12 - 11:13 - 5:11 - 0:0 - 0:0,0,3,Nikoghosyan Narek,Papyan Karen,fiurst,Nikoghosyan Narek - Papyan Karen,62,26,36,10,-10,22,24,16,0,0,2,2,6,0,0,10,10:12 - 11:13 - 5:11 - 0:0 - 0:0
15138033,2023-11-12 10:35:00,Nazaryan Mushegh - Arutyunov Ruben,2:3,11:4 - 8:11 - 9:11 - 11:9 - 11:6,3,2,Nazaryan Mushegh,Arutyunov Ruben,fiurst,Arutyunov Ruben - Nazaryan Mushegh,91,41,50,9,-9,15,19,20,20,17,7,-3,-2,2,5,9,4:11 - 11:8 - 11:9 - 9:11 - 6:11
15137661,2023-11-12 10:15:00,Papyan Karen - Rafayelyan Edgar,1:3,5:11 - 11:9 - 5:11 - 3:11 - 0:0,1,3,Papyan Karen,Rafayelyan Edgar,fiurst,Papyan Karen - Rafayelyan Edgar,66,24,42,18,-18,16,20,16,14,0,6,-2,6,8,0,18,5:11 - 11:9 - 5:11 - 3:11 - 0:0
15137656,2023-11-12 10:00:00,Nikoghosyan Narek - Nazaryan Mushegh,3:2,7:11 - 11:9 - 14:12 - 10:12 - 4:11,2,3,Nikoghosyan Narek,Nazaryan Mushegh,fiurst,Nazaryan Mushegh - Nikoghosyan Narek,101,55,46,-9,9,18,20,26,22,15,-4,2,2,-2,-7,-9,11:7 - 9:11 - 12:14 - 12:10 - 11:4
15118905,2023-11-11 17:45:00,Grigoryan Erik - Avakimyan Davit,3:1,10:12 - 8:11 - 12:10 - 6:11 - 0:0,1,3,Grigoryan Erik,Avakimyan Davit,fiurst,Avakimyan Davit - Grigoryan Erik,80,44,36,-8,8,22,19,22,17,0,-2,-3,2,-5,0,-8,12:10 - 11:8 - 10:12 - 11:6 - 0:0
15118899,2023-11-11 17:30:00,Petrosyan Davit - Darbinyan Armen,1:3,11:5 - 7:11 - 11:7 - 11:5 - 0:0,3,1,Petrosyan Davit,Darbinyan Armen,fiurst,Darbinyan Armen - Petrosyan Davit,68,28,40,12,-12,16,18,18,16,0,6,-4,4,6,0,12,5:11 - 11:7 - 7:11 - 5:11 - 0:0
15118892,2023-11-11 17:00:00,Avakimyan Davit - Darbinyan Armen,2:3,11:9 - 11:13 - 11:5 - 7:11 - 7:11,2,3,Avakimyan Davit,Darbinyan Armen,fiurst,Avakimyan Davit - Darbinyan Armen,96,47,49,2,-2,20,24,16,18,18,-2,2,-6,4,4,2,11:9 - 11:13 - 11:5 - 7:11 - 7:11
15118890,2023-11-11 16:45:00,Grigoryan Erik - Petrosyan Davit,0:3,7:11 - 7:11 - 6:11 - 0:0 - 0:0,0,3,Grigoryan Erik,Petrosyan Davit,fiurst,Grigoryan Erik - Petrosyan Davit,53,20,33,13,-13,18,18,17,0,0,4,4,5,0,0,13,7:11 - 7:11 - 6:11 - 0:0 - 0:0
15118881,2023-11-11 16:30:00,Nazaryan Mushegh - Arutyunov Ruben,3:2,11:8 - 9:11 - 11:5 - 8:11 - 8:11,2,3,Nazaryan Mushegh,Arutyunov Ruben,fiurst,Arutyunov Ruben - Nazaryan Mushegh,93,46,47,1,-1,19,20,16,19,19,3,-2,6,-3,-3,1,8:11 - 11:9 - 5:11 - 11:8 - 11:8
15118876,2023-11-11 16:15:00,Grigoryan Erik - Darbinyan Armen,1:3,10:12 - 11:5 - 12:10 - 11:6 - 0:0,3,1,Grigoryan Erik,Darbinyan Armen,fiurst,Darbinyan Armen - Grigoryan Erik,77,33,44,11,-11,22,16,22,17,0,-2,6,2,5,0,11,12:10 - 5:11 - 10:12 - 6:11 - 0:0
15118872,2023-11-11 16:00:00,Petrosyan Davit - Avakimyan Davit,3:2,7:11 - 8:11 - 11:7 - 11:9 - 7:11,2,3,Petrosyan Davit,Avakimyan Davit,fiurst,Avakimyan Davit - Petrosyan Davit,93,49,44,-5,5,18,19,18,20,18,-4,-3,4,2,-4,-5,11:7 - 11:8 - 7:11 - 9:11 - 11:7
15118868,2023-11-11 15:45:00,Rafayelyan Edgar - Nikoghosyan Narek,3:0,8:11 - 9:11 - 8:11 - 0:0 - 0:0,0,3,Rafayelyan Edgar,Nikoghosyan Narek,fiurst,Nikoghosyan Narek - Rafayelyan Edgar,58,33,25,-8,8,19,20,19,0,0,-3,-2,-3,0,0,-8,11:8 - 11:9 - 11:8 - 0:0 - 0:0
15118866,2023-11-11 15:30:00,Avakimyan Davit - Grigoryan Erik,3:0,11:7 - 11:6 - 11:9 - 0:0 - 0:0,3,0,Avakimyan Davit,Grigoryan Erik,fiurst,Avakimyan Davit - Grigoryan Erik,55,33,22,-11,11,18,17,20,0,0,-4,-5,-2,0,0,-11,11:7 - 11:6 - 11:9 - 0:0 - 0:0
15118865,2023-11-11 15:15:00,Darbinyan Armen - Petrosyan Davit,1:3,16:14 - 7:11 - 5:11 - 7:11 - 0:0,1,3,Darbinyan Armen,Petrosyan Davit,fiurst,Darbinyan Armen - Petrosyan Davit,82,35,47,12,-12,30,18,16,18,0,-2,4,6,4,0,12,16:14 - 7:11 - 5:11 - 7:11 - 0:0
15118852,2023-11-11 15:00:00,Nazaryan Mushegh - Mkrtchyan Andranik,1:3,11:4 - 12:14 - 11:8 - 11:8 - 0:0,3,1,Nazaryan Mushegh,Mkrtchyan Andranik,fiurst,Mkrtchyan Andranik - Nazaryan Mushegh,79,34,45,11,-11,15,26,19,19,0,7,-2,3,3,0,11,4:11 - 14:12 - 8:11 - 8:11 - 0:0
15118849,2023-11-11 14:55:00,Nikoghosyan Narek - Arutyunov Ruben,3:1,12:10 - 6:11 - 8:11 - 2:11 - 0:0,1,3,Nikoghosyan Narek,Arutyunov Ruben,fiurst,Arutyunov Ruben - Nikoghosyan Narek,71,43,28,-15,15,22,17,19,13,0,2,-5,-3,-9,0,-15,10:12 - 11:6 - 11:8 - 11:2 - 0:0
15118842,2023-11-11 14:30:00,Rafayelyan Edgar - Nazaryan Mushegh,1:3,11:8 - 10:12 - 11:3 - 14:12 - 0:0,3,1,Rafayelyan Edgar,Nazaryan Mushegh,fiurst,Nazaryan Mushegh - Rafayelyan Edgar,81,35,46,11,-11,19,22,14,26,0,3,-2,8,2,0,11,8:11 - 12:10 - 3:11 - 12:14 - 0:0
15118839,2023-11-11 14:15:00,Mkrtchyan Andranik - Nikoghosyan Narek,1:3,6:11 - 10:12 - 11:4 - 6:11 - 0:0,1,3,Mkrtchyan Andranik,Nikoghosyan Narek,fiurst,Mkrtchyan Andranik - Nikoghosyan Narek,71,33,38,5,-5,17,22,15,17,0,5,2,-7,5,0,5,6:11 - 10:12 - 11:4 - 6:11 - 0:0
15118824,2023-11-11 14:00:00,Rafayelyan Edgar - Arutyunov Ruben,2:3,11:4 - 10:12 - 11:7 - 6:11 - 11:9,3,2,Rafayelyan Edgar,Arutyunov Ruben,fiurst,Arutyunov Ruben - Rafayelyan Edgar,92,43,49,6,-6,15,22,18,17,20,7,-2,4,-5,2,6,4:11 - 12:10 - 7:11 - 11:6 - 9:11
15118821,2023-11-11 13:45:00,Nazaryan Mushegh - Nikoghosyan Narek,1:3,11:6 - 15:17 - 7:11 - 8:11 - 0:0,1,3,Nazaryan Mushegh,Nikoghosyan Narek,fiurst,Nazaryan Mushegh - Nikoghosyan Narek,86,41,45,4,-4,17,32,18,19,0,-5,2,4,3,0,4,11:6 - 15:17 - 7:11 - 8:11 - 0:0
15118816,2023-11-11 13:30:00,Mkrtchyan Andranik - Rafayelyan Edgar,0:3,6:11 - 8:11 - 4:11 - 0:0 - 0:0,0,3,Mkrtchyan Andranik,Rafayelyan Edgar,fiurst,Mkrtchyan Andranik - Rafayelyan Edgar,51,18,33,15,-15,17,19,15,0,0,5,3,7,0,0,15,6:11 - 8:11 - 4:11 - 0:0 - 0:0
15118809,2023-11-11 13:15:00,Arutyunov Ruben - Nazaryan Mushegh,3:1,11:5 - 12:14 - 11:8 - 11:9 - 0:0,3,1,Arutyunov Ruben,Nazaryan Mushegh,fiurst,Arutyunov Ruben - Nazaryan Mushegh,81,45,36,-9,9,16,26,19,20,0,-6,2,-3,-2,0,-9,11:5 - 12:14 - 11:8 - 11:9 - 0:0
15118807,2023-11-11 13:00:00,Nikoghosyan Narek - Rafayelyan Edgar,0:3,3:11 - 8:11 - 1:11 - 0:0 - 0:0,0,3,Nikoghosyan Narek,Rafayelyan Edgar,fiurst,Nikoghosyan Narek - Rafayelyan Edgar,45,12,33,21,-21,14,19,12,0,0,8,3,10,0,0,21,3:11 - 8:11 - 1:11 - 0:0 - 0:0
15118804,2023-11-11 12:45:00,Arutyunov Ruben - Mkrtchyan Andranik,3:0,11:7 - 12:10 - 11:7 - 0:0 - 0:0,3,0,Arutyunov Ruben,Mkrtchyan Andranik,fiurst,Arutyunov Ruben - Mkrtchyan Andranik,58,34,24,-10,10,18,22,18,0,0,-4,-2,-4,0,0,-10,11:7 - 12:10 - 11:7 - 0:0 - 0:0
15118791,2023-11-11 12:15:00,Nazaryan Mushegh - Rafayelyan Edgar,3:1,13:11 - 4:11 - 11:8 - 11:5 - 0:0,3,1,Nazaryan Mushegh,Rafayelyan Edgar,fiurst,Nazaryan Mushegh - Rafayelyan Edgar,74,39,35,-4,4,24,15,19,16,0,-2,7,-3,-6,0,-4,13:11 - 4:11 - 11:8 - 11:5 - 0:0
15118790,2023-11-11 12:00:00,Arutyunov Ruben - Nikoghosyan Narek,0:3,7:11 - 3:11 - 4:11 - 0:0 - 0:0,0,3,Arutyunov Ruben,Nikoghosyan Narek,fiurst,Arutyunov Ruben - Nikoghosyan Narek,47,14,33,19,-19,18,14,15,0,0,4,8,7,0,0,19,7:11 - 3:11 - 4:11 - 0:0 - 0:0
15118786,2023-11-11 11:50:00,Mkrtchyan Andranik - Nazaryan Mushegh,3:0,12:10 - 11:8 - 11:5 - 0:0 - 0:0,3,0,Mkrtchyan Andranik,Nazaryan Mushegh,fiurst,Mkrtchyan Andranik - Nazaryan Mushegh,57,34,23,-11,11,22,19,16,0,0,-2,-3,-6,0,0,-11,12:10 - 11:8 - 11:5 - 0:0 - 0:0
15118784,2023-11-11 11:30:00,Arutyunov Ruben - Rafayelyan Edgar,2:3,11:7 - 11:4 - 5:11 - 4:11 - 5:11,2,3,Arutyunov Ruben,Rafayelyan Edgar,fiurst,Arutyunov Ruben - Rafayelyan Edgar,80,36,44,8,-8,18,15,16,15,16,-4,-7,6,7,6,8,11:7 - 11:4 - 5:11 - 4:11 - 5:11
15118776,2023-11-11 11:15:00,Nikoghosyan Narek - Mkrtchyan Andranik,2:3,7:11 - 7:11 - 11:8 - 11:6 - 11:8,3,2,Nikoghosyan Narek,Mkrtchyan Andranik,fiurst,Mkrtchyan Andranik - Nikoghosyan Narek,91,44,47,3,-3,18,18,19,17,19,-4,-4,3,5,3,3,11:7 - 11:7 - 8:11 - 6:11 - 8:11
15118767,2023-11-11 11:05:00,Nazaryan Mushegh - Arutyunov Ruben,3:1,11:4 - 8:11 - 6:11 - 2:11 - 0:0,1,3,Nazaryan Mushegh,Arutyunov Ruben,fiurst,Arutyunov Ruben - Nazaryan Mushegh,64,37,27,-10,10,15,19,17,13,0,7,-3,-5,-9,0,-10,4:11 - 11:8 - 11:6 - 11:2 - 0:0
15118756,2023-11-11 10:45:00,Rafayelyan Edgar - Mkrtchyan Andranik,0:3,11:7 - 11:9 - 11:9 - 0:0 - 0:0,3,0,Rafayelyan Edgar,Mkrtchyan Andranik,fiurst,Mkrtchyan Andranik - Rafayelyan Edgar,58,25,33,8,-8,18,20,20,0,0,4,2,2,0,0,8,7:11 - 9:11 - 9:11 - 0:0 - 0:0
15118749,2023-11-11 10:40:00,Nikoghosyan Narek - Nazaryan Mushegh,1:3,11:5 - 11:8 - 5:11 - 11:7 - 0:0,3,1,Nikoghosyan Narek,Nazaryan Mushegh,fiurst,Nazaryan Mushegh - Nikoghosyan Narek,69,31,38,7,-7,16,19,16,18,0,6,3,-6,4,0,7,5:11 - 8:11 - 11:5 - 7:11 - 0:0
15118747,2023-11-11 10:15:00,Mkrtchyan Andranik - Arutyunov Ruben,0:3,11:6 - 14:12 - 11:7 - 0:0 - 0:0,3,0,Mkrtchyan Andranik,Arutyunov Ruben,fiurst,Arutyunov Ruben - Mkrtchyan Andranik,61,25,36,11,-11,17,26,18,0,0,5,2,4,0,0,11,6:11 - 12:14 - 7:11 - 0:0 - 0:0
15118745,2023-11-11 10:00:00,Rafayelyan Edgar - Nikoghosyan Narek,3:2,11:7 - 6:11 - 7:11 - 13:11 - 8:11,2,3,Rafayelyan Edgar,Nikoghosyan Narek,fiurst,Nikoghosyan Narek - Rafayelyan Edgar,96,51,45,-6,6,18,17,18,24,19,4,-5,-4,2,-3,-6,7:11 - 11:6 - 11:7 - 11:13 - 11:8
15098590,2023-11-10 17:45:00,Avakimyan Davit - Gevorgyan Gegham,3:1,9:11 - 11:7 - 11:8 - 11:8 - 0:0,3,1,Avakimyan Davit,Gevorgyan Gegham,fiurst,Avakimyan Davit - Gevorgyan Gegham,76,42,34,-8,8,20,18,19,19,0,2,-4,-3,-3,0,-8,9:11 - 11:7 - 11:8 - 11:8 - 0:0
15098638,2023-11-10 17:30:00,Darbinyan Armen - Petrosyan Davit,1:3,11:8 - 13:15 - 5:11 - 7:11 - 0:0,1,3,Darbinyan Armen,Petrosyan Davit,fiurst,Darbinyan Armen - Petrosyan Davit,81,36,45,9,-9,19,28,16,18,0,-3,2,6,4,0,9,11:8 - 13:15 - 5:11 - 7:11 - 0:0
15098589,2023-11-10 17:00:00,Gevorgyan Gegham - Darbinyan Armen,0:3,11:6 - 11:7 - 11:3 - 0:0 - 0:0,3,0,Gevorgyan Gegham,Darbinyan Armen,fiurst,Darbinyan Armen - Gevorgyan Gegham,49,16,33,17,-17,17,18,14,0,0,5,4,8,0,0,17,6:11 - 7:11 - 3:11 - 0:0 - 0:0
15098586,2023-11-10 16:45:00,Avakimyan Davit - Petrosyan Davit,3:0,12:10 - 11:7 - 11:8 - 0:0 - 0:0,3,0,Avakimyan Davit,Petrosyan Davit,fiurst,Avakimyan Davit - Petrosyan Davit,59,34,25,-9,9,22,18,19,0,0,-2,-4,-3,0,0,-9,12:10 - 11:7 - 11:8 - 0:0 - 0:0
15098583,2023-11-10 16:30:00,Nazaryan Mushegh - Mkrtchyan Andranik,3:0,7:11 - 6:11 - 8:11 - 0:0 - 0:0,0,3,Nazaryan Mushegh,Mkrtchyan Andranik,fiurst,Mkrtchyan Andranik - Nazaryan Mushegh,54,33,21,-12,12,18,17,19,0,0,-4,-5,-3,0,0,-12,11:7 - 11:6 - 11:8 - 0:0 - 0:0
15098579,2023-11-10 16:15:00,Darbinyan Armen - Avakimyan Davit,3:0,6:11 - 5:11 - 7:11 - 0:0 - 0:0,0,3,Darbinyan Armen,Avakimyan Davit,fiurst,Avakimyan Davit - Darbinyan Armen,51,33,18,-15,15,17,16,18,0,0,-5,-6,-4,0,0,-15,11:6 - 11:5 - 11:7 - 0:0 - 0:0
15098281,2023-11-10 16:00:00,Petrosyan Davit - Gevorgyan Gegham,0:3,11:6 - 11:7 - 11:6 - 0:0 - 0:0,3,0,Petrosyan Davit,Gevorgyan Gegham,fiurst,Gevorgyan Gegham - Petrosyan Davit,52,19,33,14,-14,17,18,17,0,0,5,4,5,0,0,14,6:11 - 7:11 - 6:11 - 0:0 - 0:0
15098273,2023-11-10 15:45:00,Nazaryan Mushegh - Rafayelyan Edgar,0:3,4:11 - 9:11 - 6:11 - 0:0 - 0:0,0,3,Nazaryan Mushegh,Rafayelyan Edgar,fiurst,Nazaryan Mushegh - Rafayelyan Edgar,52,19,33,14,-14,15,20,17,0,0,7,2,5,0,0,14,4:11 - 9:11 - 6:11 - 0:0 - 0:0
15098267,2023-11-10 15:30:00,Gevorgyan Gegham - Avakimyan Davit,3:0,11:13 - 4:11 - 9:11 - 0:0 - 0:0,0,3,Gevorgyan Gegham,Avakimyan Davit,fiurst,Avakimyan Davit - Gevorgyan Gegham,59,35,24,-11,11,24,15,20,0,0,-2,-7,-2,0,0,-11,13:11 - 11:4 - 11:9 - 0:0 - 0:0
15098265,2023-11-10 15:15:00,Mkrtchyan Andranik - Nikoghosyan Narek,1:3,11:9 - 13:15 - 7:11 - 8:11 - 0:0,1,3,Mkrtchyan Andranik,Nikoghosyan Narek,fiurst,Mkrtchyan Andranik - Nikoghosyan Narek,85,39,46,7,-7,20,28,18,19,0,-2,2,4,3,0,7,11:9 - 13:15 - 7:11 - 8:11 - 0:0
15098261,2023-11-10 15:00:00,Nazaryan Mushegh - Diaryan Aleksandr,3:2,4:11 - 11:7 - 11:8 - 5:11 - 5:11,2,3,Nazaryan Mushegh,Diaryan Aleksandr,fiurst,Diaryan Aleksandr - Nazaryan Mushegh,84,48,36,-12,12,15,18,19,16,16,-7,4,3,-6,-6,-12,11:4 - 7:11 - 8:11 - 11:5 - 11:5
15098260,2023-11-10 14:45:00,Nikoghosyan Narek - Rafayelyan Edgar,0:3,2:11 - 9:11 - 4:11 - 0:0 - 0:0,0,3,Nikoghosyan Narek,Rafayelyan Edgar,fiurst,Nikoghosyan Narek - Rafayelyan Edgar,48,15,33,18,-18,13,20,15,0,0,9,2,7,0,0,18,2:11 - 9:11 - 4:11 - 0:0 - 0:0
15098247,2023-11-10 14:35:00,Mkrtchyan Andranik - Nazaryan Mushegh,3:1,11:5 - 10:12 - 11:7 - 21:19 - 0:0,3,1,Mkrtchyan Andranik,Nazaryan Mushegh,fiurst,Mkrtchyan Andranik - Nazaryan Mushegh,96,53,43,-10,10,16,22,18,40,0,-6,2,-4,-2,0,-10,11:5 - 10:12 - 11:7 - 21:19 - 0:0
15098243,2023-11-10 14:15:00,Diaryan Aleksandr - Nikoghosyan Narek,0:0,5:6 - 0:0 - 0:0 - 0:0 - 0:0,0,0,Diaryan Aleksandr,Nikoghosyan Narek,fiurst,Diaryan Aleksandr - Nikoghosyan Narek,11,5,6,1,-1,11,0,0,0,0,1,0,0,0,0,1,5:6 - 0:0 - 0:0 - 0:0 - 0:0
15098240,2023-11-10 14:05:00,Mkrtchyan Andranik - Rafayelyan Edgar,1:3,5:11 - 11:7 - 3:11 - 11:13 - 0:0,1,3,Mkrtchyan Andranik,Rafayelyan Edgar,fiurst,Mkrtchyan Andranik - Rafayelyan Edgar,72,30,42,12,-12,16,18,14,24,0,6,-4,8,2,0,12,5:11 - 11:7 - 3:11 - 11:13 - 0:0
15098233,2023-11-10 13:45:00,Nazaryan Mushegh - Nikoghosyan Narek,1:3,8:11 - 7:11 - 11:3 - 5:11 - 0:0,1,3,Nazaryan Mushegh,Nikoghosyan Narek,fiurst,Nazaryan Mushegh - Nikoghosyan Narek,67,31,36,5,-5,19,18,14,16,0,3,4,-8,6,0,5,8:11 - 7:11 - 11:3 - 5:11 - 0:0
15098228,2023-11-10 13:30:00,Diaryan Aleksandr - Mkrtchyan Andranik,3:0,14:12 - 11:9 - 11:8 - 0:0 - 0:0,3,0,Diaryan Aleksandr,Mkrtchyan Andranik,fiurst,Diaryan Aleksandr - Mkrtchyan Andranik,65,36,29,-7,7,26,20,19,0,0,-2,-2,-3,0,0,-7,14:12 - 11:9 - 11:8 - 0:0 - 0:0
15098198,2023-11-10 13:15:00,Rafayelyan Edgar - Nazaryan Mushegh,1:3,11:6 - 9:11 - 11:8 - 11:8 - 0:0,3,1,Rafayelyan Edgar,Nazaryan Mushegh,fiurst,Nazaryan Mushegh - Rafayelyan Edgar,75,33,42,9,-9,17,20,19,19,0,5,-2,3,3,0,9,6:11 - 11:9 - 8:11 - 8:11 - 0:0
15098167,2023-11-10 13:00:00,Nikoghosyan Narek - Mkrtchyan Andranik,0:3,11:4 - 11:8 - 11:4 - 0:0 - 0:0,3,0,Nikoghosyan Narek,Mkrtchyan Andranik,fiurst,Mkrtchyan Andranik - Nikoghosyan Narek,49,16,33,17,-17,15,19,15,0,0,7,3,7,0,0,17,4:11 - 8:11 - 4:11 - 0:0 - 0:0
15098148,2023-11-10 12:45:00,Rafayelyan Edgar - Diaryan Aleksandr,1:3,11:7 - 6:11 - 11:6 - 11:6 - 0:0,3,1,Rafayelyan Edgar,Diaryan Aleksandr,fiurst,Diaryan Aleksandr - Rafayelyan Edgar,69,30,39,9,-9,18,17,17,17,0,4,-5,5,5,0,9,7:11 - 11:6 - 6:11 - 6:11 - 0:0
15098144,2023-11-10 12:15:00,Nazaryan Mushegh - Mkrtchyan Andranik,0:3,11:9 - 11:9 - 11:9 - 0:0 - 0:0,3,0,Nazaryan Mushegh,Mkrtchyan Andranik,fiurst,Mkrtchyan Andranik - Nazaryan Mushegh,60,27,33,6,-6,20,20,20,0,0,2,2,2,0,0,6,9:11 - 9:11 - 9:11 - 0:0 - 0:0
15098142,2023-11-10 12:00:00,Rafayelyan Edgar - Nikoghosyan Narek,3:0,8:11 - 8:11 - 15:17 - 0:0 - 0:0,0,3,Rafayelyan Edgar,Nikoghosyan Narek,fiurst,Nikoghosyan Narek - Rafayelyan Edgar,70,39,31,-8,8,19,19,32,0,0,-3,-3,-2,0,0,-8,11:8 - 11:8 - 17:15 - 0:0 - 0:0
15098140,2023-11-10 11:55:00,Diaryan Aleksandr - Nazaryan Mushegh,3:0,11:3 - 11:5 - 11:3 - 0:0 - 0:0,3,0,Diaryan Aleksandr,Nazaryan Mushegh,fiurst,Diaryan Aleksandr - Nazaryan Mushegh,44,33,11,-22,22,14,16,14,0,0,-8,-6,-8,0,0,-22,11:3 - 11:5 - 11:3 - 0:0 - 0:0
15098139,2023-11-10 11:30:00,Rafayelyan Edgar - Mkrtchyan Andranik,3:0,10:12 - 7:11 - 7:11 - 0:0 - 0:0,0,3,Rafayelyan Edgar,Mkrtchyan Andranik,fiurst,Mkrtchyan Andranik - Rafayelyan Edgar,58,34,24,-10,10,22,18,18,0,0,-2,-4,-4,0,0,-10,12:10 - 11:7 - 11:7 - 0:0 - 0:0
15098129,2023-11-10 11:20:00,Nikoghosyan Narek - Diaryan Aleksandr,3:0,12:14 - 4:11 - 7:11 - 0:0 - 0:0,0,3,Nikoghosyan Narek,Diaryan Aleksandr,fiurst,Diaryan Aleksandr - Nikoghosyan Narek,59,36,23,-13,13,26,15,18,0,0,-2,-7,-4,0,0,-13,14:12 - 11:4 - 11:7 - 0:0 - 0:0
15098108,2023-11-10 11:00:00,Nazaryan Mushegh - Rafayelyan Edgar,0:3,11:13 - 3:11 - 7:11 - 0:0 - 0:0,0,3,Nazaryan Mushegh,Rafayelyan Edgar,fiurst,Nazaryan Mushegh - Rafayelyan Edgar,56,21,35,14,-14,24,14,18,0,0,2,8,4,0,0,14,11:13 - 3:11 - 7:11 - 0:0 - 0:0
15098107,2023-11-10 10:45:00,Mkrtchyan Andranik - Diaryan Aleksandr,3:2,9:11 - 10:12 - 12:10 - 11:8 - 5:11,2,3,Mkrtchyan Andranik,Diaryan Aleksandr,fiurst,Diaryan Aleksandr - Mkrtchyan Andranik,99,52,47,-5,5,20,22,22,19,16,-2,-2,2,3,-6,-5,11:9 - 12:10 - 10:12 - 8:11 - 11:5
15098103,2023-11-10 10:30:00,Nikoghosyan Narek - Nazaryan Mushegh,0:3,12:10 - 11:7 - 11:6 - 0:0 - 0:0,3,0,Nikoghosyan Narek,Nazaryan Mushegh,fiurst,Nazaryan Mushegh - Nikoghosyan Narek,57,23,34,11,-11,22,18,17,0,0,2,4,5,0,0,11,10:12 - 7:11 - 6:11 - 0:0 - 0:0
15098101,2023-11-10 10:15:00,Diaryan Aleksandr - Rafayelyan Edgar,2:3,11:9 - 11:1 - 7:11 - 7:11 - 7:11,2,3,Diaryan Aleksandr,Rafayelyan Edgar,fiurst,Diaryan Aleksandr - Rafayelyan Edgar,86,43,43,0,0,20,12,18,18,18,-2,-10,4,4,4,0,11:9 - 11:1 - 7:11 - 7:11 - 7:11
15098099,2023-11-10 10:00:00,Mkrtchyan Andranik - Nikoghosyan Narek,1:3,11:6 - 5:11 - 7:11 - 7:11 - 0:0,1,3,Mkrtchyan Andranik,Nikoghosyan Narek,fiurst,Mkrtchyan Andranik - Nikoghosyan Narek,69,30,39,9,-9,17,16,18,18,0,-5,6,4,4,0,9,11:6 - 5:11 - 7:11 - 7:11 - 0:0
15081523,2023-11-09 17:25:00,Grigoryan Erik - Gevorgyan Gegham,3:1,6:11 - 8:11 - 16:14 - 9:11 - 0:0,1,3,Grigoryan Erik,Gevorgyan Gegham,fiurst,Gevorgyan Gegham - Grigoryan Erik,86,47,39,-8,8,17,19,30,20,0,-5,-3,2,-2,0,-8,11:6 - 11:8 - 14:16 - 11:9 - 0:0
15081516,2023-11-09 17:15:00,Petrosyan Davit - Darbinyan Armen,0:3,11:4 - 11:8 - 12:10 - 0:0 - 0:0,3,0,Petrosyan Davit,Darbinyan Armen,fiurst,Darbinyan Armen - Petrosyan Davit,56,22,34,12,-12,15,19,22,0,0,7,3,2,0,0,12,4:11 - 8:11 - 10:12 - 0:0 - 0:0
15081504,2023-11-09 16:50:00,Gevorgyan Gegham - Petrosyan Davit,3:1,11:7 - 4:11 - 11:9 - 11:9 - 0:0,3,1,Gevorgyan Gegham,Petrosyan Davit,fiurst,Gevorgyan Gegham - Petrosyan Davit,73,37,36,-1,1,18,15,20,20,0,-4,7,-2,-2,0,-1,11:7 - 4:11 - 11:9 - 11:9 - 0:0
15081505,2023-11-09 16:40:00,Grigoryan Erik - Gevorgyan Hayk,0:0,0:0 - 0:0 - 0:0 - 0:0 - 0:0,0,0,Grigoryan Erik,Gevorgyan Hayk,fiurst,Gevorgyan Hayk - Grigoryan Erik,0,0,0,0,0,0,0,0,0,0,0,0,0,0,0,0,0:0 - 0:0 - 0:0 - 0:0 - 0:0
15081491,2023-11-09 16:25:00,Gevorgyan Hayk - Petrosyan Davit,0:3,11:13 - 3:11 - 4:11 - 0:0 - 0:0,0,3,Gevorgyan Hayk,Petrosyan Davit,fiurst,Gevorgyan Hayk - Petrosyan Davit,53,18,35,17,-17,24,14,15,0,0,2,8,7,0,0,17,11:13 - 3:11 - 4:11 - 0:0 - 0:0
15081493,2023-11-09 16:20:00,Darbinyan Armen - Grigoryan Erik,3:0,11:9 - 11:5 - 11:7 - 0:0 - 0:0,3,0,Darbinyan Armen,Grigoryan Erik,fiurst,Darbinyan Armen - Grigoryan Erik,54,33,21,-12,12,20,16,18,0,0,-2,-6,-4,0,0,-12,11:9 - 11:5 - 11:7 - 0:0 - 0:0
15081486,2023-11-09 16:05:00,Gevorgyan Gegham - Darbinyan Armen,0:3,11:7 - 11:3 - 11:8 - 0:0 - 0:0,3,0,Gevorgyan Gegham,Darbinyan Armen,fiurst,Darbinyan Armen - Gevorgyan Gegham,51,18,33,15,-15,18,14,19,0,0,4,8,3,0,0,15,7:11 - 3:11 - 8:11 - 0:0 - 0:0
15081482,2023-11-09 16:00:00,Petrosyan Davit - Grigoryan Erik,1:3,11:5 - 12:10 - 8:11 - 11:7 - 0:0,3,1,Petrosyan Davit,Grigoryan Erik,fiurst,Grigoryan Erik - Petrosyan Davit,75,33,42,9,-9,16,22,19,18,0,6,2,-3,4,0,9,5:11 - 10:12 - 11:8 - 7:11 - 0:0
15081477,2023-11-09 15:15:00,Mkrtchyan Andranik - Nikoghosyan Narek,0:3,7:11 - 6:11 - 6:11 - 0:0 - 0:0,0,3,Mkrtchyan Andranik,Nikoghosyan Narek,fiurst,Mkrtchyan Andranik - Nikoghosyan Narek,52,19,33,14,-14,18,17,17,0,0,4,5,5,0,0,14,7:11 - 6:11 - 6:11 - 0:0 - 0:0
15081478,2023-11-09 15:15:00,Gevorgyan Hayk - Gevorgyan Gegham,3:0,7:11 - 4:11 - 9:11 - 0:0 - 0:0,0,3,Gevorgyan Hayk,Gevorgyan Gegham,fiurst,Gevorgyan Gegham - Gevorgyan Hayk,53,33,20,-13,13,18,15,20,0,0,-4,-7,-2,0,0,-13,11:7 - 11:4 - 11:9 - 0:0 - 0:0
15081476,2023-11-09 14:45:00,Rafayelyan Edgar - Arutyunov Ruben,0:3,11:6 - 11:8 - 33:31 - 0:0 - 0:0,3,0,Rafayelyan Edgar,Arutyunov Ruben,fiurst,Arutyunov Ruben - Rafayelyan Edgar,100,45,55,10,-10,17,19,64,0,0,5,3,2,0,0,10,6:11 - 8:11 - 31:33 - 0:0 - 0:0
15081470,2023-11-09 14:45:00,Diaryan Aleksandr - Mkrtchyan Andranik,3:1,10:12 - 11:8 - 11:3 - 11:8 - 0:0,3,1,Diaryan Aleksandr,Mkrtchyan Andranik,fiurst,Diaryan Aleksandr - Mkrtchyan Andranik,74,43,31,-12,12,22,19,14,19,0,2,-3,-8,-3,0,-12,10:12 - 11:8 - 11:3 - 11:8 - 0:0
15081461,2023-11-09 14:15:00,Nikoghosyan Narek - Rafayelyan Edgar,3:2,7:11 - 11:8 - 11:5 - 6:11 - 12:10,3,2,Nikoghosyan Narek,Rafayelyan Edgar,fiurst,Nikoghosyan Narek - Rafayelyan Edgar,92,47,45,-2,2,18,19,16,17,22,4,-3,-6,5,-2,-2,7:11 - 11:8 - 11:5 - 6:11 - 12:10
15081459,2023-11-09 14:05:00,Diaryan Aleksandr - Arutyunov Ruben,2:3,11:3 - 9:11 - 9:11 - 11:9 - 11:2,3,2,Diaryan Aleksandr,Arutyunov Ruben,fiurst,Arutyunov Ruben - Diaryan Aleksandr,87,36,51,15,-15,14,20,20,20,13,8,-2,-2,2,9,15,3:11 - 11:9 - 11:9 - 9:11 - 2:11
15081455,2023-11-09 13:50:00,Mkrtchyan Andranik - Rafayelyan Edgar,1:3,11:5 - 3:11 - 4:11 - 7:11 - 0:0,1,3,Mkrtchyan Andranik,Rafayelyan Edgar,fiurst,Mkrtchyan Andranik - Rafayelyan Edgar,63,25,38,13,-13,16,14,15,18,0,-6,8,7,4,0,13,11:5 - 3:11 - 4:11 - 7:11 - 0:0
15081449,2023-11-09 13:40:00,Nikoghosyan Narek - Diaryan Aleksandr,3:0,10:12 - 6:11 - 9:11 - 0:0 - 0:0,0,3,Nikoghosyan Narek,Diaryan Aleksandr,fiurst,Diaryan Aleksandr - Nikoghosyan Narek,59,34,25,-9,9,22,17,20,0,0,-2,-5,-2,0,0,-9,12:10 - 11:6 - 11:9 - 0:0 - 0:0
15081447,2023-11-09 13:30:00,Arutyunov Ruben - Mkrtchyan Andranik,3:0,11:8 - 11:2 - 11:4 - 0:0 - 0:0,3,0,Arutyunov Ruben,Mkrtchyan Andranik,fiurst,Arutyunov Ruben - Mkrtchyan Andranik,47,33,14,-19,19,19,13,15,0,0,-3,-9,-7,0,0,-19,11:8 - 11:2 - 11:4 - 0:0 - 0:0
15081436,2023-11-09 13:00:00,Rafayelyan Edgar - Diaryan Aleksandr,3:2,10:12 - 11:9 - 13:15 - 11:6 - 9:11,2,3,Rafayelyan Edgar,Diaryan Aleksandr,fiurst,Diaryan Aleksandr - Rafayelyan Edgar,107,53,54,1,-1,22,20,28,17,20,-2,2,-2,5,-2,1,12:10 - 9:11 - 15:13 - 6:11 - 11:9
15081427,2023-11-09 12:45:00,Arutyunov Ruben - Nikoghosyan Narek,1:3,6:11 - 8:11 - 11:9 - 8:11 - 0:0,1,3,Arutyunov Ruben,Nikoghosyan Narek,fiurst,Arutyunov Ruben - Nikoghosyan Narek,75,33,42,9,-9,17,19,20,19,0,5,3,-2,3,0,9,6:11 - 8:11 - 11:9 - 8:11 - 0:0
15081426,2023-11-09 12:35:00,Mkrtchyan Andranik - Diaryan Aleksandr,3:1,7:11 - 7:11 - 11:9 - 6:11 - 0:0,1,3,Mkrtchyan Andranik,Diaryan Aleksandr,fiurst,Diaryan Aleksandr - Mkrtchyan Andranik,73,42,31,-11,11,18,18,20,17,0,-4,-4,2,-5,0,-11,11:7 - 11:7 - 9:11 - 11:6 - 0:0
15081419,2023-11-09 12:00:00,Nikoghosyan Narek - Mkrtchyan Andranik,1:3,11:7 - 11:5 - 11:13 - 12:10 - 0:0,3,1,Nikoghosyan Narek,Mkrtchyan Andranik,fiurst,Mkrtchyan Andranik - Nikoghosyan Narek,80,35,45,10,-10,18,16,24,22,0,4,6,-2,2,0,10,7:11 - 5:11 - 13:11 - 10:12 - 0:0
15081424,2023-11-09 12:00:00,Arutyunov Ruben - Rafayelyan Edgar,0:3,7:11 - 1:11 - 4:11 - 0:0 - 0:0,0,3,Arutyunov Ruben,Rafayelyan Edgar,fiurst,Arutyunov Ruben - Rafayelyan Edgar,45,12,33,21,-21,18,12,15,0,0,4,10,7,0,0,21,7:11 - 1:11 - 4:11 - 0:0 - 0:0
15081417,2023-11-09 11:30:00,Arutyunov Ruben - Diaryan Aleksandr,0:3,7:11 - 4:11 - 6:11 - 0:0 - 0:0,0,3,Arutyunov Ruben,Diaryan Aleksandr,fiurst,Arutyunov Ruben - Diaryan Aleksandr,50,17,33,16,-16,18,15,17,0,0,4,7,5,0,0,16,7:11 - 4:11 - 6:11 - 0:0 - 0:0
15081415,2023-11-09 11:25:00,Rafayelyan Edgar - Nikoghosyan Narek,3:1,14:16 - 11:7 - 5:11 - 7:11 - 0:0,1,3,Rafayelyan Edgar,Nikoghosyan Narek,fiurst,Nikoghosyan Narek - Rafayelyan Edgar,82,45,37,-8,8,30,18,16,18,0,-2,4,-6,-4,0,-8,16:14 - 7:11 - 11:5 - 11:7 - 0:0
15080347,2023-11-09 11:00:00,Mkrtchyan Andranik - Arutyunov Ruben,3:0,8:11 - 2:11 - 9:11 - 0:0 - 0:0,0,3,Mkrtchyan Andranik,Arutyunov Ruben,fiurst,Arutyunov Ruben - Mkrtchyan Andranik,52,33,19,-14,14,19,13,20,0,0,-3,-9,-2,0,0,-14,11:8 - 11:2 - 11:9 - 0:0 - 0:0
15080337,2023-11-09 10:45:00,Diaryan Aleksandr - Nikoghosyan Narek,2:3,3:11 - 7:11 - 11:8 - 12:10 - 9:11,2,3,Diaryan Aleksandr,Nikoghosyan Narek,fiurst,Diaryan Aleksandr - Nikoghosyan Narek,93,42,51,9,-9,14,18,19,22,20,8,4,-3,-2,2,9,3:11 - 7:11 - 11:8 - 12:10 - 9:11
15080334,2023-11-09 10:30:00,Rafayelyan Edgar - Mkrtchyan Andranik,0:3,11:9 - 14:12 - 11:7 - 0:0 - 0:0,3,0,Rafayelyan Edgar,Mkrtchyan Andranik,fiurst,Mkrtchyan Andranik - Rafayelyan Edgar,64,28,36,8,-8,20,26,18,0,0,2,2,4,0,0,8,9:11 - 12:14 - 7:11 - 0:0 - 0:0
15080332,2023-11-09 10:15:00,Nikoghosyan Narek - Arutyunov Ruben,0:3,13:11 - 11:3 - 11:5 - 0:0 - 0:0,3,0,Nikoghosyan Narek,Arutyunov Ruben,fiurst,Arutyunov Ruben - Nikoghosyan Narek,54,19,35,16,-16,24,14,16,0,0,2,8,6,0,0,16,11:13 - 3:11 - 5:11 - 0:0 - 0:0
15080330,2023-11-09 10:00:00,Diaryan Aleksandr - Rafayelyan Edgar,1:3,11:5 - 9:11 - 11:13 - 9:11 - 0:0,1,3,Diaryan Aleksandr,Rafayelyan Edgar,fiurst,Diaryan Aleksandr - Rafayelyan Edgar,80,40,40,0,0,16,20,24,20,0,-6,2,2,2,0,0,11:5 - 9:11 - 11:13 - 9:11 - 0:0
15062301,2023-11-08 17:35:00,Avakimyan Davit - Gevorgyan Gegham,3:0,11:6 - 11:9 - 11:8 - 0:0 - 0:0,3,0,Avakimyan Davit,Gevorgyan Gegham,fiurst,Avakimyan Davit - Gevorgyan Gegham,56,33,23,-10,10,17,20,19,0,0,-5,-2,-3,0,0,-10,11:6 - 11:9 - 11:8 - 0:0 - 0:0
15062286,2023-11-08 17:15:00,Grigoryan Erik - Avakimyan Davit,3:2,8:11 - 11:4 - 8:11 - 11:8 - 7:11,2,3,Grigoryan Erik,Avakimyan Davit,fiurst,Avakimyan Davit - Grigoryan Erik,90,45,45,0,0,19,15,19,19,18,-3,7,-3,3,-4,0,11:8 - 4:11 - 11:8 - 8:11 - 11:7
15062296,2023-11-08 17:15:00,Mkrtchyan Andranik - Gevorgyan Hayk,3:1,11:8 - 8:11 - 6:11 - 8:11 - 0:0,1,3,Mkrtchyan Andranik,Gevorgyan Hayk,fiurst,Gevorgyan Hayk - Mkrtchyan Andranik,74,41,33,-8,8,19,19,17,19,0,3,-3,-5,-3,0,-8,8:11 - 11:8 - 11:6 - 11:8 - 0:0
15062283,2023-11-08 16:45:00,Gevorgyan Hayk - Grigoryan Erik,2:3,8:11 - 11:6 - 11:5 - 4:11 - 4:11,2,3,Gevorgyan Hayk,Grigoryan Erik,fiurst,Gevorgyan Hayk - Grigoryan Erik,82,38,44,6,-6,19,17,16,15,15,3,-5,-6,7,7,6,8:11 - 11:6 - 11:5 - 4:11 - 4:11
15062284,2023-11-08 16:45:00,Mkrtchyan Andranik - Gevorgyan Gegham,2:3,16:14 - 7:11 - 9:11 - 11:4 - 11:7,3,2,Mkrtchyan Andranik,Gevorgyan Gegham,fiurst,Gevorgyan Gegham - Mkrtchyan Andranik,101,47,54,7,-7,30,18,20,15,18,2,-4,-2,7,4,7,14:16 - 11:7 - 11:9 - 4:11 - 7:11
15062281,2023-11-08 16:15:00,Avakimyan Davit - Mkrtchyan Andranik,1:3,9:11 - 11:9 - 8:11 - 7:11 - 0:0,1,3,Avakimyan Davit,Mkrtchyan Andranik,fiurst,Avakimyan Davit - Mkrtchyan Andranik,77,35,42,7,-7,20,20,19,18,0,2,-2,3,4,0,7,9:11 - 11:9 - 8:11 - 7:11 - 0:0
15062268,2023-11-08 16:05:00,Gevorgyan Gegham - Grigoryan Erik,3:2,15:17 - 11:6 - 9:11 - 11:8 - 11:6,3,2,Gevorgyan Gegham,Grigoryan Erik,fiurst,Gevorgyan Gegham - Grigoryan Erik,105,57,48,-9,9,32,17,20,19,17,2,-5,2,-3,-5,-9,15:17 - 11:6 - 9:11 - 11:8 - 11:6
15062263,2023-11-08 15:45:00,Gevorgyan Hayk - Avakimyan Davit,3:1,6:11 - 8:11 - 11:9 - 8:11 - 0:0,1,3,Gevorgyan Hayk,Avakimyan Davit,fiurst,Avakimyan Davit - Gevorgyan Hayk,75,42,33,-9,9,17,19,20,19,0,-5,-3,2,-3,0,-9,11:6 - 11:8 - 9:11 - 11:8 - 0:0
15062255,2023-11-08 15:30:00,Grigoryan Erik - Mkrtchyan Andranik,1:3,11:4 - 4:11 - 3:11 - 6:11 - 0:0,1,3,Grigoryan Erik,Mkrtchyan Andranik,fiurst,Grigoryan Erik - Mkrtchyan Andranik,61,24,37,13,-13,15,15,14,17,0,-7,7,8,5,0,13,11:4 - 4:11 - 3:11 - 6:11 - 0:0
15062253,2023-11-08 15:15:00,Gevorgyan Gegham - Gevorgyan Hayk,1:3,8:11 - 11:8 - 6:11 - 6:11 - 0:0,1,3,Gevorgyan Gegham,Gevorgyan Hayk,fiurst,Gevorgyan Gegham - Gevorgyan Hayk,72,31,41,10,-10,19,19,17,17,0,3,-3,5,5,0,10,8:11 - 11:8 - 6:11 - 6:11 - 0:0
15062247,2023-11-08 15:00:00,Arutyunov Ruben - Nazaryan Mushegh,1:3,6:11 - 11:6 - 4:11 - 4:11 - 0:0,1,3,Arutyunov Ruben,Nazaryan Mushegh,fiurst,Arutyunov Ruben - Nazaryan Mushegh,64,25,39,14,-14,17,17,15,15,0,5,-5,7,7,0,14,6:11 - 11:6 - 4:11 - 4:11 - 0:0
15062240,2023-11-08 14:45:00,Diaryan Aleksandr - Nikoghosyan Narek,3:2,10:12 - 11:3 - 11:2 - 8:11 - 12:10,3,2,Diaryan Aleksandr,Nikoghosyan Narek,fiurst,Diaryan Aleksandr - Nikoghosyan Narek,90,52,38,-14,14,22,14,13,19,22,2,-8,-9,3,-2,-14,10:12 - 11:3 - 11:2 - 8:11 - 12:10
15062214,2023-11-08 14:30:00,Soghomonyan Hrayr - Arutyunov Ruben,3:0,9:11 - 5:11 - 3:11 - 0:0 - 0:0,0,3,Soghomonyan Hrayr,Arutyunov Ruben,fiurst,Arutyunov Ruben - Soghomonyan Hrayr,50,33,17,-16,16,20,16,14,0,0,-2,-6,-8,0,0,-16,11:9 - 11:5 - 11:3 - 0:0 - 0:0
15062209,2023-11-08 14:20:00,Nazaryan Mushegh - Diaryan Aleksandr,3:0,6:11 - 4:11 - 9:11 - 0:0 - 0:0,0,3,Nazaryan Mushegh,Diaryan Aleksandr,fiurst,Diaryan Aleksandr - Nazaryan Mushegh,52,33,19,-14,14,17,15,20,0,0,-5,-7,-2,0,0,-14,11:6 - 11:4 - 11:9 - 0:0 - 0:0
15062191,2023-11-08 14:00:00,Arutyunov Ruben - Diaryan Aleksandr,1:3,11:7 - 6:11 - 8:11 - 9:11 - 0:0,1,3,Arutyunov Ruben,Diaryan Aleksandr,fiurst,Arutyunov Ruben - Diaryan Aleksandr,74,34,40,6,-6,18,17,19,20,0,-4,5,3,2,0,6,11:7 - 6:11 - 8:11 - 9:11 - 0:0
15062206,2023-11-08 14:00:00,Soghomonyan Hrayr - Nikoghosyan Narek,3:0,3:11 - 7:11 - 9:11 - 0:0 - 0:0,0,3,Soghomonyan Hrayr,Nikoghosyan Narek,fiurst,Nikoghosyan Narek - Soghomonyan Hrayr,52,33,19,-14,14,14,18,20,0,0,-8,-4,-2,0,0,-14,11:3 - 11:7 - 11:9 - 0:0 - 0:0
15062185,2023-11-08 13:30:00,Nazaryan Mushegh - Soghomonyan Hrayr,3:1,11:6 - 9:11 - 11:6 - 11:8 - 0:0,3,1,Nazaryan Mushegh,Soghomonyan Hrayr,fiurst,Nazaryan Mushegh - Soghomonyan Hrayr,73,42,31,-11,11,17,20,17,19,0,-5,2,-5,-3,0,-11,11:6 - 9:11 - 11:6 - 11:8 - 0:0
15062178,2023-11-08 13:15:00,Nikoghosyan Narek - Arutyunov Ruben,2:3,11:7 - 7:11 - 9:11 - 14:12 - 11:9,3,2,Nikoghosyan Narek,Arutyunov Ruben,fiurst,Arutyunov Ruben - Nikoghosyan Narek,102,50,52,2,-2,18,18,20,26,20,4,-4,-2,2,2,2,7:11 - 11:7 - 11:9 - 12:14 - 9:11
15062173,2023-11-08 13:00:00,Diaryan Aleksandr - Soghomonyan Hrayr,3:0,11:3 - 11:6 - 11:7 - 0:0 - 0:0,3,0,Diaryan Aleksandr,Soghomonyan Hrayr,fiurst,Diaryan Aleksandr - Soghomonyan Hrayr,49,33,16,-17,17,14,17,18,0,0,-8,-5,-4,0,0,-17,11:3 - 11:6 - 11:7 - 0:0 - 0:0
15062157,2023-11-08 12:45:00,Nikoghosyan Narek - Nazaryan Mushegh,2:3,11:5 - 6:11 - 11:7 - 5:11 - 11:7,3,2,Nikoghosyan Narek,Nazaryan Mushegh,fiurst,Nazaryan Mushegh - Nikoghosyan Narek,85,41,44,3,-3,16,17,18,16,18,6,-5,4,-6,4,3,5:11 - 11:6 - 7:11 - 11:5 - 7:11
15062154,2023-11-08 12:15:00,Arutyunov Ruben - Soghomonyan Hrayr,3:0,11:5 - 11:4 - 11:6 - 0:0 - 0:0,3,0,Arutyunov Ruben,Soghomonyan Hrayr,fiurst,Arutyunov Ruben - Soghomonyan Hrayr,48,33,15,-18,18,16,15,17,0,0,-6,-7,-5,0,0,-18,11:5 - 11:4 - 11:6 - 0:0 - 0:0
15062151,2023-11-08 12:00:00,Nikoghosyan Narek - Diaryan Aleksandr,3:1,5:11 - 11:9 - 10:12 - 8:11 - 0:0,1,3,Nikoghosyan Narek,Diaryan Aleksandr,fiurst,Diaryan Aleksandr - Nikoghosyan Narek,77,43,34,-9,9,16,20,22,19,0,-6,2,-2,-3,0,-9,11:5 - 9:11 - 12:10 - 11:8 - 0:0
15062147,2023-11-08 11:45:00,Nazaryan Mushegh - Arutyunov Ruben,0:3,11:4 - 11:9 - 11:8 - 0:0 - 0:0,3,0,Nazaryan Mushegh,Arutyunov Ruben,fiurst,Arutyunov Ruben - Nazaryan Mushegh,54,21,33,12,-12,15,20,19,0,0,7,2,3,0,0,12,4:11 - 9:11 - 8:11 - 0:0 - 0:0
15062146,2023-11-08 11:35:00,Nikoghosyan Narek - Soghomonyan Hrayr,3:0,14:12 - 11:9 - 11:5 - 0:0 - 0:0,3,0,Nikoghosyan Narek,Soghomonyan Hrayr,fiurst,Nikoghosyan Narek - Soghomonyan Hrayr,62,36,26,-10,10,26,20,16,0,0,-2,-2,-6,0,0,-10,14:12 - 11:9 - 11:5 - 0:0 - 0:0
15062135,2023-11-08 11:15:00,Diaryan Aleksandr - Nazaryan Mushegh,3:1,12:10 - 9:11 - 11:2 - 11:5 - 0:0,3,1,Diaryan Aleksandr,Nazaryan Mushegh,fiurst,Diaryan Aleksandr - Nazaryan Mushegh,71,43,28,-15,15,22,20,13,16,0,-2,2,-9,-6,0,-15,12:10 - 9:11 - 11:2 - 11:5 - 0:0
15062133,2023-11-08 11:00:00,Arutyunov Ruben - Nikoghosyan Narek,3:1,10:12 - 11:5 - 11:6 - 11:4 - 0:0,3,1,Arutyunov Ruben,Nikoghosyan Narek,fiurst,Arutyunov Ruben - Nikoghosyan Narek,70,43,27,-16,16,22,16,17,15,0,2,-6,-5,-7,0,-16,10:12 - 11:5 - 11:6 - 11:4 - 0:0
15062132,2023-11-08 10:45:00,Soghomonyan Hrayr - Nazaryan Mushegh,3:1,8:11 - 11:9 - 9:11 - 5:11 - 0:0,1,3,Soghomonyan Hrayr,Nazaryan Mushegh,fiurst,Nazaryan Mushegh - Soghomonyan Hrayr,75,42,33,-9,9,19,20,20,16,0,-3,2,-2,-6,0,-9,11:8 - 9:11 - 11:9 - 11:5 - 0:0
15062129,2023-11-08 10:30:00,Diaryan Aleksandr - Arutyunov Ruben,0:3,11:6 - 11:8 - 11:7 - 0:0 - 0:0,3,0,Diaryan Aleksandr,Arutyunov Ruben,fiurst,Arutyunov Ruben - Diaryan Aleksandr,54,21,33,12,-12,17,19,18,0,0,5,3,4,0,0,12,6:11 - 8:11 - 7:11 - 0:0 - 0:0
15062128,2023-11-08 10:15:00,Nazaryan Mushegh - Nikoghosyan Narek,3:0,11:8 - 11:6 - 11:6 - 0:0 - 0:0,3,0,Nazaryan Mushegh,Nikoghosyan Narek,fiurst,Nazaryan Mushegh - Nikoghosyan Narek,53,33,20,-13,13,19,17,17,0,0,-3,-5,-5,0,0,-13,11:8 - 11:6 - 11:6 - 0:0 - 0:0
15062126,2023-11-08 10:00:00,Soghomonyan Hrayr - Diaryan Aleksandr,3:0,5:11 - 5:11 - 7:11 - 0:0 - 0:0,0,3,Soghomonyan Hrayr,Diaryan Aleksandr,fiurst,Diaryan Aleksandr - Soghomonyan Hrayr,50,33,17,-16,16,16,16,18,0,0,-6,-6,-4,0,0,-16,11:5 - 11:5 - 11:7 - 0:0 - 0:0
15044958,2023-11-07 17:50:00,Mkrtchyan Andranik - Darbinyan Armen,0:3,11:5 - 11:3 - 11:5 - 0:0 - 0:0,3,0,Mkrtchyan Andranik,Darbinyan Armen,fiurst,Darbinyan Armen - Mkrtchyan Andranik,46,13,33,20,-20,16,14,16,0,0,6,8,6,0,0,20,5:11 - 3:11 - 5:11 - 0:0 - 0:0
15044987,2023-11-07 17:30:00,Darbinyan Armen - Grigoryan Erik,2:3,11:8 - 13:11 - 7:11 - 3:11 - 8:11,2,3,Darbinyan Armen,Grigoryan Erik,fiurst,Darbinyan Armen - Grigoryan Erik,94,42,52,10,-10,19,24,18,14,19,-3,-2,4,8,3,10,11:8 - 13:11 - 7:11 - 3:11 - 8:11
15044984,2023-11-07 17:15:00,Avakimyan Davit - Mkrtchyan Andranik,1:3,9:11 - 11:8 - 12:14 - 4:11 - 0:0,1,3,Avakimyan Davit,Mkrtchyan Andranik,fiurst,Avakimyan Davit - Mkrtchyan Andranik,80,36,44,8,-8,20,19,26,15,0,2,-3,2,7,0,8,9:11 - 11:8 - 12:14 - 4:11 - 0:0
15063949,2023-11-07 17:10:00,Grigoryan Erik - Mkrtchyan Andranik,0:3,5:11 - 5:11 - 5:11 - 0:0 - 0:0,0,3,Grigoryan Erik,Mkrtchyan Andranik,fiurst,Grigoryan Erik - Mkrtchyan Andranik,48,15,33,18,-18,16,16,16,0,0,6,6,6,0,0,18,5:11 - 5:11 - 5:11 - 0:0 - 0:0
15044981,2023-11-07 17:00:00,Gevorgyan Gegham - Darbinyan Armen,0:3,11:4 - 11:6 - 11:5 - 0:0 - 0:0,3,0,Gevorgyan Gegham,Darbinyan Armen,fiurst,Darbinyan Armen - Gevorgyan Gegham,48,15,33,18,-18,15,17,16,0,0,7,5,6,0,0,18,4:11 - 6:11 - 5:11 - 0:0 - 0:0
15044979,2023-11-07 16:45:00,Avakimyan Davit - Grigoryan Erik,1:3,6:11 - 9:11 - 11:6 - 8:11 - 0:0,1,3,Avakimyan Davit,Grigoryan Erik,fiurst,Avakimyan Davit - Grigoryan Erik,73,34,39,5,-5,17,20,17,19,0,5,2,-5,3,0,5,6:11 - 9:11 - 11:6 - 8:11 - 0:0
15044977,2023-11-07 16:30:00,Mkrtchyan Andranik - Gevorgyan Gegham,0:3,11:9 - 14:12 - 13:11 - 0:0 - 0:0,3,0,Mkrtchyan Andranik,Gevorgyan Gegham,fiurst,Gevorgyan Gegham - Mkrtchyan Andranik,70,32,38,6,-6,20,26,24,0,0,2,2,2,0,0,6,9:11 - 12:14 - 11:13 - 0:0 - 0:0
15044965,2023-11-07 16:15:00,Darbinyan Armen - Avakimyan Davit,3:0,5:11 - 5:11 - 5:11 - 0:0 - 0:0,0,3,Darbinyan Armen,Avakimyan Davit,fiurst,Avakimyan Davit - Darbinyan Armen,48,33,15,-18,18,16,16,16,0,0,-6,-6,-6,0,0,-18,11:5 - 11:5 - 11:5 - 0:0 - 0:0
15044961,2023-11-07 16:00:00,Grigoryan Erik - Gevorgyan Gegham,0:3,11:5 - 11:6 - 11:7 - 0:0 - 0:0,3,0,Grigoryan Erik,Gevorgyan Gegham,fiurst,Gevorgyan Gegham - Grigoryan Erik,51,18,33,15,-15,16,17,18,0,0,6,5,4,0,0,15,5:11 - 6:11 - 7:11 - 0:0 - 0:0
15044955,2023-11-07 15:30:00,Gevorgyan Gegham - Avakimyan Davit,3:0,8:11 - 9:11 - 5:11 - 0:0 - 0:0,0,3,Gevorgyan Gegham,Avakimyan Davit,fiurst,Avakimyan Davit - Gevorgyan Gegham,55,33,22,-11,11,19,20,16,0,0,-3,-2,-6,0,0,-11,11:8 - 11:9 - 11:5 - 0:0 - 0:0
15044948,2023-11-07 15:00:00,Diaryan Aleksandr - Rafayelyan Edgar,3:1,11:9 - 5:11 - 12:10 - 11:3 - 0:0,3,1,Diaryan Aleksandr,Rafayelyan Edgar,fiurst,Diaryan Aleksandr - Rafayelyan Edgar,72,39,33,-6,6,20,16,22,14,0,-2,6,-2,-8,0,-6,11:9 - 5:11 - 12:10 - 11:3 - 0:0
15044946,2023-11-07 14:45:00,Arutyunov Ruben - Nikoghosyan Narek,0:3,8:11 - 6:11 - 8:11 - 0:0 - 0:0,0,3,Arutyunov Ruben,Nikoghosyan Narek,fiurst,Arutyunov Ruben - Nikoghosyan Narek,55,22,33,11,-11,19,17,19,0,0,3,5,3,0,0,11,8:11 - 6:11 - 8:11 - 0:0 - 0:0
15044942,2023-11-07 14:30:00,Nazaryan Mushegh - Diaryan Aleksandr,3:0,7:11 - 6:11 - 4:11 - 0:0 - 0:0,0,3,Nazaryan Mushegh,Diaryan Aleksandr,fiurst,Diaryan Aleksandr - Nazaryan Mushegh,50,33,17,-16,16,18,17,15,0,0,-4,-5,-7,0,0,-16,11:7 - 11:6 - 11:4 - 0:0 - 0:0
15044936,2023-11-07 14:20:00,Rafayelyan Edgar - Arutyunov Ruben,0:3,11:9 - 11:8 - 11:5 - 0:0 - 0:0,3,0,Rafayelyan Edgar,Arutyunov Ruben,fiurst,Arutyunov Ruben - Rafayelyan Edgar,55,22,33,11,-11,20,19,16,0,0,2,3,6,0,0,11,9:11 - 8:11 - 5:11 - 0:0 - 0:0
15044924,2023-11-07 14:00:00,Nazaryan Mushegh - Nikoghosyan Narek,1:3,11:8 - 5:11 - 9:11 - 4:11 - 0:0,1,3,Nazaryan Mushegh,Nikoghosyan Narek,fiurst,Nazaryan Mushegh - Nikoghosyan Narek,70,29,41,12,-12,19,16,20,15,0,-3,6,2,7,0,12,11:8 - 5:11 - 9:11 - 4:11 - 0:0
15044921,2023-11-07 13:55:00,Diaryan Aleksandr - Arutyunov Ruben,0:3,11:3 - 11:8 - 11:8 - 0:0 - 0:0,3,0,Diaryan Aleksandr,Arutyunov Ruben,fiurst,Arutyunov Ruben - Diaryan Aleksandr,52,19,33,14,-14,14,19,19,0,0,8,3,3,0,0,14,3:11 - 8:11 - 8:11 - 0:0 - 0:0
15044918,2023-11-07 13:30:00,Rafayelyan Edgar - Nazaryan Mushegh,1:3,8:11 - 11:4 - 11:8 - 11:6 - 0:0,3,1,Rafayelyan Edgar,Nazaryan Mushegh,fiurst,Nazaryan Mushegh - Rafayelyan Edgar,70,29,41,12,-12,19,15,19,17,0,-3,7,3,5,0,12,11:8 - 4:11 - 8:11 - 6:11 - 0:0
15044912,2023-11-07 13:15:00,Nikoghosyan Narek - Diaryan Aleksandr,1:3,11:7 - 11:6 - 10:12 - 11:8 - 0:0,3,1,Nikoghosyan Narek,Diaryan Aleksandr,fiurst,Diaryan Aleksandr - Nikoghosyan Narek,76,33,43,10,-10,18,17,22,19,0,4,5,-2,3,0,10,7:11 - 6:11 - 12:10 - 8:11 - 0:0
15044907,2023-11-07 13:00:00,Arutyunov Ruben - Nazaryan Mushegh,0:3,3:11 - 4:11 - 10:12 - 0:0 - 0:0,0,3,Arutyunov Ruben,Nazaryan Mushegh,fiurst,Arutyunov Ruben - Nazaryan Mushegh,51,17,34,17,-17,14,15,22,0,0,8,7,2,0,0,17,3:11 - 4:11 - 10:12 - 0:0 - 0:0
15044901,2023-11-07 12:50:00,Nikoghosyan Narek - Rafayelyan Edgar,3:2,11:1 - 10:12 - 11:8 - 8:11 - 11:3,3,2,Nikoghosyan Narek,Rafayelyan Edgar,fiurst,Nikoghosyan Narek - Rafayelyan Edgar,86,51,35,-16,16,12,22,19,19,14,-10,2,-3,3,-8,-16,11:1 - 10:12 - 11:8 - 8:11 - 11:3
15044893,2023-11-07 12:15:00,Diaryan Aleksandr - Nazaryan Mushegh,3:0,11:9 - 11:8 - 11:5 - 0:0 - 0:0,3,0,Diaryan Aleksandr,Nazaryan Mushegh,fiurst,Diaryan Aleksandr - Nazaryan Mushegh,55,33,22,-11,11,20,19,16,0,0,-2,-3,-6,0,0,-11,11:9 - 11:8 - 11:5 - 0:0 - 0:0
15044892,2023-11-07 12:00:00,Nikoghosyan Narek - Arutyunov Ruben,0:3,11:2 - 11:1 - 11:7 - 0:0 - 0:0,3,0,Nikoghosyan Narek,Arutyunov Ruben,fiurst,Arutyunov Ruben - Nikoghosyan Narek,43,10,33,23,-23,13,12,18,0,0,9,10,4,0,0,23,2:11 - 1:11 - 7:11 - 0:0 - 0:0
15044891,2023-11-07 11:45:00,Rafayelyan Edgar - Diaryan Aleksandr,0:3,11:5 - 13:11 - 11:7 - 0:0 - 0:0,3,0,Rafayelyan Edgar,Diaryan Aleksandr,fiurst,Diaryan Aleksandr - Rafayelyan Edgar,58,23,35,12,-12,16,24,18,0,0,6,2,4,0,0,12,5:11 - 11:13 - 7:11 - 0:0 - 0:0
15044889,2023-11-07 11:30:00,Nikoghosyan Narek - Nazaryan Mushegh,1:3,11:1 - 8:11 - 11:5 - 11:6 - 0:0,3,1,Nikoghosyan Narek,Nazaryan Mushegh,fiurst,Nazaryan Mushegh - Nikoghosyan Narek,64,23,41,18,-18,12,19,16,17,0,10,-3,6,5,0,18,1:11 - 11:8 - 5:11 - 6:11 - 0:0
15044888,2023-11-07 11:15:00,Arutyunov Ruben - Rafayelyan Edgar,1:3,12:10 - 6:11 - 3:11 - 8:11 - 0:0,1,3,Arutyunov Ruben,Rafayelyan Edgar,fiurst,Arutyunov Ruben - Rafayelyan Edgar,72,29,43,14,-14,22,17,14,19,0,-2,5,8,3,0,14,12:10 - 6:11 - 3:11 - 8:11 - 0:0
15044881,2023-11-07 11:00:00,Diaryan Aleksandr - Nikoghosyan Narek,3:1,11:2 - 8:11 - 13:11 - 11:7 - 0:0,3,1,Diaryan Aleksandr,Nikoghosyan Narek,fiurst,Diaryan Aleksandr - Nikoghosyan Narek,74,43,31,-12,12,13,19,24,18,0,-9,3,-2,-4,0,-12,11:2 - 8:11 - 13:11 - 11:7 - 0:0
15044879,2023-11-07 10:45:00,Nazaryan Mushegh - Rafayelyan Edgar,1:3,13:11 - 6:11 - 7:11 - 4:11 - 0:0,1,3,Nazaryan Mushegh,Rafayelyan Edgar,fiurst,Nazaryan Mushegh - Rafayelyan Edgar,74,30,44,14,-14,24,17,18,15,0,-2,5,4,7,0,14,13:11 - 6:11 - 7:11 - 4:11 - 0:0
15044878,2023-11-07 10:30:00,Arutyunov Ruben - Diaryan Aleksandr,0:3,4:11 - 8:11 - 8:11 - 0:0 - 0:0,0,3,Arutyunov Ruben,Diaryan Aleksandr,fiurst,Arutyunov Ruben - Diaryan Aleksandr,53,20,33,13,-13,15,19,19,0,0,7,3,3,0,0,13,4:11 - 8:11 - 8:11 - 0:0 - 0:0
15044877,2023-11-07 10:15:00,Rafayelyan Edgar - Nikoghosyan Narek,3:0,4:11 - 6:11 - 9:11 - 0:0 - 0:0,0,3,Rafayelyan Edgar,Nikoghosyan Narek,fiurst,Nikoghosyan Narek - Rafayelyan Edgar,52,33,19,-14,14,15,17,20,0,0,-7,-5,-2,0,0,-14,11:4 - 11:6 - 11:9 - 0:0 - 0:0
15044876,2023-11-07 10:00:00,Nazaryan Mushegh - Arutyunov Ruben,3:2,11:8 - 11:2 - 6:11 - 3:11 - 3:11,2,3,Nazaryan Mushegh,Arutyunov Ruben,fiurst,Arutyunov Ruben - Nazaryan Mushegh,77,43,34,-9,9,19,13,17,14,14,3,9,-5,-8,-8,-9,8:11 - 2:11 - 11:6 - 11:3 - 11:3
15027113,2023-11-06 17:30:00,Gevorgyan Gegham - Avakimyan Davit,3:1,12:14 - 11:9 - 8:11 - 9:11 - 0:0,1,3,Gevorgyan Gegham,Avakimyan Davit,fiurst,Avakimyan Davit - Gevorgyan Gegham,85,45,40,-5,5,26,20,19,20,0,-2,2,-3,-2,0,-5,14:12 - 9:11 - 11:8 - 11:9 - 0:0
15027109,2023-11-06 17:15:00,Petrosyan Davit - Mkrtchyan Andranik,3:0,5:11 - 4:11 - 9:11 - 0:0 - 0:0,0,3,Petrosyan Davit,Mkrtchyan Andranik,fiurst,Mkrtchyan Andranik - Petrosyan Davit,51,33,18,-15,15,16,15,20,0,0,-6,-7,-2,0,0,-15,11:5 - 11:4 - 11:9 - 0:0 - 0:0
15027108,2023-11-06 17:05:00,Gevorgyan Hayk - Gevorgyan Gegham,1:3,6:11 - 11:5 - 11:3 - 11:7 - 0:0,3,1,Gevorgyan Hayk,Gevorgyan Gegham,fiurst,Gevorgyan Gegham - Gevorgyan Hayk,65,26,39,13,-13,17,16,14,18,0,-5,6,8,4,0,13,11:6 - 5:11 - 3:11 - 7:11 - 0:0
15027093,2023-11-06 16:45:00,Petrosyan Davit - Avakimyan Davit,3:0,4:11 - 7:11 - 3:11 - 0:0 - 0:0,0,3,Petrosyan Davit,Avakimyan Davit,fiurst,Avakimyan Davit - Petrosyan Davit,47,33,14,-19,19,15,18,14,0,0,-7,-4,-8,0,0,-19,11:4 - 11:7 - 11:3 - 0:0 - 0:0
15027091,2023-11-06 16:40:00,Mkrtchyan Andranik - Gevorgyan Hayk,1:3,11:8 - 11:9 - 9:11 - 13:11 - 0:0,3,1,Mkrtchyan Andranik,Gevorgyan Hayk,fiurst,Gevorgyan Hayk - Mkrtchyan Andranik,83,39,44,5,-5,19,20,20,24,0,3,2,-2,2,0,5,8:11 - 9:11 - 11:9 - 11:13 - 0:0
15027089,2023-11-06 16:15:00,Gevorgyan Gegham - Petrosyan Davit,3:0,11:8 - 11:5 - 11:7 - 0:0 - 0:0,3,0,Gevorgyan Gegham,Petrosyan Davit,fiurst,Gevorgyan Gegham - Petrosyan Davit,53,33,20,-13,13,19,16,18,0,0,-3,-6,-4,0,0,-13,11:8 - 11:5 - 11:7 - 0:0 - 0:0
15027086,2023-11-06 16:10:00,Avakimyan Davit - Gevorgyan Hayk,0:3,5:11 - 7:11 - 9:11 - 0:0 - 0:0,0,3,Avakimyan Davit,Gevorgyan Hayk,fiurst,Avakimyan Davit - Gevorgyan Hayk,54,21,33,12,-12,16,18,20,0,0,6,4,2,0,0,12,5:11 - 7:11 - 9:11 - 0:0 - 0:0
15027068,2023-11-06 15:45:00,Avakimyan Davit - Mkrtchyan Andranik,2:3,13:11 - 11:6 - 12:14 - 6:11 - 7:11,2,3,Avakimyan Davit,Mkrtchyan Andranik,fiurst,Avakimyan Davit - Mkrtchyan Andranik,102,49,53,4,-4,24,17,26,17,18,-2,-5,2,5,4,4,13:11 - 11:6 - 12:14 - 6:11 - 7:11
15027082,2023-11-06 15:30:00,Gevorgyan Hayk - Petrosyan Davit,3:2,8:11 - 11:8 - 11:8 - 4:11 - 11:8,3,2,Gevorgyan Hayk,Petrosyan Davit,fiurst,Gevorgyan Hayk - Petrosyan Davit,91,45,46,1,-1,19,19,19,15,19,3,-3,-3,7,-3,1,8:11 - 11:8 - 11:8 - 4:11 - 11:8
15027083,2023-11-06 15:15:00,Mkrtchyan Andranik - Gevorgyan Gegham,2:3,4:11 - 11:8 - 11:9 - 7:11 - 11:7,3,2,Mkrtchyan Andranik,Gevorgyan Gegham,fiurst,Gevorgyan Gegham - Mkrtchyan Andranik,90,46,44,-2,2,15,19,20,18,18,-7,3,2,-4,4,-2,11:4 - 8:11 - 9:11 - 11:7 - 7:11
15027065,2023-11-06 14:45:00,Diaryan Aleksandr - Arutyunov Ruben,1:3,11:3 - 11:5 - 5:11 - 11:5 - 0:0,3,1,Diaryan Aleksandr,Arutyunov Ruben,fiurst,Arutyunov Ruben - Diaryan Aleksandr,62,24,38,14,-14,14,16,16,16,0,8,6,-6,6,0,14,3:11 - 5:11 - 11:5 - 5:11 - 0:0
15027061,2023-11-06 14:30:00,Nazaryan Mushegh - Rafayelyan Edgar,3:0,11:5 - 11:7 - 11:7 - 0:0 - 0:0,3,0,Nazaryan Mushegh,Rafayelyan Edgar,fiurst,Nazaryan Mushegh - Rafayelyan Edgar,52,33,19,-14,14,16,18,18,0,0,-6,-4,-4,0,0,-14,11:5 - 11:7 - 11:7 - 0:0 - 0:0
15027058,2023-11-06 14:00:00,Nazaryan Mushegh - Arutyunov Ruben,3:2,12:14 - 11:8 - 7:11 - 11:3 - 9:11,2,3,Nazaryan Mushegh,Arutyunov Ruben,fiurst,Arutyunov Ruben - Nazaryan Mushegh,97,47,50,3,-3,26,19,18,14,20,-2,3,-4,8,-2,3,14:12 - 8:11 - 11:7 - 3:11 - 11:9
15027046,2023-11-06 13:45:00,Rafayelyan Edgar - Diaryan Aleksandr,3:1,9:11 - 11:7 - 7:11 - 8:11 - 0:0,1,3,Rafayelyan Edgar,Diaryan Aleksandr,fiurst,Diaryan Aleksandr - Rafayelyan Edgar,75,40,35,-5,5,20,18,18,19,0,-2,4,-4,-3,0,-5,11:9 - 7:11 - 11:7 - 11:8 - 0:0
15027035,2023-11-06 13:15:00,Arutyunov Ruben - Rafayelyan Edgar,0:3,4:11 - 9:11 - 11:13 - 0:0 - 0:0,0,3,Arutyunov Ruben,Rafayelyan Edgar,fiurst,Arutyunov Ruben - Rafayelyan Edgar,59,24,35,11,-11,15,20,24,0,0,7,2,2,0,0,11,4:11 - 9:11 - 11:13 - 0:0 - 0:0
15027030,2023-11-06 13:00:00,Diaryan Aleksandr - Nazaryan Mushegh,3:1,11:7 - 11:5 - 8:11 - 11:5 - 0:0,3,1,Diaryan Aleksandr,Nazaryan Mushegh,fiurst,Diaryan Aleksandr - Nazaryan Mushegh,69,41,28,-13,13,18,16,19,16,0,-4,-6,3,-6,0,-13,11:7 - 11:5 - 8:11 - 11:5 - 0:0
15027002,2023-11-06 12:15:00,Rafayelyan Edgar - Nazaryan Mushegh,0:3,12:10 - 11:5 - 11:7 - 0:0 - 0:0,3,0,Rafayelyan Edgar,Nazaryan Mushegh,fiurst,Nazaryan Mushegh - Rafayelyan Edgar,56,22,34,12,-12,22,16,18,0,0,2,6,4,0,0,12,10:12 - 5:11 - 7:11 - 0:0 - 0:0
15026997,2023-11-06 12:05:00,Arutyunov Ruben - Diaryan Aleksandr,0:3,6:11 - 8:11 - 7:11 - 0:0 - 0:0,0,3,Arutyunov Ruben,Diaryan Aleksandr,fiurst,Arutyunov Ruben - Diaryan Aleksandr,54,21,33,12,-12,17,19,18,0,0,5,3,4,0,0,12,6:11 - 8:11 - 7:11 - 0:0 - 0:0
15026983,2023-11-06 11:30:00,Arutyunov Ruben - Nazaryan Mushegh,2:3,11:13 - 11:6 - 11:7 - 3:11 - 9:11,2,3,Arutyunov Ruben,Nazaryan Mushegh,fiurst,Arutyunov Ruben - Nazaryan Mushegh,93,45,48,3,-3,24,17,18,14,20,2,-5,-4,8,2,3,11:13 - 11:6 - 11:7 - 3:11 - 9:11
15026967,2023-11-06 11:00:00,Rafayelyan Edgar - Arutyunov Ruben,0:3,11:3 - 12:10 - 11:7 - 0:0 - 0:0,3,0,Rafayelyan Edgar,Arutyunov Ruben,fiurst,Arutyunov Ruben - Rafayelyan Edgar,54,20,34,14,-14,14,22,18,0,0,8,2,4,0,0,14,3:11 - 10:12 - 7:11 - 0:0 - 0:0
15026963,2023-11-06 10:45:00,Nazaryan Mushegh - Soghomonyan Hrayr,3:0,11:8 - 11:8 - 11:6 - 0:0 - 0:0,3,0,Nazaryan Mushegh,Soghomonyan Hrayr,fiurst,Nazaryan Mushegh - Soghomonyan Hrayr,55,33,22,-11,11,19,19,17,0,0,-3,-3,-5,0,0,-11,11:8 - 11:8 - 11:6 - 0:0 - 0:0
15026961,2023-11-06 10:30:00,Diaryan Aleksandr - Rafayelyan Edgar,3:1,1:11 - 11:6 - 11:8 - 11:5 - 0:0,3,1,Diaryan Aleksandr,Rafayelyan Edgar,fiurst,Diaryan Aleksandr - Rafayelyan Edgar,64,34,30,-4,4,12,17,19,16,0,10,-5,-3,-6,0,-4,1:11 - 11:6 - 11:8 - 11:5 - 0:0
15026959,2023-11-06 10:15:00,Soghomonyan Hrayr - Arutyunov Ruben,3:0,9:11 - 5:11 - 4:11 - 0:0 - 0:0,0,3,Soghomonyan Hrayr,Arutyunov Ruben,fiurst,Arutyunov Ruben - Soghomonyan Hrayr,51,33,18,-15,15,20,16,15,0,0,-2,-6,-7,0,0,-15,11:9 - 11:5 - 11:4 - 0:0 - 0:0
15026946,2023-11-06 10:00:00,Nazaryan Mushegh - Diaryan Aleksandr,3:0,3:11 - 6:11 - 8:11 - 0:0 - 0:0,0,3,Nazaryan Mushegh,Diaryan Aleksandr,fiurst,Diaryan Aleksandr - Nazaryan Mushegh,50,33,17,-16,16,14,17,19,0,0,-8,-5,-3,0,0,-16,11:3 - 11:6 - 11:8 - 0:0 - 0:0
15007980,2023-11-05 17:30:00,Darbinyan Armen - Gevorgyan Gegham,0:3,6:11 - 4:11 - 7:11 - 0:0 - 0:0,0,3,Darbinyan Armen,Gevorgyan Gegham,fiurst,Darbinyan Armen - Gevorgyan Gegham,50,17,33,16,-16,17,15,18,0,0,5,7,4,0,0,16,6:11 - 4:11 - 7:11 - 0:0 - 0:0
15007974,2023-11-05 17:20:00,Grigoryan Erik - Gevorgyan Hayk,0:3,17:15 - 11:6 - 14:12 - 0:0 - 0:0,3,0,Grigoryan Erik,Gevorgyan Hayk,fiurst,Gevorgyan Hayk - Grigoryan Erik,75,33,42,9,-9,32,17,26,0,0,2,5,2,0,0,9,15:17 - 6:11 - 12:14 - 0:0 - 0:0
15007971,2023-11-05 17:00:00,Petrosyan Davit - Darbinyan Armen,1:3,8:11 - 11:9 - 11:2 - 11:5 - 0:0,3,1,Petrosyan Davit,Darbinyan Armen,fiurst,Darbinyan Armen - Petrosyan Davit,68,27,41,14,-14,19,20,13,16,0,-3,2,9,6,0,14,11:8 - 9:11 - 2:11 - 5:11 - 0:0
15007968,2023-11-05 16:50:00,Grigoryan Erik - Gevorgyan Gegham,2:3,7:11 - 11:5 - 11:5 - 9:11 - 11:8,3,2,Grigoryan Erik,Gevorgyan Gegham,fiurst,Gevorgyan Gegham - Grigoryan Erik,89,40,49,9,-9,18,16,16,20,19,-4,6,6,-2,3,9,11:7 - 5:11 - 5:11 - 11:9 - 8:11
15007957,2023-11-05 16:30:00,Gevorgyan Hayk - Petrosyan Davit,0:3,8:11 - 9:11 - 6:11 - 0:0 - 0:0,0,3,Gevorgyan Hayk,Petrosyan Davit,fiurst,Gevorgyan Hayk - Petrosyan Davit,56,23,33,10,-10,19,20,17,0,0,3,2,5,0,0,10,8:11 - 9:11 - 6:11 - 0:0 - 0:0
15007955,2023-11-05 16:20:00,Darbinyan Armen - Grigoryan Erik,1:3,11:5 - 6:11 - 8:11 - 10:12 - 0:0,1,3,Darbinyan Armen,Grigoryan Erik,fiurst,Darbinyan Armen - Grigoryan Erik,74,35,39,4,-4,16,17,19,22,0,-6,5,3,2,0,4,11:5 - 6:11 - 8:11 - 10:12 - 0:0
15007954,2023-11-05 16:00:00,Gevorgyan Gegham - Petrosyan Davit,1:3,7:11 - 11:4 - 4:11 - 7:11 - 0:0,1,3,Gevorgyan Gegham,Petrosyan Davit,fiurst,Gevorgyan Gegham - Petrosyan Davit,66,29,37,8,-8,18,15,15,18,0,4,-7,7,4,0,8,7:11 - 11:4 - 4:11 - 7:11 - 0:0
15007949,2023-11-05 15:45:00,Gevorgyan Hayk - Darbinyan Armen,2:3,11:6 - 7:11 - 11:4 - 7:11 - 11:7,3,2,Gevorgyan Hayk,Darbinyan Armen,fiurst,Darbinyan Armen - Gevorgyan Hayk,86,39,47,8,-8,17,18,15,18,18,5,-4,7,-4,4,8,6:11 - 11:7 - 4:11 - 11:7 - 7:11
15007947,2023-11-05 15:30:00,Petrosyan Davit - Grigoryan Erik,0:3,13:11 - 12:10 - 11:4 - 0:0 - 0:0,3,0,Petrosyan Davit,Grigoryan Erik,fiurst,Grigoryan Erik - Petrosyan Davit,61,25,36,11,-11,24,22,15,0,0,2,2,7,0,0,11,11:13 - 10:12 - 4:11 - 0:0 - 0:0
15007945,2023-11-05 15:15:00,Gevorgyan Gegham - Gevorgyan Hayk,2:3,12:10 - 12:10 - 3:11 - 7:11 - 4:11,2,3,Gevorgyan Gegham,Gevorgyan Hayk,fiurst,Gevorgyan Gegham - Gevorgyan Hayk,91,38,53,15,-15,22,22,14,18,15,-2,-2,8,4,7,15,12:10 - 12:10 - 3:11 - 7:11 - 4:11
15007943,2023-11-05 15:00:00,Diaryan Aleksandr - Rafayelyan Edgar,1:3,11:8 - 6:11 - 6:11 - 7:11 - 0:0,1,3,Diaryan Aleksandr,Rafayelyan Edgar,fiurst,Diaryan Aleksandr - Rafayelyan Edgar,71,30,41,11,-11,19,17,17,18,0,-3,5,5,4,0,11,11:8 - 6:11 - 6:11 - 7:11 - 0:0
15007940,2023-11-05 14:50:00,Nazaryan Mushegh - Soghomonyan Hrayr,1:3,9:11 - 8:11 - 11:4 - 6:11 - 0:0,1,3,Nazaryan Mushegh,Soghomonyan Hrayr,fiurst,Nazaryan Mushegh - Soghomonyan Hrayr,71,34,37,3,-3,20,19,15,17,0,2,3,-7,5,0,3,9:11 - 8:11 - 11:4 - 6:11 - 0:0
15007935,2023-11-05 14:30:00,Nikoghosyan Narek - Diaryan Aleksandr,3:0,7:11 - 8:11 - 10:12 - 0:0 - 0:0,0,3,Nikoghosyan Narek,Diaryan Aleksandr,fiurst,Diaryan Aleksandr - Nikoghosyan Narek,59,34,25,-9,9,18,19,22,0,0,-4,-3,-2,0,0,-9,11:7 - 11:8 - 12:10 - 0:0 - 0:0
15007924,2023-11-05 14:15:00,Rafayelyan Edgar - Nazaryan Mushegh,2:3,12:14 - 11:8 - 11:2 - 9:11 - 13:11,3,2,Rafayelyan Edgar,Nazaryan Mushegh,fiurst,Nazaryan Mushegh - Rafayelyan Edgar,102,46,56,10,-10,26,19,13,20,24,-2,3,9,-2,2,10,14:12 - 8:11 - 2:11 - 11:9 - 11:13
15007923,2023-11-05 14:00:00,Nikoghosyan Narek - Soghomonyan Hrayr,3:0,11:5 - 11:4 - 11:6 - 0:0 - 0:0,3,0,Nikoghosyan Narek,Soghomonyan Hrayr,fiurst,Nikoghosyan Narek - Soghomonyan Hrayr,48,33,15,-18,18,16,15,17,0,0,-6,-7,-5,0,0,-18,11:5 - 11:4 - 11:6 - 0:0 - 0:0
15007922,2023-11-05 13:45:00,Diaryan Aleksandr - Nazaryan Mushegh,3:0,11:3 - 11:7 - 11:9 - 0:0 - 0:0,3,0,Diaryan Aleksandr,Nazaryan Mushegh,fiurst,Diaryan Aleksandr - Nazaryan Mushegh,52,33,19,-14,14,14,18,20,0,0,-8,-4,-2,0,0,-14,11:3 - 11:7 - 11:9 - 0:0 - 0:0
15007914,2023-11-05 13:30:00,Rafayelyan Edgar - Nikoghosyan Narek,1:3,12:10 - 6:11 - 11:4 - 11:6 - 0:0,3,1,Rafayelyan Edgar,Nikoghosyan Narek,fiurst,Nikoghosyan Narek - Rafayelyan Edgar,71,31,40,9,-9,22,17,15,17,0,2,-5,7,5,0,9,10:12 - 11:6 - 4:11 - 6:11 - 0:0
15007911,2023-11-05 13:15:00,Soghomonyan Hrayr - Diaryan Aleksandr,3:0,8:11 - 7:11 - 9:11 - 0:0 - 0:0,0,3,Soghomonyan Hrayr,Diaryan Aleksandr,fiurst,Diaryan Aleksandr - Soghomonyan Hrayr,57,33,24,-9,9,19,18,20,0,0,-3,-4,-2,0,0,-9,11:8 - 11:7 - 11:9 - 0:0 - 0:0
15007905,2023-11-05 13:05:00,Nazaryan Mushegh - Nikoghosyan Narek,3:1,5:11 - 11:4 - 11:5 - 11:9 - 0:0,3,1,Nazaryan Mushegh,Nikoghosyan Narek,fiurst,Nazaryan Mushegh - Nikoghosyan Narek,67,38,29,-9,9,16,15,16,20,0,6,-7,-6,-2,0,-9,5:11 - 11:4 - 11:5 - 11:9 - 0:0
15007896,2023-11-05 12:45:00,Soghomonyan Hrayr - Rafayelyan Edgar,3:0,3:11 - 5:11 - 8:11 - 0:0 - 0:0,0,3,Soghomonyan Hrayr,Rafayelyan Edgar,fiurst,Rafayelyan Edgar - Soghomonyan Hrayr,49,33,16,-17,17,14,16,19,0,0,-8,-6,-3,0,0,-17,11:3 - 11:5 - 11:8 - 0:0 - 0:0
15007895,2023-11-05 12:15:00,Diaryan Aleksandr - Nikoghosyan Narek,3:1,11:13 - 14:12 - 12:10 - 11:9 - 0:0,3,1,Diaryan Aleksandr,Nikoghosyan Narek,fiurst,Diaryan Aleksandr - Nikoghosyan Narek,92,48,44,-4,4,24,26,22,20,0,2,-2,-2,-2,0,-4,11:13 - 14:12 - 12:10 - 11:9 - 0:0
15007894,2023-11-05 12:00:00,Soghomonyan Hrayr - Nazaryan Mushegh,3:1,5:11 - 9:11 - 11:6 - 8:11 - 0:0,1,3,Soghomonyan Hrayr,Nazaryan Mushegh,fiurst,Nazaryan Mushegh - Soghomonyan Hrayr,72,39,33,-6,6,16,20,17,19,0,-6,-2,5,-3,0,-6,11:5 - 11:9 - 6:11 - 11:8 - 0:0
15007888,2023-11-05 11:55:00,Rafayelyan Edgar - Diaryan Aleksandr,0:3,11:7 - 11:8 - 11:2 - 0:0 - 0:0,3,0,Rafayelyan Edgar,Diaryan Aleksandr,fiurst,Diaryan Aleksandr - Rafayelyan Edgar,50,17,33,16,-16,18,19,13,0,0,4,3,9,0,0,16,7:11 - 8:11 - 2:11 - 0:0 - 0:0
15007881,2023-11-05 11:30:00,Soghomonyan Hrayr - Nikoghosyan Narek,3:0,7:11 - 5:11 - 6:11 - 0:0 - 0:0,0,3,Soghomonyan Hrayr,Nikoghosyan Narek,fiurst,Nikoghosyan Narek - Soghomonyan Hrayr,51,33,18,-15,15,18,16,17,0,0,-4,-6,-5,0,0,-15,11:7 - 11:5 - 11:6 - 0:0 - 0:0
15007880,2023-11-05 11:15:00,Nazaryan Mushegh - Rafayelyan Edgar,2:3,12:10 - 12:10 - 6:11 - 2:11 - 12:14,2,3,Nazaryan Mushegh,Rafayelyan Edgar,fiurst,Nazaryan Mushegh - Rafayelyan Edgar,100,44,56,12,-12,22,22,17,13,26,-2,-2,5,9,2,12,12:10 - 12:10 - 6:11 - 2:11 - 12:14
15007879,2023-11-05 11:00:00,Diaryan Aleksandr - Soghomonyan Hrayr,3:0,11:7 - 11:4 - 11:4 - 0:0 - 0:0,3,0,Diaryan Aleksandr,Soghomonyan Hrayr,fiurst,Diaryan Aleksandr - Soghomonyan Hrayr,48,33,15,-18,18,18,15,15,0,0,-4,-7,-7,0,0,-18,11:7 - 11:4 - 11:4 - 0:0 - 0:0
15007877,2023-11-05 10:45:00,Nikoghosyan Narek - Rafayelyan Edgar,0:3,8:11 - 9:11 - 2:11 - 0:0 - 0:0,0,3,Nikoghosyan Narek,Rafayelyan Edgar,fiurst,Nikoghosyan Narek - Rafayelyan Edgar,52,19,33,14,-14,19,20,13,0,0,3,2,9,0,0,14,8:11 - 9:11 - 2:11 - 0:0 - 0:0
15007876,2023-11-05 10:30:00,Nazaryan Mushegh - Diaryan Aleksandr,3:0,4:11 - 6:11 - 4:11 - 0:0 - 0:0,0,3,Nazaryan Mushegh,Diaryan Aleksandr,fiurst,Diaryan Aleksandr - Nazaryan Mushegh,47,33,14,-19,19,15,17,15,0,0,-7,-5,-7,0,0,-19,11:4 - 11:6 - 11:4 - 0:0 - 0:0
15007865,2023-11-05 10:15:00,Rafayelyan Edgar - Soghomonyan Hrayr,3:0,12:10 - 11:7 - 11:4 - 0:0 - 0:0,3,0,Rafayelyan Edgar,Soghomonyan Hrayr,fiurst,Rafayelyan Edgar - Soghomonyan Hrayr,55,34,21,-13,13,22,18,15,0,0,-2,-4,-7,0,0,-13,12:10 - 11:7 - 11:4 - 0:0 - 0:0
15007863,2023-11-05 10:00:00,Nikoghosyan Narek - Nazaryan Mushegh,1:3,12:10 - 5:11 - 11:5 - 11:4 - 0:0,3,1,Nikoghosyan Narek,Nazaryan Mushegh,fiurst,Nazaryan Mushegh - Nikoghosyan Narek,69,30,39,9,-9,22,16,16,15,0,2,-6,6,7,0,9,10:12 - 11:5 - 5:11 - 4:11 - 0:0
14988546,2023-11-04 17:30:00,Avakimyan Davit - Darbinyan Armen,2:3,11:8 - 11:7 - 9:11 - 5:11 - 5:11,2,3,Avakimyan Davit,Darbinyan Armen,fiurst,Avakimyan Davit - Darbinyan Armen,89,41,48,7,-7,19,18,20,16,16,-3,-4,2,6,6,7,11:8 - 11:7 - 9:11 - 5:11 - 5:11
14988543,2023-11-04 17:15:00,Mkrtchyan Andranik - Gevorgyan Gegham,1:3,6:11 - 11:3 - 13:11 - 11:6 - 0:0,3,1,Mkrtchyan Andranik,Gevorgyan Gegham,fiurst,Gevorgyan Gegham - Mkrtchyan Andranik,72,31,41,10,-10,17,14,24,17,0,-5,8,2,5,0,10,11:6 - 3:11 - 11:13 - 6:11 - 0:0
14988539,2023-11-04 17:10:00,Grigoryan Erik - Avakimyan Davit,3:0,8:11 - 10:12 - 8:11 - 0:0 - 0:0,0,3,Grigoryan Erik,Avakimyan Davit,fiurst,Avakimyan Davit - Grigoryan Erik,60,34,26,-8,8,19,22,19,0,0,-3,-2,-3,0,0,-8,11:8 - 12:10 - 11:8 - 0:0 - 0:0
14988537,2023-11-04 16:50:00,Mkrtchyan Andranik - Darbinyan Armen,0:3,11:7 - 11:3 - 11:4 - 0:0 - 0:0,3,0,Mkrtchyan Andranik,Darbinyan Armen,fiurst,Darbinyan Armen - Mkrtchyan Andranik,47,14,33,19,-19,18,14,15,0,0,4,8,7,0,0,19,7:11 - 3:11 - 4:11 - 0:0 - 0:0
14988535,2023-11-04 16:40:00,Gevorgyan Gegham - Grigoryan Erik,3:1,8:11 - 11:4 - 11:5 - 13:11 - 0:0,3,1,Gevorgyan Gegham,Grigoryan Erik,fiurst,Gevorgyan Gegham - Grigoryan Erik,74,43,31,-12,12,19,15,16,24,0,3,-7,-6,-2,0,-12,8:11 - 11:4 - 11:5 - 13:11 - 0:0
14995193,2023-11-04 16:15:00,Avakimyan Davit - Mkrtchyan Andranik,2:3,9:11 - 11:6 - 11:9 - 9:11 - 7:11,2,3,Avakimyan Davit,Mkrtchyan Andranik,fiurst,Avakimyan Davit - Mkrtchyan Andranik,95,47,48,1,-1,20,17,20,20,18,2,-5,-2,2,4,1,9:11 - 11:6 - 11:9 - 9:11 - 7:11
14988501,2023-11-04 16:00:00,Darbinyan Armen - Grigoryan Erik,3:2,9:11 - 9:11 - 11:9 - 11:6 - 11:4,3,2,Darbinyan Armen,Grigoryan Erik,fiurst,Darbinyan Armen - Grigoryan Erik,92,51,41,-10,10,20,20,20,17,15,2,2,-2,-5,-7,-10,9:11 - 9:11 - 11:9 - 11:6 - 11:4
14988499,2023-11-04 15:45:00,Gevorgyan Gegham - Avakimyan Davit,3:2,12:10 - 6:11 - 8:11 - 11:9 - 7:11,2,3,Gevorgyan Gegham,Avakimyan Davit,fiurst,Avakimyan Davit - Gevorgyan Gegham,96,52,44,-8,8,22,17,19,20,18,2,-5,-3,2,-4,-8,10:12 - 11:6 - 11:8 - 9:11 - 11:7
14988496,2023-11-04 15:30:00,Grigoryan Erik - Mkrtchyan Andranik,1:3,10:12 - 9:11 - 11:6 - 7:11 - 0:0,1,3,Grigoryan Erik,Mkrtchyan Andranik,fiurst,Grigoryan Erik - Mkrtchyan Andranik,77,37,40,3,-3,22,20,17,18,0,2,2,-5,4,0,3,10:12 - 9:11 - 11:6 - 7:11 - 0:0
14988486,2023-11-04 15:15:00,Darbinyan Armen - Gevorgyan Gegham,3:1,11:8 - 11:9 - 13:15 - 11:6 - 0:0,3,1,Darbinyan Armen,Gevorgyan Gegham,fiurst,Darbinyan Armen - Gevorgyan Gegham,84,46,38,-8,8,19,20,28,17,0,-3,-2,2,-5,0,-8,11:8 - 11:9 - 13:15 - 11:6 - 0:0
14984798,2023-11-04 15:05:00,Nikoghosyan Narek - Soghomonyan Hrayr,3:1,8:11 - 12:10 - 11:8 - 11:6 - 0:0,3,1,Nikoghosyan Narek,Soghomonyan Hrayr,fiurst,Nikoghosyan Narek - Soghomonyan Hrayr,77,42,35,-7,7,19,22,19,17,0,3,-2,-3,-5,0,-7,8:11 - 12:10 - 11:8 - 11:6 - 0:0
14984796,2023-11-04 15:00:00,Rafayelyan Edgar - Arutyunov Ruben,0:0,4:2 - 0:0 - 0:0 - 0:0 - 0:0,0,0,Rafayelyan Edgar,Arutyunov Ruben,fiurst,Arutyunov Ruben - Rafayelyan Edgar,6,2,4,2,-2,6,0,0,0,0,2,0,0,0,0,2,2:4 - 0:0 - 0:0 - 0:0 - 0:0
14984792,2023-11-04 14:35:00,Soghomonyan Hrayr - Rafayelyan Edgar,3:0,5:11 - 5:11 - 5:11 - 0:0 - 0:0,0,3,Soghomonyan Hrayr,Rafayelyan Edgar,fiurst,Rafayelyan Edgar - Soghomonyan Hrayr,48,33,15,-18,18,16,16,16,0,0,-6,-6,-6,0,0,-18,11:5 - 11:5 - 11:5 - 0:0 - 0:0
14984795,2023-11-04 14:35:00,Papyan Karen - Nikoghosyan Narek,1:3,6:11 - 13:11 - 11:4 - 11:8 - 0:0,3,1,Papyan Karen,Nikoghosyan Narek,fiurst,Nikoghosyan Narek - Papyan Karen,75,34,41,7,-7,17,24,15,19,0,-5,2,7,3,0,7,11:6 - 11:13 - 4:11 - 8:11 - 0:0
14984790,2023-11-04 14:00:00,Papyan Karen - Arutyunov Ruben,0:3,11:7 - 11:8 - 11:9 - 0:0 - 0:0,3,0,Papyan Karen,Arutyunov Ruben,fiurst,Arutyunov Ruben - Papyan Karen,57,24,33,9,-9,18,19,20,0,0,4,3,2,0,0,9,7:11 - 8:11 - 9:11 - 0:0 - 0:0
14984789,2023-11-04 13:55:00,Nikoghosyan Narek - Rafayelyan Edgar,2:3,9:11 - 11:9 - 9:11 - 11:7 - 4:11,2,3,Nikoghosyan Narek,Rafayelyan Edgar,fiurst,Nikoghosyan Narek - Rafayelyan Edgar,93,44,49,5,-5,20,20,20,18,15,2,-2,2,-4,7,5,9:11 - 11:9 - 9:11 - 11:7 - 4:11
14984787,2023-11-04 13:30:00,Soghomonyan Hrayr - Papyan Karen,3:0,7:11 - 11:13 - 7:11 - 0:0 - 0:0,0,3,Soghomonyan Hrayr,Papyan Karen,fiurst,Papyan Karen - Soghomonyan Hrayr,60,35,25,-10,10,18,24,18,0,0,-4,-2,-4,0,0,-10,11:7 - 13:11 - 11:7 - 0:0 - 0:0
14984775,2023-11-04 13:20:00,Arutyunov Ruben - Nikoghosyan Narek,1:3,12:14 - 2:11 - 11:8 - 8:11 - 0:0,1,3,Arutyunov Ruben,Nikoghosyan Narek,fiurst,Arutyunov Ruben - Nikoghosyan Narek,77,33,44,11,-11,26,13,19,19,0,2,9,-3,3,0,11,12:14 - 2:11 - 11:8 - 8:11 - 0:0
14984773,2023-11-04 13:00:00,Rafayelyan Edgar - Papyan Karen,0:3,11:9 - 11:6 - 11:7 - 0:0 - 0:0,3,0,Rafayelyan Edgar,Papyan Karen,fiurst,Papyan Karen - Rafayelyan Edgar,55,22,33,11,-11,20,17,18,0,0,2,5,4,0,0,11,9:11 - 6:11 - 7:11 - 0:0 - 0:0
14984772,2023-11-04 12:45:00,Arutyunov Ruben - Soghomonyan Hrayr,1:3,11:7 - 3:11 - 9:11 - 6:11 - 0:0,1,3,Arutyunov Ruben,Soghomonyan Hrayr,fiurst,Arutyunov Ruben - Soghomonyan Hrayr,69,29,40,11,-11,18,14,20,17,0,-4,8,2,5,0,11,11:7 - 3:11 - 9:11 - 6:11 - 0:0
14984771,2023-11-04 12:35:00,Nikoghosyan Narek - Papyan Karen,3:0,14:12 - 11:7 - 11:1 - 0:0 - 0:0,3,0,Nikoghosyan Narek,Papyan Karen,fiurst,Nikoghosyan Narek - Papyan Karen,56,36,20,-16,16,26,18,12,0,0,-2,-4,-10,0,0,-16,14:12 - 11:7 - 11:1 - 0:0 - 0:0
14983380,2023-11-04 12:33:53,Undefined - Undefined1,1:0,11:2 - 0:0 - 0:0 - 0:0 - 0:0,1,0,Undefined,Undefined1,fiurst,Undefined - Undefined1,13,11,2,-9,9,13,0,0,0,0,-9,0,0,0,0,-9,11:2 - 0:0 - 0:0 - 0:0 - 0:0
14984769,2023-11-04 12:10:00,Arutyunov Ruben - Rafayelyan Edgar,1:3,4:11 - 10:12 - 11:9 - 5:11 - 0:0,1,3,Arutyunov Ruben,Rafayelyan Edgar,fiurst,Arutyunov Ruben - Rafayelyan Edgar,73,30,43,13,-13,15,22,20,16,0,7,2,-2,6,0,13,4:11 - 10:12 - 11:9 - 5:11 - 0:0
14984766,2023-11-04 11:55:00,Soghomonyan Hrayr - Nikoghosyan Narek,2:3,11:13 - 9:11 - 13:11 - 11:6 - 12:10,3,2,Soghomonyan Hrayr,Nikoghosyan Narek,fiurst,Nikoghosyan Narek - Soghomonyan Hrayr,107,51,56,5,-5,24,20,24,17,22,-2,-2,2,5,2,5,13:11 - 11:9 - 11:13 - 6:11 - 10:12
14984763,2023-11-04 11:45:00,Arutyunov Ruben - Papyan Karen,3:0,11:1 - 11:9 - 11:2 - 0:0 - 0:0,3,0,Arutyunov Ruben,Papyan Karen,fiurst,Arutyunov Ruben - Papyan Karen,45,33,12,-21,21,12,20,13,0,0,-10,-2,-9,0,0,-21,11:1 - 11:9 - 11:2 - 0:0 - 0:0
14984762,2023-11-04 11:15:00,Rafayelyan Edgar - Soghomonyan Hrayr,2:3,6:11 - 9:11 - 11:8 - 11:8 - 8:11,2,3,Rafayelyan Edgar,Soghomonyan Hrayr,fiurst,Rafayelyan Edgar - Soghomonyan Hrayr,94,45,49,4,-4,17,20,19,19,19,5,2,-3,-3,3,4,6:11 - 9:11 - 11:8 - 11:8 - 8:11
14984761,2023-11-04 11:05:00,Nikoghosyan Narek - Arutyunov Ruben,3:2,6:11 - 12:10 - 11:0 - 5:11 - 7:11,2,3,Nikoghosyan Narek,Arutyunov Ruben,fiurst,Arutyunov Ruben - Nikoghosyan Narek,84,43,41,-2,2,17,22,11,16,18,-5,2,11,-6,-4,-2,11:6 - 10:12 - 0:11 - 11:5 - 11:7
14984749,2023-11-04 10:45:00,Papyan Karen - Soghomonyan Hrayr,3:2,11:9 - 6:11 - 3:11 - 11:8 - 17:15,3,2,Papyan Karen,Soghomonyan Hrayr,fiurst,Papyan Karen - Soghomonyan Hrayr,102,48,54,6,-6,20,17,14,19,32,-2,5,8,-3,-2,6,11:9 - 6:11 - 3:11 - 11:8 - 17:15
14984748,2023-11-04 10:30:00,Rafayelyan Edgar - Nikoghosyan Narek,2:3,5:11 - 11:5 - 11:3 - 9:11 - 11:7,3,2,Rafayelyan Edgar,Nikoghosyan Narek,fiurst,Nikoghosyan Narek - Rafayelyan Edgar,84,37,47,10,-10,16,16,14,20,18,-6,6,8,-2,4,10,11:5 - 5:11 - 3:11 - 11:9 - 7:11
14984747,2023-11-04 10:15:00,Soghomonyan Hrayr - Arutyunov Ruben,3:1,11:4 - 9:11 - 7:11 - 8:11 - 0:0,1,3,Soghomonyan Hrayr,Arutyunov Ruben,fiurst,Arutyunov Ruben - Soghomonyan Hrayr,72,37,35,-2,2,15,20,18,19,0,7,-2,-4,-3,0,-2,4:11 - 11:9 - 11:7 - 11:8 - 0:0
14984742,2023-11-04 10:00:00,Papyan Karen - Rafayelyan Edgar,1:3,7:11 - 6:11 - 11:6 - 7:11 - 0:0,1,3,Papyan Karen,Rafayelyan Edgar,fiurst,Papyan Karen - Rafayelyan Edgar,70,31,39,8,-8,18,17,17,18,0,4,5,-5,4,0,8,7:11 - 6:11 - 11:6 - 7:11 - 0:0
14963047,2023-11-03 17:30:00,Grigoryan Erik - Mkrtchyan Andranik,1:3,11:7 - 4:11 - 9:11 - 9:11 - 0:0,1,3,Grigoryan Erik,Mkrtchyan Andranik,fiurst,Grigoryan Erik - Mkrtchyan Andranik,73,33,40,7,-7,18,15,20,20,0,-4,7,2,2,0,7,11:7 - 4:11 - 9:11 - 9:11 - 0:0
14963046,2023-11-03 17:15:00,Petrosyan Davit - Avakimyan Davit,3:1,8:11 - 8:11 - 12:10 - 7:11 - 0:0,1,3,Petrosyan Davit,Avakimyan Davit,fiurst,Avakimyan Davit - Petrosyan Davit,78,43,35,-8,8,19,19,22,18,0,-3,-3,2,-4,0,-8,11:8 - 11:8 - 10:12 - 11:7 - 0:0
14963042,2023-11-03 17:05:00,Gevorgyan Gegham - Grigoryan Erik,3:0,11:4 - 13:11 - 13:11 - 0:0 - 0:0,3,0,Gevorgyan Gegham,Grigoryan Erik,fiurst,Gevorgyan Gegham - Grigoryan Erik,63,37,26,-11,11,15,24,24,0,0,-7,-2,-2,0,0,-11,11:4 - 13:11 - 13:11 - 0:0 - 0:0
14963041,2023-11-03 16:45:00,Petrosyan Davit - Mkrtchyan Andranik,3:1,7:11 - 11:4 - 3:11 - 9:11 - 0:0,1,3,Petrosyan Davit,Mkrtchyan Andranik,fiurst,Mkrtchyan Andranik - Petrosyan Davit,67,37,30,-7,7,18,15,14,20,0,-4,7,-8,-2,0,-7,11:7 - 4:11 - 11:3 - 11:9 - 0:0
14963030,2023-11-03 16:30:00,Avakimyan Davit - Gevorgyan Gegham,3:0,12:10 - 11:9 - 11:2 - 0:0 - 0:0,3,0,Avakimyan Davit,Gevorgyan Gegham,fiurst,Avakimyan Davit - Gevorgyan Gegham,55,34,21,-13,13,22,20,13,0,0,-2,-2,-9,0,0,-13,12:10 - 11:9 - 11:2 - 0:0 - 0:0
14963021,2023-11-03 16:15:00,Grigoryan Erik - Petrosyan Davit,2:3,5:11 - 11:3 - 11:6 - 8:11 - 9:11,2,3,Grigoryan Erik,Petrosyan Davit,fiurst,Grigoryan Erik - Petrosyan Davit,86,44,42,-2,2,16,14,17,19,20,6,-8,-5,3,2,-2,5:11 - 11:3 - 11:6 - 8:11 - 9:11
14963020,2023-11-03 16:00:00,Mkrtchyan Andranik - Gevorgyan Gegham,1:3,11:9 - 9:11 - 11:9 - 13:11 - 0:0,3,1,Mkrtchyan Andranik,Gevorgyan Gegham,fiurst,Gevorgyan Gegham - Mkrtchyan Andranik,84,40,44,4,-4,20,20,20,24,0,2,-2,2,2,0,4,9:11 - 11:9 - 9:11 - 11:13 - 0:0
14963018,2023-11-03 15:45:00,Avakimyan Davit - Grigoryan Erik,3:0,11:3 - 11:8 - 11:9 - 0:0 - 0:0,3,0,Avakimyan Davit,Grigoryan Erik,fiurst,Avakimyan Davit - Grigoryan Erik,53,33,20,-13,13,14,19,20,0,0,-8,-3,-2,0,0,-13,11:3 - 11:8 - 11:9 - 0:0 - 0:0
14963012,2023-11-03 15:30:00,Gevorgyan Gegham - Petrosyan Davit,3:0,11:9 - 12:10 - 11:7 - 0:0 - 0:0,3,0,Gevorgyan Gegham,Petrosyan Davit,fiurst,Gevorgyan Gegham - Petrosyan Davit,60,34,26,-8,8,20,22,18,0,0,-2,-2,-4,0,0,-8,11:9 - 12:10 - 11:7 - 0:0 - 0:0
14963008,2023-11-03 15:20:00,Mkrtchyan Andranik - Avakimyan Davit,2:3,8:11 - 6:11 - 11:9 - 12:10 - 11:2,3,2,Mkrtchyan Andranik,Avakimyan Davit,fiurst,Avakimyan Davit - Mkrtchyan Andranik,91,43,48,5,-5,19,17,20,22,13,-3,-5,2,2,9,5,11:8 - 11:6 - 9:11 - 10:12 - 2:11
14962995,2023-11-03 15:00:00,Nikoghosyan Narek - Diaryan Aleksandr,0:3,11:9 - 12:10 - 11:9 - 0:0 - 0:0,3,0,Nikoghosyan Narek,Diaryan Aleksandr,fiurst,Diaryan Aleksandr - Nikoghosyan Narek,62,28,34,6,-6,20,22,20,0,0,2,2,2,0,0,6,9:11 - 10:12 - 9:11 - 0:0 - 0:0
14963006,2023-11-03 15:00:00,Nazaryan Mushegh - Papyan Karen,0:0,0:0 - 0:0 - 0:0 - 0:0 - 0:0,0,0,Nazaryan Mushegh,Papyan Karen,fiurst,Nazaryan Mushegh - Papyan Karen,0,0,0,0,0,0,0,0,0,0,0,0,0,0,0,0,0:0 - 0:0 - 0:0 - 0:0 - 0:0
14962991,2023-11-03 14:30:00,Arutyunov Ruben - Nazaryan Mushegh,3:2,11:8 - 11:8 - 5:11 - 5:11 - 19:17,3,2,Arutyunov Ruben,Nazaryan Mushegh,fiurst,Arutyunov Ruben - Nazaryan Mushegh,106,51,55,4,-4,19,19,16,16,36,-3,-3,6,6,-2,4,11:8 - 11:8 - 5:11 - 5:11 - 19:17
14962987,2023-11-03 14:15:00,Papyan Karen - Nikoghosyan Narek,3:2,11:13 - 11:8 - 11:7 - 9:11 - 7:11,2,3,Papyan Karen,Nikoghosyan Narek,fiurst,Nikoghosyan Narek - Papyan Karen,99,50,49,-1,1,24,19,18,20,18,-2,3,4,-2,-4,-1,13:11 - 8:11 - 7:11 - 11:9 - 11:7
14962980,2023-11-03 14:05:00,Arutyunov Ruben - Diaryan Aleksandr,0:3,3:11 - 6:11 - 9:11 - 0:0 - 0:0,0,3,Arutyunov Ruben,Diaryan Aleksandr,fiurst,Arutyunov Ruben - Diaryan Aleksandr,51,18,33,15,-15,14,17,20,0,0,8,5,2,0,0,15,3:11 - 6:11 - 9:11 - 0:0 - 0:0
14962959,2023-11-03 13:45:00,Nazaryan Mushegh - Nikoghosyan Narek,2:3,11:4 - 11:8 - 7:11 - 9:11 - 8:11,2,3,Nazaryan Mushegh,Nikoghosyan Narek,fiurst,Nazaryan Mushegh - Nikoghosyan Narek,91,46,45,-1,1,15,19,18,20,19,-7,-3,4,2,3,-1,11:4 - 11:8 - 7:11 - 9:11 - 8:11
14962957,2023-11-03 13:30:00,Papyan Karen - Arutyunov Ruben,3:2,8:11 - 11:8 - 8:11 - 11:9 - 6:11,2,3,Papyan Karen,Arutyunov Ruben,fiurst,Arutyunov Ruben - Papyan Karen,94,50,44,-6,6,19,19,19,20,17,-3,3,-3,2,-5,-6,11:8 - 8:11 - 11:8 - 9:11 - 11:6
14962944,2023-11-03 13:15:00,Diaryan Aleksandr - Nazaryan Mushegh,3:0,11:5 - 11:6 - 11:6 - 0:0 - 0:0,3,0,Diaryan Aleksandr,Nazaryan Mushegh,fiurst,Diaryan Aleksandr - Nazaryan Mushegh,50,33,17,-16,16,16,17,17,0,0,-6,-5,-5,0,0,-16,11:5 - 11:6 - 11:6 - 0:0 - 0:0
14962942,2023-11-03 13:00:00,Nikoghosyan Narek - Arutyunov Ruben,0:3,11:4 - 11:3 - 11:6 - 0:0 - 0:0,3,0,Nikoghosyan Narek,Arutyunov Ruben,fiurst,Arutyunov Ruben - Nikoghosyan Narek,46,13,33,20,-20,15,14,17,0,0,7,8,5,0,0,20,4:11 - 3:11 - 6:11 - 0:0 - 0:0
14962937,2023-11-03 12:45:00,Diaryan Aleksandr - Papyan Karen,3:1,11:2 - 12:10 - 9:11 - 11:9 - 0:0,3,1,Diaryan Aleksandr,Papyan Karen,fiurst,Diaryan Aleksandr - Papyan Karen,75,43,32,-11,11,13,22,20,20,0,-9,-2,2,-2,0,-11,11:2 - 12:10 - 9:11 - 11:9 - 0:0
14962931,2023-11-03 12:15:00,Nazaryan Mushegh - Arutyunov Ruben,1:3,11:3 - 11:8 - 10:12 - 12:10 - 0:0,3,1,Nazaryan Mushegh,Arutyunov Ruben,fiurst,Arutyunov Ruben - Nazaryan Mushegh,77,33,44,11,-11,14,19,22,22,0,8,3,-2,2,0,11,3:11 - 8:11 - 12:10 - 10:12 - 0:0
14962928,2023-11-03 12:05:00,Diaryan Aleksandr - Nikoghosyan Narek,3:1,11:7 - 9:11 - 11:4 - 11:3 - 0:0,3,1,Diaryan Aleksandr,Nikoghosyan Narek,fiurst,Diaryan Aleksandr - Nikoghosyan Narek,67,42,25,-17,17,18,20,15,14,0,-4,2,-7,-8,0,-17,11:7 - 9:11 - 11:4 - 11:3 - 0:0
14962915,2023-11-03 11:45:00,Papyan Karen - Nazaryan Mushegh,1:3,11:7 - 8:11 - 11:6 - 11:7 - 0:0,3,1,Papyan Karen,Nazaryan Mushegh,fiurst,Nazaryan Mushegh - Papyan Karen,72,31,41,10,-10,18,19,17,18,0,4,-3,5,4,0,10,7:11 - 11:8 - 6:11 - 7:11 - 0:0
14962904,2023-11-03 11:30:00,Diaryan Aleksandr - Arutyunov Ruben,1:3,12:10 - 11:9 - 4:11 - 11:8 - 0:0,3,1,Diaryan Aleksandr,Arutyunov Ruben,fiurst,Arutyunov Ruben - Diaryan Aleksandr,76,38,38,0,0,22,20,15,19,0,2,2,-7,3,0,0,10:12 - 9:11 - 11:4 - 8:11 - 0:0
14962901,2023-11-03 11:15:00,Nikoghosyan Narek - Papyan Karen,3:1,11:6 - 11:4 - 5:11 - 11:4 - 0:0,3,1,Nikoghosyan Narek,Papyan Karen,fiurst,Nikoghosyan Narek - Papyan Karen,63,38,25,-13,13,17,15,16,15,0,-5,-7,6,-7,0,-13,11:6 - 11:4 - 5:11 - 11:4 - 0:0
14962898,2023-11-03 11:05:00,Nazaryan Mushegh - Diaryan Aleksandr,3:0,5:11 - 9:11 - 8:11 - 0:0 - 0:0,0,3,Nazaryan Mushegh,Diaryan Aleksandr,fiurst,Diaryan Aleksandr - Nazaryan Mushegh,55,33,22,-11,11,16,20,19,0,0,-6,-2,-3,0,0,-11,11:5 - 11:9 - 11:8 - 0:0 - 0:0
14962884,2023-11-03 10:45:00,Arutyunov Ruben - Papyan Karen,3:2,4:11 - 11:6 - 7:11 - 11:7 - 11:7,3,2,Arutyunov Ruben,Papyan Karen,fiurst,Arutyunov Ruben - Papyan Karen,86,44,42,-2,2,15,17,18,18,18,7,-5,4,-4,-4,-2,4:11 - 11:6 - 7:11 - 11:7 - 11:7
14962882,2023-11-03 10:30:00,Nikoghosyan Narek - Nazaryan Mushegh,1:3,5:11 - 11:7 - 11:6 - 11:9 - 0:0,3,1,Nikoghosyan Narek,Nazaryan Mushegh,fiurst,Nazaryan Mushegh - Nikoghosyan Narek,71,33,38,5,-5,16,18,17,20,0,-6,4,5,2,0,5,11:5 - 7:11 - 6:11 - 9:11 - 0:0
14962874,2023-11-03 10:25:00,Papyan Karen - Diaryan Aleksandr,3:0,9:11 - 2:11 - 3:11 - 0:0 - 0:0,0,3,Papyan Karen,Diaryan Aleksandr,fiurst,Diaryan Aleksandr - Papyan Karen,47,33,14,-19,19,20,13,14,0,0,-2,-9,-8,0,0,-19,11:9 - 11:2 - 11:3 - 0:0 - 0:0
14962873,2023-11-03 10:00:00,Arutyunov Ruben - Nikoghosyan Narek,2:3,4:11 - 13:11 - 11:5 - 6:11 - 4:11,2,3,Arutyunov Ruben,Nikoghosyan Narek,fiurst,Arutyunov Ruben - Nikoghosyan Narek,87,38,49,11,-11,15,24,16,17,15,7,-2,-6,5,7,11,4:11 - 13:11 - 11:5 - 6:11 - 4:11
14944478,2023-11-02 17:30:00,Darbinyan Armen - Avakimyan Davit,3:0,6:11 - 8:11 - 7:11 - 0:0 - 0:0,0,3,Darbinyan Armen,Avakimyan Davit,fiurst,Avakimyan Davit - Darbinyan Armen,54,33,21,-12,12,17,19,18,0,0,-5,-3,-4,0,0,-12,11:6 - 11:8 - 11:7 - 0:0 - 0:0
14944477,2023-11-02 17:05:00,Petrosyan Davit - Mkrtchyan Andranik,2:3,11:6 - 7:11 - 11:8 - 9:11 - 11:9,3,2,Petrosyan Davit,Mkrtchyan Andranik,fiurst,Mkrtchyan Andranik - Petrosyan Davit,94,45,49,4,-4,17,18,19,20,20,5,-4,3,-2,2,4,6:11 - 11:7 - 8:11 - 11:9 - 9:11
14944476,2023-11-02 17:00:00,Gevorgyan Gegham - Darbinyan Armen,0:3,11:7 - 11:4 - 11:6 - 0:0 - 0:0,3,0,Gevorgyan Gegham,Darbinyan Armen,fiurst,Darbinyan Armen - Gevorgyan Gegham,50,17,33,16,-16,18,15,17,0,0,4,7,5,0,0,16,7:11 - 4:11 - 6:11 - 0:0 - 0:0
14944474,2023-11-02 16:45:00,Petrosyan Davit - Avakimyan Davit,3:0,9:11 - 16:18 - 12:14 - 0:0 - 0:0,0,3,Petrosyan Davit,Avakimyan Davit,fiurst,Avakimyan Davit - Petrosyan Davit,80,43,37,-6,6,20,34,26,0,0,-2,-2,-2,0,0,-6,11:9 - 18:16 - 14:12 - 0:0 - 0:0
14944446,2023-11-02 16:30:00,Mkrtchyan Andranik - Gevorgyan Gegham,1:3,8:11 - 11:8 - 11:7 - 11:9 - 0:0,3,1,Mkrtchyan Andranik,Gevorgyan Gegham,fiurst,Gevorgyan Gegham - Mkrtchyan Andranik,76,35,41,6,-6,19,19,18,20,0,-3,3,4,2,0,6,11:8 - 8:11 - 7:11 - 9:11 - 0:0
14944423,2023-11-02 16:15:00,Darbinyan Armen - Petrosyan Davit,2:3,12:10 - 9:11 - 6:11 - 11:8 - 7:11,2,3,Darbinyan Armen,Petrosyan Davit,fiurst,Darbinyan Armen - Petrosyan Davit,96,45,51,6,-6,22,20,17,19,18,-2,2,5,-3,4,6,12:10 - 9:11 - 6:11 - 11:8 - 7:11
14944421,2023-11-02 16:05:00,Avakimyan Davit - Gevorgyan Gegham,1:3,11:5 - 5:11 - 3:11 - 5:11 - 0:0,1,3,Avakimyan Davit,Gevorgyan Gegham,fiurst,Avakimyan Davit - Gevorgyan Gegham,62,24,38,14,-14,16,16,14,16,0,-6,6,8,6,0,14,11:5 - 5:11 - 3:11 - 5:11 - 0:0
14944394,2023-11-02 15:45:00,Mkrtchyan Andranik - Darbinyan Armen,0:3,11:6 - 11:3 - 11:6 - 0:0 - 0:0,3,0,Mkrtchyan Andranik,Darbinyan Armen,fiurst,Darbinyan Armen - Mkrtchyan Andranik,48,15,33,18,-18,17,14,17,0,0,5,8,5,0,0,18,6:11 - 3:11 - 6:11 - 0:0 - 0:0
14944390,2023-11-02 15:30:00,Gevorgyan Gegham - Petrosyan Davit,1:3,10:12 - 12:10 - 3:11 - 8:11 - 0:0,1,3,Gevorgyan Gegham,Petrosyan Davit,fiurst,Gevorgyan Gegham - Petrosyan Davit,77,33,44,11,-11,22,22,14,19,0,2,-2,8,3,0,11,10:12 - 12:10 - 3:11 - 8:11 - 0:0
14944385,2023-11-02 15:15:00,Avakimyan Davit - Mkrtchyan Andranik,3:2,7:11 - 11:7 - 11:7 - 9:11 - 11:5,3,2,Avakimyan Davit,Mkrtchyan Andranik,fiurst,Avakimyan Davit - Mkrtchyan Andranik,90,49,41,-8,8,18,18,18,20,16,4,-4,-4,2,-6,-8,7:11 - 11:7 - 11:7 - 9:11 - 11:5
14944382,2023-11-02 15:00:00,Soghomonyan Hrayr - Diaryan Aleksandr,2:3,11:13 - 9:11 - 11:7 - 11:5 - 11:5,3,2,Soghomonyan Hrayr,Diaryan Aleksandr,fiurst,Diaryan Aleksandr - Soghomonyan Hrayr,94,41,53,12,-12,24,20,18,16,16,-2,-2,4,6,6,12,13:11 - 11:9 - 7:11 - 5:11 - 5:11
14944372,2023-11-02 14:45:00,Rafayelyan Edgar - Arutyunov Ruben,0:3,11:8 - 11:7 - 11:4 - 0:0 - 0:0,3,0,Rafayelyan Edgar,Arutyunov Ruben,fiurst,Arutyunov Ruben - Rafayelyan Edgar,52,19,33,14,-14,19,18,15,0,0,3,4,7,0,0,14,8:11 - 7:11 - 4:11 - 0:0 - 0:0
14944370,2023-11-02 14:40:00,Nazaryan Mushegh - Soghomonyan Hrayr,3:0,11:8 - 11:6 - 11:6 - 0:0 - 0:0,3,0,Nazaryan Mushegh,Soghomonyan Hrayr,fiurst,Nazaryan Mushegh - Soghomonyan Hrayr,53,33,20,-13,13,19,17,17,0,0,-3,-5,-5,0,0,-13,11:8 - 11:6 - 11:6 - 0:0 - 0:0
14944367,2023-11-02 14:15:00,Diaryan Aleksandr - Rafayelyan Edgar,3:2,11:9 - 10:12 - 11:2 - 7:11 - 11:9,3,2,Diaryan Aleksandr,Rafayelyan Edgar,fiurst,Diaryan Aleksandr - Rafayelyan Edgar,93,50,43,-7,7,20,22,13,18,20,-2,2,-9,4,-2,-7,11:9 - 10:12 - 11:2 - 7:11 - 11:9
14944365,2023-11-02 14:00:00,Nazaryan Mushegh - Arutyunov Ruben,3:2,11:5 - 13:11 - 6:11 - 7:11 - 15:17,2,3,Nazaryan Mushegh,Arutyunov Ruben,fiurst,Arutyunov Ruben - Nazaryan Mushegh,107,55,52,-3,3,16,24,17,18,32,6,2,-5,-4,-2,-3,5:11 - 11:13 - 11:6 - 11:7 - 17:15
14944353,2023-11-02 13:50:00,Soghomonyan Hrayr - Rafayelyan Edgar,3:0,6:11 - 10:12 - 9:11 - 0:0 - 0:0,0,3,Soghomonyan Hrayr,Rafayelyan Edgar,fiurst,Rafayelyan Edgar - Soghomonyan Hrayr,59,34,25,-9,9,17,22,20,0,0,-5,-2,-2,0,0,-9,11:6 - 12:10 - 11:9 - 0:0 - 0:0
14944344,2023-11-02 13:30:00,Diaryan Aleksandr - Nazaryan Mushegh,3:1,4:11 - 11:9 - 11:5 - 11:3 - 0:0,3,1,Diaryan Aleksandr,Nazaryan Mushegh,fiurst,Diaryan Aleksandr - Nazaryan Mushegh,65,37,28,-9,9,15,20,16,14,0,7,-2,-6,-8,0,-9,4:11 - 11:9 - 11:5 - 11:3 - 0:0
14944333,2023-11-02 13:20:00,Arutyunov Ruben - Soghomonyan Hrayr,1:3,11:13 - 8:11 - 11:7 - 6:11 - 0:0,1,3,Arutyunov Ruben,Soghomonyan Hrayr,fiurst,Arutyunov Ruben - Soghomonyan Hrayr,78,36,42,6,-6,24,19,18,17,0,2,3,-4,5,0,6,11:13 - 8:11 - 11:7 - 6:11 - 0:0
14944332,2023-11-02 13:00:00,Rafayelyan Edgar - Nazaryan Mushegh,0:3,11:9 - 11:5 - 11:8 - 0:0 - 0:0,3,0,Rafayelyan Edgar,Nazaryan Mushegh,fiurst,Nazaryan Mushegh - Rafayelyan Edgar,55,22,33,11,-11,20,16,19,0,0,2,6,3,0,0,11,9:11 - 5:11 - 8:11 - 0:0 - 0:0
14944325,2023-11-02 12:55:00,Arutyunov Ruben - Diaryan Aleksandr,0:3,3:11 - 9:11 - 4:11 - 0:0 - 0:0,0,3,Arutyunov Ruben,Diaryan Aleksandr,fiurst,Arutyunov Ruben - Diaryan Aleksandr,49,16,33,17,-17,14,20,15,0,0,8,2,7,0,0,17,3:11 - 9:11 - 4:11 - 0:0 - 0:0
14944322,2023-11-02 12:20:00,Soghomonyan Hrayr - Nazaryan Mushegh,2:3,11:7 - 11:2 - 9:11 - 8:11 - 11:7,3,2,Soghomonyan Hrayr,Nazaryan Mushegh,fiurst,Nazaryan Mushegh - Soghomonyan Hrayr,88,38,50,12,-12,18,13,20,19,18,4,9,-2,-3,4,12,7:11 - 2:11 - 11:9 - 11:8 - 7:11
14944318,2023-11-02 12:15:00,Arutyunov Ruben - Rafayelyan Edgar,2:3,7:11 - 11:7 - 11:9 - 7:11 - 6:11,2,3,Arutyunov Ruben,Rafayelyan Edgar,fiurst,Arutyunov Ruben - Rafayelyan Edgar,91,42,49,7,-7,18,18,20,18,17,4,-4,-2,4,5,7,7:11 - 11:7 - 11:9 - 7:11 - 6:11
14944314,2023-11-02 11:50:00,Diaryan Aleksandr - Soghomonyan Hrayr,3:1,11:7 - 11:7 - 9:11 - 11:7 - 0:0,3,1,Diaryan Aleksandr,Soghomonyan Hrayr,fiurst,Diaryan Aleksandr - Soghomonyan Hrayr,74,42,32,-10,10,18,18,20,18,0,-4,-4,2,-4,0,-10,11:7 - 11:7 - 9:11 - 11:7 - 0:0
14944302,2023-11-02 11:40:00,Arutyunov Ruben - Nazaryan Mushegh,3:1,11:8 - 8:11 - 17:15 - 11:6 - 0:0,3,1,Arutyunov Ruben,Nazaryan Mushegh,fiurst,Arutyunov Ruben - Nazaryan Mushegh,87,47,40,-7,7,19,19,32,17,0,-3,3,-2,-5,0,-7,11:8 - 8:11 - 17:15 - 11:6 - 0:0
14944299,2023-11-02 11:15:00,Rafayelyan Edgar - Diaryan Aleksandr,3:1,11:7 - 7:11 - 3:11 - 9:11 - 0:0,1,3,Rafayelyan Edgar,Diaryan Aleksandr,fiurst,Diaryan Aleksandr - Rafayelyan Edgar,70,40,30,-10,10,18,18,14,20,0,4,-4,-8,-2,0,-10,7:11 - 11:7 - 11:3 - 11:9 - 0:0
14944297,2023-11-02 11:10:00,Soghomonyan Hrayr - Arutyunov Ruben,1:3,11:7 - 12:10 - 5:11 - 11:9 - 0:0,3,1,Soghomonyan Hrayr,Arutyunov Ruben,fiurst,Arutyunov Ruben - Soghomonyan Hrayr,76,37,39,2,-2,18,22,16,20,0,4,2,-6,2,0,2,7:11 - 10:12 - 11:5 - 9:11 - 0:0
14944292,2023-11-02 10:45:00,Nazaryan Mushegh - Diaryan Aleksandr,3:1,6:11 - 11:7 - 4:11 - 7:11 - 0:0,1,3,Nazaryan Mushegh,Diaryan Aleksandr,fiurst,Diaryan Aleksandr - Nazaryan Mushegh,68,40,28,-12,12,17,18,15,18,0,-5,4,-7,-4,0,-12,11:6 - 7:11 - 11:4 - 11:7 - 0:0
14944290,2023-11-02 10:30:00,Rafayelyan Edgar - Soghomonyan Hrayr,3:2,9:11 - 6:11 - 11:8 - 15:13 - 11:6,3,2,Rafayelyan Edgar,Soghomonyan Hrayr,fiurst,Rafayelyan Edgar - Soghomonyan Hrayr,101,52,49,-3,3,20,17,19,28,17,2,5,-3,-2,-5,-3,9:11 - 6:11 - 11:8 - 15:13 - 11:6
14944288,2023-11-02 10:20:00,Diaryan Aleksandr - Arutyunov Ruben,0:3,11:9 - 11:5 - 11:7 - 0:0 - 0:0,3,0,Diaryan Aleksandr,Arutyunov Ruben,fiurst,Arutyunov Ruben - Diaryan Aleksandr,54,21,33,12,-12,20,16,18,0,0,2,6,4,0,0,12,9:11 - 5:11 - 7:11 - 0:0 - 0:0
14929356,2023-11-02 10:00:00,Nazaryan Mushegh - Rafayelyan Edgar,1:3,5:11 - 9:11 - 11:9 - 5:11 - 0:0,1,3,Nazaryan Mushegh,Rafayelyan Edgar,fiurst,Nazaryan Mushegh - Rafayelyan Edgar,72,30,42,12,-12,16,20,20,16,0,6,2,-2,6,0,12,5:11 - 9:11 - 11:9 - 5:11 - 0:0
14929779,2023-11-01 17:15:00,Mkrtchyan Andranik - Avakimyan Davit,2:3,11:4 - 8:11 - 25:23 - 9:11 - 11:6,3,2,Mkrtchyan Andranik,Avakimyan Davit,fiurst,Avakimyan Davit - Mkrtchyan Andranik,119,55,64,9,-9,15,19,48,20,17,7,-3,2,-2,5,9,4:11 - 11:8 - 23:25 - 11:9 - 6:11
14929781,2023-11-01 17:15:00,Darbinyan Armen - Petrosyan Davit,2:3,11:9 - 5:11 - 11:7 - 9:11 - 1:11,2,3,Darbinyan Armen,Petrosyan Davit,fiurst,Darbinyan Armen - Petrosyan Davit,86,37,49,12,-12,20,16,18,20,12,-2,6,-4,2,10,12,11:9 - 5:11 - 11:7 - 9:11 - 1:11
14929767,2023-11-01 17:00:00,Gevorgyan Hayk - Darbinyan Armen,0:3,11:6 - 11:7 - 11:8 - 0:0 - 0:0,3,0,Gevorgyan Hayk,Darbinyan Armen,fiurst,Darbinyan Armen - Gevorgyan Hayk,54,21,33,12,-12,17,18,19,0,0,5,4,3,0,0,12,6:11 - 7:11 - 8:11 - 0:0 - 0:0
14929765,2023-11-01 16:45:00,Mkrtchyan Andranik - Petrosyan Davit,3:0,11:4 - 11:3 - 12:10 - 0:0 - 0:0,3,0,Mkrtchyan Andranik,Petrosyan Davit,fiurst,Mkrtchyan Andranik - Petrosyan Davit,51,34,17,-17,17,15,14,22,0,0,-7,-8,-2,0,0,-17,11:4 - 11:3 - 12:10 - 0:0 - 0:0
14929763,2023-11-01 16:30:00,Avakimyan Davit - Gevorgyan Hayk,1:3,11:13 - 11:8 - 4:11 - 5:11 - 0:0,1,3,Avakimyan Davit,Gevorgyan Hayk,fiurst,Avakimyan Davit - Gevorgyan Hayk,74,31,43,12,-12,24,19,15,16,0,2,-3,7,6,0,12,11:13 - 11:8 - 4:11 - 5:11 - 0:0
14929761,2023-11-01 16:15:00,Darbinyan Armen - Mkrtchyan Andranik,1:3,11:9 - 7:11 - 7:11 - 7:11 - 0:0,1,3,Darbinyan Armen,Mkrtchyan Andranik,fiurst,Darbinyan Armen - Mkrtchyan Andranik,74,32,42,10,-10,20,18,18,18,0,-2,4,4,4,0,10,11:9 - 7:11 - 7:11 - 7:11 - 0:0
14929755,2023-11-01 16:00:00,Petrosyan Davit - Gevorgyan Hayk,3:0,6:11 - 7:11 - 7:11 - 0:0 - 0:0,0,3,Petrosyan Davit,Gevorgyan Hayk,fiurst,Gevorgyan Hayk - Petrosyan Davit,53,33,20,-13,13,17,18,18,0,0,-5,-4,-4,0,0,-13,11:6 - 11:7 - 11:7 - 0:0 - 0:0
14929750,2023-11-01 15:55:00,Avakimyan Davit - Darbinyan Armen,3:0,11:7 - 15:13 - 11:9 - 0:0 - 0:0,3,0,Avakimyan Davit,Darbinyan Armen,fiurst,Avakimyan Davit - Darbinyan Armen,66,37,29,-8,8,18,28,20,0,0,-4,-2,-2,0,0,-8,11:7 - 15:13 - 11:9 - 0:0 - 0:0
14929734,2023-11-01 15:30:00,Gevorgyan Hayk - Mkrtchyan Andranik,1:3,10:12 - 11:9 - 7:11 - 8:11 - 0:0,1,3,Gevorgyan Hayk,Mkrtchyan Andranik,fiurst,Gevorgyan Hayk - Mkrtchyan Andranik,79,36,43,7,-7,22,20,18,19,0,2,-2,4,3,0,7,10:12 - 11:9 - 7:11 - 8:11 - 0:0
14929731,2023-11-01 15:15:00,Petrosyan Davit - Avakimyan Davit,2:3,11:9 - 9:11 - 11:8 - 8:11 - 11:9,3,2,Petrosyan Davit,Avakimyan Davit,fiurst,Avakimyan Davit - Petrosyan Davit,98,48,50,2,-2,20,20,19,19,20,2,-2,3,-3,2,2,9:11 - 11:9 - 8:11 - 11:8 - 9:11
14929434,2023-11-01 15:00:00,Rafayelyan Edgar - Nikoghosyan Narek,2:3,11:8 - 18:16 - 8:11 - 4:11 - 11:8,3,2,Rafayelyan Edgar,Nikoghosyan Narek,fiurst,Nikoghosyan Narek - Rafayelyan Edgar,106,54,52,-2,2,19,34,19,15,19,3,2,-3,-7,3,-2,8:11 - 16:18 - 11:8 - 11:4 - 8:11
14929432,2023-11-01 14:30:00,Diaryan Aleksandr - Rafayelyan Edgar,3:0,11:5 - 11:3 - 11:7 - 0:0 - 0:0,3,0,Diaryan Aleksandr,Rafayelyan Edgar,fiurst,Diaryan Aleksandr - Rafayelyan Edgar,48,33,15,-18,18,16,14,18,0,0,-6,-8,-4,0,0,-18,11:5 - 11:3 - 11:7 - 0:0 - 0:0
14929385,2023-11-01 14:20:00,Nikoghosyan Narek - Soghomonyan Hrayr,0:3,8:11 - 8:11 - 6:11 - 0:0 - 0:0,0,3,Nikoghosyan Narek,Soghomonyan Hrayr,fiurst,Nikoghosyan Narek - Soghomonyan Hrayr,55,22,33,11,-11,19,19,17,0,0,3,3,5,0,0,11,8:11 - 8:11 - 6:11 - 0:0 - 0:0
14929372,2023-11-01 13:45:00,Rafayelyan Edgar - Soghomonyan Hrayr,2:3,2:11 - 11:8 - 11:9 - 9:11 - 3:11,2,3,Rafayelyan Edgar,Soghomonyan Hrayr,fiurst,Rafayelyan Edgar - Soghomonyan Hrayr,86,36,50,14,-14,13,19,20,20,14,9,-3,-2,2,8,14,2:11 - 11:8 - 11:9 - 9:11 - 3:11
14929371,2023-11-01 13:30:00,Nikoghosyan Narek - Diaryan Aleksandr,3:2,13:11 - 7:11 - 6:11 - 19:17 - 4:11,2,3,Nikoghosyan Narek,Diaryan Aleksandr,fiurst,Diaryan Aleksandr - Nikoghosyan Narek,110,61,49,-12,12,24,18,17,36,15,2,-4,-5,2,-7,-12,11:13 - 11:7 - 11:6 - 17:19 - 11:4
14929369,2023-11-01 13:00:00,Soghomonyan Hrayr - Diaryan Aleksandr,3:0,7:11 - 7:11 - 5:11 - 0:0 - 0:0,0,3,Soghomonyan Hrayr,Diaryan Aleksandr,fiurst,Diaryan Aleksandr - Soghomonyan Hrayr,52,33,19,-14,14,18,18,16,0,0,-4,-4,-6,0,0,-14,11:7 - 11:7 - 11:5 - 0:0 - 0:0
14928904,2023-11-01 12:20:00,Rafayelyan Edgar - Diaryan Aleksandr,3:2,4:11 - 11:7 - 11:5 - 8:11 - 8:11,2,3,Rafayelyan Edgar,Diaryan Aleksandr,fiurst,Diaryan Aleksandr - Rafayelyan Edgar,87,45,42,-3,3,15,18,16,19,19,-7,4,6,-3,-3,-3,11:4 - 7:11 - 5:11 - 11:8 - 11:8
14928893,2023-11-01 12:00:00,Nikoghosyan Narek - Rafayelyan Edgar,3:0,11:5 - 11:9 - 11:9 - 0:0 - 0:0,3,0,Nikoghosyan Narek,Rafayelyan Edgar,fiurst,Nikoghosyan Narek - Rafayelyan Edgar,56,33,23,-10,10,16,20,20,0,0,-6,-2,-2,0,0,-10,11:5 - 11:9 - 11:9 - 0:0 - 0:0
14928880,2023-11-01 11:20:00,Soghomonyan Hrayr - Nikoghosyan Narek,3:2,11:13 - 11:5 - 7:11 - 11:5 - 7:11,2,3,Soghomonyan Hrayr,Nikoghosyan Narek,fiurst,Nikoghosyan Narek - Soghomonyan Hrayr,92,45,47,2,-2,24,16,18,16,18,-2,6,-4,6,-4,2,13:11 - 5:11 - 11:7 - 5:11 - 11:7
14928863,2023-11-01 10:45:00,Diaryan Aleksandr - Nikoghosyan Narek,3:1,12:10 - 14:16 - 11:5 - 11:4 - 0:0,3,1,Diaryan Aleksandr,Nikoghosyan Narek,fiurst,Diaryan Aleksandr - Nikoghosyan Narek,83,48,35,-13,13,22,30,16,15,0,-2,2,-6,-7,0,-13,12:10 - 14:16 - 11:5 - 11:4 - 0:0
14928861,2023-11-01 10:30:00,Soghomonyan Hrayr - Rafayelyan Edgar,1:3,11:7 - 10:12 - 11:6 - 11:6 - 0:0,3,1,Soghomonyan Hrayr,Rafayelyan Edgar,fiurst,Rafayelyan Edgar - Soghomonyan Hrayr,74,31,43,12,-12,18,22,17,17,0,4,-2,5,5,0,12,7:11 - 12:10 - 6:11 - 6:11 - 0:0
14928858,2023-11-01 10:15:00,Nikoghosyan Narek - Papyan Karen,3:1,3:11 - 11:9 - 11:7 - 11:5 - 0:0,3,1,Nikoghosyan Narek,Papyan Karen,fiurst,Nikoghosyan Narek - Papyan Karen,68,36,32,-4,4,14,20,18,16,0,8,-2,-4,-6,0,-4,3:11 - 11:9 - 11:7 - 11:5 - 0:0
14928856,2023-11-01 10:00:00,Diaryan Aleksandr - Soghomonyan Hrayr,3:0,11:7 - 11:9 - 11:4 - 0:0 - 0:0,3,0,Diaryan Aleksandr,Soghomonyan Hrayr,fiurst,Diaryan Aleksandr - Soghomonyan Hrayr,53,33,20,-13,13,18,20,15,0,0,-4,-2,-7,0,0,-13,11:7 - 11:9 - 11:4 - 0:0 - 0:0
14920439,2023-10-31 17:30:00,Darbinyan Armen - Gevorgyan Hayk,0:3,8:11 - 11:13 - 6:11 - 0:0 - 0:0,0,3,Darbinyan Armen,Gevorgyan Hayk,fiurst,Darbinyan Armen - Gevorgyan Hayk,60,25,35,10,-10,19,24,17,0,0,3,2,5,0,0,10,8:11 - 11:13 - 6:11 - 0:0 - 0:0
14920425,2023-10-31 17:20:00,Gevorgyan Gegham - Petrosyan Davit,2:3,11:8 - 11:6 - 6:11 - 7:11 - 7:11,2,3,Gevorgyan Gegham,Petrosyan Davit,fiurst,Gevorgyan Gegham - Petrosyan Davit,89,42,47,5,-5,19,17,17,18,18,-3,-5,5,4,4,5,11:8 - 11:6 - 6:11 - 7:11 - 7:11
14920423,2023-10-31 17:00:00,Mkrtchyan Andranik - Darbinyan Armen,0:3,11:5 - 11:4 - 11:5 - 0:0 - 0:0,3,0,Mkrtchyan Andranik,Darbinyan Armen,fiurst,Darbinyan Armen - Mkrtchyan Andranik,47,14,33,19,-19,16,15,16,0,0,6,7,6,0,0,19,5:11 - 4:11 - 5:11 - 0:0 - 0:0
14920419,2023-10-31 16:45:00,Gevorgyan Gegham - Gevorgyan Hayk,2:3,5:11 - 11:5 - 6:11 - 11:7 - 6:11,2,3,Gevorgyan Gegham,Gevorgyan Hayk,fiurst,Gevorgyan Gegham - Gevorgyan Hayk,84,39,45,6,-6,16,16,17,18,17,6,-6,5,-4,5,6,5:11 - 11:5 - 6:11 - 11:7 - 6:11
14917403,2023-10-31 16:30:00,Petrosyan Davit - Mkrtchyan Andranik,3:0,7:11 - 8:11 - 9:11 - 0:0 - 0:0,0,3,Petrosyan Davit,Mkrtchyan Andranik,fiurst,Mkrtchyan Andranik - Petrosyan Davit,57,33,24,-9,9,18,19,20,0,0,-4,-3,-2,0,0,-9,11:7 - 11:8 - 11:9 - 0:0 - 0:0
14917424,2023-10-31 16:15:00,Darbinyan Armen - Gevorgyan Gegham,0:3,6:11 - 3:11 - 5:11 - 0:0 - 0:0,0,3,Darbinyan Armen,Gevorgyan Gegham,fiurst,Darbinyan Armen - Gevorgyan Gegham,47,14,33,19,-19,17,14,16,0,0,5,8,6,0,0,19,6:11 - 3:11 - 5:11 - 0:0 - 0:0
14917413,2023-10-31 16:00:00,Petrosyan Davit - Darbinyan Armen,0:3,11:7 - 11:8 - 12:10 - 0:0 - 0:0,3,0,Petrosyan Davit,Darbinyan Armen,fiurst,Darbinyan Armen - Petrosyan Davit,59,25,34,9,-9,18,19,22,0,0,4,3,2,0,0,9,7:11 - 8:11 - 10:12 - 0:0 - 0:0
14917415,2023-10-31 16:00:00,Gevorgyan Hayk - Mkrtchyan Andranik,0:3,7:11 - 10:12 - 9:11 - 0:0 - 0:0,0,3,Gevorgyan Hayk,Mkrtchyan Andranik,fiurst,Gevorgyan Hayk - Mkrtchyan Andranik,60,26,34,8,-8,18,22,20,0,0,4,2,2,0,0,8,7:11 - 10:12 - 9:11 - 0:0 - 0:0
14917409,2023-10-31 15:30:00,Mkrtchyan Andranik - Gevorgyan Gegham,2:3,12:10 - 8:11 - 11:5 - 8:11 - 11:5,3,2,Mkrtchyan Andranik,Gevorgyan Gegham,fiurst,Gevorgyan Gegham - Mkrtchyan Andranik,92,42,50,8,-8,22,19,16,19,16,2,-3,6,-3,6,8,10:12 - 11:8 - 5:11 - 11:8 - 5:11
14917407,2023-10-31 15:15:00,Gevorgyan Hayk - Petrosyan Davit,1:3,8:11 - 11:8 - 6:11 - 7:11 - 0:0,1,3,Gevorgyan Hayk,Petrosyan Davit,fiurst,Gevorgyan Hayk - Petrosyan Davit,73,32,41,9,-9,19,19,17,18,0,3,-3,5,4,0,9,8:11 - 11:8 - 6:11 - 7:11 - 0:0
14917405,2023-10-31 15:00:00,Papyan Karen - Arutyunov Ruben,0:3,11:8 - 11:7 - 12:10 - 0:0 - 0:0,3,0,Papyan Karen,Arutyunov Ruben,fiurst,Arutyunov Ruben - Papyan Karen,59,25,34,9,-9,19,18,22,0,0,3,4,2,0,0,9,8:11 - 7:11 - 10:12 - 0:0 - 0:0
14917401,2023-10-31 14:45:00,Nikoghosyan Narek - Nazaryan Mushegh,1:3,11:6 - 11:6 - 9:11 - 11:5 - 0:0,3,1,Nikoghosyan Narek,Nazaryan Mushegh,fiurst,Nazaryan Mushegh - Nikoghosyan Narek,70,28,42,14,-14,17,17,20,16,0,5,5,-2,6,0,14,6:11 - 6:11 - 11:9 - 5:11 - 0:0
14917394,2023-10-31 14:30:00,Soghomonyan Hrayr - Papyan Karen,1:3,11:6 - 11:8 - 2:11 - 11:8 - 0:0,3,1,Soghomonyan Hrayr,Papyan Karen,fiurst,Papyan Karen - Soghomonyan Hrayr,68,33,35,2,-2,17,19,13,19,0,5,3,-9,3,0,2,6:11 - 8:11 - 11:2 - 8:11 - 0:0
14917387,2023-10-31 14:25:00,Arutyunov Ruben - Nikoghosyan Narek,1:3,11:6 - 2:11 - 4:11 - 10:12 - 0:0,1,3,Arutyunov Ruben,Nikoghosyan Narek,fiurst,Arutyunov Ruben - Nikoghosyan Narek,67,27,40,13,-13,17,13,15,22,0,-5,9,7,2,0,13,11:6 - 2:11 - 4:11 - 10:12 - 0:0
14917383,2023-10-31 14:05:00,Soghomonyan Hrayr - Nazaryan Mushegh,2:3,11:6 - 6:11 - 11:8 - 5:11 - 11:6,3,2,Soghomonyan Hrayr,Nazaryan Mushegh,fiurst,Nazaryan Mushegh - Soghomonyan Hrayr,86,42,44,2,-2,17,17,19,16,17,5,-5,3,-6,5,2,6:11 - 11:6 - 8:11 - 11:5 - 6:11
14917382,2023-10-31 13:45:00,Papyan Karen - Nikoghosyan Narek,2:3,11:7 - 12:10 - 5:11 - 6:11 - 11:5,3,2,Papyan Karen,Nikoghosyan Narek,fiurst,Nikoghosyan Narek - Papyan Karen,89,44,45,1,-1,18,22,16,17,16,4,2,-6,-5,6,1,7:11 - 10:12 - 11:5 - 11:6 - 5:11
14917316,2023-10-31 13:40:00,Arutyunov Ruben - Soghomonyan Hrayr,0:3,5:11 - 4:11 - 7:11 - 0:0 - 0:0,0,3,Arutyunov Ruben,Soghomonyan Hrayr,fiurst,Arutyunov Ruben - Soghomonyan Hrayr,49,16,33,17,-17,16,15,18,0,0,6,7,4,0,0,17,5:11 - 4:11 - 7:11 - 0:0 - 0:0
14917289,2023-10-31 13:15:00,Nazaryan Mushegh - Papyan Karen,1:3,11:6 - 3:11 - 8:11 - 8:11 - 0:0,1,3,Nazaryan Mushegh,Papyan Karen,fiurst,Nazaryan Mushegh - Papyan Karen,69,30,39,9,-9,17,14,19,19,0,-5,8,3,3,0,9,11:6 - 3:11 - 8:11 - 8:11 - 0:0
14917288,2023-10-31 13:05:00,Nikoghosyan Narek - Soghomonyan Hrayr,3:1,11:5 - 8:11 - 14:12 - 11:8 - 0:0,3,1,Nikoghosyan Narek,Soghomonyan Hrayr,fiurst,Nikoghosyan Narek - Soghomonyan Hrayr,80,44,36,-8,8,16,19,26,19,0,-6,3,-2,-3,0,-8,11:5 - 8:11 - 14:12 - 11:8 - 0:0
14917282,2023-10-31 12:45:00,Nazaryan Mushegh - Arutyunov Ruben,1:3,11:9 - 7:11 - 11:5 - 11:7 - 0:0,3,1,Nazaryan Mushegh,Arutyunov Ruben,fiurst,Arutyunov Ruben - Nazaryan Mushegh,72,32,40,8,-8,20,18,16,18,0,2,-4,6,4,0,8,9:11 - 11:7 - 5:11 - 7:11 - 0:0
14917278,2023-10-31 12:30:00,Papyan Karen - Soghomonyan Hrayr,3:0,11:9 - 12:10 - 11:8 - 0:0 - 0:0,3,0,Papyan Karen,Soghomonyan Hrayr,fiurst,Papyan Karen - Soghomonyan Hrayr,61,34,27,-7,7,20,22,19,0,0,-2,-2,-3,0,0,-7,11:9 - 12:10 - 11:8 - 0:0 - 0:0
14917261,2023-10-31 12:00:00,Arutyunov Ruben - Papyan Karen,2:3,11:5 - 12:10 - 6:11 - 8:11 - 8:11,2,3,Arutyunov Ruben,Papyan Karen,fiurst,Arutyunov Ruben - Papyan Karen,93,45,48,3,-3,16,22,17,19,19,-6,-2,5,3,3,3,11:5 - 12:10 - 6:11 - 8:11 - 8:11
14917274,2023-10-31 12:00:00,Nazaryan Mushegh - Nikoghosyan Narek,1:3,5:11 - 11:8 - 5:11 - 6:11 - 0:0,1,3,Nazaryan Mushegh,Nikoghosyan Narek,fiurst,Nazaryan Mushegh - Nikoghosyan Narek,68,27,41,14,-14,16,19,16,17,0,6,-3,6,5,0,14,5:11 - 11:8 - 5:11 - 6:11 - 0:0
14917257,2023-10-31 11:30:00,Nazaryan Mushegh - Soghomonyan Hrayr,3:1,11:9 - 7:11 - 11:5 - 11:6 - 0:0,3,1,Nazaryan Mushegh,Soghomonyan Hrayr,fiurst,Nazaryan Mushegh - Soghomonyan Hrayr,71,40,31,-9,9,20,18,16,17,0,-2,4,-6,-5,0,-9,11:9 - 7:11 - 11:5 - 11:6 - 0:0
14917256,2023-10-31 11:25:00,Nikoghosyan Narek - Arutyunov Ruben,3:1,11:9 - 6:11 - 2:11 - 9:11 - 0:0,1,3,Nikoghosyan Narek,Arutyunov Ruben,fiurst,Arutyunov Ruben - Nikoghosyan Narek,70,42,28,-14,14,20,17,13,20,0,2,-5,-9,-2,0,-14,9:11 - 11:6 - 11:2 - 11:9 - 0:0
14917253,2023-10-31 11:05:00,Papyan Karen - Nazaryan Mushegh,0:3,11:2 - 11:9 - 11:8 - 0:0 - 0:0,3,0,Papyan Karen,Nazaryan Mushegh,fiurst,Nazaryan Mushegh - Papyan Karen,52,19,33,14,-14,13,20,19,0,0,9,2,3,0,0,14,2:11 - 9:11 - 8:11 - 0:0 - 0:0
14917242,2023-10-31 10:50:00,Soghomonyan Hrayr - Arutyunov Ruben,3:1,10:12 - 12:10 - 8:11 - 8:11 - 0:0,1,3,Soghomonyan Hrayr,Arutyunov Ruben,fiurst,Arutyunov Ruben - Soghomonyan Hrayr,82,44,38,-6,6,22,22,19,19,0,-2,2,-3,-3,0,-6,12:10 - 10:12 - 11:8 - 11:8 - 0:0
14917237,2023-10-31 10:30:00,Nikoghosyan Narek - Papyan Karen,3:2,11:9 - 9:11 - 3:11 - 11:5 - 14:12,3,2,Nikoghosyan Narek,Papyan Karen,fiurst,Nikoghosyan Narek - Papyan Karen,96,48,48,0,0,20,20,14,16,26,-2,2,8,-6,-2,0,11:9 - 9:11 - 3:11 - 11:5 - 14:12
14917231,2023-10-31 10:15:00,Arutyunov Ruben - Nazaryan Mushegh,3:2,4:11 - 9:11 - 11:5 - 11:8 - 11:9,3,2,Arutyunov Ruben,Nazaryan Mushegh,fiurst,Arutyunov Ruben - Nazaryan Mushegh,90,46,44,-2,2,15,20,16,19,20,7,2,-6,-3,-2,-2,4:11 - 9:11 - 11:5 - 11:8 - 11:9
14917227,2023-10-31 10:00:00,Soghomonyan Hrayr - Nikoghosyan Narek,3:0,7:11 - 6:11 - 7:11 - 0:0 - 0:0,0,3,Soghomonyan Hrayr,Nikoghosyan Narek,fiurst,Nikoghosyan Narek - Soghomonyan Hrayr,53,33,20,-13,13,18,17,18,0,0,-4,-5,-4,0,0,-13,11:7 - 11:6 - 11:7 - 0:0 - 0:0
14897700,2023-10-30 17:30:00,Darbinyan Armen - Gevorgyan Gegham,0:3,9:11 - 8:11 - 11:13 - 0:0 - 0:0,0,3,Darbinyan Armen,Gevorgyan Gegham,fiurst,Darbinyan Armen - Gevorgyan Gegham,63,28,35,7,-7,20,19,24,0,0,2,3,2,0,0,7,9:11 - 8:11 - 11:13 - 0:0 - 0:0
14897686,2023-10-30 17:15:00,Gevorgyan Hayk - Mkrtchyan Andranik,3:0,12:10 - 11:9 - 11:9 - 0:0 - 0:0,3,0,Gevorgyan Hayk,Mkrtchyan Andranik,fiurst,Gevorgyan Hayk - Mkrtchyan Andranik,62,34,28,-6,6,22,20,20,0,0,-2,-2,-2,0,0,-6,12:10 - 11:9 - 11:9 - 0:0 - 0:0
14897685,2023-10-30 17:00:00,Petrosyan Davit - Darbinyan Armen,0:3,11:2 - 11:4 - 11:5 - 0:0 - 0:0,3,0,Petrosyan Davit,Darbinyan Armen,fiurst,Darbinyan Armen - Petrosyan Davit,44,11,33,22,-22,13,15,16,0,0,9,7,6,0,0,22,2:11 - 4:11 - 5:11 - 0:0 - 0:0
14897684,2023-10-30 16:45:00,Gevorgyan Hayk - Gevorgyan Gegham,0:3,11:8 - 11:4 - 11:4 - 0:0 - 0:0,3,0,Gevorgyan Hayk,Gevorgyan Gegham,fiurst,Gevorgyan Gegham - Gevorgyan Hayk,49,16,33,17,-17,19,15,15,0,0,3,7,7,0,0,17,8:11 - 4:11 - 4:11 - 0:0 - 0:0
14897683,2023-10-30 16:30:00,Mkrtchyan Andranik - Petrosyan Davit,3:1,11:6 - 7:11 - 11:8 - 11:9 - 0:0,3,1,Mkrtchyan Andranik,Petrosyan Davit,fiurst,Mkrtchyan Andranik - Petrosyan Davit,74,40,34,-6,6,17,18,19,20,0,-5,4,-3,-2,0,-6,11:6 - 7:11 - 11:8 - 11:9 - 0:0
14897679,2023-10-30 16:15:00,Darbinyan Armen - Gevorgyan Hayk,0:3,7:11 - 6:11 - 1:11 - 0:0 - 0:0,0,3,Darbinyan Armen,Gevorgyan Hayk,fiurst,Darbinyan Armen - Gevorgyan Hayk,47,14,33,19,-19,18,17,12,0,0,4,5,10,0,0,19,7:11 - 6:11 - 1:11 - 0:0 - 0:0
14897674,2023-10-30 16:05:00,Gevorgyan Gegham - Petrosyan Davit,1:3,7:11 - 1:11 - 11:3 - 9:11 - 0:0,1,3,Gevorgyan Gegham,Petrosyan Davit,fiurst,Gevorgyan Gegham - Petrosyan Davit,64,28,36,8,-8,18,12,14,20,0,4,10,-8,2,0,8,7:11 - 1:11 - 11:3 - 9:11 - 0:0
14897668,2023-10-30 16:00:00,Mkrtchyan Andranik - Darbinyan Armen,0:3,11:6 - 11:7 - 11:6 - 0:0 - 0:0,3,0,Mkrtchyan Andranik,Darbinyan Armen,fiurst,Darbinyan Armen - Mkrtchyan Andranik,52,19,33,14,-14,17,18,17,0,0,5,4,5,0,0,14,6:11 - 7:11 - 6:11 - 0:0 - 0:0
14897666,2023-10-30 15:30:00,Petrosyan Davit - Gevorgyan Hayk,3:1,11:7 - 13:15 - 7:11 - 9:11 - 0:0,1,3,Petrosyan Davit,Gevorgyan Hayk,fiurst,Gevorgyan Hayk - Petrosyan Davit,84,44,40,-4,4,18,28,18,20,0,4,-2,-4,-2,0,-4,7:11 - 15:13 - 11:7 - 11:9 - 0:0
14897656,2023-10-30 15:15:00,Gevorgyan Gegham - Mkrtchyan Andranik,1:3,6:11 - 11:8 - 3:11 - 8:11 - 0:0,1,3,Gevorgyan Gegham,Mkrtchyan Andranik,fiurst,Gevorgyan Gegham - Mkrtchyan Andranik,69,28,41,13,-13,17,19,14,19,0,5,-3,8,3,0,13,6:11 - 11:8 - 3:11 - 8:11 - 0:0
14897654,2023-10-30 15:00:00,Arutyunov Ruben - Nazaryan Mushegh,3:2,7:11 - 11:6 - 11:2 - 7:11 - 11:6,3,2,Arutyunov Ruben,Nazaryan Mushegh,fiurst,Arutyunov Ruben - Nazaryan Mushegh,83,47,36,-11,11,18,17,13,18,17,4,-5,-9,4,-5,-11,7:11 - 11:6 - 11:2 - 7:11 - 11:6
14897653,2023-10-30 14:45:00,Papyan Karen - Diaryan Aleksandr,3:0,4:11 - 3:11 - 6:11 - 0:0 - 0:0,0,3,Papyan Karen,Diaryan Aleksandr,fiurst,Diaryan Aleksandr - Papyan Karen,46,33,13,-20,20,15,14,17,0,0,-7,-8,-5,0,0,-20,11:4 - 11:3 - 11:6 - 0:0 - 0:0
14897651,2023-10-30 14:30:00,Rafayelyan Edgar - Arutyunov Ruben,0:3,11:4 - 11:8 - 11:7 - 0:0 - 0:0,3,0,Rafayelyan Edgar,Arutyunov Ruben,fiurst,Arutyunov Ruben - Rafayelyan Edgar,52,19,33,14,-14,15,19,18,0,0,7,3,4,0,0,14,4:11 - 8:11 - 7:11 - 0:0 - 0:0
14897648,2023-10-30 14:15:00,Nazaryan Mushegh - Papyan Karen,2:3,5:11 - 11:8 - 7:11 - 11:6 - 11:13,2,3,Nazaryan Mushegh,Papyan Karen,fiurst,Nazaryan Mushegh - Papyan Karen,94,45,49,4,-4,16,19,18,17,24,6,-3,4,-5,2,4,5:11 - 11:8 - 7:11 - 11:6 - 11:13
14897646,2023-10-30 14:00:00,Rafayelyan Edgar - Diaryan Aleksandr,3:1,11:8 - 8:11 - 5:11 - 14:16 - 0:0,1,3,Rafayelyan Edgar,Diaryan Aleksandr,fiurst,Diaryan Aleksandr - Rafayelyan Edgar,84,46,38,-8,8,19,19,16,30,0,3,-3,-6,-2,0,-8,8:11 - 11:8 - 11:5 - 16:14 - 0:0
14897644,2023-10-30 13:45:00,Arutyunov Ruben - Papyan Karen,0:3,10:12 - 7:11 - 7:11 - 0:0 - 0:0,0,3,Arutyunov Ruben,Papyan Karen,fiurst,Arutyunov Ruben - Papyan Karen,58,24,34,10,-10,22,18,18,0,0,2,4,4,0,0,10,10:12 - 7:11 - 7:11 - 0:0 - 0:0
14897643,2023-10-30 13:30:00,Nazaryan Mushegh - Rafayelyan Edgar,1:3,7:11 - 11:8 - 6:11 - 9:11 - 0:0,1,3,Nazaryan Mushegh,Rafayelyan Edgar,fiurst,Nazaryan Mushegh - Rafayelyan Edgar,74,33,41,8,-8,18,19,17,20,0,4,-3,5,2,0,8,7:11 - 11:8 - 6:11 - 9:11 - 0:0
14897641,2023-10-30 13:15:00,Diaryan Aleksandr - Arutyunov Ruben,0:3,11:7 - 11:9 - 11:7 - 0:0 - 0:0,3,0,Diaryan Aleksandr,Arutyunov Ruben,fiurst,Arutyunov Ruben - Diaryan Aleksandr,56,23,33,10,-10,18,20,18,0,0,4,2,4,0,0,10,7:11 - 9:11 - 7:11 - 0:0 - 0:0
14897640,2023-10-30 13:00:00,Papyan Karen - Rafayelyan Edgar,3:2,6:11 - 11:3 - 10:12 - 11:3 - 11:9,3,2,Papyan Karen,Rafayelyan Edgar,fiurst,Papyan Karen - Rafayelyan Edgar,87,49,38,-11,11,17,14,22,14,20,5,-8,2,-8,-2,-11,6:11 - 11:3 - 10:12 - 11:3 - 11:9
14897639,2023-10-30 12:45:00,Diaryan Aleksandr - Nazaryan Mushegh,3:1,11:4 - 11:5 - 5:11 - 11:5 - 0:0,3,1,Diaryan Aleksandr,Nazaryan Mushegh,fiurst,Diaryan Aleksandr - Nazaryan Mushegh,63,38,25,-13,13,15,16,16,16,0,-7,-6,6,-6,0,-13,11:4 - 11:5 - 5:11 - 11:5 - 0:0
14897638,2023-10-30 12:15:00,Arutyunov Ruben - Rafayelyan Edgar,0:3,7:11 - 1:11 - 10:12 - 0:0 - 0:0,0,3,Arutyunov Ruben,Rafayelyan Edgar,fiurst,Arutyunov Ruben - Rafayelyan Edgar,52,18,34,16,-16,18,12,22,0,0,4,10,2,0,0,16,7:11 - 1:11 - 10:12 - 0:0 - 0:0
14897627,2023-10-30 12:00:00,Diaryan Aleksandr - Papyan Karen,0:3,13:15 - 6:11 - 6:11 - 0:0 - 0:0,0,3,Diaryan Aleksandr,Papyan Karen,fiurst,Diaryan Aleksandr - Papyan Karen,62,25,37,12,-12,28,17,17,0,0,2,5,5,0,0,12,13:15 - 6:11 - 6:11 - 0:0 - 0:0
14897625,2023-10-30 11:45:00,Nazaryan Mushegh - Arutyunov Ruben,0:3,11:7 - 11:9 - 11:2 - 0:0 - 0:0,3,0,Nazaryan Mushegh,Arutyunov Ruben,fiurst,Arutyunov Ruben - Nazaryan Mushegh,51,18,33,15,-15,18,20,13,0,0,4,2,9,0,0,15,7:11 - 9:11 - 2:11 - 0:0 - 0:0
14897624,2023-10-30 11:30:00,Diaryan Aleksandr - Rafayelyan Edgar,3:0,11:8 - 11:9 - 11:4 - 0:0 - 0:0,3,0,Diaryan Aleksandr,Rafayelyan Edgar,fiurst,Diaryan Aleksandr - Rafayelyan Edgar,54,33,21,-12,12,19,20,15,0,0,-3,-2,-7,0,0,-12,11:8 - 11:9 - 11:4 - 0:0 - 0:0
14897620,2023-10-30 11:15:00,Papyan Karen - Nazaryan Mushegh,1:3,6:11 - 11:7 - 11:8 - 11:5 - 0:0,3,1,Papyan Karen,Nazaryan Mushegh,fiurst,Nazaryan Mushegh - Papyan Karen,70,31,39,8,-8,17,18,19,16,0,-5,4,3,6,0,8,11:6 - 7:11 - 8:11 - 5:11 - 0:0
14897617,2023-10-30 11:00:00,Arutyunov Ruben - Diaryan Aleksandr,1:3,11:8 - 6:11 - 3:11 - 11:13 - 0:0,1,3,Arutyunov Ruben,Diaryan Aleksandr,fiurst,Arutyunov Ruben - Diaryan Aleksandr,74,31,43,12,-12,19,17,14,24,0,-3,5,8,2,0,12,11:8 - 6:11 - 3:11 - 11:13 - 0:0
14897615,2023-10-30 10:45:00,Rafayelyan Edgar - Nazaryan Mushegh,1:3,11:8 - 8:11 - 11:6 - 11:6 - 0:0,3,1,Rafayelyan Edgar,Nazaryan Mushegh,fiurst,Nazaryan Mushegh - Rafayelyan Edgar,72,31,41,10,-10,19,19,17,17,0,3,-3,5,5,0,10,8:11 - 11:8 - 6:11 - 6:11 - 0:0
14897583,2023-10-30 10:30:00,Papyan Karen - Arutyunov Ruben,0:3,11:7 - 11:9 - 11:7 - 0:0 - 0:0,3,0,Papyan Karen,Arutyunov Ruben,fiurst,Arutyunov Ruben - Papyan Karen,56,23,33,10,-10,18,20,18,0,0,4,2,4,0,0,10,7:11 - 9:11 - 7:11 - 0:0 - 0:0
14897572,2023-10-30 10:15:00,Nazaryan Mushegh - Diaryan Aleksandr,3:0,8:11 - 8:11 - 11:13 - 0:0 - 0:0,0,3,Nazaryan Mushegh,Diaryan Aleksandr,fiurst,Diaryan Aleksandr - Nazaryan Mushegh,62,35,27,-8,8,19,19,24,0,0,-3,-3,-2,0,0,-8,11:8 - 11:8 - 13:11 - 0:0 - 0:0
14897571,2023-10-30 10:00:00,Rafayelyan Edgar - Papyan Karen,3:2,9:11 - 11:8 - 11:7 - 6:11 - 6:11,2,3,Rafayelyan Edgar,Papyan Karen,fiurst,Papyan Karen - Rafayelyan Edgar,91,48,43,-5,5,20,19,18,17,17,-2,3,4,-5,-5,-5,11:9 - 8:11 - 7:11 - 11:6 - 11:6
14880438,2023-10-29 17:30:00,Gevorgyan Hayk - Darbinyan Armen,0:3,11:9 - 11:6 - 11:5 - 0:0 - 0:0,3,0,Gevorgyan Hayk,Darbinyan Armen,fiurst,Darbinyan Armen - Gevorgyan Hayk,53,20,33,13,-13,20,17,16,0,0,2,5,6,0,0,13,9:11 - 6:11 - 5:11 - 0:0 - 0:0
14880433,2023-10-29 17:15:00,Petrosyan Davit - Avakimyan Davit,3:0,9:11 - 4:11 - 2:11 - 0:0 - 0:0,0,3,Petrosyan Davit,Avakimyan Davit,fiurst,Avakimyan Davit - Petrosyan Davit,48,33,15,-18,18,20,15,13,0,0,-2,-7,-9,0,0,-18,11:9 - 11:4 - 11:2 - 0:0 - 0:0
14880432,2023-10-29 17:00:00,Gevorgyan Gegham - Gevorgyan Hayk,2:3,11:13 - 11:7 - 5:11 - 12:10 - 6:11,2,3,Gevorgyan Gegham,Gevorgyan Hayk,fiurst,Gevorgyan Gegham - Gevorgyan Hayk,97,45,52,7,-7,24,18,16,22,17,2,-4,6,-2,5,7,11:13 - 11:7 - 5:11 - 12:10 - 6:11
14880420,2023-10-29 16:45:00,Petrosyan Davit - Darbinyan Armen,0:3,11:2 - 11:6 - 11:7 - 0:0 - 0:0,3,0,Petrosyan Davit,Darbinyan Armen,fiurst,Darbinyan Armen - Petrosyan Davit,48,15,33,18,-18,13,17,18,0,0,9,5,4,0,0,18,2:11 - 6:11 - 7:11 - 0:0 - 0:0
14880412,2023-10-29 16:30:00,Avakimyan Davit - Gevorgyan Gegham,3:1,11:13 - 11:8 - 11:9 - 11:5 - 0:0,3,1,Avakimyan Davit,Gevorgyan Gegham,fiurst,Avakimyan Davit - Gevorgyan Gegham,79,44,35,-9,9,24,19,20,16,0,2,-3,-2,-6,0,-9,11:13 - 11:8 - 11:9 - 11:5 - 0:0
14880410,2023-10-29 16:15:00,Gevorgyan Hayk - Petrosyan Davit,3:1,11:6 - 11:6 - 9:11 - 11:7 - 0:0,3,1,Gevorgyan Hayk,Petrosyan Davit,fiurst,Gevorgyan Hayk - Petrosyan Davit,72,42,30,-12,12,17,17,20,18,0,-5,-5,2,-4,0,-12,11:6 - 11:6 - 9:11 - 11:7 - 0:0
14880390,2023-10-29 16:00:00,Darbinyan Armen - Gevorgyan Gegham,1:3,4:11 - 11:9 - 7:11 - 7:11 - 0:0,1,3,Darbinyan Armen,Gevorgyan Gegham,fiurst,Darbinyan Armen - Gevorgyan Gegham,71,29,42,13,-13,15,20,18,18,0,7,-2,4,4,0,13,4:11 - 11:9 - 7:11 - 7:11 - 0:0
14880384,2023-10-29 15:45:00,Avakimyan Davit - Gevorgyan Hayk,1:3,5:11 - 8:11 - 11:6 - 6:11 - 0:0,1,3,Avakimyan Davit,Gevorgyan Hayk,fiurst,Avakimyan Davit - Gevorgyan Hayk,69,30,39,9,-9,16,19,17,17,0,6,3,-5,5,0,9,5:11 - 8:11 - 11:6 - 6:11 - 0:0
14880379,2023-10-29 15:30:00,Gevorgyan Gegham - Petrosyan Davit,1:3,3:11 - 6:11 - 12:10 - 7:11 - 0:0,1,3,Gevorgyan Gegham,Petrosyan Davit,fiurst,Gevorgyan Gegham - Petrosyan Davit,71,28,43,15,-15,14,17,22,18,0,8,5,-2,4,0,15,3:11 - 6:11 - 12:10 - 7:11 - 0:0
14880373,2023-10-29 15:15:00,Darbinyan Armen - Avakimyan Davit,3:0,8:11 - 9:11 - 13:15 - 0:0 - 0:0,0,3,Darbinyan Armen,Avakimyan Davit,fiurst,Avakimyan Davit - Darbinyan Armen,67,37,30,-7,7,19,20,28,0,0,-3,-2,-2,0,0,-7,11:8 - 11:9 - 15:13 - 0:0 - 0:0
14880370,2023-10-29 15:10:00,Papyan Karen - Diaryan Aleksandr,3:1,7:11 - 2:11 - 11:5 - 2:11 - 0:0,1,3,Papyan Karen,Diaryan Aleksandr,fiurst,Diaryan Aleksandr - Papyan Karen,60,38,22,-16,16,18,13,16,13,0,-4,-9,6,-9,0,-16,11:7 - 11:2 - 5:11 - 11:2 - 0:0
14880356,2023-10-29 14:50:00,Arutyunov Ruben - Soghomonyan Hrayr,1:3,11:13 - 11:4 - 7:11 - 9:11 - 0:0,1,3,Arutyunov Ruben,Soghomonyan Hrayr,fiurst,Arutyunov Ruben - Soghomonyan Hrayr,77,38,39,1,-1,24,15,18,20,0,2,-7,4,2,0,1,11:13 - 11:4 - 7:11 - 9:11 - 0:0
14880355,2023-10-29 14:30:00,Nikoghosyan Narek - Papyan Karen,2:3,11:5 - 11:8 - 8:11 - 8:11 - 8:11,2,3,Nikoghosyan Narek,Papyan Karen,fiurst,Nikoghosyan Narek - Papyan Karen,92,46,46,0,0,16,19,19,19,19,-6,-3,3,3,3,0,11:5 - 11:8 - 8:11 - 8:11 - 8:11
14880352,2023-10-29 14:15:00,Diaryan Aleksandr - Arutyunov Ruben,3:2,11:9 - 9:11 - 6:11 - 11:8 - 3:11,2,3,Diaryan Aleksandr,Arutyunov Ruben,fiurst,Arutyunov Ruben - Diaryan Aleksandr,90,50,40,-10,10,20,20,17,19,14,2,-2,-5,3,-8,-10,9:11 - 11:9 - 11:6 - 8:11 - 11:3
14880349,2023-10-29 14:10:00,Nikoghosyan Narek - Soghomonyan Hrayr,3:0,11:6 - 11:9 - 11:6 - 0:0 - 0:0,3,0,Nikoghosyan Narek,Soghomonyan Hrayr,fiurst,Nikoghosyan Narek - Soghomonyan Hrayr,54,33,21,-12,12,17,20,17,0,0,-5,-2,-5,0,0,-12,11:6 - 11:9 - 11:6 - 0:0 - 0:0
14880347,2023-10-29 13:45:00,Papyan Karen - Arutyunov Ruben,1:3,11:7 - 13:11 - 5:11 - 11:6 - 0:0,3,1,Papyan Karen,Arutyunov Ruben,fiurst,Arutyunov Ruben - Papyan Karen,75,35,40,5,-5,18,24,16,17,0,4,2,-6,5,0,5,7:11 - 11:13 - 11:5 - 6:11 - 0:0
14880343,2023-10-29 13:30:00,Diaryan Aleksandr - Nikoghosyan Narek,2:3,7:11 - 11:4 - 11:7 - 5:11 - 9:11,2,3,Diaryan Aleksandr,Nikoghosyan Narek,fiurst,Diaryan Aleksandr - Nikoghosyan Narek,87,43,44,1,-1,18,15,18,16,20,4,-7,-4,6,2,1,7:11 - 11:4 - 11:7 - 5:11 - 9:11
14880336,2023-10-29 13:15:00,Soghomonyan Hrayr - Papyan Karen,3:1,6:11 - 12:10 - 9:11 - 5:11 - 0:0,1,3,Soghomonyan Hrayr,Papyan Karen,fiurst,Papyan Karen - Soghomonyan Hrayr,75,43,32,-11,11,17,22,20,16,0,-5,2,-2,-6,0,-11,11:6 - 10:12 - 11:9 - 11:5 - 0:0
14880334,2023-10-29 13:00:00,Arutyunov Ruben - Nikoghosyan Narek,1:3,2:11 - 5:11 - 11:9 - 11:13 - 0:0,1,3,Arutyunov Ruben,Nikoghosyan Narek,fiurst,Arutyunov Ruben - Nikoghosyan Narek,73,29,44,15,-15,13,16,20,24,0,9,6,-2,2,0,15,2:11 - 5:11 - 11:9 - 11:13 - 0:0
14880328,2023-10-29 12:45:00,Soghomonyan Hrayr - Diaryan Aleksandr,3:0,6:11 - 9:11 - 4:11 - 0:0 - 0:0,0,3,Soghomonyan Hrayr,Diaryan Aleksandr,fiurst,Diaryan Aleksandr - Soghomonyan Hrayr,52,33,19,-14,14,17,20,15,0,0,-5,-2,-7,0,0,-14,11:6 - 11:9 - 11:4 - 0:0 - 0:0
14880317,2023-10-29 12:15:00,Papyan Karen - Nikoghosyan Narek,1:3,11:9 - 9:11 - 11:7 - 11:8 - 0:0,3,1,Papyan Karen,Nikoghosyan Narek,fiurst,Nikoghosyan Narek - Papyan Karen,77,35,42,7,-7,20,20,18,19,0,2,-2,4,3,0,7,9:11 - 11:9 - 7:11 - 8:11 - 0:0
14878857,2023-10-29 12:00:00,Soghomonyan Hrayr - Arutyunov Ruben,3:1,11:8 - 7:11 - 10:12 - 6:11 - 0:0,1,3,Soghomonyan Hrayr,Arutyunov Ruben,fiurst,Arutyunov Ruben - Soghomonyan Hrayr,76,42,34,-8,8,19,18,22,17,0,3,-4,-2,-5,0,-8,8:11 - 11:7 - 12:10 - 11:6 - 0:0
14878844,2023-10-29 11:50:00,Diaryan Aleksandr - Papyan Karen,1:3,11:7 - 7:11 - 4:11 - 8:11 - 0:0,1,3,Diaryan Aleksandr,Papyan Karen,fiurst,Diaryan Aleksandr - Papyan Karen,70,30,40,10,-10,18,18,15,19,0,-4,4,7,3,0,10,11:7 - 7:11 - 4:11 - 8:11 - 0:0
14878843,2023-10-29 11:30:00,Soghomonyan Hrayr - Nikoghosyan Narek,3:0,6:11 - 3:11 - 6:11 - 0:0 - 0:0,0,3,Soghomonyan Hrayr,Nikoghosyan Narek,fiurst,Nikoghosyan Narek - Soghomonyan Hrayr,48,33,15,-18,18,17,14,17,0,0,-5,-8,-5,0,0,-18,11:6 - 11:3 - 11:6 - 0:0 - 0:0
14878842,2023-10-29 11:20:00,Arutyunov Ruben - Diaryan Aleksandr,1:3,11:9 - 11:13 - 5:11 - 5:11 - 0:0,1,3,Arutyunov Ruben,Diaryan Aleksandr,fiurst,Arutyunov Ruben - Diaryan Aleksandr,76,32,44,12,-12,20,24,16,16,0,-2,2,6,6,0,12,11:9 - 11:13 - 5:11 - 5:11 - 0:0
14878839,2023-10-29 11:00:00,Papyan Karen - Soghomonyan Hrayr,3:1,8:11 - 11:3 - 11:9 - 11:3 - 0:0,3,1,Papyan Karen,Soghomonyan Hrayr,fiurst,Papyan Karen - Soghomonyan Hrayr,67,41,26,-15,15,19,14,20,14,0,3,-8,-2,-8,0,-15,8:11 - 11:3 - 11:9 - 11:3 - 0:0
14878838,2023-10-29 10:45:00,Nikoghosyan Narek - Diaryan Aleksandr,3:1,11:9 - 10:12 - 5:11 - 8:11 - 0:0,1,3,Nikoghosyan Narek,Diaryan Aleksandr,fiurst,Diaryan Aleksandr - Nikoghosyan Narek,77,43,34,-9,9,20,22,16,19,0,2,-2,-6,-3,0,-9,9:11 - 12:10 - 11:5 - 11:8 - 0:0
14878834,2023-10-29 10:40:00,Arutyunov Ruben - Papyan Karen,1:3,13:11 - 9:11 - 8:11 - 3:11 - 0:0,1,3,Arutyunov Ruben,Papyan Karen,fiurst,Arutyunov Ruben - Papyan Karen,77,33,44,11,-11,24,20,19,14,0,-2,2,3,8,0,11,13:11 - 9:11 - 8:11 - 3:11 - 0:0
14878833,2023-10-29 10:15:00,Diaryan Aleksandr - Soghomonyan Hrayr,3:2,12:10 - 9:11 - 11:7 - 10:12 - 11:9,3,2,Diaryan Aleksandr,Soghomonyan Hrayr,fiurst,Diaryan Aleksandr - Soghomonyan Hrayr,102,53,49,-4,4,22,20,18,22,20,-2,2,-4,2,-2,-4,12:10 - 9:11 - 11:7 - 10:12 - 11:9
14878832,2023-10-29 10:00:00,Nikoghosyan Narek - Arutyunov Ruben,1:3,8:11 - 11:5 - 14:12 - 13:11 - 0:0,3,1,Nikoghosyan Narek,Arutyunov Ruben,fiurst,Arutyunov Ruben - Nikoghosyan Narek,85,39,46,7,-7,19,16,26,24,0,-3,6,2,2,0,7,11:8 - 5:11 - 12:14 - 11:13 - 0:0
14861244,2023-10-28 17:30:00,Avakimyan Davit - Mkrtchyan Andranik,0:3,10:12 - 9:11 - 9:11 - 0:0 - 0:0,0,3,Avakimyan Davit,Mkrtchyan Andranik,fiurst,Avakimyan Davit - Mkrtchyan Andranik,62,28,34,6,-6,22,20,20,0,0,2,2,2,0,0,6,10:12 - 9:11 - 9:11 - 0:0 - 0:0
14861228,2023-10-28 17:15:00,Darbinyan Armen - Gevorgyan Gegham,0:3,2:11 - 3:11 - 5:11 - 0:0 - 0:0,0,3,Darbinyan Armen,Gevorgyan Gegham,fiurst,Darbinyan Armen - Gevorgyan Gegham,43,10,33,23,-23,13,14,16,0,0,9,8,6,0,0,23,2:11 - 3:11 - 5:11 - 0:0 - 0:0
14861186,2023-10-28 17:00:00,Grigoryan Erik - Avakimyan Davit,3:0,4:11 - 9:11 - 7:11 - 0:0 - 0:0,0,3,Grigoryan Erik,Avakimyan Davit,fiurst,Avakimyan Davit - Grigoryan Erik,53,33,20,-13,13,15,20,18,0,0,-7,-2,-4,0,0,-13,11:4 - 11:9 - 11:7 - 0:0 - 0:0
14861134,2023-10-28 16:45:00,Darbinyan Armen - Mkrtchyan Andranik,0:3,11:13 - 6:11 - 8:11 - 0:0 - 0:0,0,3,Darbinyan Armen,Mkrtchyan Andranik,fiurst,Darbinyan Armen - Mkrtchyan Andranik,60,25,35,10,-10,24,17,19,0,0,2,5,3,0,0,10,11:13 - 6:11 - 8:11 - 0:0 - 0:0
14861107,2023-10-28 16:30:00,Gevorgyan Gegham - Grigoryan Erik,3:1,11:5 - 11:7 - 8:11 - 11:9 - 0:0,3,1,Gevorgyan Gegham,Grigoryan Erik,fiurst,Gevorgyan Gegham - Grigoryan Erik,73,41,32,-9,9,16,18,19,20,0,-6,-4,3,-2,0,-9,11:5 - 11:7 - 8:11 - 11:9 - 0:0
14861106,2023-10-28 16:15:00,Avakimyan Davit - Darbinyan Armen,2:3,11:6 - 9:11 - 11:4 - 10:12 - 9:11,2,3,Avakimyan Davit,Darbinyan Armen,fiurst,Avakimyan Davit - Darbinyan Armen,94,50,44,-6,6,17,20,15,22,20,-5,2,-7,2,2,-6,11:6 - 9:11 - 11:4 - 10:12 - 9:11
14861105,2023-10-28 16:00:00,Mkrtchyan Andranik - Grigoryan Erik,1:3,11:6 - 13:11 - 4:11 - 11:6 - 0:0,3,1,Mkrtchyan Andranik,Grigoryan Erik,fiurst,Grigoryan Erik - Mkrtchyan Andranik,73,34,39,5,-5,17,24,15,17,0,5,2,-7,5,0,5,6:11 - 11:13 - 11:4 - 6:11 - 0:0
14861099,2023-10-28 15:45:00,Gevorgyan Gegham - Avakimyan Davit,3:1,6:11 - 4:11 - 11:7 - 6:11 - 0:0,1,3,Gevorgyan Gegham,Avakimyan Davit,fiurst,Avakimyan Davit - Gevorgyan Gegham,67,40,27,-13,13,17,15,18,17,0,-5,-7,4,-5,0,-13,11:6 - 11:4 - 7:11 - 11:6 - 0:0
14861096,2023-10-28 15:30:00,Grigoryan Erik - Darbinyan Armen,3:0,9:11 - 5:11 - 5:11 - 0:0 - 0:0,0,3,Grigoryan Erik,Darbinyan Armen,fiurst,Darbinyan Armen - Grigoryan Erik,52,33,19,-14,14,20,16,16,0,0,-2,-6,-6,0,0,-14,11:9 - 11:5 - 11:5 - 0:0 - 0:0
14861095,2023-10-28 15:15:00,Mkrtchyan Andranik - Gevorgyan Gegham,0:3,12:10 - 11:3 - 11:7 - 0:0 - 0:0,3,0,Mkrtchyan Andranik,Gevorgyan Gegham,fiurst,Gevorgyan Gegham - Mkrtchyan Andranik,54,20,34,14,-14,22,14,18,0,0,2,8,4,0,0,14,10:12 - 3:11 - 7:11 - 0:0 - 0:0
14861076,2023-10-28 15:00:00,Soghomonyan Hrayr - Nikoghosyan Narek,3:1,9:11 - 11:4 - 5:11 - 9:11 - 0:0,1,3,Soghomonyan Hrayr,Nikoghosyan Narek,fiurst,Nikoghosyan Narek - Soghomonyan Hrayr,71,37,34,-3,3,20,15,16,20,0,-2,7,-6,-2,0,-3,11:9 - 4:11 - 11:5 - 11:9 - 0:0
14861074,2023-10-28 14:45:00,Rafayelyan Edgar - Nazaryan Mushegh,2:3,7:11 - 9:11 - 11:4 - 11:8 - 11:4,3,2,Rafayelyan Edgar,Nazaryan Mushegh,fiurst,Nazaryan Mushegh - Rafayelyan Edgar,87,38,49,11,-11,18,20,15,19,15,-4,-2,7,3,7,11,11:7 - 11:9 - 4:11 - 8:11 - 4:11
14861063,2023-10-28 14:30:00,Papyan Karen - Soghomonyan Hrayr,3:0,12:10 - 11:8 - 11:6 - 0:0 - 0:0,3,0,Papyan Karen,Soghomonyan Hrayr,fiurst,Papyan Karen - Soghomonyan Hrayr,58,34,24,-10,10,22,19,17,0,0,-2,-3,-5,0,0,-10,12:10 - 11:8 - 11:6 - 0:0 - 0:0
14861057,2023-10-28 14:20:00,Papyan Karen - Nazaryan Mushegh,0:3,11:5 - 11:7 - 11:7 - 0:0 - 0:0,3,0,Papyan Karen,Nazaryan Mushegh,fiurst,Nazaryan Mushegh - Papyan Karen,52,19,33,14,-14,16,18,18,0,0,6,4,4,0,0,14,5:11 - 7:11 - 7:11 - 0:0 - 0:0
14861061,2023-10-28 14:20:00,Nikoghosyan Narek - Rafayelyan Edgar,1:3,11:6 - 4:11 - 9:11 - 6:11 - 0:0,1,3,Nikoghosyan Narek,Rafayelyan Edgar,fiurst,Nikoghosyan Narek - Rafayelyan Edgar,69,30,39,9,-9,17,15,20,17,0,-5,7,2,5,0,9,11:6 - 4:11 - 9:11 - 6:11 - 0:0
14861055,2023-10-28 13:55:00,Soghomonyan Hrayr - Rafayelyan Edgar,3:1,7:11 - 12:10 - 7:11 - 5:11 - 0:0,1,3,Soghomonyan Hrayr,Rafayelyan Edgar,fiurst,Rafayelyan Edgar - Soghomonyan Hrayr,74,43,31,-12,12,18,22,18,16,0,-4,2,-4,-6,0,-12,11:7 - 10:12 - 11:7 - 11:5 - 0:0
14861050,2023-10-28 13:45:00,Nikoghosyan Narek - Papyan Karen,1:3,6:11 - 8:11 - 12:10 - 7:11 - 0:0,1,3,Nikoghosyan Narek,Papyan Karen,fiurst,Nikoghosyan Narek - Papyan Karen,76,33,43,10,-10,17,19,22,18,0,5,3,-2,4,0,10,6:11 - 8:11 - 12:10 - 7:11 - 0:0
14861047,2023-10-28 13:25:00,Nazaryan Mushegh - Soghomonyan Hrayr,1:3,11:4 - 4:11 - 8:11 - 7:11 - 0:0,1,3,Nazaryan Mushegh,Soghomonyan Hrayr,fiurst,Nazaryan Mushegh - Soghomonyan Hrayr,67,30,37,7,-7,15,15,19,18,0,-7,7,3,4,0,7,11:4 - 4:11 - 8:11 - 7:11 - 0:0
14861044,2023-10-28 13:10:00,Rafayelyan Edgar - Papyan Karen,3:2,11:5 - 11:3 - 10:12 - 12:14 - 8:11,2,3,Rafayelyan Edgar,Papyan Karen,fiurst,Papyan Karen - Rafayelyan Edgar,97,45,52,7,-7,16,14,22,26,19,6,8,-2,-2,-3,7,5:11 - 3:11 - 12:10 - 14:12 - 11:8
14861042,2023-10-28 12:55:00,Nazaryan Mushegh - Nikoghosyan Narek,1:3,4:11 - 7:11 - 11:5 - 8:11 - 0:0,1,3,Nazaryan Mushegh,Nikoghosyan Narek,fiurst,Nazaryan Mushegh - Nikoghosyan Narek,68,30,38,8,-8,15,18,16,19,0,7,4,-6,3,0,8,4:11 - 7:11 - 11:5 - 8:11 - 0:0
14861032,2023-10-28 12:35:00,Soghomonyan Hrayr - Papyan Karen,3:1,6:11 - 8:11 - 11:8 - 7:11 - 0:0,1,3,Soghomonyan Hrayr,Papyan Karen,fiurst,Papyan Karen - Soghomonyan Hrayr,73,41,32,-9,9,17,19,19,18,0,-5,-3,3,-4,0,-9,11:6 - 11:8 - 8:11 - 11:7 - 0:0
14861031,2023-10-28 12:10:00,Nazaryan Mushegh - Rafayelyan Edgar,0:3,13:15 - 5:11 - 10:12 - 0:0 - 0:0,0,3,Nazaryan Mushegh,Rafayelyan Edgar,fiurst,Nazaryan Mushegh - Rafayelyan Edgar,66,28,38,10,-10,28,16,22,0,0,2,6,2,0,0,10,13:15 - 5:11 - 10:12 - 0:0 - 0:0
14861029,2023-10-28 11:55:00,Nikoghosyan Narek - Soghomonyan Hrayr,3:2,8:11 - 9:11 - 11:7 - 11:6 - 11:6,3,2,Nikoghosyan Narek,Soghomonyan Hrayr,fiurst,Nikoghosyan Narek - Soghomonyan Hrayr,91,50,41,-9,9,19,20,18,17,17,3,2,-4,-5,-5,-9,8:11 - 9:11 - 11:7 - 11:6 - 11:6
14861027,2023-10-28 11:30:00,Nazaryan Mushegh - Papyan Karen,2:3,6:11 - 11:8 - 10:12 - 11:9 - 9:11,2,3,Nazaryan Mushegh,Papyan Karen,fiurst,Nazaryan Mushegh - Papyan Karen,98,47,51,4,-4,17,19,22,20,20,5,-3,2,-2,2,4,6:11 - 11:8 - 10:12 - 11:9 - 9:11
14860990,2023-10-28 11:15:00,Rafayelyan Edgar - Nikoghosyan Narek,3:1,7:11 - 7:11 - 11:6 - 3:11 - 0:0,1,3,Rafayelyan Edgar,Nikoghosyan Narek,fiurst,Nikoghosyan Narek - Rafayelyan Edgar,67,39,28,-11,11,18,18,17,14,0,-4,-4,5,-8,0,-11,11:7 - 11:7 - 6:11 - 11:3 - 0:0
14860988,2023-10-28 11:05:00,Soghomonyan Hrayr - Nazaryan Mushegh,3:0,10:12 - 9:11 - 11:13 - 0:0 - 0:0,0,3,Soghomonyan Hrayr,Nazaryan Mushegh,fiurst,Nazaryan Mushegh - Soghomonyan Hrayr,66,36,30,-6,6,22,20,24,0,0,-2,-2,-2,0,0,-6,12:10 - 11:9 - 13:11 - 0:0 - 0:0
14860985,2023-10-28 10:45:00,Papyan Karen - Nikoghosyan Narek,2:3,12:14 - 12:10 - 9:11 - 11:5 - 11:8,3,2,Papyan Karen,Nikoghosyan Narek,fiurst,Nikoghosyan Narek - Papyan Karen,103,48,55,7,-7,26,22,20,16,19,-2,2,-2,6,3,7,14:12 - 10:12 - 11:9 - 5:11 - 8:11
14860962,2023-10-28 10:35:00,Rafayelyan Edgar - Soghomonyan Hrayr,3:2,4:11 - 9:11 - 11:2 - 11:5 - 11:8,3,2,Rafayelyan Edgar,Soghomonyan Hrayr,fiurst,Rafayelyan Edgar - Soghomonyan Hrayr,83,46,37,-9,9,15,20,13,16,19,7,2,-9,-6,-3,-9,4:11 - 9:11 - 11:2 - 11:5 - 11:8
14860919,2023-10-28 10:15:00,Nikoghosyan Narek - Nazaryan Mushegh,3:0,6:11 - 8:11 - 11:13 - 0:0 - 0:0,0,3,Nikoghosyan Narek,Nazaryan Mushegh,fiurst,Nazaryan Mushegh - Nikoghosyan Narek,60,35,25,-10,10,17,19,24,0,0,-5,-3,-2,0,0,-10,11:6 - 11:8 - 13:11 - 0:0 - 0:0
14860905,2023-10-28 10:00:00,Papyan Karen - Rafayelyan Edgar,3:1,7:11 - 11:8 - 11:9 - 11:8 - 0:0,3,1,Papyan Karen,Rafayelyan Edgar,fiurst,Papyan Karen - Rafayelyan Edgar,76,40,36,-4,4,18,19,20,19,0,4,-3,-2,-3,0,-4,7:11 - 11:8 - 11:9 - 11:8 - 0:0
14839061,2023-10-27 17:30:00,Gevorgyan Gegham - Avakimyan Davit,3:2,8:11 - 12:10 - 8:11 - 11:9 - 4:11,2,3,Gevorgyan Gegham,Avakimyan Davit,fiurst,Avakimyan Davit - Gevorgyan Gegham,95,52,43,-9,9,19,22,19,20,15,-3,2,-3,2,-7,-9,11:8 - 10:12 - 11:8 - 9:11 - 11:4
14839057,2023-10-27 17:15:00,Mkrtchyan Andranik - Gevorgyan Hayk,3:1,7:11 - 11:13 - 12:10 - 8:11 - 0:0,1,3,Mkrtchyan Andranik,Gevorgyan Hayk,fiurst,Gevorgyan Hayk - Mkrtchyan Andranik,83,45,38,-7,7,18,24,22,19,0,-4,-2,2,-3,0,-7,11:7 - 13:11 - 10:12 - 11:8 - 0:0
14839040,2023-10-27 16:50:00,Mkrtchyan Andranik - Avakimyan Davit,3:1,10:12 - 12:10 - 5:11 - 5:11 - 0:0,1,3,Mkrtchyan Andranik,Avakimyan Davit,fiurst,Avakimyan Davit - Mkrtchyan Andranik,76,44,32,-12,12,22,22,16,16,0,-2,2,-6,-6,0,-12,12:10 - 10:12 - 11:5 - 11:5 - 0:0
14839038,2023-10-27 16:15:00,Gevorgyan Gegham - Mkrtchyan Andranik,2:3,11:4 - 6:11 - 11:7 - 7:11 - 8:11,2,3,Gevorgyan Gegham,Mkrtchyan Andranik,fiurst,Gevorgyan Gegham - Mkrtchyan Andranik,87,43,44,1,-1,15,17,18,18,19,-7,5,-4,4,3,1,11:4 - 6:11 - 11:7 - 7:11 - 8:11
14839033,2023-10-27 16:10:00,Avakimyan Davit - Petrosyan Davit,0:0,0:0 - 0:0 - 0:0 - 0:0 - 0:0,0,0,Avakimyan Davit,Petrosyan Davit,fiurst,Avakimyan Davit - Petrosyan Davit,0,0,0,0,0,0,0,0,0,0,0,0,0,0,0,0,0:0 - 0:0 - 0:0 - 0:0 - 0:0
14839021,2023-10-27 15:45:00,Gevorgyan Hayk - Gevorgyan Gegham,0:3,11:6 - 11:9 - 11:5 - 0:0 - 0:0,3,0,Gevorgyan Hayk,Gevorgyan Gegham,fiurst,Gevorgyan Gegham - Gevorgyan Hayk,53,20,33,13,-13,17,20,16,0,0,5,2,6,0,0,13,6:11 - 9:11 - 5:11 - 0:0 - 0:0
14839013,2023-10-27 15:30:00,Petrosyan Davit - Mkrtchyan Andranik,3:2,11:7 - 8:11 - 11:3 - 3:11 - 8:11,2,3,Petrosyan Davit,Mkrtchyan Andranik,fiurst,Mkrtchyan Andranik - Petrosyan Davit,84,43,41,-2,2,18,19,14,14,19,4,-3,8,-8,-3,-2,7:11 - 11:8 - 3:11 - 11:3 - 11:8
14839009,2023-10-27 15:15:00,Avakimyan Davit - Gevorgyan Hayk,1:3,8:11 - 11:7 - 6:11 - 7:11 - 0:0,1,3,Avakimyan Davit,Gevorgyan Hayk,fiurst,Avakimyan Davit - Gevorgyan Hayk,72,32,40,8,-8,19,18,17,18,0,3,-4,5,4,0,8,8:11 - 11:7 - 6:11 - 7:11 - 0:0
14839001,2023-10-27 15:05:00,Diaryan Aleksandr - Rafayelyan Edgar,1:3,11:13 - 12:10 - 9:11 - 8:11 - 0:0,1,3,Diaryan Aleksandr,Rafayelyan Edgar,fiurst,Diaryan Aleksandr - Rafayelyan Edgar,85,40,45,5,-5,24,22,20,19,0,2,-2,2,3,0,5,11:13 - 12:10 - 9:11 - 8:11 - 0:0
14838997,2023-10-27 14:45:00,Nazaryan Mushegh - Nikoghosyan Narek,1:3,11:9 - 4:11 - 7:11 - 8:11 - 0:0,1,3,Nazaryan Mushegh,Nikoghosyan Narek,fiurst,Nazaryan Mushegh - Nikoghosyan Narek,72,30,42,12,-12,20,15,18,19,0,-2,7,4,3,0,12,11:9 - 4:11 - 7:11 - 8:11 - 0:0
14838992,2023-10-27 14:30:00,Arutyunov Ruben - Diaryan Aleksandr,1:3,7:11 - 3:11 - 14:12 - 10:12 - 0:0,1,3,Arutyunov Ruben,Diaryan Aleksandr,fiurst,Arutyunov Ruben - Diaryan Aleksandr,80,34,46,12,-12,18,14,26,22,0,4,8,-2,2,0,12,7:11 - 3:11 - 14:12 - 10:12 - 0:0
14838988,2023-10-27 14:25:00,Rafayelyan Edgar - Nazaryan Mushegh,0:3,11:9 - 11:6 - 11:6 - 0:0 - 0:0,3,0,Rafayelyan Edgar,Nazaryan Mushegh,fiurst,Nazaryan Mushegh - Rafayelyan Edgar,54,21,33,12,-12,20,17,17,0,0,2,5,5,0,0,12,9:11 - 6:11 - 6:11 - 0:0 - 0:0
14838984,2023-10-27 14:15:00,Arutyunov Ruben - Nikoghosyan Narek,0:3,4:11 - 5:11 - 6:11 - 0:0 - 0:0,0,3,Arutyunov Ruben,Nikoghosyan Narek,fiurst,Arutyunov Ruben - Nikoghosyan Narek,48,15,33,18,-18,15,16,17,0,0,7,6,5,0,0,18,4:11 - 5:11 - 6:11 - 0:0 - 0:0
14838972,2023-10-27 13:45:00,Diaryan Aleksandr - Nazaryan Mushegh,3:0,11:5 - 11:5 - 11:7 - 0:0 - 0:0,3,0,Diaryan Aleksandr,Nazaryan Mushegh,fiurst,Diaryan Aleksandr - Nazaryan Mushegh,50,33,17,-16,16,16,16,18,0,0,-6,-6,-4,0,0,-16,11:5 - 11:5 - 11:7 - 0:0 - 0:0
14838968,2023-10-27 13:35:00,Rafayelyan Edgar - Arutyunov Ruben,0:3,11:5 - 11:5 - 11:7 - 0:0 - 0:0,3,0,Rafayelyan Edgar,Arutyunov Ruben,fiurst,Arutyunov Ruben - Rafayelyan Edgar,50,17,33,16,-16,16,16,18,0,0,6,6,4,0,0,16,5:11 - 5:11 - 7:11 - 0:0 - 0:0
14838967,2023-10-27 13:30:00,Nikoghosyan Narek - Diaryan Aleksandr,3:2,11:3 - 9:11 - 7:11 - 11:9 - 7:11,2,3,Nikoghosyan Narek,Diaryan Aleksandr,fiurst,Diaryan Aleksandr - Nikoghosyan Narek,90,45,45,0,0,14,20,18,20,18,8,-2,-4,2,-4,0,3:11 - 11:9 - 11:7 - 9:11 - 11:7
14838955,2023-10-27 13:00:00,Nazaryan Mushegh - Arutyunov Ruben,2:3,9:11 - 11:8 - 11:4 - 4:11 - 13:11,3,2,Nazaryan Mushegh,Arutyunov Ruben,fiurst,Arutyunov Ruben - Nazaryan Mushegh,93,45,48,3,-3,20,19,15,15,24,-2,3,7,-7,2,3,11:9 - 8:11 - 4:11 - 11:4 - 11:13
14838953,2023-10-27 12:45:00,Nikoghosyan Narek - Rafayelyan Edgar,3:2,11:6 - 7:11 - 10:12 - 11:9 - 11:9,3,2,Nikoghosyan Narek,Rafayelyan Edgar,fiurst,Nikoghosyan Narek - Rafayelyan Edgar,97,50,47,-3,3,17,18,22,20,20,-5,4,2,-2,-2,-3,11:6 - 7:11 - 10:12 - 11:9 - 11:9
14838950,2023-10-27 12:15:00,Diaryan Aleksandr - Arutyunov Ruben,0:3,11:6 - 11:4 - 11:5 - 0:0 - 0:0,3,0,Diaryan Aleksandr,Arutyunov Ruben,fiurst,Arutyunov Ruben - Diaryan Aleksandr,48,15,33,18,-18,17,15,16,0,0,5,7,6,0,0,18,6:11 - 4:11 - 5:11 - 0:0 - 0:0
14838946,2023-10-27 12:05:00,Nikoghosyan Narek - Nazaryan Mushegh,0:3,11:9 - 11:4 - 11:7 - 0:0 - 0:0,3,0,Nikoghosyan Narek,Nazaryan Mushegh,fiurst,Nazaryan Mushegh - Nikoghosyan Narek,53,20,33,13,-13,20,15,18,0,0,2,7,4,0,0,13,9:11 - 4:11 - 7:11 - 0:0 - 0:0
14838945,2023-10-27 11:45:00,Rafayelyan Edgar - Diaryan Aleksandr,3:0,10:12 - 9:11 - 9:11 - 0:0 - 0:0,0,3,Rafayelyan Edgar,Diaryan Aleksandr,fiurst,Diaryan Aleksandr - Rafayelyan Edgar,62,34,28,-6,6,22,20,20,0,0,-2,-2,-2,0,0,-6,12:10 - 11:9 - 11:9 - 0:0 - 0:0
14838942,2023-10-27 11:40:00,Nikoghosyan Narek - Arutyunov Ruben,0:3,11:6 - 11:9 - 11:5 - 0:0 - 0:0,3,0,Nikoghosyan Narek,Arutyunov Ruben,fiurst,Arutyunov Ruben - Nikoghosyan Narek,53,20,33,13,-13,17,20,16,0,0,5,2,6,0,0,13,6:11 - 9:11 - 5:11 - 0:0 - 0:0
14838931,2023-10-27 11:15:00,Nazaryan Mushegh - Rafayelyan Edgar,2:3,11:2 - 11:5 - 14:16 - 8:11 - 4:11,2,3,Nazaryan Mushegh,Rafayelyan Edgar,fiurst,Nazaryan Mushegh - Rafayelyan Edgar,93,48,45,-3,3,13,16,30,19,15,-9,-6,2,3,7,-3,11:2 - 11:5 - 14:16 - 8:11 - 4:11
14838925,2023-10-27 11:00:00,Diaryan Aleksandr - Nikoghosyan Narek,2:3,5:11 - 11:5 - 10:12 - 11:7 - 5:11,2,3,Diaryan Aleksandr,Nikoghosyan Narek,fiurst,Diaryan Aleksandr - Nikoghosyan Narek,88,42,46,4,-4,16,16,22,18,16,6,-6,2,-4,6,4,5:11 - 11:5 - 10:12 - 11:7 - 5:11
14838923,2023-10-27 10:50:00,Arutyunov Ruben - Rafayelyan Edgar,0:3,8:11 - 10:12 - 7:11 - 0:0 - 0:0,0,3,Arutyunov Ruben,Rafayelyan Edgar,fiurst,Arutyunov Ruben - Rafayelyan Edgar,59,25,34,9,-9,19,22,18,0,0,3,2,4,0,0,9,8:11 - 10:12 - 7:11 - 0:0 - 0:0
14838922,2023-10-27 10:30:00,Nazaryan Mushegh - Diaryan Aleksandr,3:0,8:11 - 8:11 - 9:11 - 0:0 - 0:0,0,3,Nazaryan Mushegh,Diaryan Aleksandr,fiurst,Diaryan Aleksandr - Nazaryan Mushegh,58,33,25,-8,8,19,19,20,0,0,-3,-3,-2,0,0,-8,11:8 - 11:8 - 11:9 - 0:0 - 0:0
14838910,2023-10-27 10:15:00,Rafayelyan Edgar - Nikoghosyan Narek,3:2,4:11 - 11:7 - 11:9 - 7:11 - 6:11,2,3,Rafayelyan Edgar,Nikoghosyan Narek,fiurst,Nikoghosyan Narek - Rafayelyan Edgar,88,49,39,-10,10,15,18,20,18,17,-7,4,2,-4,-5,-10,11:4 - 7:11 - 9:11 - 11:7 - 11:6
14838909,2023-10-27 10:00:00,Arutyunov Ruben - Nazaryan Mushegh,1:3,4:11 - 9:11 - 11:6 - 5:11 - 0:0,1,3,Arutyunov Ruben,Nazaryan Mushegh,fiurst,Arutyunov Ruben - Nazaryan Mushegh,68,29,39,10,-10,15,20,17,16,0,7,2,-5,6,0,10,4:11 - 9:11 - 11:6 - 5:11 - 0:0
14823903,2023-10-26 17:45:00,Darbinyan Armen - Avakimyan Davit,3:1,6:11 - 9:11 - 11:9 - 5:11 - 0:0,1,3,Darbinyan Armen,Avakimyan Davit,fiurst,Avakimyan Davit - Darbinyan Armen,73,42,31,-11,11,17,20,20,16,0,-5,-2,2,-6,0,-11,11:6 - 11:9 - 9:11 - 11:5 - 0:0
14823960,2023-10-26 17:30:00,Darbinyan Armen - Petrosyan Davit,0:3,11:13 - 7:11 - 7:11 - 0:0 - 0:0,0,3,Darbinyan Armen,Petrosyan Davit,fiurst,Darbinyan Armen - Petrosyan Davit,60,25,35,10,-10,24,18,18,0,0,2,4,4,0,0,10,11:13 - 7:11 - 7:11 - 0:0 - 0:0
14823950,2023-10-26 17:20:00,Avakimyan Davit - Grigoryan Erik,3:0,11:6 - 11:6 - 11:9 - 0:0 - 0:0,3,0,Avakimyan Davit,Grigoryan Erik,fiurst,Avakimyan Davit - Grigoryan Erik,54,33,21,-12,12,17,17,20,0,0,-5,-5,-2,0,0,-12,11:6 - 11:6 - 11:9 - 0:0 - 0:0
14823920,2023-10-26 17:00:00,Gevorgyan Hayk - Darbinyan Armen,0:3,11:3 - 11:9 - 12:10 - 0:0 - 0:0,3,0,Gevorgyan Hayk,Darbinyan Armen,fiurst,Darbinyan Armen - Gevorgyan Hayk,56,22,34,12,-12,14,20,22,0,0,8,2,2,0,0,12,3:11 - 9:11 - 10:12 - 0:0 - 0:0
14823899,2023-10-26 16:50:00,Grigoryan Erik - Darbinyan Armen,3:0,6:11 - 4:11 - 6:11 - 0:0 - 0:0,0,3,Grigoryan Erik,Darbinyan Armen,fiurst,Darbinyan Armen - Grigoryan Erik,49,33,16,-17,17,17,15,17,0,0,-5,-7,-5,0,0,-17,11:6 - 11:4 - 11:6 - 0:0 - 0:0
14823915,2023-10-26 16:45:00,Avakimyan Davit - Petrosyan Davit,2:3,7:11 - 11:8 - 12:10 - 8:11 - 7:11,2,3,Avakimyan Davit,Petrosyan Davit,fiurst,Avakimyan Davit - Petrosyan Davit,96,45,51,6,-6,18,19,22,19,18,4,-3,-2,3,4,6,7:11 - 11:8 - 12:10 - 8:11 - 7:11
14823904,2023-10-26 16:35:00,Grigoryan Erik - Gevorgyan Hayk,3:0,8:11 - 8:11 - 3:11 - 0:0 - 0:0,0,3,Grigoryan Erik,Gevorgyan Hayk,fiurst,Gevorgyan Hayk - Grigoryan Erik,52,33,19,-14,14,19,19,14,0,0,-3,-3,-8,0,0,-14,11:8 - 11:8 - 11:3 - 0:0 - 0:0
14823902,2023-10-26 16:00:00,Petrosyan Davit - Gevorgyan Hayk,3:2,11:8 - 13:11 - 9:11 - 6:11 - 7:11,2,3,Petrosyan Davit,Gevorgyan Hayk,fiurst,Gevorgyan Hayk - Petrosyan Davit,98,52,46,-6,6,19,24,20,17,18,3,2,-2,-5,-4,-6,8:11 - 11:13 - 11:9 - 11:6 - 11:7
14823893,2023-10-26 15:30:00,Gevorgyan Hayk - Avakimyan Davit,0:3,11:6 - 11:7 - 11:8 - 0:0 - 0:0,3,0,Gevorgyan Hayk,Avakimyan Davit,fiurst,Avakimyan Davit - Gevorgyan Hayk,54,21,33,12,-12,17,18,19,0,0,5,4,3,0,0,12,6:11 - 7:11 - 8:11 - 0:0 - 0:0
14823890,2023-10-26 15:20:00,Petrosyan Davit - Grigoryan Erik,1:3,6:11 - 15:13 - 11:4 - 11:4 - 0:0,3,1,Petrosyan Davit,Grigoryan Erik,fiurst,Grigoryan Erik - Petrosyan Davit,75,32,43,11,-11,17,28,15,15,0,-5,2,7,7,0,11,11:6 - 13:15 - 4:11 - 4:11 - 0:0
14823875,2023-10-26 15:00:00,Diaryan Aleksandr - Soghomonyan Hrayr,3:0,11:7 - 11:5 - 11:6 - 0:0 - 0:0,3,0,Diaryan Aleksandr,Soghomonyan Hrayr,fiurst,Diaryan Aleksandr - Soghomonyan Hrayr,51,33,18,-15,15,18,16,17,0,0,-4,-6,-5,0,0,-15,11:7 - 11:5 - 11:6 - 0:0 - 0:0
14823874,2023-10-26 14:45:00,Rafayelyan Edgar - Arutyunov Ruben,0:3,11:8 - 11:4 - 11:7 - 0:0 - 0:0,3,0,Rafayelyan Edgar,Arutyunov Ruben,fiurst,Arutyunov Ruben - Rafayelyan Edgar,52,19,33,14,-14,19,15,18,0,0,3,7,4,0,0,14,8:11 - 4:11 - 7:11 - 0:0 - 0:0
14823870,2023-10-26 14:30:00,Nikoghosyan Narek - Diaryan Aleksandr,3:1,8:11 - 8:11 - 11:9 - 7:11 - 0:0,1,3,Nikoghosyan Narek,Diaryan Aleksandr,fiurst,Diaryan Aleksandr - Nikoghosyan Narek,76,42,34,-8,8,19,19,20,18,0,-3,-3,2,-4,0,-8,11:8 - 11:8 - 9:11 - 11:7 - 0:0
14823867,2023-10-26 14:15:00,Soghomonyan Hrayr - Rafayelyan Edgar,3:1,11:7 - 11:13 - 6:11 - 7:11 - 0:0,1,3,Soghomonyan Hrayr,Rafayelyan Edgar,fiurst,Rafayelyan Edgar - Soghomonyan Hrayr,77,42,35,-7,7,18,24,17,18,0,4,-2,-5,-4,0,-7,7:11 - 13:11 - 11:6 - 11:7 - 0:0
14823863,2023-10-26 14:10:00,Nikoghosyan Narek - Arutyunov Ruben,0:3,11:3 - 11:7 - 11:3 - 0:0 - 0:0,3,0,Nikoghosyan Narek,Arutyunov Ruben,fiurst,Arutyunov Ruben - Nikoghosyan Narek,46,13,33,20,-20,14,18,14,0,0,8,4,8,0,0,20,3:11 - 7:11 - 3:11 - 0:0 - 0:0
14823859,2023-10-26 13:45:00,Diaryan Aleksandr - Rafayelyan Edgar,0:3,7:11 - 5:11 - 9:11 - 0:0 - 0:0,0,3,Diaryan Aleksandr,Rafayelyan Edgar,fiurst,Diaryan Aleksandr - Rafayelyan Edgar,54,21,33,12,-12,18,16,20,0,0,4,6,2,0,0,12,7:11 - 5:11 - 9:11 - 0:0 - 0:0
14823847,2023-10-26 13:30:00,Soghomonyan Hrayr - Nikoghosyan Narek,1:3,11:13 - 11:9 - 12:10 - 11:8 - 0:0,3,1,Soghomonyan Hrayr,Nikoghosyan Narek,fiurst,Nikoghosyan Narek - Soghomonyan Hrayr,85,40,45,5,-5,24,20,22,19,0,-2,2,2,3,0,5,13:11 - 9:11 - 10:12 - 8:11 - 0:0
14823844,2023-10-26 13:25:00,Arutyunov Ruben - Diaryan Aleksandr,0:3,7:11 - 9:11 - 6:11 - 0:0 - 0:0,0,3,Arutyunov Ruben,Diaryan Aleksandr,fiurst,Arutyunov Ruben - Diaryan Aleksandr,55,22,33,11,-11,18,20,17,0,0,4,2,5,0,0,11,7:11 - 9:11 - 6:11 - 0:0 - 0:0
14823837,2023-10-26 13:00:00,Rafayelyan Edgar - Nikoghosyan Narek,3:0,9:11 - 9:11 - 7:11 - 0:0 - 0:0,0,3,Rafayelyan Edgar,Nikoghosyan Narek,fiurst,Nikoghosyan Narek - Rafayelyan Edgar,58,33,25,-8,8,20,20,18,0,0,-2,-2,-4,0,0,-8,11:9 - 11:9 - 11:7 - 0:0 - 0:0
14823834,2023-10-26 12:45:00,Arutyunov Ruben - Soghomonyan Hrayr,2:3,10:12 - 7:11 - 11:9 - 11:6 - 7:11,2,3,Arutyunov Ruben,Soghomonyan Hrayr,fiurst,Arutyunov Ruben - Soghomonyan Hrayr,95,46,49,3,-3,22,18,20,17,18,2,4,-2,-5,4,3,10:12 - 7:11 - 11:9 - 11:6 - 7:11
14823833,2023-10-26 12:15:00,Diaryan Aleksandr - Nikoghosyan Narek,3:1,4:11 - 11:9 - 11:8 - 11:9 - 0:0,3,1,Diaryan Aleksandr,Nikoghosyan Narek,fiurst,Diaryan Aleksandr - Nikoghosyan Narek,74,37,37,0,0,15,20,19,20,0,7,-2,-3,-2,0,0,4:11 - 11:9 - 11:8 - 11:9 - 0:0
14823831,2023-10-26 12:00:00,Arutyunov Ruben - Rafayelyan Edgar,0:3,3:11 - 9:11 - 12:14 - 0:0 - 0:0,0,3,Arutyunov Ruben,Rafayelyan Edgar,fiurst,Arutyunov Ruben - Rafayelyan Edgar,60,24,36,12,-12,14,20,26,0,0,8,2,2,0,0,12,3:11 - 9:11 - 12:14 - 0:0 - 0:0
14823824,2023-10-26 11:45:00,Soghomonyan Hrayr - Diaryan Aleksandr,3:0,9:11 - 4:11 - 9:11 - 0:0 - 0:0,0,3,Soghomonyan Hrayr,Diaryan Aleksandr,fiurst,Diaryan Aleksandr - Soghomonyan Hrayr,55,33,22,-11,11,20,15,20,0,0,-2,-7,-2,0,0,-11,11:9 - 11:4 - 11:9 - 0:0 - 0:0
14823818,2023-10-26 11:30:00,Arutyunov Ruben - Nikoghosyan Narek,0:3,7:11 - 8:11 - 8:11 - 0:0 - 0:0,0,3,Arutyunov Ruben,Nikoghosyan Narek,fiurst,Arutyunov Ruben - Nikoghosyan Narek,56,23,33,10,-10,18,19,19,0,0,4,3,3,0,0,10,7:11 - 8:11 - 8:11 - 0:0 - 0:0
14823816,2023-10-26 11:20:00,Rafayelyan Edgar - Soghomonyan Hrayr,3:0,11:7 - 11:7 - 11:8 - 0:0 - 0:0,3,0,Rafayelyan Edgar,Soghomonyan Hrayr,fiurst,Rafayelyan Edgar - Soghomonyan Hrayr,55,33,22,-11,11,18,18,19,0,0,-4,-4,-3,0,0,-11,11:7 - 11:7 - 11:8 - 0:0 - 0:0
14823813,2023-10-26 11:05:00,Diaryan Aleksandr - Arutyunov Ruben,0:3,11:9 - 11:8 - 11:6 - 0:0 - 0:0,3,0,Diaryan Aleksandr,Arutyunov Ruben,fiurst,Arutyunov Ruben - Diaryan Aleksandr,56,23,33,10,-10,20,19,17,0,0,2,3,5,0,0,10,9:11 - 8:11 - 6:11 - 0:0 - 0:0
14823809,2023-10-26 10:50:00,Nikoghosyan Narek - Soghomonyan Hrayr,3:0,11:9 - 11:8 - 11:9 - 0:0 - 0:0,3,0,Nikoghosyan Narek,Soghomonyan Hrayr,fiurst,Nikoghosyan Narek - Soghomonyan Hrayr,59,33,26,-7,7,20,19,20,0,0,-2,-3,-2,0,0,-7,11:9 - 11:8 - 11:9 - 0:0 - 0:0
14823808,2023-10-26 10:30:00,Rafayelyan Edgar - Diaryan Aleksandr,3:2,9:11 - 11:5 - 5:11 - 11:7 - 10:12,2,3,Rafayelyan Edgar,Diaryan Aleksandr,fiurst,Diaryan Aleksandr - Rafayelyan Edgar,92,46,46,0,0,20,16,16,18,22,-2,6,-6,4,-2,0,11:9 - 5:11 - 11:5 - 7:11 - 12:10
14823803,2023-10-26 10:15:00,Soghomonyan Hrayr - Arutyunov Ruben,3:2,8:11 - 12:10 - 5:11 - 11:4 - 11:13,2,3,Soghomonyan Hrayr,Arutyunov Ruben,fiurst,Arutyunov Ruben - Soghomonyan Hrayr,96,49,47,-2,2,19,22,16,15,24,-3,2,-6,7,-2,-2,11:8 - 10:12 - 11:5 - 4:11 - 13:11
14823793,2023-10-26 10:00:00,Nikoghosyan Narek - Rafayelyan Edgar,0:3,9:11 - 7:11 - 7:11 - 0:0 - 0:0,0,3,Nikoghosyan Narek,Rafayelyan Edgar,fiurst,Nikoghosyan Narek - Rafayelyan Edgar,56,23,33,10,-10,20,18,18,0,0,2,4,4,0,0,10,9:11 - 7:11 - 7:11 - 0:0 - 0:0
14825281,2023-10-25 17:45:00,Darbinyan Armen - Gevorgyan Hayk,0:3,2:11 - 2:11 - 7:11 - 0:0 - 0:0,0,3,Darbinyan Armen,Gevorgyan Hayk,fiurst,Darbinyan Armen - Gevorgyan Hayk,44,11,33,22,-22,13,13,18,0,0,9,9,4,0,0,22,2:11 - 2:11 - 7:11 - 0:0 - 0:0
14804137,2023-10-25 17:30:00,Mkrtchyan Andranik - Darbinyan Armen,0:3,11:5 - 11:6 - 11:8 - 0:0 - 0:0,3,0,Mkrtchyan Andranik,Darbinyan Armen,fiurst,Darbinyan Armen - Mkrtchyan Andranik,52,19,33,14,-14,16,17,19,0,0,6,5,3,0,0,14,5:11 - 6:11 - 8:11 - 0:0 - 0:0
14804136,2023-10-25 17:15:00,Avakimyan Davit - Gevorgyan Hayk,3:0,11:9 - 11:9 - 11:9 - 0:0 - 0:0,3,0,Avakimyan Davit,Gevorgyan Hayk,fiurst,Avakimyan Davit - Gevorgyan Hayk,60,33,27,-6,6,20,20,20,0,0,-2,-2,-2,0,0,-6,11:9 - 11:9 - 11:9 - 0:0 - 0:0
14804134,2023-10-25 17:00:00,Grigoryan Erik - Mkrtchyan Andranik,0:3,5:11 - 6:11 - 5:11 - 0:0 - 0:0,0,3,Grigoryan Erik,Mkrtchyan Andranik,fiurst,Grigoryan Erik - Mkrtchyan Andranik,49,16,33,17,-17,16,17,16,0,0,6,5,6,0,0,17,5:11 - 6:11 - 5:11 - 0:0 - 0:0
14804132,2023-10-25 16:45:00,Avakimyan Davit - Darbinyan Armen,3:0,11:9 - 11:9 - 11:7 - 0:0 - 0:0,3,0,Avakimyan Davit,Darbinyan Armen,fiurst,Avakimyan Davit - Darbinyan Armen,58,33,25,-8,8,20,20,18,0,0,-2,-2,-4,0,0,-8,11:9 - 11:9 - 11:7 - 0:0 - 0:0
14804123,2023-10-25 16:35:00,Gevorgyan Hayk - Grigoryan Erik,3:0,13:11 - 11:3 - 11:3 - 0:0 - 0:0,3,0,Gevorgyan Hayk,Grigoryan Erik,fiurst,Gevorgyan Hayk - Grigoryan Erik,52,35,17,-18,18,24,14,14,0,0,-2,-8,-8,0,0,-18,13:11 - 11:3 - 11:3 - 0:0 - 0:0
14804119,2023-10-25 16:15:00,Mkrtchyan Andranik - Avakimyan Davit,0:3,11:9 - 11:8 - 11:3 - 0:0 - 0:0,3,0,Mkrtchyan Andranik,Avakimyan Davit,fiurst,Avakimyan Davit - Mkrtchyan Andranik,53,20,33,13,-13,20,19,14,0,0,2,3,8,0,0,13,9:11 - 8:11 - 3:11 - 0:0 - 0:0
14804117,2023-10-25 16:00:00,Darbinyan Armen - Grigoryan Erik,2:3,9:11 - 11:6 - 11:8 - 9:11 - 10:12,2,3,Darbinyan Armen,Grigoryan Erik,fiurst,Darbinyan Armen - Grigoryan Erik,98,50,48,-2,2,20,17,19,20,22,2,-5,-3,2,2,-2,9:11 - 11:6 - 11:8 - 9:11 - 10:12
14804106,2023-10-25 15:45:00,Gevorgyan Hayk - Mkrtchyan Andranik,0:3,8:11 - 8:11 - 6:11 - 0:0 - 0:0,0,3,Gevorgyan Hayk,Mkrtchyan Andranik,fiurst,Gevorgyan Hayk - Mkrtchyan Andranik,55,22,33,11,-11,19,19,17,0,0,3,3,5,0,0,11,8:11 - 8:11 - 6:11 - 0:0 - 0:0
14804103,2023-10-25 15:30:00,Grigoryan Erik - Avakimyan Davit,3:0,5:11 - 8:11 - 6:11 - 0:0 - 0:0,0,3,Grigoryan Erik,Avakimyan Davit,fiurst,Avakimyan Davit - Grigoryan Erik,52,33,19,-14,14,16,19,17,0,0,-6,-3,-5,0,0,-14,11:5 - 11:8 - 11:6 - 0:0 - 0:0
14804099,2023-10-25 15:00:00,Nazaryan Mushegh - Rafayelyan Edgar,1:3,6:11 - 4:11 - 11:8 - 7:11 - 0:0,1,3,Nazaryan Mushegh,Rafayelyan Edgar,fiurst,Nazaryan Mushegh - Rafayelyan Edgar,69,28,41,13,-13,17,15,19,18,0,5,7,-3,4,0,13,6:11 - 4:11 - 11:8 - 7:11 - 0:0
14804095,2023-10-25 14:50:00,Papyan Karen - Soghomonyan Hrayr,2:3,11:7 - 8:11 - 11:5 - 8:11 - 4:11,2,3,Papyan Karen,Soghomonyan Hrayr,fiurst,Papyan Karen - Soghomonyan Hrayr,87,42,45,3,-3,18,19,16,19,15,-4,3,-6,3,7,3,11:7 - 8:11 - 11:5 - 8:11 - 4:11
14804094,2023-10-25 14:30:00,Diaryan Aleksandr - Nazaryan Mushegh,3:0,11:4 - 11:8 - 11:6 - 0:0 - 0:0,3,0,Diaryan Aleksandr,Nazaryan Mushegh,fiurst,Diaryan Aleksandr - Nazaryan Mushegh,51,33,18,-15,15,15,19,17,0,0,-7,-3,-5,0,0,-15,11:4 - 11:8 - 11:6 - 0:0 - 0:0
14804092,2023-10-25 14:20:00,Rafayelyan Edgar - Papyan Karen,3:1,9:11 - 11:5 - 11:13 - 9:11 - 0:0,1,3,Rafayelyan Edgar,Papyan Karen,fiurst,Papyan Karen - Rafayelyan Edgar,80,40,40,0,0,20,16,24,20,0,-2,6,-2,-2,0,0,11:9 - 5:11 - 13:11 - 11:9 - 0:0
14804081,2023-10-25 14:10:00,Diaryan Aleksandr - Soghomonyan Hrayr,3:0,11:7 - 11:9 - 11:6 - 0:0 - 0:0,3,0,Diaryan Aleksandr,Soghomonyan Hrayr,fiurst,Diaryan Aleksandr - Soghomonyan Hrayr,55,33,22,-11,11,18,20,17,0,0,-4,-2,-5,0,0,-11,11:7 - 11:9 - 11:6 - 0:0 - 0:0
14804080,2023-10-25 13:45:00,Nazaryan Mushegh - Papyan Karen,1:3,11:8 - 12:14 - 11:13 - 5:11 - 0:0,1,3,Nazaryan Mushegh,Papyan Karen,fiurst,Nazaryan Mushegh - Papyan Karen,85,39,46,7,-7,19,26,24,16,0,-3,2,2,6,0,7,11:8 - 12:14 - 11:13 - 5:11 - 0:0
14804078,2023-10-25 13:35:00,Rafayelyan Edgar - Diaryan Aleksandr,3:2,11:4 - 12:10 - 9:11 - 9:11 - 5:11,2,3,Rafayelyan Edgar,Diaryan Aleksandr,fiurst,Diaryan Aleksandr - Rafayelyan Edgar,93,47,46,-1,1,15,22,20,20,16,7,2,-2,-2,-6,-1,4:11 - 10:12 - 11:9 - 11:9 - 11:5
14804077,2023-10-25 13:20:00,Soghomonyan Hrayr - Nazaryan Mushegh,1:3,11:8 - 11:8 - 4:11 - 11:7 - 0:0,3,1,Soghomonyan Hrayr,Nazaryan Mushegh,fiurst,Nazaryan Mushegh - Soghomonyan Hrayr,71,34,37,3,-3,19,19,15,18,0,3,3,-7,4,0,3,8:11 - 8:11 - 11:4 - 7:11 - 0:0
14804075,2023-10-25 13:00:00,Papyan Karen - Diaryan Aleksandr,3:2,11:9 - 10:12 - 11:7 - 8:11 - 3:11,2,3,Papyan Karen,Diaryan Aleksandr,fiurst,Diaryan Aleksandr - Papyan Karen,93,50,43,-7,7,20,22,18,19,14,2,-2,4,-3,-8,-7,9:11 - 12:10 - 7:11 - 11:8 - 11:3
14804072,2023-10-25 12:45:00,Soghomonyan Hrayr - Rafayelyan Edgar,3:1,6:11 - 13:11 - 9:11 - 5:11 - 0:0,1,3,Soghomonyan Hrayr,Rafayelyan Edgar,fiurst,Rafayelyan Edgar - Soghomonyan Hrayr,77,44,33,-11,11,17,24,20,16,0,-5,2,-2,-6,0,-11,11:6 - 11:13 - 11:9 - 11:5 - 0:0
14804071,2023-10-25 12:20:00,Nazaryan Mushegh - Diaryan Aleksandr,3:0,4:11 - 7:11 - 8:11 - 0:0 - 0:0,0,3,Nazaryan Mushegh,Diaryan Aleksandr,fiurst,Diaryan Aleksandr - Nazaryan Mushegh,52,33,19,-14,14,15,18,19,0,0,-7,-4,-3,0,0,-14,11:4 - 11:7 - 11:8 - 0:0 - 0:0
14804063,2023-10-25 12:00:00,Soghomonyan Hrayr - Papyan Karen,3:2,4:11 - 7:11 - 11:9 - 11:9 - 10:12,2,3,Soghomonyan Hrayr,Papyan Karen,fiurst,Papyan Karen - Soghomonyan Hrayr,95,52,43,-9,9,15,18,20,20,22,-7,-4,2,2,-2,-9,11:4 - 11:7 - 9:11 - 9:11 - 12:10
14804062,2023-10-25 11:45:00,Rafayelyan Edgar - Nazaryan Mushegh,3:2,8:11 - 11:5 - 11:5 - 7:11 - 7:11,2,3,Rafayelyan Edgar,Nazaryan Mushegh,fiurst,Nazaryan Mushegh - Rafayelyan Edgar,87,43,44,1,-1,19,16,16,18,18,-3,6,6,-4,-4,1,11:8 - 5:11 - 5:11 - 11:7 - 11:7
14804050,2023-10-25 11:30:00,Soghomonyan Hrayr - Diaryan Aleksandr,3:1,11:7 - 6:11 - 7:11 - 8:11 - 0:0,1,3,Soghomonyan Hrayr,Diaryan Aleksandr,fiurst,Diaryan Aleksandr - Soghomonyan Hrayr,72,40,32,-8,8,18,17,18,19,0,4,-5,-4,-3,0,-8,7:11 - 11:6 - 11:7 - 11:8 - 0:0
14804048,2023-10-25 11:25:00,Papyan Karen - Rafayelyan Edgar,1:3,6:11 - 8:11 - 13:11 - 5:11 - 0:0,1,3,Papyan Karen,Rafayelyan Edgar,fiurst,Papyan Karen - Rafayelyan Edgar,76,32,44,12,-12,17,19,24,16,0,5,3,-2,6,0,12,6:11 - 8:11 - 13:11 - 5:11 - 0:0
14804046,2023-10-25 11:00:00,Nazaryan Mushegh - Soghomonyan Hrayr,3:0,16:14 - 11:9 - 11:5 - 0:0 - 0:0,3,0,Nazaryan Mushegh,Soghomonyan Hrayr,fiurst,Nazaryan Mushegh - Soghomonyan Hrayr,66,38,28,-10,10,30,20,16,0,0,-2,-2,-6,0,0,-10,16:14 - 11:9 - 11:5 - 0:0 - 0:0
14804030,2023-10-25 10:45:00,Diaryan Aleksandr - Rafayelyan Edgar,2:3,7:11 - 11:8 - 11:4 - 12:14 - 7:11,2,3,Diaryan Aleksandr,Rafayelyan Edgar,fiurst,Diaryan Aleksandr - Rafayelyan Edgar,96,48,48,0,0,18,19,15,26,18,4,-3,-7,2,4,0,7:11 - 11:8 - 11:4 - 12:14 - 7:11
14804029,2023-10-25 10:30:00,Papyan Karen - Nazaryan Mushegh,1:3,11:8 - 12:10 - 6:11 - 14:12 - 0:0,3,1,Papyan Karen,Nazaryan Mushegh,fiurst,Nazaryan Mushegh - Papyan Karen,84,41,43,2,-2,19,22,17,26,0,3,2,-5,2,0,2,8:11 - 10:12 - 11:6 - 12:14 - 0:0
14804027,2023-10-25 10:15:00,Rafayelyan Edgar - Soghomonyan Hrayr,3:0,11:8 - 11:5 - 11:7 - 0:0 - 0:0,3,0,Rafayelyan Edgar,Soghomonyan Hrayr,fiurst,Rafayelyan Edgar - Soghomonyan Hrayr,53,33,20,-13,13,19,16,18,0,0,-3,-6,-4,0,0,-13,11:8 - 11:5 - 11:7 - 0:0 - 0:0
14804024,2023-10-25 10:00:00,Diaryan Aleksandr - Papyan Karen,3:1,6:11 - 11:7 - 11:7 - 11:6 - 0:0,3,1,Diaryan Aleksandr,Papyan Karen,fiurst,Diaryan Aleksandr - Papyan Karen,70,39,31,-8,8,17,18,18,17,0,5,-4,-4,-5,0,-8,6:11 - 11:7 - 11:7 - 11:6 - 0:0
14786226,2023-10-24 17:30:00,Petrosyan Davit - Mkrtchyan Andranik,3:2,5:11 - 11:4 - 4:11 - 11:7 - 8:11,2,3,Petrosyan Davit,Mkrtchyan Andranik,fiurst,Mkrtchyan Andranik - Petrosyan Davit,83,44,39,-5,5,16,15,15,18,19,-6,7,-7,4,-3,-5,11:5 - 4:11 - 11:4 - 7:11 - 11:8
14786215,2023-10-24 17:15:00,Avakimyan Davit - Grigoryan Erik,1:3,12:14 - 6:11 - 11:7 - 11:13 - 0:0,1,3,Avakimyan Davit,Grigoryan Erik,fiurst,Avakimyan Davit - Grigoryan Erik,85,40,45,5,-5,26,17,18,24,0,2,5,-4,2,0,5,12:14 - 6:11 - 11:7 - 11:13 - 0:0
14786203,2023-10-24 17:05:00,Gevorgyan Hayk - Petrosyan Davit,0:3,15:17 - 6:11 - 7:11 - 0:0 - 0:0,0,3,Gevorgyan Hayk,Petrosyan Davit,fiurst,Gevorgyan Hayk - Petrosyan Davit,67,28,39,11,-11,32,17,18,0,0,2,5,4,0,0,11,15:17 - 6:11 - 7:11 - 0:0 - 0:0
14786201,2023-10-24 16:45:00,Avakimyan Davit - Mkrtchyan Andranik,2:3,11:13 - 11:7 - 11:7 - 9:11 - 8:11,2,3,Avakimyan Davit,Mkrtchyan Andranik,fiurst,Avakimyan Davit - Mkrtchyan Andranik,99,50,49,-1,1,24,18,18,20,19,2,-4,-4,2,3,-1,11:13 - 11:7 - 11:7 - 9:11 - 8:11
14786199,2023-10-24 16:30:00,Grigoryan Erik - Gevorgyan Hayk,3:0,8:11 - 6:11 - 8:11 - 0:0 - 0:0,0,3,Grigoryan Erik,Gevorgyan Hayk,fiurst,Gevorgyan Hayk - Grigoryan Erik,55,33,22,-11,11,19,17,19,0,0,-3,-5,-3,0,0,-11,11:8 - 11:6 - 11:8 - 0:0 - 0:0
14786196,2023-10-24 16:15:00,Petrosyan Davit - Avakimyan Davit,3:0,12:14 - 14:16 - 7:11 - 0:0 - 0:0,0,3,Petrosyan Davit,Avakimyan Davit,fiurst,Avakimyan Davit - Petrosyan Davit,74,41,33,-8,8,26,30,18,0,0,-2,-2,-4,0,0,-8,14:12 - 16:14 - 11:7 - 0:0 - 0:0
14786192,2023-10-24 16:00:00,Mkrtchyan Andranik - Gevorgyan Hayk,0:3,11:8 - 11:4 - 11:7 - 0:0 - 0:0,3,0,Mkrtchyan Andranik,Gevorgyan Hayk,fiurst,Gevorgyan Hayk - Mkrtchyan Andranik,52,19,33,14,-14,19,15,18,0,0,3,7,4,0,0,14,8:11 - 4:11 - 7:11 - 0:0 - 0:0
14786188,2023-10-24 15:45:00,Grigoryan Erik - Petrosyan Davit,0:3,9:11 - 7:11 - 3:11 - 0:0 - 0:0,0,3,Grigoryan Erik,Petrosyan Davit,fiurst,Grigoryan Erik - Petrosyan Davit,52,19,33,14,-14,20,18,14,0,0,2,4,8,0,0,14,9:11 - 7:11 - 3:11 - 0:0 - 0:0
14786184,2023-10-24 15:30:00,Gevorgyan Hayk - Avakimyan Davit,3:1,7:11 - 6:11 - 11:8 - 7:11 - 0:0,1,3,Gevorgyan Hayk,Avakimyan Davit,fiurst,Avakimyan Davit - Gevorgyan Hayk,72,41,31,-10,10,18,17,19,18,0,-4,-5,3,-4,0,-10,11:7 - 11:6 - 8:11 - 11:7 - 0:0
14786181,2023-10-24 15:15:00,Mkrtchyan Andranik - Grigoryan Erik,0:3,11:7 - 11:8 - 11:6 - 0:0 - 0:0,3,0,Mkrtchyan Andranik,Grigoryan Erik,fiurst,Grigoryan Erik - Mkrtchyan Andranik,54,21,33,12,-12,18,19,17,0,0,4,3,5,0,0,12,7:11 - 8:11 - 6:11 - 0:0 - 0:0
14786137,2023-10-24 14:45:00,Nazaryan Mushegh - Nikoghosyan Narek,0:3,7:11 - 6:11 - 6:11 - 0:0 - 0:0,0,3,Nazaryan Mushegh,Nikoghosyan Narek,fiurst,Nazaryan Mushegh - Nikoghosyan Narek,52,19,33,14,-14,18,17,17,0,0,4,5,5,0,0,14,7:11 - 6:11 - 6:11 - 0:0 - 0:0
14786135,2023-10-24 14:30:00,Soghomonyan Hrayr - Papyan Karen,3:0,9:11 - 12:14 - 8:11 - 0:0 - 0:0,0,3,Soghomonyan Hrayr,Papyan Karen,fiurst,Papyan Karen - Soghomonyan Hrayr,65,36,29,-7,7,20,26,19,0,0,-2,-2,-3,0,0,-7,11:9 - 14:12 - 11:8 - 0:0 - 0:0
14786133,2023-10-24 14:20:00,Arutyunov Ruben - Nazaryan Mushegh,0:3,8:11 - 7:11 - 3:11 - 0:0 - 0:0,0,3,Arutyunov Ruben,Nazaryan Mushegh,fiurst,Arutyunov Ruben - Nazaryan Mushegh,51,18,33,15,-15,19,18,14,0,0,3,4,8,0,0,15,8:11 - 7:11 - 3:11 - 0:0 - 0:0
14786127,2023-10-24 14:00:00,Soghomonyan Hrayr - Nikoghosyan Narek,2:3,7:11 - 11:5 - 9:11 - 11:9 - 11:7,3,2,Soghomonyan Hrayr,Nikoghosyan Narek,fiurst,Nikoghosyan Narek - Soghomonyan Hrayr,92,43,49,6,-6,18,16,20,20,18,-4,6,-2,2,4,6,11:7 - 5:11 - 11:9 - 9:11 - 7:11
14786113,2023-10-24 13:55:00,Papyan Karen - Nazaryan Mushegh,3:1,7:11 - 11:9 - 8:11 - 10:12 - 0:0,1,3,Papyan Karen,Nazaryan Mushegh,fiurst,Nazaryan Mushegh - Papyan Karen,79,43,36,-7,7,18,20,19,22,0,-4,2,-3,-2,0,-7,11:7 - 9:11 - 11:8 - 12:10 - 0:0
14786111,2023-10-24 13:30:00,Arutyunov Ruben - Soghomonyan Hrayr,3:1,4:11 - 11:2 - 11:6 - 11:7 - 0:0,3,1,Arutyunov Ruben,Soghomonyan Hrayr,fiurst,Arutyunov Ruben - Soghomonyan Hrayr,63,37,26,-11,11,15,13,17,18,0,7,-9,-5,-4,0,-11,4:11 - 11:2 - 11:6 - 11:7 - 0:0
14786110,2023-10-24 13:15:00,Nikoghosyan Narek - Papyan Karen,3:1,5:11 - 11:8 - 11:8 - 11:8 - 0:0,3,1,Nikoghosyan Narek,Papyan Karen,fiurst,Nikoghosyan Narek - Papyan Karen,73,38,35,-3,3,16,19,19,19,0,6,-3,-3,-3,0,-3,5:11 - 11:8 - 11:8 - 11:8 - 0:0
14786106,2023-10-24 13:00:00,Nazaryan Mushegh - Soghomonyan Hrayr,1:3,11:9 - 7:11 - 7:11 - 7:11 - 0:0,1,3,Nazaryan Mushegh,Soghomonyan Hrayr,fiurst,Nazaryan Mushegh - Soghomonyan Hrayr,74,32,42,10,-10,20,18,18,18,0,-2,4,4,4,0,10,11:9 - 7:11 - 7:11 - 7:11 - 0:0
14786054,2023-10-24 12:45:00,Nikoghosyan Narek - Arutyunov Ruben,2:3,6:11 - 4:11 - 16:14 - 12:10 - 11:2,3,2,Nikoghosyan Narek,Arutyunov Ruben,fiurst,Arutyunov Ruben - Nikoghosyan Narek,97,48,49,1,-1,17,15,30,22,13,-5,-7,2,2,9,1,11:6 - 11:4 - 14:16 - 10:12 - 2:11
14786048,2023-10-24 12:25:00,Papyan Karen - Soghomonyan Hrayr,3:0,13:11 - 11:6 - 11:5 - 0:0 - 0:0,3,0,Papyan Karen,Soghomonyan Hrayr,fiurst,Papyan Karen - Soghomonyan Hrayr,57,35,22,-13,13,24,17,16,0,0,-2,-5,-6,0,0,-13,13:11 - 11:6 - 11:5 - 0:0 - 0:0
14786044,2023-10-24 12:10:00,Nikoghosyan Narek - Nazaryan Mushegh,3:1,7:11 - 8:11 - 11:5 - 7:11 - 0:0,1,3,Nikoghosyan Narek,Nazaryan Mushegh,fiurst,Nazaryan Mushegh - Nikoghosyan Narek,71,38,33,-5,5,18,19,16,18,0,-4,-3,6,-4,0,-5,11:7 - 11:8 - 5:11 - 11:7 - 0:0
14786041,2023-10-24 12:00:00,Arutyunov Ruben - Papyan Karen,0:3,10:12 - 11:13 - 10:12 - 0:0 - 0:0,0,3,Arutyunov Ruben,Papyan Karen,fiurst,Arutyunov Ruben - Papyan Karen,68,31,37,6,-6,22,24,22,0,0,2,2,2,0,0,6,10:12 - 11:13 - 10:12 - 0:0 - 0:0
14786035,2023-10-24 11:30:00,Nazaryan Mushegh - Arutyunov Ruben,0:3,11:9 - 11:5 - 11:2 - 0:0 - 0:0,3,0,Nazaryan Mushegh,Arutyunov Ruben,fiurst,Arutyunov Ruben - Nazaryan Mushegh,49,16,33,17,-17,20,16,13,0,0,2,6,9,0,0,17,9:11 - 5:11 - 2:11 - 0:0 - 0:0
14786038,2023-10-24 11:30:00,Nikoghosyan Narek - Soghomonyan Hrayr,3:2,9:11 - 5:11 - 11:9 - 11:8 - 11:9,3,2,Nikoghosyan Narek,Soghomonyan Hrayr,fiurst,Nikoghosyan Narek - Soghomonyan Hrayr,95,47,48,1,-1,20,16,20,19,20,2,6,-2,-3,-2,1,9:11 - 5:11 - 11:9 - 11:8 - 11:9
14786027,2023-10-24 11:05:00,Papyan Karen - Nikoghosyan Narek,0:3,12:10 - 11:8 - 11:8 - 0:0 - 0:0,3,0,Papyan Karen,Nikoghosyan Narek,fiurst,Nikoghosyan Narek - Papyan Karen,60,26,34,8,-8,22,19,19,0,0,2,3,3,0,0,8,10:12 - 8:11 - 8:11 - 0:0 - 0:0
14786020,2023-10-24 10:45:00,Soghomonyan Hrayr - Arutyunov Ruben,3:2,11:6 - 8:11 - 8:11 - 11:9 - 5:11,2,3,Soghomonyan Hrayr,Arutyunov Ruben,fiurst,Arutyunov Ruben - Soghomonyan Hrayr,91,48,43,-5,5,17,19,19,20,16,5,-3,-3,2,-6,-5,6:11 - 11:8 - 11:8 - 9:11 - 11:5
14786015,2023-10-24 10:30:00,Nazaryan Mushegh - Papyan Karen,2:3,11:9 - 6:11 - 9:11 - 11:4 - 7:11,2,3,Nazaryan Mushegh,Papyan Karen,fiurst,Nazaryan Mushegh - Papyan Karen,90,44,46,2,-2,20,17,20,15,18,-2,5,2,-7,4,2,11:9 - 6:11 - 9:11 - 11:4 - 7:11
14786009,2023-10-24 10:15:00,Arutyunov Ruben - Nikoghosyan Narek,3:2,8:11 - 11:5 - 11:6 - 7:11 - 11:7,3,2,Arutyunov Ruben,Nikoghosyan Narek,fiurst,Arutyunov Ruben - Nikoghosyan Narek,88,48,40,-8,8,19,16,17,18,18,3,-6,-5,4,-4,-8,8:11 - 11:5 - 11:6 - 7:11 - 11:7
14786005,2023-10-24 10:00:00,Soghomonyan Hrayr - Nazaryan Mushegh,3:0,8:11 - 6:11 - 7:11 - 0:0 - 0:0,0,3,Soghomonyan Hrayr,Nazaryan Mushegh,fiurst,Nazaryan Mushegh - Soghomonyan Hrayr,54,33,21,-12,12,19,17,18,0,0,-3,-5,-4,0,0,-12,11:8 - 11:6 - 11:7 - 0:0 - 0:0
14763834,2023-10-23 17:30:00,Mkrtchyan Andranik - Avakimyan Davit,1:3,11:13 - 11:8 - 11:4 - 11:8 - 0:0,3,1,Mkrtchyan Andranik,Avakimyan Davit,fiurst,Avakimyan Davit - Mkrtchyan Andranik,77,33,44,11,-11,24,19,15,19,0,-2,3,7,3,0,11,13:11 - 8:11 - 4:11 - 8:11 - 0:0
14763833,2023-10-23 17:15:00,Petrosyan Davit - Soghomonyan Hrayr,0:3,5:11 - 5:11 - 5:11 - 0:0 - 0:0,0,3,Petrosyan Davit,Soghomonyan Hrayr,fiurst,Petrosyan Davit - Soghomonyan Hrayr,48,15,33,18,-18,16,16,16,0,0,6,6,6,0,0,18,5:11 - 5:11 - 5:11 - 0:0 - 0:0
14763819,2023-10-23 17:05:00,Gevorgyan Gegham - Mkrtchyan Andranik,0:3,7:11 - 8:11 - 9:11 - 0:0 - 0:0,0,3,Gevorgyan Gegham,Mkrtchyan Andranik,fiurst,Gevorgyan Gegham - Mkrtchyan Andranik,57,24,33,9,-9,18,19,20,0,0,4,3,2,0,0,9,7:11 - 8:11 - 9:11 - 0:0 - 0:0
14763811,2023-10-23 16:45:00,Petrosyan Davit - Avakimyan Davit,3:1,5:11 - 12:10 - 6:11 - 2:11 - 0:0,1,3,Petrosyan Davit,Avakimyan Davit,fiurst,Avakimyan Davit - Petrosyan Davit,68,43,25,-18,18,16,22,17,13,0,-6,2,-5,-9,0,-18,11:5 - 10:12 - 11:6 - 11:2 - 0:0
14763810,2023-10-23 16:30:00,Soghomonyan Hrayr - Gevorgyan Gegham,1:3,11:7 - 11:7 - 7:11 - 12:10 - 0:0,3,1,Soghomonyan Hrayr,Gevorgyan Gegham,fiurst,Gevorgyan Gegham - Soghomonyan Hrayr,76,35,41,6,-6,18,18,18,22,0,4,4,-4,2,0,6,7:11 - 7:11 - 11:7 - 10:12 - 0:0
14763809,2023-10-23 16:25:00,Mkrtchyan Andranik - Petrosyan Davit,3:1,8:11 - 16:14 - 13:11 - 11:6 - 0:0,3,1,Mkrtchyan Andranik,Petrosyan Davit,fiurst,Mkrtchyan Andranik - Petrosyan Davit,90,48,42,-6,6,19,30,24,17,0,3,-2,-2,-5,0,-6,8:11 - 16:14 - 13:11 - 11:6 - 0:0
14763804,2023-10-23 16:05:00,Avakimyan Davit - Gevorgyan Gegham,3:0,11:8 - 12:10 - 11:7 - 0:0 - 0:0,3,0,Avakimyan Davit,Gevorgyan Gegham,fiurst,Avakimyan Davit - Gevorgyan Gegham,59,34,25,-9,9,19,22,18,0,0,-3,-2,-4,0,0,-9,11:8 - 12:10 - 11:7 - 0:0 - 0:0
14763796,2023-10-23 15:45:00,Soghomonyan Hrayr - Mkrtchyan Andranik,1:3,11:6 - 11:8 - 5:11 - 11:3 - 0:0,3,1,Soghomonyan Hrayr,Mkrtchyan Andranik,fiurst,Mkrtchyan Andranik - Soghomonyan Hrayr,66,28,38,10,-10,17,19,16,14,0,5,3,-6,8,0,10,6:11 - 8:11 - 11:5 - 3:11 - 0:0
14763792,2023-10-23 15:30:00,Gevorgyan Gegham - Petrosyan Davit,2:3,11:9 - 5:11 - 7:11 - 11:7 - 6:11,2,3,Gevorgyan Gegham,Petrosyan Davit,fiurst,Gevorgyan Gegham - Petrosyan Davit,89,40,49,9,-9,20,16,18,18,17,-2,6,4,-4,5,9,11:9 - 5:11 - 7:11 - 11:7 - 6:11
14763787,2023-10-23 15:15:00,Avakimyan Davit - Soghomonyan Hrayr,2:3,13:11 - 9:11 - 14:12 - 1:11 - 8:11,2,3,Avakimyan Davit,Soghomonyan Hrayr,fiurst,Avakimyan Davit - Soghomonyan Hrayr,101,45,56,11,-11,24,20,26,12,19,-2,2,-2,10,3,11,13:11 - 9:11 - 14:12 - 1:11 - 8:11
14763772,2023-10-23 15:00:00,Arutyunov Ruben - Nazaryan Mushegh,0:3,7:11 - 7:11 - 6:11 - 0:0 - 0:0,0,3,Arutyunov Ruben,Nazaryan Mushegh,fiurst,Arutyunov Ruben - Nazaryan Mushegh,53,20,33,13,-13,18,18,17,0,0,4,4,5,0,0,13,7:11 - 7:11 - 6:11 - 0:0 - 0:0
14763769,2023-10-23 14:50:00,Papyan Karen - Diaryan Aleksandr,3:1,1:11 - 11:9 - 7:11 - 6:11 - 0:0,1,3,Papyan Karen,Diaryan Aleksandr,fiurst,Diaryan Aleksandr - Papyan Karen,67,42,25,-17,17,12,20,18,17,0,-10,2,-4,-5,0,-17,11:1 - 9:11 - 11:7 - 11:6 - 0:0
14763765,2023-10-23 14:30:00,Rafayelyan Edgar - Arutyunov Ruben,0:3,11:6 - 11:6 - 11:7 - 0:0 - 0:0,3,0,Rafayelyan Edgar,Arutyunov Ruben,fiurst,Arutyunov Ruben - Rafayelyan Edgar,52,19,33,14,-14,17,17,18,0,0,5,5,4,0,0,14,6:11 - 6:11 - 7:11 - 0:0 - 0:0
14763764,2023-10-23 14:15:00,Nazaryan Mushegh - Papyan Karen,1:3,11:6 - 8:11 - 11:13 - 8:11 - 0:0,1,3,Nazaryan Mushegh,Papyan Karen,fiurst,Nazaryan Mushegh - Papyan Karen,79,38,41,3,-3,17,19,24,19,0,-5,3,2,3,0,3,11:6 - 8:11 - 11:13 - 8:11 - 0:0
14763753,2023-10-23 14:00:00,Rafayelyan Edgar - Diaryan Aleksandr,0:3,11:7 - 11:7 - 11:5 - 0:0 - 0:0,3,0,Rafayelyan Edgar,Diaryan Aleksandr,fiurst,Diaryan Aleksandr - Rafayelyan Edgar,52,19,33,14,-14,18,18,16,0,0,4,4,6,0,0,14,7:11 - 7:11 - 5:11 - 0:0 - 0:0
14763752,2023-10-23 13:45:00,Arutyunov Ruben - Papyan Karen,0:3,8:11 - 8:11 - 6:11 - 0:0 - 0:0,0,3,Arutyunov Ruben,Papyan Karen,fiurst,Arutyunov Ruben - Papyan Karen,55,22,33,11,-11,19,19,17,0,0,3,3,5,0,0,11,8:11 - 8:11 - 6:11 - 0:0 - 0:0
14763749,2023-10-23 13:30:00,Nazaryan Mushegh - Rafayelyan Edgar,1:3,7:11 - 6:11 - 11:7 - 5:11 - 0:0,1,3,Nazaryan Mushegh,Rafayelyan Edgar,fiurst,Nazaryan Mushegh - Rafayelyan Edgar,69,29,40,11,-11,18,17,18,16,0,4,5,-4,6,0,11,7:11 - 6:11 - 11:7 - 5:11 - 0:0
14763747,2023-10-23 13:15:00,Diaryan Aleksandr - Arutyunov Ruben,0:3,11:8 - 11:6 - 11:2 - 0:0 - 0:0,3,0,Diaryan Aleksandr,Arutyunov Ruben,fiurst,Arutyunov Ruben - Diaryan Aleksandr,49,16,33,17,-17,19,17,13,0,0,3,5,9,0,0,17,8:11 - 6:11 - 2:11 - 0:0 - 0:0
14763744,2023-10-23 13:00:00,Papyan Karen - Rafayelyan Edgar,2:3,6:11 - 12:10 - 6:11 - 11:6 - 9:11,2,3,Papyan Karen,Rafayelyan Edgar,fiurst,Papyan Karen - Rafayelyan Edgar,93,44,49,5,-5,17,22,17,17,20,5,-2,5,-5,2,5,6:11 - 12:10 - 6:11 - 11:6 - 9:11
14763740,2023-10-23 12:45:00,Diaryan Aleksandr - Nazaryan Mushegh,3:1,6:11 - 11:7 - 11:5 - 11:7 - 0:0,3,1,Diaryan Aleksandr,Nazaryan Mushegh,fiurst,Diaryan Aleksandr - Nazaryan Mushegh,69,39,30,-9,9,17,18,16,18,0,5,-4,-6,-4,0,-9,6:11 - 11:7 - 11:5 - 11:7 - 0:0
14763737,2023-10-23 12:15:00,Arutyunov Ruben - Rafayelyan Edgar,3:1,11:9 - 5:11 - 12:10 - 13:11 - 0:0,3,1,Arutyunov Ruben,Rafayelyan Edgar,fiurst,Arutyunov Ruben - Rafayelyan Edgar,82,41,41,0,0,20,16,22,24,0,-2,6,-2,-2,0,0,11:9 - 5:11 - 12:10 - 13:11 - 0:0
14763728,2023-10-23 12:00:00,Diaryan Aleksandr - Papyan Karen,3:1,11:8 - 11:13 - 11:6 - 11:9 - 0:0,3,1,Diaryan Aleksandr,Papyan Karen,fiurst,Diaryan Aleksandr - Papyan Karen,80,44,36,-8,8,19,24,17,20,0,-3,2,-5,-2,0,-8,11:8 - 11:13 - 11:6 - 11:9 - 0:0
14763721,2023-10-23 11:45:00,Nazaryan Mushegh - Arutyunov Ruben,1:3,7:11 - 11:5 - 11:9 - 11:9 - 0:0,3,1,Nazaryan Mushegh,Arutyunov Ruben,fiurst,Arutyunov Ruben - Nazaryan Mushegh,74,34,40,6,-6,18,16,20,20,0,-4,6,2,2,0,6,11:7 - 5:11 - 9:11 - 9:11 - 0:0
14763715,2023-10-23 11:30:00,Diaryan Aleksandr - Rafayelyan Edgar,1:3,11:6 - 3:11 - 5:11 - 11:13 - 0:0,1,3,Diaryan Aleksandr,Rafayelyan Edgar,fiurst,Diaryan Aleksandr - Rafayelyan Edgar,71,30,41,11,-11,17,14,16,24,0,-5,8,6,2,0,11,11:6 - 3:11 - 5:11 - 11:13 - 0:0
14763711,2023-10-23 11:15:00,Papyan Karen - Nazaryan Mushegh,3:0,9:11 - 8:11 - 6:11 - 0:0 - 0:0,0,3,Papyan Karen,Nazaryan Mushegh,fiurst,Nazaryan Mushegh - Papyan Karen,56,33,23,-10,10,20,19,17,0,0,-2,-3,-5,0,0,-10,11:9 - 11:8 - 11:6 - 0:0 - 0:0
14763708,2023-10-23 11:00:00,Arutyunov Ruben - Diaryan Aleksandr,1:3,11:9 - 5:11 - 7:11 - 8:11 - 0:0,1,3,Arutyunov Ruben,Diaryan Aleksandr,fiurst,Arutyunov Ruben - Diaryan Aleksandr,73,31,42,11,-11,20,16,18,19,0,-2,6,4,3,0,11,11:9 - 5:11 - 7:11 - 8:11 - 0:0
14763706,2023-10-23 10:45:00,Rafayelyan Edgar - Nazaryan Mushegh,0:3,11:5 - 11:8 - 11:4 - 0:0 - 0:0,3,0,Rafayelyan Edgar,Nazaryan Mushegh,fiurst,Nazaryan Mushegh - Rafayelyan Edgar,50,17,33,16,-16,16,19,15,0,0,6,3,7,0,0,16,5:11 - 8:11 - 4:11 - 0:0 - 0:0
14763696,2023-10-23 10:30:00,Papyan Karen - Arutyunov Ruben,0:3,11:8 - 11:9 - 11:5 - 0:0 - 0:0,3,0,Papyan Karen,Arutyunov Ruben,fiurst,Arutyunov Ruben - Papyan Karen,55,22,33,11,-11,19,20,16,0,0,3,2,6,0,0,11,8:11 - 9:11 - 5:11 - 0:0 - 0:0
14763691,2023-10-23 10:15:00,Nazaryan Mushegh - Diaryan Aleksandr,3:0,7:11 - 5:11 - 7:11 - 0:0 - 0:0,0,3,Nazaryan Mushegh,Diaryan Aleksandr,fiurst,Diaryan Aleksandr - Nazaryan Mushegh,52,33,19,-14,14,18,16,18,0,0,-4,-6,-4,0,0,-14,11:7 - 11:5 - 11:7 - 0:0 - 0:0
14763677,2023-10-23 10:00:00,Rafayelyan Edgar - Papyan Karen,1:3,11:7 - 11:8 - 10:12 - 11:9 - 0:0,3,1,Rafayelyan Edgar,Papyan Karen,fiurst,Papyan Karen - Rafayelyan Edgar,79,36,43,7,-7,18,19,22,20,0,4,3,-2,2,0,7,7:11 - 8:11 - 12:10 - 9:11 - 0:0
14742602,2023-10-22 17:30:00,Soghomonyan Hrayr - Petrosyan Davit,1:3,14:12 - 8:11 - 11:4 - 11:6 - 0:0,3,1,Soghomonyan Hrayr,Petrosyan Davit,fiurst,Petrosyan Davit - Soghomonyan Hrayr,77,33,44,11,-11,26,19,15,17,0,2,-3,7,5,0,11,12:14 - 11:8 - 4:11 - 6:11 - 0:0
14742596,2023-10-22 17:15:00,Darbinyan Armen - Gevorgyan Gegham,0:3,10:12 - 9:11 - 6:11 - 0:0 - 0:0,0,3,Darbinyan Armen,Gevorgyan Gegham,fiurst,Darbinyan Armen - Gevorgyan Gegham,59,25,34,9,-9,22,20,17,0,0,2,2,5,0,0,9,10:12 - 9:11 - 6:11 - 0:0 - 0:0
14742594,2023-10-22 17:00:00,Grigoryan Erik - Soghomonyan Hrayr,0:3,6:11 - 5:11 - 7:11 - 0:0 - 0:0,0,3,Grigoryan Erik,Soghomonyan Hrayr,fiurst,Grigoryan Erik - Soghomonyan Hrayr,51,18,33,15,-15,17,16,18,0,0,5,6,4,0,0,15,6:11 - 5:11 - 7:11 - 0:0 - 0:0
14742591,2023-10-22 16:45:00,Darbinyan Armen - Petrosyan Davit,0:3,5:11 - 7:11 - 4:11 - 0:0 - 0:0,0,3,Darbinyan Armen,Petrosyan Davit,fiurst,Darbinyan Armen - Petrosyan Davit,49,16,33,17,-17,16,18,15,0,0,6,4,7,0,0,17,5:11 - 7:11 - 4:11 - 0:0 - 0:0
14742590,2023-10-22 16:35:00,Gevorgyan Gegham - Grigoryan Erik,3:0,11:6 - 11:9 - 11:6 - 0:0 - 0:0,3,0,Gevorgyan Gegham,Grigoryan Erik,fiurst,Gevorgyan Gegham - Grigoryan Erik,54,33,21,-12,12,17,20,17,0,0,-5,-2,-5,0,0,-12,11:6 - 11:9 - 11:6 - 0:0 - 0:0
14742576,2023-10-22 16:15:00,Soghomonyan Hrayr - Darbinyan Armen,2:3,7:11 - 11:6 - 10:12 - 11:7 - 11:3,3,2,Soghomonyan Hrayr,Darbinyan Armen,fiurst,Darbinyan Armen - Soghomonyan Hrayr,89,39,50,11,-11,18,17,22,18,14,-4,5,-2,4,8,11,11:7 - 6:11 - 12:10 - 7:11 - 3:11
14742572,2023-10-22 16:05:00,Petrosyan Davit - Grigoryan Erik,3:2,7:11 - 8:11 - 11:8 - 11:8 - 8:11,2,3,Petrosyan Davit,Grigoryan Erik,fiurst,Grigoryan Erik - Petrosyan Davit,94,49,45,-4,4,18,19,19,19,19,-4,-3,3,3,-3,-4,11:7 - 11:8 - 8:11 - 8:11 - 11:8
14742569,2023-10-22 15:50:00,Grigoryan Erik - Darbinyan Armen,3:1,11:13 - 11:13 - 11:3 - 8:11 - 0:0,1,3,Grigoryan Erik,Darbinyan Armen,fiurst,Darbinyan Armen - Grigoryan Erik,81,40,41,1,-1,24,24,14,19,0,-2,-2,8,-3,0,1,13:11 - 13:11 - 3:11 - 11:8 - 0:0
14742571,2023-10-22 15:45:00,Gevorgyan Gegham - Soghomonyan Hrayr,1:3,1:11 - 6:11 - 11:9 - 12:14 - 0:0,1,3,Gevorgyan Gegham,Soghomonyan Hrayr,fiurst,Gevorgyan Gegham - Soghomonyan Hrayr,75,30,45,15,-15,12,17,20,26,0,10,5,-2,2,0,15,1:11 - 6:11 - 11:9 - 12:14 - 0:0
14742554,2023-10-22 15:20:00,Rafayelyan Edgar - Diaryan Aleksandr,3:2,8:11 - 11:8 - 11:8 - 6:11 - 8:11,2,3,Rafayelyan Edgar,Diaryan Aleksandr,fiurst,Diaryan Aleksandr - Rafayelyan Edgar,93,49,44,-5,5,19,19,19,17,19,-3,3,3,-5,-3,-5,11:8 - 8:11 - 8:11 - 11:6 - 11:8
14742555,2023-10-22 15:15:00,Petrosyan Davit - Gevorgyan Gegham,0:3,11:8 - 11:7 - 11:7 - 0:0 - 0:0,3,0,Petrosyan Davit,Gevorgyan Gegham,fiurst,Gevorgyan Gegham - Petrosyan Davit,55,22,33,11,-11,19,18,18,0,0,3,4,4,0,0,11,8:11 - 7:11 - 7:11 - 0:0 - 0:0
14742517,2023-10-22 14:50:00,Nikoghosyan Narek - Rafayelyan Edgar,2:3,5:11 - 11:13 - 11:5 - 11:6 - 3:11,2,3,Nikoghosyan Narek,Rafayelyan Edgar,fiurst,Nikoghosyan Narek - Rafayelyan Edgar,87,41,46,5,-5,16,24,16,17,14,6,2,-6,-5,8,5,5:11 - 11:13 - 11:5 - 11:6 - 3:11
14742553,2023-10-22 14:45:00,Nazaryan Mushegh - Antonyan Eduard,3:1,4:11 - 11:6 - 7:11 - 9:11 - 0:0,1,3,Nazaryan Mushegh,Antonyan Eduard,fiurst,Antonyan Eduard - Nazaryan Mushegh,70,39,31,-8,8,15,17,18,20,0,-7,5,-4,-2,0,-8,11:4 - 6:11 - 11:7 - 11:9 - 0:0
14742486,2023-10-22 14:25:00,Diaryan Aleksandr - Nazaryan Mushegh,3:1,11:5 - 7:11 - 11:5 - 11:7 - 0:0,3,1,Diaryan Aleksandr,Nazaryan Mushegh,fiurst,Diaryan Aleksandr - Nazaryan Mushegh,68,40,28,-12,12,16,18,16,18,0,-6,4,-6,-4,0,-12,11:5 - 7:11 - 11:5 - 11:7 - 0:0
14742485,2023-10-22 14:20:00,Nikoghosyan Narek - Antonyan Eduard,3:1,7:11 - 11:7 - 7:11 - 9:11 - 0:0,1,3,Nikoghosyan Narek,Antonyan Eduard,fiurst,Antonyan Eduard - Nikoghosyan Narek,74,40,34,-6,6,18,18,18,20,0,-4,4,-4,-2,0,-6,11:7 - 7:11 - 11:7 - 11:9 - 0:0
14742474,2023-10-22 14:10:00,Rafayelyan Edgar - Nazaryan Mushegh,0:3,11:8 - 11:7 - 11:4 - 0:0 - 0:0,3,0,Rafayelyan Edgar,Nazaryan Mushegh,fiurst,Nazaryan Mushegh - Rafayelyan Edgar,52,19,33,14,-14,19,18,15,0,0,3,4,7,0,0,14,8:11 - 7:11 - 4:11 - 0:0 - 0:0
14742473,2023-10-22 13:45:00,Diaryan Aleksandr - Nikoghosyan Narek,3:2,12:10 - 9:11 - 11:9 - 7:11 - 11:3,3,2,Diaryan Aleksandr,Nikoghosyan Narek,fiurst,Diaryan Aleksandr - Nikoghosyan Narek,94,50,44,-6,6,22,20,20,18,14,-2,2,-2,4,-8,-6,12:10 - 9:11 - 11:9 - 7:11 - 11:3
14742472,2023-10-22 13:35:00,Antonyan Eduard - Rafayelyan Edgar,3:1,12:10 - 12:10 - 9:11 - 11:4 - 0:0,3,1,Antonyan Eduard,Rafayelyan Edgar,fiurst,Antonyan Eduard - Rafayelyan Edgar,79,44,35,-9,9,22,22,20,15,0,-2,-2,2,-7,0,-9,12:10 - 12:10 - 9:11 - 11:4 - 0:0
14742471,2023-10-22 13:10:00,Nazaryan Mushegh - Nikoghosyan Narek,0:3,8:11 - 8:11 - 12:14 - 0:0 - 0:0,0,3,Nazaryan Mushegh,Nikoghosyan Narek,fiurst,Nazaryan Mushegh - Nikoghosyan Narek,64,28,36,8,-8,19,19,26,0,0,3,3,2,0,0,8,8:11 - 8:11 - 12:14 - 0:0 - 0:0
14742466,2023-10-22 12:45:00,Antonyan Eduard - Diaryan Aleksandr,3:2,6:11 - 11:7 - 11:8 - 6:11 - 12:10,3,2,Antonyan Eduard,Diaryan Aleksandr,fiurst,Antonyan Eduard - Diaryan Aleksandr,93,46,47,1,-1,17,18,19,17,22,5,-4,-3,5,-2,1,6:11 - 11:7 - 11:8 - 6:11 - 12:10
14742447,2023-10-22 12:30:00,Rafayelyan Edgar - Nikoghosyan Narek,2:3,8:11 - 11:7 - 11:7 - 6:11 - 11:8,3,2,Rafayelyan Edgar,Nikoghosyan Narek,fiurst,Nikoghosyan Narek - Rafayelyan Edgar,91,44,47,3,-3,19,18,18,17,19,-3,4,4,-5,3,3,11:8 - 7:11 - 7:11 - 11:6 - 8:11
14742445,2023-10-22 12:00:00,Antonyan Eduard - Nazaryan Mushegh,3:0,11:8 - 11:3 - 11:5 - 0:0 - 0:0,3,0,Antonyan Eduard,Nazaryan Mushegh,fiurst,Antonyan Eduard - Nazaryan Mushegh,49,33,16,-17,17,19,14,16,0,0,-3,-8,-6,0,0,-17,11:8 - 11:3 - 11:5 - 0:0 - 0:0
14742442,2023-10-22 11:50:00,Diaryan Aleksandr - Rafayelyan Edgar,3:2,9:11 - 14:12 - 13:11 - 5:11 - 11:2,3,2,Diaryan Aleksandr,Rafayelyan Edgar,fiurst,Diaryan Aleksandr - Rafayelyan Edgar,99,52,47,-5,5,20,26,24,16,13,2,-2,-2,6,-9,-5,9:11 - 14:12 - 13:11 - 5:11 - 11:2
14742440,2023-10-22 11:30:00,Antonyan Eduard - Nikoghosyan Narek,1:3,6:11 - 6:11 - 11:6 - 7:11 - 0:0,1,3,Antonyan Eduard,Nikoghosyan Narek,fiurst,Antonyan Eduard - Nikoghosyan Narek,69,30,39,9,-9,17,17,17,18,0,5,5,-5,4,0,9,6:11 - 6:11 - 11:6 - 7:11 - 0:0
14742436,2023-10-22 11:15:00,Nazaryan Mushegh - Diaryan Aleksandr,3:0,12:14 - 8:11 - 4:11 - 0:0 - 0:0,0,3,Nazaryan Mushegh,Diaryan Aleksandr,fiurst,Diaryan Aleksandr - Nazaryan Mushegh,60,36,24,-12,12,26,19,15,0,0,-2,-3,-7,0,0,-12,14:12 - 11:8 - 11:4 - 0:0 - 0:0
14742433,2023-10-22 11:00:00,Rafayelyan Edgar - Antonyan Eduard,2:3,11:5 - 11:6 - 7:11 - 3:11 - 11:8,3,2,Rafayelyan Edgar,Antonyan Eduard,fiurst,Antonyan Eduard - Rafayelyan Edgar,84,41,43,2,-2,16,17,18,14,19,6,5,-4,-8,3,2,5:11 - 6:11 - 11:7 - 11:3 - 8:11
14742430,2023-10-22 10:45:00,Nikoghosyan Narek - Diaryan Aleksandr,2:3,11:7 - 9:11 - 11:7 - 11:13 - 11:8,3,2,Nikoghosyan Narek,Diaryan Aleksandr,fiurst,Diaryan Aleksandr - Nikoghosyan Narek,99,46,53,7,-7,18,20,18,24,19,4,-2,4,-2,3,7,7:11 - 11:9 - 7:11 - 13:11 - 8:11
14742417,2023-10-22 10:30:00,Nazaryan Mushegh - Rafayelyan Edgar,1:3,8:11 - 11:4 - 8:11 - 9:11 - 0:0,1,3,Nazaryan Mushegh,Rafayelyan Edgar,fiurst,Nazaryan Mushegh - Rafayelyan Edgar,73,36,37,1,-1,19,15,19,20,0,3,-7,3,2,0,1,8:11 - 11:4 - 8:11 - 9:11 - 0:0
14742413,2023-10-22 10:15:00,Diaryan Aleksandr - Antonyan Eduard,1:3,11:6 - 11:4 - 6:11 - 11:7 - 0:0,3,1,Diaryan Aleksandr,Antonyan Eduard,fiurst,Antonyan Eduard - Diaryan Aleksandr,67,28,39,11,-11,17,15,17,18,0,5,7,-5,4,0,11,6:11 - 4:11 - 11:6 - 7:11 - 0:0
14742412,2023-10-22 10:00:00,Nikoghosyan Narek - Nazaryan Mushegh,1:3,11:6 - 11:7 - 8:11 - 11:6 - 0:0,3,1,Nikoghosyan Narek,Nazaryan Mushegh,fiurst,Nazaryan Mushegh - Nikoghosyan Narek,71,30,41,11,-11,17,18,19,17,0,5,4,-3,5,0,11,6:11 - 7:11 - 11:8 - 6:11 - 0:0
14724647,2023-10-21 17:30:00,Avakimyan Davit - Grigoryan Erik,3:0,11:5 - 11:4 - 11:8 - 0:0 - 0:0,3,0,Avakimyan Davit,Grigoryan Erik,fiurst,Avakimyan Davit - Grigoryan Erik,50,33,17,-16,16,16,15,19,0,0,-6,-7,-3,0,0,-16,11:5 - 11:4 - 11:8 - 0:0 - 0:0
14724645,2023-10-21 17:15:00,Soghomonyan Hrayr - Mkrtchyan Andranik,1:3,11:7 - 8:11 - 11:5 - 12:10 - 0:0,3,1,Soghomonyan Hrayr,Mkrtchyan Andranik,fiurst,Mkrtchyan Andranik - Soghomonyan Hrayr,75,33,42,9,-9,18,19,16,22,0,4,-3,6,2,0,9,7:11 - 11:8 - 5:11 - 10:12 - 0:0
14724640,2023-10-21 17:00:00,Gevorgyan Gegham - Avakimyan Davit,3:1,9:11 - 9:11 - 12:10 - 9:11 - 0:0,1,3,Gevorgyan Gegham,Avakimyan Davit,fiurst,Avakimyan Davit - Gevorgyan Gegham,82,43,39,-4,4,20,20,22,20,0,-2,-2,2,-2,0,-4,11:9 - 11:9 - 10:12 - 11:9 - 0:0
14724637,2023-10-21 16:45:00,Soghomonyan Hrayr - Grigoryan Erik,1:3,11:7 - 11:7 - 8:11 - 12:10 - 0:0,3,1,Soghomonyan Hrayr,Grigoryan Erik,fiurst,Grigoryan Erik - Soghomonyan Hrayr,77,35,42,7,-7,18,18,19,22,0,4,4,-3,2,0,7,7:11 - 7:11 - 11:8 - 10:12 - 0:0
14724635,2023-10-21 16:30:00,Mkrtchyan Andranik - Gevorgyan Gegham,0:3,11:9 - 11:7 - 13:11 - 0:0 - 0:0,3,0,Mkrtchyan Andranik,Gevorgyan Gegham,fiurst,Gevorgyan Gegham - Mkrtchyan Andranik,62,27,35,8,-8,20,18,24,0,0,2,4,2,0,0,8,9:11 - 7:11 - 11:13 - 0:0 - 0:0
14724632,2023-10-21 16:15:00,Avakimyan Davit - Soghomonyan Hrayr,0:3,4:11 - 4:11 - 9:11 - 0:0 - 0:0,0,3,Avakimyan Davit,Soghomonyan Hrayr,fiurst,Avakimyan Davit - Soghomonyan Hrayr,50,17,33,16,-16,15,15,20,0,0,7,7,2,0,0,16,4:11 - 4:11 - 9:11 - 0:0 - 0:0
14724623,2023-10-21 16:05:00,Grigoryan Erik - Gevorgyan Gegham,0:3,14:12 - 11:5 - 11:8 - 0:0 - 0:0,3,0,Grigoryan Erik,Gevorgyan Gegham,fiurst,Gevorgyan Gegham - Grigoryan Erik,61,25,36,11,-11,26,16,19,0,0,2,6,3,0,0,11,12:14 - 5:11 - 8:11 - 0:0 - 0:0
14724610,2023-10-21 15:50:00,Mkrtchyan Andranik - Avakimyan Davit,1:3,11:8 - 8:11 - 11:9 - 11:5 - 0:0,3,1,Mkrtchyan Andranik,Avakimyan Davit,fiurst,Avakimyan Davit - Mkrtchyan Andranik,74,33,41,8,-8,19,19,20,16,0,3,-3,2,6,0,8,8:11 - 11:8 - 9:11 - 5:11 - 0:0
14724606,2023-10-21 15:30:00,Gevorgyan Gegham - Soghomonyan Hrayr,1:3,12:10 - 11:13 - 7:11 - 9:11 - 0:0,1,3,Gevorgyan Gegham,Soghomonyan Hrayr,fiurst,Gevorgyan Gegham - Soghomonyan Hrayr,84,39,45,6,-6,22,24,18,20,0,-2,2,4,2,0,6,12:10 - 11:13 - 7:11 - 9:11 - 0:0
14724602,2023-10-21 15:15:00,Grigoryan Erik - Mkrtchyan Andranik,3:2,5:11 - 11:9 - 7:11 - 11:9 - 11:7,3,2,Grigoryan Erik,Mkrtchyan Andranik,fiurst,Grigoryan Erik - Mkrtchyan Andranik,92,45,47,2,-2,16,20,18,20,18,6,-2,4,-2,-4,2,5:11 - 11:9 - 7:11 - 11:9 - 11:7
14724459,2023-10-21 15:05:00,Nikoghosyan Narek - Antonyan Eduard,2:3,11:6 - 11:7 - 5:11 - 9:11 - 11:7,3,2,Nikoghosyan Narek,Antonyan Eduard,fiurst,Antonyan Eduard - Nikoghosyan Narek,89,42,47,5,-5,17,18,16,20,18,5,4,-6,-2,4,5,6:11 - 7:11 - 11:5 - 11:9 - 7:11
14724454,2023-10-21 14:50:00,Rafayelyan Edgar - Arutyunov Ruben,0:3,11:3 - 11:5 - 11:6 - 0:0 - 0:0,3,0,Rafayelyan Edgar,Arutyunov Ruben,fiurst,Arutyunov Ruben - Rafayelyan Edgar,47,14,33,19,-19,14,16,17,0,0,8,6,5,0,0,19,3:11 - 5:11 - 6:11 - 0:0 - 0:0
14724448,2023-10-21 14:30:00,Papyan Karen - Nikoghosyan Narek,3:2,11:7 - 13:11 - 5:11 - 2:11 - 10:12,2,3,Papyan Karen,Nikoghosyan Narek,fiurst,Nikoghosyan Narek - Papyan Karen,93,52,41,-11,11,18,24,16,13,22,4,2,-6,-9,-2,-11,7:11 - 11:13 - 11:5 - 11:2 - 12:10
14724445,2023-10-21 14:15:00,Antonyan Eduard - Rafayelyan Edgar,2:3,8:11 - 11:6 - 12:10 - 7:11 - 5:11,2,3,Antonyan Eduard,Rafayelyan Edgar,fiurst,Antonyan Eduard - Rafayelyan Edgar,92,43,49,6,-6,19,17,22,18,16,3,-5,-2,4,6,6,8:11 - 11:6 - 12:10 - 7:11 - 5:11
14724428,2023-10-21 14:00:00,Nikoghosyan Narek - Rafayelyan Edgar,3:0,11:4 - 11:4 - 11:4 - 0:0 - 0:0,3,0,Nikoghosyan Narek,Rafayelyan Edgar,fiurst,Nikoghosyan Narek - Rafayelyan Edgar,45,33,12,-21,21,15,15,15,0,0,-7,-7,-7,0,0,-21,11:4 - 11:4 - 11:4 - 0:0 - 0:0
14724433,2023-10-21 14:00:00,Papyan Karen - Arutyunov Ruben,1:3,5:11 - 11:8 - 11:9 - 12:10 - 0:0,3,1,Papyan Karen,Arutyunov Ruben,fiurst,Arutyunov Ruben - Papyan Karen,77,38,39,1,-1,16,19,20,22,0,-6,3,2,2,0,1,11:5 - 8:11 - 9:11 - 10:12 - 0:0
14724425,2023-10-21 13:30:00,Antonyan Eduard - Papyan Karen,3:0,11:7 - 11:4 - 11:6 - 0:0 - 0:0,3,0,Antonyan Eduard,Papyan Karen,fiurst,Antonyan Eduard - Papyan Karen,50,33,17,-16,16,18,15,17,0,0,-4,-7,-5,0,0,-16,11:7 - 11:4 - 11:6 - 0:0 - 0:0
14724406,2023-10-21 13:20:00,Arutyunov Ruben - Nikoghosyan Narek,2:3,3:11 - 7:11 - 11:8 - 13:11 - 9:11,2,3,Arutyunov Ruben,Nikoghosyan Narek,fiurst,Arutyunov Ruben - Nikoghosyan Narek,95,43,52,9,-9,14,18,19,24,20,8,4,-3,-2,2,9,3:11 - 7:11 - 11:8 - 13:11 - 9:11
14724405,2023-10-21 13:00:00,Rafayelyan Edgar - Papyan Karen,1:3,11:5 - 7:11 - 11:8 - 11:6 - 0:0,3,1,Rafayelyan Edgar,Papyan Karen,fiurst,Papyan Karen - Rafayelyan Edgar,70,30,40,10,-10,16,18,19,17,0,6,-4,3,5,0,10,5:11 - 11:7 - 8:11 - 6:11 - 0:0
14724397,2023-10-21 12:45:00,Arutyunov Ruben - Antonyan Eduard,1:3,11:6 - 7:11 - 11:7 - 11:7 - 0:0,3,1,Arutyunov Ruben,Antonyan Eduard,fiurst,Antonyan Eduard - Arutyunov Ruben,71,31,40,9,-9,17,18,18,18,0,5,-4,4,4,0,9,6:11 - 11:7 - 7:11 - 7:11 - 0:0
14724384,2023-10-21 12:20:00,Nikoghosyan Narek - Papyan Karen,0:3,12:14 - 7:11 - 6:11 - 0:0 - 0:0,0,3,Nikoghosyan Narek,Papyan Karen,fiurst,Nikoghosyan Narek - Papyan Karen,61,25,36,11,-11,26,18,17,0,0,2,4,5,0,0,11,12:14 - 7:11 - 6:11 - 0:0 - 0:0
14724383,2023-10-21 12:05:00,Arutyunov Ruben - Rafayelyan Edgar,0:3,3:11 - 5:11 - 7:11 - 0:0 - 0:0,0,3,Arutyunov Ruben,Rafayelyan Edgar,fiurst,Arutyunov Ruben - Rafayelyan Edgar,48,15,33,18,-18,14,16,18,0,0,8,6,4,0,0,18,3:11 - 5:11 - 7:11 - 0:0 - 0:0
14724382,2023-10-21 11:45:00,Antonyan Eduard - Nikoghosyan Narek,3:2,11:7 - 4:11 - 11:6 - 4:11 - 11:8,3,2,Antonyan Eduard,Nikoghosyan Narek,fiurst,Antonyan Eduard - Nikoghosyan Narek,84,41,43,2,-2,18,15,17,15,19,-4,7,-5,7,-3,2,11:7 - 4:11 - 11:6 - 4:11 - 11:8
14724378,2023-10-21 11:40:00,Arutyunov Ruben - Papyan Karen,0:3,9:11 - 6:11 - 5:11 - 0:0 - 0:0,0,3,Arutyunov Ruben,Papyan Karen,fiurst,Arutyunov Ruben - Papyan Karen,53,20,33,13,-13,20,17,16,0,0,2,5,6,0,0,13,9:11 - 6:11 - 5:11 - 0:0 - 0:0
14724377,2023-10-21 11:15:00,Rafayelyan Edgar - Antonyan Eduard,3:0,9:11 - 4:11 - 6:11 - 0:0 - 0:0,0,3,Rafayelyan Edgar,Antonyan Eduard,fiurst,Antonyan Eduard - Rafayelyan Edgar,52,33,19,-14,14,20,15,17,0,0,-2,-7,-5,0,0,-14,11:9 - 11:4 - 11:6 - 0:0 - 0:0
14724374,2023-10-21 11:00:00,Nikoghosyan Narek - Arutyunov Ruben,1:3,13:11 - 9:11 - 12:10 - 11:7 - 0:0,3,1,Nikoghosyan Narek,Arutyunov Ruben,fiurst,Arutyunov Ruben - Nikoghosyan Narek,84,39,45,6,-6,24,20,22,18,0,2,-2,2,4,0,6,11:13 - 11:9 - 10:12 - 7:11 - 0:0
14724364,2023-10-21 10:45:00,Papyan Karen - Antonyan Eduard,0:3,13:11 - 11:6 - 14:12 - 0:0 - 0:0,3,0,Papyan Karen,Antonyan Eduard,fiurst,Antonyan Eduard - Papyan Karen,67,29,38,9,-9,24,17,26,0,0,2,5,2,0,0,9,11:13 - 6:11 - 12:14 - 0:0 - 0:0
14724363,2023-10-21 10:30:00,Rafayelyan Edgar - Nikoghosyan Narek,1:3,11:7 - 11:9 - 6:11 - 11:6 - 0:0,3,1,Rafayelyan Edgar,Nikoghosyan Narek,fiurst,Nikoghosyan Narek - Rafayelyan Edgar,72,33,39,6,-6,18,20,17,17,0,4,2,-5,5,0,6,7:11 - 9:11 - 11:6 - 6:11 - 0:0
14724362,2023-10-21 10:15:00,Antonyan Eduard - Arutyunov Ruben,3:0,11:9 - 11:7 - 11:7 - 0:0 - 0:0,3,0,Antonyan Eduard,Arutyunov Ruben,fiurst,Antonyan Eduard - Arutyunov Ruben,56,33,23,-10,10,20,18,18,0,0,-2,-4,-4,0,0,-10,11:9 - 11:7 - 11:7 - 0:0 - 0:0
14724358,2023-10-21 10:00:00,Papyan Karen - Rafayelyan Edgar,3:1,11:8 - 11:5 - 8:11 - 11:8 - 0:0,3,1,Papyan Karen,Rafayelyan Edgar,fiurst,Papyan Karen - Rafayelyan Edgar,73,41,32,-9,9,19,16,19,19,0,-3,-6,3,-3,0,-9,11:8 - 11:5 - 8:11 - 11:8 - 0:0
14705165,2023-10-20 17:30:00,Darbinyan Armen - Gevorgyan Gegham,1:3,11:4 - 1:11 - 10:12 - 7:11 - 0:0,1,3,Darbinyan Armen,Gevorgyan Gegham,fiurst,Darbinyan Armen - Gevorgyan Gegham,67,29,38,9,-9,15,12,22,18,0,-7,10,2,4,0,9,11:4 - 1:11 - 10:12 - 7:11 - 0:0
14705153,2023-10-20 17:15:00,Mkrtchyan Andranik - Avakimyan Davit,3:1,11:5 - 6:11 - 5:11 - 4:11 - 0:0,1,3,Mkrtchyan Andranik,Avakimyan Davit,fiurst,Avakimyan Davit - Mkrtchyan Andranik,64,38,26,-12,12,16,17,16,15,0,6,-5,-6,-7,0,-12,5:11 - 11:6 - 11:5 - 11:4 - 0:0
14705151,2023-10-20 17:00:00,Petrosyan Davit - Darbinyan Armen,0:3,11:8 - 11:9 - 11:7 - 0:0 - 0:0,3,0,Petrosyan Davit,Darbinyan Armen,fiurst,Darbinyan Armen - Petrosyan Davit,57,24,33,9,-9,19,20,18,0,0,3,2,4,0,0,9,8:11 - 9:11 - 7:11 - 0:0 - 0:0
14705148,2023-10-20 16:45:00,Mkrtchyan Andranik - Gevorgyan Gegham,2:3,9:11 - 4:11 - 11:7 - 11:9 - 11:4,3,2,Mkrtchyan Andranik,Gevorgyan Gegham,fiurst,Gevorgyan Gegham - Mkrtchyan Andranik,88,42,46,4,-4,20,15,18,20,15,-2,-7,4,2,7,4,11:9 - 11:4 - 7:11 - 9:11 - 4:11
14705144,2023-10-20 16:30:00,Avakimyan Davit - Petrosyan Davit,3:0,11:7 - 11:8 - 11:9 - 0:0 - 0:0,3,0,Avakimyan Davit,Petrosyan Davit,fiurst,Avakimyan Davit - Petrosyan Davit,57,33,24,-9,9,18,19,20,0,0,-4,-3,-2,0,0,-9,11:7 - 11:8 - 11:9 - 0:0 - 0:0
14705141,2023-10-20 16:15:00,Darbinyan Armen - Mkrtchyan Andranik,0:3,8:11 - 7:11 - 9:11 - 0:0 - 0:0,0,3,Darbinyan Armen,Mkrtchyan Andranik,fiurst,Darbinyan Armen - Mkrtchyan Andranik,57,24,33,9,-9,19,18,20,0,0,3,4,2,0,0,9,8:11 - 7:11 - 9:11 - 0:0 - 0:0
14705140,2023-10-20 16:00:00,Gevorgyan Gegham - Petrosyan Davit,3:1,6:11 - 11:8 - 11:8 - 11:4 - 0:0,3,1,Gevorgyan Gegham,Petrosyan Davit,fiurst,Gevorgyan Gegham - Petrosyan Davit,70,39,31,-8,8,17,19,19,15,0,5,-3,-3,-7,0,-8,6:11 - 11:8 - 11:8 - 11:4 - 0:0
14705126,2023-10-20 15:45:00,Avakimyan Davit - Darbinyan Armen,3:0,12:10 - 11:7 - 11:6 - 0:0 - 0:0,3,0,Avakimyan Davit,Darbinyan Armen,fiurst,Avakimyan Davit - Darbinyan Armen,57,34,23,-11,11,22,18,17,0,0,-2,-4,-5,0,0,-11,12:10 - 11:7 - 11:6 - 0:0 - 0:0
14705125,2023-10-20 15:40:00,Petrosyan Davit - Mkrtchyan Andranik,3:0,4:11 - 3:11 - 6:11 - 0:0 - 0:0,0,3,Petrosyan Davit,Mkrtchyan Andranik,fiurst,Mkrtchyan Andranik - Petrosyan Davit,46,33,13,-20,20,15,14,17,0,0,-7,-8,-5,0,0,-20,11:4 - 11:3 - 11:6 - 0:0 - 0:0
14705122,2023-10-20 15:20:00,Nazaryan Mushegh - Papyan Karen,1:3,9:11 - 11:5 - 6:11 - 3:11 - 0:0,1,3,Nazaryan Mushegh,Papyan Karen,fiurst,Nazaryan Mushegh - Papyan Karen,67,29,38,9,-9,20,16,17,14,0,2,-6,5,8,0,9,9:11 - 11:5 - 6:11 - 3:11 - 0:0
14705123,2023-10-20 15:20:00,Gevorgyan Gegham - Avakimyan Davit,1:3,11:8 - 11:8 - 9:11 - 11:7 - 0:0,3,1,Gevorgyan Gegham,Avakimyan Davit,fiurst,Avakimyan Davit - Gevorgyan Gegham,76,34,42,8,-8,19,19,20,18,0,3,3,-2,4,0,8,8:11 - 8:11 - 11:9 - 7:11 - 0:0
14705119,2023-10-20 14:55:00,Diaryan Aleksandr - Nikoghosyan Narek,3:1,6:11 - 11:2 - 12:10 - 11:9 - 0:0,3,1,Diaryan Aleksandr,Nikoghosyan Narek,fiurst,Diaryan Aleksandr - Nikoghosyan Narek,72,40,32,-8,8,17,13,22,20,0,5,-9,-2,-2,0,-8,6:11 - 11:2 - 12:10 - 11:9 - 0:0
14705115,2023-10-20 14:50:00,Arutyunov Ruben - Nazaryan Mushegh,3:2,11:9 - 13:11 - 5:11 - 8:11 - 17:15,3,2,Arutyunov Ruben,Nazaryan Mushegh,fiurst,Arutyunov Ruben - Nazaryan Mushegh,111,54,57,3,-3,20,24,16,19,32,-2,-2,6,3,-2,3,11:9 - 13:11 - 5:11 - 8:11 - 17:15
14705114,2023-10-20 14:15:00,Papyan Karen - Diaryan Aleksandr,2:3,6:11 - 6:11 - 11:6 - 11:8 - 12:10,3,2,Papyan Karen,Diaryan Aleksandr,fiurst,Diaryan Aleksandr - Papyan Karen,92,46,46,0,0,17,17,17,19,22,-5,-5,5,3,2,0,11:6 - 11:6 - 6:11 - 8:11 - 10:12
14705108,2023-10-20 14:10:00,Arutyunov Ruben - Nikoghosyan Narek,2:3,7:11 - 11:5 - 11:8 - 8:11 - 6:11,2,3,Arutyunov Ruben,Nikoghosyan Narek,fiurst,Arutyunov Ruben - Nikoghosyan Narek,89,43,46,3,-3,18,16,19,19,17,4,-6,-3,3,5,3,7:11 - 11:5 - 11:8 - 8:11 - 6:11
14705107,2023-10-20 13:45:00,Nazaryan Mushegh - Diaryan Aleksandr,3:0,9:11 - 2:11 - 6:11 - 0:0 - 0:0,0,3,Nazaryan Mushegh,Diaryan Aleksandr,fiurst,Diaryan Aleksandr - Nazaryan Mushegh,50,33,17,-16,16,20,13,17,0,0,-2,-9,-5,0,0,-16,11:9 - 11:2 - 11:6 - 0:0 - 0:0
14705106,2023-10-20 13:40:00,Papyan Karen - Arutyunov Ruben,3:1,5:11 - 7:11 - 13:11 - 5:11 - 0:0,1,3,Papyan Karen,Arutyunov Ruben,fiurst,Arutyunov Ruben - Papyan Karen,74,44,30,-14,14,16,18,24,16,0,-6,-4,2,-6,0,-14,11:5 - 11:7 - 11:13 - 11:5 - 0:0
14705097,2023-10-20 13:15:00,Nikoghosyan Narek - Nazaryan Mushegh,0:3,12:10 - 11:6 - 11:7 - 0:0 - 0:0,3,0,Nikoghosyan Narek,Nazaryan Mushegh,fiurst,Nazaryan Mushegh - Nikoghosyan Narek,57,23,34,11,-11,22,17,18,0,0,2,5,4,0,0,11,10:12 - 6:11 - 7:11 - 0:0 - 0:0
14705022,2023-10-20 13:00:00,Diaryan Aleksandr - Arutyunov Ruben,3:1,10:12 - 11:8 - 8:11 - 11:13 - 0:0,1,3,Diaryan Aleksandr,Arutyunov Ruben,fiurst,Arutyunov Ruben - Diaryan Aleksandr,84,44,40,-4,4,22,19,19,24,0,-2,3,-3,-2,0,-4,12:10 - 8:11 - 11:8 - 13:11 - 0:0
14705019,2023-10-20 12:50:00,Nikoghosyan Narek - Papyan Karen,3:2,7:11 - 11:3 - 11:0 - 7:11 - 11:9,3,2,Nikoghosyan Narek,Papyan Karen,fiurst,Nikoghosyan Narek - Papyan Karen,81,47,34,-13,13,18,14,11,18,20,4,-8,-11,4,-2,-13,7:11 - 11:3 - 11:0 - 7:11 - 11:9
14705006,2023-10-20 12:20:00,Nazaryan Mushegh - Arutyunov Ruben,1:3,11:4 - 11:7 - 3:11 - 11:8 - 0:0,3,1,Nazaryan Mushegh,Arutyunov Ruben,fiurst,Arutyunov Ruben - Nazaryan Mushegh,66,30,36,6,-6,15,18,14,19,0,7,4,-8,3,0,6,4:11 - 7:11 - 11:3 - 8:11 - 0:0
14705003,2023-10-20 12:10:00,Nikoghosyan Narek - Diaryan Aleksandr,1:3,13:11 - 4:11 - 14:12 - 11:8 - 0:0,3,1,Nikoghosyan Narek,Diaryan Aleksandr,fiurst,Diaryan Aleksandr - Nikoghosyan Narek,84,42,42,0,0,24,15,26,19,0,2,-7,2,3,0,0,11:13 - 11:4 - 12:14 - 8:11 - 0:0
14704999,2023-10-20 12:00:00,Papyan Karen - Nazaryan Mushegh,3:0,10:12 - 8:11 - 4:11 - 0:0 - 0:0,0,3,Papyan Karen,Nazaryan Mushegh,fiurst,Nazaryan Mushegh - Papyan Karen,56,34,22,-12,12,22,19,15,0,0,-2,-3,-7,0,0,-12,12:10 - 11:8 - 11:4 - 0:0 - 0:0
14704981,2023-10-20 11:30:00,Diaryan Aleksandr - Papyan Karen,3:2,11:9 - 9:11 - 5:11 - 11:6 - 12:10,3,2,Diaryan Aleksandr,Papyan Karen,fiurst,Diaryan Aleksandr - Papyan Karen,95,48,47,-1,1,20,20,16,17,22,-2,2,6,-5,-2,-1,11:9 - 9:11 - 5:11 - 11:6 - 12:10
14704992,2023-10-20 11:30:00,Nikoghosyan Narek - Arutyunov Ruben,3:2,11:9 - 8:11 - 10:12 - 11:3 - 10:12,2,3,Nikoghosyan Narek,Arutyunov Ruben,fiurst,Arutyunov Ruben - Nikoghosyan Narek,97,47,50,3,-3,20,19,22,14,22,2,-3,-2,8,-2,3,9:11 - 11:8 - 12:10 - 3:11 - 12:10
14704978,2023-10-20 11:00:00,Nazaryan Mushegh - Nikoghosyan Narek,1:3,10:12 - 11:7 - 4:11 - 7:11 - 0:0,1,3,Nazaryan Mushegh,Nikoghosyan Narek,fiurst,Nazaryan Mushegh - Nikoghosyan Narek,73,32,41,9,-9,22,18,15,18,0,2,-4,7,4,0,9,10:12 - 11:7 - 4:11 - 7:11 - 0:0
14704975,2023-10-20 10:45:00,Arutyunov Ruben - Papyan Karen,2:3,8:11 - 12:10 - 10:12 - 11:8 - 11:13,2,3,Arutyunov Ruben,Papyan Karen,fiurst,Arutyunov Ruben - Papyan Karen,106,52,54,2,-2,19,22,22,19,24,3,-2,2,-3,2,2,8:11 - 12:10 - 10:12 - 11:8 - 11:13
14704973,2023-10-20 10:30:00,Diaryan Aleksandr - Nazaryan Mushegh,3:1,11:9 - 11:13 - 11:9 - 11:8 - 0:0,3,1,Diaryan Aleksandr,Nazaryan Mushegh,fiurst,Diaryan Aleksandr - Nazaryan Mushegh,83,44,39,-5,5,20,24,20,19,0,-2,2,-2,-3,0,-5,11:9 - 11:13 - 11:9 - 11:8 - 0:0
14704969,2023-10-20 10:15:00,Papyan Karen - Nikoghosyan Narek,2:3,11:8 - 6:11 - 11:7 - 7:11 - 11:8,3,2,Papyan Karen,Nikoghosyan Narek,fiurst,Nikoghosyan Narek - Papyan Karen,91,45,46,1,-1,19,17,18,18,19,3,-5,4,-4,3,1,8:11 - 11:6 - 7:11 - 11:7 - 8:11
14704968,2023-10-20 10:00:00,Arutyunov Ruben - Diaryan Aleksandr,0:3,6:11 - 4:11 - 5:11 - 0:0 - 0:0,0,3,Arutyunov Ruben,Diaryan Aleksandr,fiurst,Arutyunov Ruben - Diaryan Aleksandr,48,15,33,18,-18,17,15,16,0,0,5,7,6,0,0,18,6:11 - 4:11 - 5:11 - 0:0 - 0:0
14686802,2023-10-19 17:30:00,Darbinyan Armen - Soghomonyan Hrayr,0:3,8:11 - 5:11 - 7:11 - 0:0 - 0:0,0,3,Darbinyan Armen,Soghomonyan Hrayr,fiurst,Darbinyan Armen - Soghomonyan Hrayr,53,20,33,13,-13,19,16,18,0,0,3,6,4,0,0,13,8:11 - 5:11 - 7:11 - 0:0 - 0:0
14686801,2023-10-19 17:20:00,Avakimyan Davit - Petrosyan Davit,3:0,11:5 - 11:5 - 11:3 - 0:0 - 0:0,3,0,Avakimyan Davit,Petrosyan Davit,fiurst,Avakimyan Davit - Petrosyan Davit,46,33,13,-20,20,16,16,14,0,0,-6,-6,-8,0,0,-20,11:5 - 11:5 - 11:3 - 0:0 - 0:0
14686800,2023-10-19 17:05:00,Grigoryan Erik - Darbinyan Armen,3:1,10:12 - 7:11 - 11:8 - 5:11 - 0:0,1,3,Grigoryan Erik,Darbinyan Armen,fiurst,Darbinyan Armen - Grigoryan Erik,75,42,33,-9,9,22,18,19,16,0,-2,-4,3,-6,0,-9,12:10 - 11:7 - 8:11 - 11:5 - 0:0
14686788,2023-10-19 16:45:00,Avakimyan Davit - Soghomonyan Hrayr,2:3,5:11 - 11:9 - 11:9 - 3:11 - 11:13,2,3,Avakimyan Davit,Soghomonyan Hrayr,fiurst,Avakimyan Davit - Soghomonyan Hrayr,94,41,53,12,-12,16,20,20,14,24,6,-2,-2,8,2,12,5:11 - 11:9 - 11:9 - 3:11 - 11:13
14686786,2023-10-19 16:35:00,Petrosyan Davit - Grigoryan Erik,1:3,9:11 - 11:5 - 11:6 - 11:7 - 0:0,3,1,Petrosyan Davit,Grigoryan Erik,fiurst,Grigoryan Erik - Petrosyan Davit,71,29,42,13,-13,20,16,17,18,0,-2,6,5,4,0,13,11:9 - 5:11 - 6:11 - 7:11 - 0:0
14686785,2023-10-19 16:15:00,Darbinyan Armen - Avakimyan Davit,3:0,9:11 - 10:12 - 8:11 - 0:0 - 0:0,0,3,Darbinyan Armen,Avakimyan Davit,fiurst,Avakimyan Davit - Darbinyan Armen,61,34,27,-7,7,20,22,19,0,0,-2,-2,-3,0,0,-7,11:9 - 12:10 - 11:8 - 0:0 - 0:0
14686780,2023-10-19 16:00:00,Soghomonyan Hrayr - Grigoryan Erik,0:3,11:8 - 11:7 - 11:4 - 0:0 - 0:0,3,0,Soghomonyan Hrayr,Grigoryan Erik,fiurst,Grigoryan Erik - Soghomonyan Hrayr,52,19,33,14,-14,19,18,15,0,0,3,4,7,0,0,14,8:11 - 7:11 - 4:11 - 0:0 - 0:0
14686768,2023-10-19 15:45:00,Grigoryan Erik - Avakimyan Davit,3:0,7:11 - 5:11 - 9:11 - 0:0 - 0:0,0,3,Grigoryan Erik,Avakimyan Davit,fiurst,Avakimyan Davit - Grigoryan Erik,54,33,21,-12,12,18,16,20,0,0,-4,-6,-2,0,0,-12,11:7 - 11:5 - 11:9 - 0:0 - 0:0
14686779,2023-10-19 15:45:00,Petrosyan Davit - Darbinyan Armen,1:3,5:11 - 11:3 - 11:6 - 11:4 - 0:0,3,1,Petrosyan Davit,Darbinyan Armen,fiurst,Darbinyan Armen - Petrosyan Davit,62,24,38,14,-14,16,14,17,15,0,-6,8,5,7,0,14,11:5 - 3:11 - 6:11 - 4:11 - 0:0
14686766,2023-10-19 15:15:00,Soghomonyan Hrayr - Petrosyan Davit,0:3,11:6 - 11:7 - 11:8 - 0:0 - 0:0,3,0,Soghomonyan Hrayr,Petrosyan Davit,fiurst,Petrosyan Davit - Soghomonyan Hrayr,54,21,33,12,-12,17,18,19,0,0,5,4,3,0,0,12,6:11 - 7:11 - 8:11 - 0:0 - 0:0
14686763,2023-10-19 15:00:00,Arutyunov Ruben - Antonyan Eduard,3:2,11:6 - 10:12 - 9:11 - 11:9 - 7:11,2,3,Arutyunov Ruben,Antonyan Eduard,fiurst,Antonyan Eduard - Arutyunov Ruben,97,49,48,-1,1,17,22,20,20,18,5,-2,-2,2,-4,-1,6:11 - 12:10 - 11:9 - 9:11 - 11:7
14686761,2023-10-19 14:45:00,Rafayelyan Edgar - Diaryan Aleksandr,3:2,11:8 - 1:11 - 5:11 - 11:9 - 7:11,2,3,Rafayelyan Edgar,Diaryan Aleksandr,fiurst,Diaryan Aleksandr - Rafayelyan Edgar,85,50,35,-15,15,19,12,16,20,18,3,-10,-6,2,-4,-15,8:11 - 11:1 - 11:5 - 9:11 - 11:7
14686758,2023-10-19 14:30:00,Nazaryan Mushegh - Arutyunov Ruben,0:3,12:10 - 11:8 - 11:8 - 0:0 - 0:0,3,0,Nazaryan Mushegh,Arutyunov Ruben,fiurst,Arutyunov Ruben - Nazaryan Mushegh,60,26,34,8,-8,22,19,19,0,0,2,3,3,0,0,8,10:12 - 8:11 - 8:11 - 0:0 - 0:0
14686755,2023-10-19 14:15:00,Antonyan Eduard - Rafayelyan Edgar,3:0,11:6 - 11:9 - 11:6 - 0:0 - 0:0,3,0,Antonyan Eduard,Rafayelyan Edgar,fiurst,Antonyan Eduard - Rafayelyan Edgar,54,33,21,-12,12,17,20,17,0,0,-5,-2,-5,0,0,-12,11:6 - 11:9 - 11:6 - 0:0 - 0:0
14686744,2023-10-19 14:00:00,Nazaryan Mushegh - Diaryan Aleksandr,3:0,5:11 - 10:12 - 9:11 - 0:0 - 0:0,0,3,Nazaryan Mushegh,Diaryan Aleksandr,fiurst,Diaryan Aleksandr - Nazaryan Mushegh,58,34,24,-10,10,16,22,20,0,0,-6,-2,-2,0,0,-10,11:5 - 12:10 - 11:9 - 0:0 - 0:0
14686743,2023-10-19 13:45:00,Arutyunov Ruben - Rafayelyan Edgar,0:3,7:11 - 1:11 - 4:11 - 0:0 - 0:0,0,3,Arutyunov Ruben,Rafayelyan Edgar,fiurst,Arutyunov Ruben - Rafayelyan Edgar,45,12,33,21,-21,18,12,15,0,0,4,10,7,0,0,21,7:11 - 1:11 - 4:11 - 0:0 - 0:0
14686742,2023-10-19 13:30:00,Antonyan Eduard - Nazaryan Mushegh,3:0,11:8 - 11:8 - 11:8 - 0:0 - 0:0,3,0,Antonyan Eduard,Nazaryan Mushegh,fiurst,Antonyan Eduard - Nazaryan Mushegh,57,33,24,-9,9,19,19,19,0,0,-3,-3,-3,0,0,-9,11:8 - 11:8 - 11:8 - 0:0 - 0:0
14686741,2023-10-19 13:15:00,Diaryan Aleksandr - Arutyunov Ruben,0:3,11:7 - 11:3 - 11:5 - 0:0 - 0:0,3,0,Diaryan Aleksandr,Arutyunov Ruben,fiurst,Arutyunov Ruben - Diaryan Aleksandr,48,15,33,18,-18,18,14,16,0,0,4,8,6,0,0,18,7:11 - 3:11 - 5:11 - 0:0 - 0:0
14686737,2023-10-19 13:00:00,Rafayelyan Edgar - Nazaryan Mushegh,1:3,11:7 - 11:7 - 9:11 - 12:10 - 0:0,3,1,Rafayelyan Edgar,Nazaryan Mushegh,fiurst,Nazaryan Mushegh - Rafayelyan Edgar,78,35,43,8,-8,18,18,20,22,0,4,4,-2,2,0,8,7:11 - 7:11 - 11:9 - 10:12 - 0:0
14686734,2023-10-19 12:45:00,Diaryan Aleksandr - Antonyan Eduard,2:3,9:11 - 4:11 - 11:4 - 11:6 - 11:6,3,2,Diaryan Aleksandr,Antonyan Eduard,fiurst,Antonyan Eduard - Diaryan Aleksandr,84,38,46,8,-8,20,15,15,17,17,-2,-7,7,5,5,8,11:9 - 11:4 - 4:11 - 6:11 - 6:11
14686732,2023-10-19 12:25:00,Arutyunov Ruben - Nazaryan Mushegh,0:3,5:11 - 9:11 - 5:11 - 0:0 - 0:0,0,3,Arutyunov Ruben,Nazaryan Mushegh,fiurst,Arutyunov Ruben - Nazaryan Mushegh,52,19,33,14,-14,16,20,16,0,0,6,2,6,0,0,14,5:11 - 9:11 - 5:11 - 0:0 - 0:0
14686731,2023-10-19 12:00:00,Diaryan Aleksandr - Rafayelyan Edgar,3:0,12:10 - 11:5 - 11:6 - 0:0 - 0:0,3,0,Diaryan Aleksandr,Rafayelyan Edgar,fiurst,Diaryan Aleksandr - Rafayelyan Edgar,55,34,21,-13,13,22,16,17,0,0,-2,-6,-5,0,0,-13,12:10 - 11:5 - 11:6 - 0:0 - 0:0
14686720,2023-10-19 11:45:00,Antonyan Eduard - Arutyunov Ruben,2:3,11:7 - 11:4 - 7:11 - 10:12 - 6:11,2,3,Antonyan Eduard,Arutyunov Ruben,fiurst,Antonyan Eduard - Arutyunov Ruben,90,45,45,0,0,18,15,18,22,17,-4,-7,4,2,5,0,11:7 - 11:4 - 7:11 - 10:12 - 6:11
14686719,2023-10-19 11:30:00,Diaryan Aleksandr - Nazaryan Mushegh,3:0,11:6 - 11:5 - 11:3 - 0:0 - 0:0,3,0,Diaryan Aleksandr,Nazaryan Mushegh,fiurst,Diaryan Aleksandr - Nazaryan Mushegh,47,33,14,-19,19,17,16,14,0,0,-5,-6,-8,0,0,-19,11:6 - 11:5 - 11:3 - 0:0 - 0:0
14686712,2023-10-19 11:15:00,Rafayelyan Edgar - Antonyan Eduard,0:3,11:8 - 11:9 - 11:6 - 0:0 - 0:0,3,0,Rafayelyan Edgar,Antonyan Eduard,fiurst,Antonyan Eduard - Rafayelyan Edgar,56,23,33,10,-10,19,20,17,0,0,3,2,5,0,0,10,8:11 - 9:11 - 6:11 - 0:0 - 0:0
14686698,2023-10-19 11:00:00,Arutyunov Ruben - Diaryan Aleksandr,1:3,11:8 - 3:11 - 1:11 - 6:11 - 0:0,1,3,Arutyunov Ruben,Diaryan Aleksandr,fiurst,Arutyunov Ruben - Diaryan Aleksandr,62,21,41,20,-20,19,14,12,17,0,-3,8,10,5,0,20,11:8 - 3:11 - 1:11 - 6:11 - 0:0
14686694,2023-10-19 10:45:00,Nazaryan Mushegh - Antonyan Eduard,3:0,7:11 - 9:11 - 6:11 - 0:0 - 0:0,0,3,Nazaryan Mushegh,Antonyan Eduard,fiurst,Antonyan Eduard - Nazaryan Mushegh,55,33,22,-11,11,18,20,17,0,0,-4,-2,-5,0,0,-11,11:7 - 11:9 - 11:6 - 0:0 - 0:0
14686691,2023-10-19 10:30:00,Rafayelyan Edgar - Arutyunov Ruben,0:3,11:6 - 11:2 - 11:7 - 0:0 - 0:0,3,0,Rafayelyan Edgar,Arutyunov Ruben,fiurst,Arutyunov Ruben - Rafayelyan Edgar,48,15,33,18,-18,17,13,18,0,0,5,9,4,0,0,18,6:11 - 2:11 - 7:11 - 0:0 - 0:0
14686685,2023-10-19 10:15:00,Nazaryan Mushegh - Rafayelyan Edgar,0:3,4:11 - 6:11 - 4:11 - 0:0 - 0:0,0,3,Nazaryan Mushegh,Rafayelyan Edgar,fiurst,Nazaryan Mushegh - Rafayelyan Edgar,47,14,33,19,-19,15,17,15,0,0,7,5,7,0,0,19,4:11 - 6:11 - 4:11 - 0:0 - 0:0
14686686,2023-10-19 10:15:00,Antonyan Eduard - Diaryan Aleksandr,2:3,11:8 - 5:11 - 6:11 - 11:5 - 4:11,2,3,Antonyan Eduard,Diaryan Aleksandr,fiurst,Antonyan Eduard - Diaryan Aleksandr,83,37,46,9,-9,19,16,17,16,15,-3,6,5,-6,7,9,11:8 - 5:11 - 6:11 - 11:5 - 4:11
14673270,2023-10-18 17:30:00,Darbinyan Armen - Mkrtchyan Andranik,3:1,11:9 - 13:11 - 5:11 - 12:10 - 0:0,3,1,Darbinyan Armen,Mkrtchyan Andranik,fiurst,Darbinyan Armen - Mkrtchyan Andranik,82,41,41,0,0,20,24,16,22,0,-2,-2,6,-2,0,0,11:9 - 13:11 - 5:11 - 12:10 - 0:0
14673260,2023-10-18 17:15:00,Grigoryan Erik - Gevorgyan Gegham,3:0,7:11 - 4:11 - 7:11 - 0:0 - 0:0,0,3,Grigoryan Erik,Gevorgyan Gegham,fiurst,Gevorgyan Gegham - Grigoryan Erik,51,33,18,-15,15,18,15,18,0,0,-4,-7,-4,0,0,-15,11:7 - 11:4 - 11:7 - 0:0 - 0:0
14673258,2023-10-18 17:00:00,Soghomonyan Hrayr - Darbinyan Armen,0:3,12:10 - 12:10 - 11:8 - 0:0 - 0:0,3,0,Soghomonyan Hrayr,Darbinyan Armen,fiurst,Darbinyan Armen - Soghomonyan Hrayr,63,28,35,7,-7,22,22,19,0,0,2,2,3,0,0,7,10:12 - 10:12 - 8:11 - 0:0 - 0:0
14673253,2023-10-18 16:50:00,Grigoryan Erik - Mkrtchyan Andranik,0:3,9:11 - 8:11 - 5:11 - 0:0 - 0:0,0,3,Grigoryan Erik,Mkrtchyan Andranik,fiurst,Grigoryan Erik - Mkrtchyan Andranik,55,22,33,11,-11,20,19,16,0,0,2,3,6,0,0,11,9:11 - 8:11 - 5:11 - 0:0 - 0:0
14673237,2023-10-18 16:40:00,Gevorgyan Gegham - Soghomonyan Hrayr,0:3,8:11 - 9:11 - 6:11 - 0:0 - 0:0,0,3,Gevorgyan Gegham,Soghomonyan Hrayr,fiurst,Gevorgyan Gegham - Soghomonyan Hrayr,56,23,33,10,-10,19,20,17,0,0,3,2,5,0,0,10,8:11 - 9:11 - 6:11 - 0:0 - 0:0
14673236,2023-10-18 16:15:00,Darbinyan Armen - Grigoryan Erik,3:2,9:11 - 11:9 - 11:9 - 9:11 - 11:9,3,2,Darbinyan Armen,Grigoryan Erik,fiurst,Darbinyan Armen - Grigoryan Erik,100,51,49,-2,2,20,20,20,20,20,2,-2,-2,2,-2,-2,9:11 - 11:9 - 11:9 - 9:11 - 11:9
14673225,2023-10-18 16:00:00,Mkrtchyan Andranik - Soghomonyan Hrayr,3:2,11:9 - 7:11 - 11:7 - 6:11 - 11:7,3,2,Mkrtchyan Andranik,Soghomonyan Hrayr,fiurst,Mkrtchyan Andranik - Soghomonyan Hrayr,91,46,45,-1,1,20,18,18,17,18,-2,4,-4,5,-4,-1,11:9 - 7:11 - 11:7 - 6:11 - 11:7
14673223,2023-10-18 15:45:00,Gevorgyan Gegham - Darbinyan Armen,2:3,11:7 - 12:10 - 12:14 - 10:12 - 11:3,3,2,Gevorgyan Gegham,Darbinyan Armen,fiurst,Darbinyan Armen - Gevorgyan Gegham,102,46,56,10,-10,18,22,26,22,14,4,2,-2,-2,8,10,7:11 - 10:12 - 14:12 - 12:10 - 3:11
14673220,2023-10-18 15:35:00,Soghomonyan Hrayr - Grigoryan Erik,0:3,11:5 - 11:9 - 11:8 - 0:0 - 0:0,3,0,Soghomonyan Hrayr,Grigoryan Erik,fiurst,Grigoryan Erik - Soghomonyan Hrayr,55,22,33,11,-11,16,20,19,0,0,6,2,3,0,0,11,5:11 - 9:11 - 8:11 - 0:0 - 0:0
14673218,2023-10-18 15:15:00,Mkrtchyan Andranik - Gevorgyan Gegham,0:3,11:8 - 11:7 - 11:7 - 0:0 - 0:0,3,0,Mkrtchyan Andranik,Gevorgyan Gegham,fiurst,Gevorgyan Gegham - Mkrtchyan Andranik,55,22,33,11,-11,19,18,18,0,0,3,4,4,0,0,11,8:11 - 7:11 - 7:11 - 0:0 - 0:0
14673205,2023-10-18 15:10:00,Nikoghosyan Narek - Rafayelyan Edgar,3:1,9:11 - 11:9 - 11:6 - 11:7 - 0:0,3,1,Nikoghosyan Narek,Rafayelyan Edgar,fiurst,Nikoghosyan Narek - Rafayelyan Edgar,75,42,33,-9,9,20,20,17,18,0,2,-2,-5,-4,0,-9,9:11 - 11:9 - 11:6 - 11:7 - 0:0
14673204,2023-10-18 14:45:00,Antonyan Eduard - Papyan Karen,1:3,11:9 - 6:11 - 7:11 - 6:11 - 0:0,1,3,Antonyan Eduard,Papyan Karen,fiurst,Antonyan Eduard - Papyan Karen,72,30,42,12,-12,20,17,18,17,0,-2,5,4,5,0,12,11:9 - 6:11 - 7:11 - 6:11 - 0:0
14673203,2023-10-18 14:30:00,Diaryan Aleksandr - Nikoghosyan Narek,3:2,8:11 - 11:9 - 5:11 - 11:6 - 11:2,3,2,Diaryan Aleksandr,Nikoghosyan Narek,fiurst,Diaryan Aleksandr - Nikoghosyan Narek,85,46,39,-7,7,19,20,16,17,13,3,-2,6,-5,-9,-7,8:11 - 11:9 - 5:11 - 11:6 - 11:2
14673202,2023-10-18 14:15:00,Rafayelyan Edgar - Antonyan Eduard,1:3,11:4 - 11:6 - 8:11 - 11:6 - 0:0,3,1,Rafayelyan Edgar,Antonyan Eduard,fiurst,Antonyan Eduard - Rafayelyan Edgar,68,27,41,14,-14,15,17,19,17,0,7,5,-3,5,0,14,4:11 - 6:11 - 11:8 - 6:11 - 0:0
14673201,2023-10-18 14:00:00,Diaryan Aleksandr - Papyan Karen,3:0,11:6 - 11:6 - 11:9 - 0:0 - 0:0,3,0,Diaryan Aleksandr,Papyan Karen,fiurst,Diaryan Aleksandr - Papyan Karen,54,33,21,-12,12,17,17,20,0,0,-5,-5,-2,0,0,-12,11:6 - 11:6 - 11:9 - 0:0 - 0:0
14673198,2023-10-18 13:50:00,Nikoghosyan Narek - Antonyan Eduard,1:3,11:6 - 12:10 - 8:11 - 11:9 - 0:0,3,1,Nikoghosyan Narek,Antonyan Eduard,fiurst,Antonyan Eduard - Nikoghosyan Narek,78,36,42,6,-6,17,22,19,20,0,5,2,-3,2,0,6,6:11 - 10:12 - 11:8 - 9:11 - 0:0
14673197,2023-10-18 13:30:00,Rafayelyan Edgar - Diaryan Aleksandr,1:3,3:11 - 11:8 - 11:6 - 11:6 - 0:0,3,1,Rafayelyan Edgar,Diaryan Aleksandr,fiurst,Diaryan Aleksandr - Rafayelyan Edgar,67,31,36,5,-5,14,19,17,17,0,-8,3,5,5,0,5,11:3 - 8:11 - 6:11 - 6:11 - 0:0
14673195,2023-10-18 13:20:00,Papyan Karen - Nikoghosyan Narek,1:3,12:10 - 13:11 - 8:11 - 12:10 - 0:0,3,1,Papyan Karen,Nikoghosyan Narek,fiurst,Nikoghosyan Narek - Papyan Karen,87,42,45,3,-3,22,24,19,22,0,2,2,-3,2,0,3,10:12 - 11:13 - 11:8 - 10:12 - 0:0
14673193,2023-10-18 13:05:00,Antonyan Eduard - Diaryan Aleksandr,1:3,2:11 - 1:11 - 13:11 - 7:11 - 0:0,1,3,Antonyan Eduard,Diaryan Aleksandr,fiurst,Antonyan Eduard - Diaryan Aleksandr,67,23,44,21,-21,13,12,24,18,0,9,10,-2,4,0,21,2:11 - 1:11 - 13:11 - 7:11 - 0:0
14673189,2023-10-18 12:55:00,Papyan Karen - Rafayelyan Edgar,3:0,11:9 - 13:11 - 11:5 - 0:0 - 0:0,3,0,Papyan Karen,Rafayelyan Edgar,fiurst,Papyan Karen - Rafayelyan Edgar,60,35,25,-10,10,20,24,16,0,0,-2,-2,-6,0,0,-10,11:9 - 13:11 - 11:5 - 0:0 - 0:0
14673180,2023-10-18 12:15:00,Nikoghosyan Narek - Diaryan Aleksandr,3:1,5:11 - 8:11 - 12:10 - 7:11 - 0:0,1,3,Nikoghosyan Narek,Diaryan Aleksandr,fiurst,Diaryan Aleksandr - Nikoghosyan Narek,75,43,32,-11,11,16,19,22,18,0,-6,-3,2,-4,0,-11,11:5 - 11:8 - 10:12 - 11:7 - 0:0
14673179,2023-10-18 12:10:00,Papyan Karen - Antonyan Eduard,3:1,11:9 - 6:11 - 8:11 - 9:11 - 0:0,1,3,Papyan Karen,Antonyan Eduard,fiurst,Antonyan Eduard - Papyan Karen,76,42,34,-8,8,20,17,19,20,0,2,-5,-3,-2,0,-8,9:11 - 11:6 - 11:8 - 11:9 - 0:0
14673177,2023-10-18 11:45:00,Rafayelyan Edgar - Nikoghosyan Narek,2:3,3:11 - 8:11 - 11:6 - 11:7 - 11:3,3,2,Rafayelyan Edgar,Nikoghosyan Narek,fiurst,Nikoghosyan Narek - Rafayelyan Edgar,82,38,44,6,-6,14,19,17,18,14,-8,-3,5,4,8,6,11:3 - 11:8 - 6:11 - 7:11 - 3:11
14673176,2023-10-18 11:40:00,Papyan Karen - Diaryan Aleksandr,3:1,8:11 - 7:11 - 11:9 - 4:11 - 0:0,1,3,Papyan Karen,Diaryan Aleksandr,fiurst,Diaryan Aleksandr - Papyan Karen,72,42,30,-12,12,19,18,20,15,0,-3,-4,2,-7,0,-12,11:8 - 11:7 - 9:11 - 11:4 - 0:0
14673171,2023-10-18 11:15:00,Antonyan Eduard - Rafayelyan Edgar,1:3,11:7 - 7:11 - 9:11 - 6:11 - 0:0,1,3,Antonyan Eduard,Rafayelyan Edgar,fiurst,Antonyan Eduard - Rafayelyan Edgar,73,33,40,7,-7,18,18,20,17,0,-4,4,2,5,0,7,11:7 - 7:11 - 9:11 - 6:11 - 0:0
14673169,2023-10-18 11:05:00,Nikoghosyan Narek - Papyan Karen,1:3,8:11 - 11:13 - 11:8 - 12:14 - 0:0,1,3,Nikoghosyan Narek,Papyan Karen,fiurst,Nikoghosyan Narek - Papyan Karen,88,42,46,4,-4,19,24,19,26,0,3,2,-3,2,0,4,8:11 - 11:13 - 11:8 - 12:14 - 0:0
14673167,2023-10-18 10:45:00,Diaryan Aleksandr - Rafayelyan Edgar,3:2,11:7 - 7:11 - 8:11 - 11:4 - 12:10,3,2,Diaryan Aleksandr,Rafayelyan Edgar,fiurst,Diaryan Aleksandr - Rafayelyan Edgar,92,49,43,-6,6,18,18,19,15,22,-4,4,3,-7,-2,-6,11:7 - 7:11 - 8:11 - 11:4 - 12:10
14673164,2023-10-18 10:30:00,Antonyan Eduard - Nikoghosyan Narek,1:3,11:7 - 9:11 - 3:11 - 9:11 - 0:0,1,3,Antonyan Eduard,Nikoghosyan Narek,fiurst,Antonyan Eduard - Nikoghosyan Narek,72,32,40,8,-8,18,20,14,20,0,-4,2,8,2,0,8,11:7 - 9:11 - 3:11 - 9:11 - 0:0
14673153,2023-10-18 10:15:00,Rafayelyan Edgar - Papyan Karen,3:0,11:13 - 8:11 - 12:14 - 0:0 - 0:0,0,3,Rafayelyan Edgar,Papyan Karen,fiurst,Papyan Karen - Rafayelyan Edgar,69,38,31,-7,7,24,19,26,0,0,-2,-3,-2,0,0,-7,13:11 - 11:8 - 14:12 - 0:0 - 0:0
14673136,2023-10-18 10:00:00,Diaryan Aleksandr - Antonyan Eduard,0:3,11:6 - 11:1 - 11:8 - 0:0 - 0:0,3,0,Diaryan Aleksandr,Antonyan Eduard,fiurst,Antonyan Eduard - Diaryan Aleksandr,48,15,33,18,-18,17,12,19,0,0,5,10,3,0,0,18,6:11 - 1:11 - 8:11 - 0:0 - 0:0
14654788,2023-10-17 17:30:00,Darbinyan Armen - Avakimyan Davit,3:0,10:12 - 8:11 - 4:11 - 0:0 - 0:0,0,3,Darbinyan Armen,Avakimyan Davit,fiurst,Avakimyan Davit - Darbinyan Armen,56,34,22,-12,12,22,19,15,0,0,-2,-3,-7,0,0,-12,12:10 - 11:8 - 11:4 - 0:0 - 0:0
14654785,2023-10-17 17:15:00,Petrosyan Davit - Grigoryan Erik,1:3,10:12 - 18:16 - 11:6 - 11:8 - 0:0,3,1,Petrosyan Davit,Grigoryan Erik,fiurst,Grigoryan Erik - Petrosyan Davit,92,42,50,8,-8,22,34,17,19,0,-2,2,5,3,0,8,12:10 - 16:18 - 6:11 - 8:11 - 0:0
14654783,2023-10-17 17:00:00,Mkrtchyan Andranik - Darbinyan Armen,0:3,11:7 - 11:7 - 11:7 - 0:0 - 0:0,3,0,Mkrtchyan Andranik,Darbinyan Armen,fiurst,Darbinyan Armen - Mkrtchyan Andranik,54,21,33,12,-12,18,18,18,0,0,4,4,4,0,0,12,7:11 - 7:11 - 7:11 - 0:0 - 0:0
14654777,2023-10-17 16:45:00,Petrosyan Davit - Avakimyan Davit,3:1,11:8 - 9:11 - 4:11 - 5:11 - 0:0,1,3,Petrosyan Davit,Avakimyan Davit,fiurst,Avakimyan Davit - Petrosyan Davit,70,41,29,-12,12,19,20,15,16,0,3,-2,-7,-6,0,-12,8:11 - 11:9 - 11:4 - 11:5 - 0:0
14654766,2023-10-17 16:40:00,Grigoryan Erik - Mkrtchyan Andranik,0:3,8:11 - 9:11 - 4:11 - 0:0 - 0:0,0,3,Grigoryan Erik,Mkrtchyan Andranik,fiurst,Grigoryan Erik - Mkrtchyan Andranik,54,21,33,12,-12,19,20,15,0,0,3,2,7,0,0,12,8:11 - 9:11 - 4:11 - 0:0 - 0:0
14654762,2023-10-17 16:15:00,Darbinyan Armen - Petrosyan Davit,0:3,3:11 - 10:12 - 0:11 - 0:0 - 0:0,0,3,Darbinyan Armen,Petrosyan Davit,fiurst,Darbinyan Armen - Petrosyan Davit,47,13,34,21,-21,14,22,11,0,0,8,2,11,0,0,21,3:11 - 10:12 - 0:11 - 0:0 - 0:0
14654757,2023-10-17 16:05:00,Avakimyan Davit - Mkrtchyan Andranik,3:2,6:11 - 12:14 - 11:7 - 12:10 - 11:9,3,2,Avakimyan Davit,Mkrtchyan Andranik,fiurst,Avakimyan Davit - Mkrtchyan Andranik,103,52,51,-1,1,17,26,18,22,20,5,2,-4,-2,-2,-1,6:11 - 12:14 - 11:7 - 12:10 - 11:9
14654752,2023-10-17 15:45:00,Grigoryan Erik - Darbinyan Armen,1:3,11:8 - 8:11 - 11:7 - 13:11 - 0:0,3,1,Grigoryan Erik,Darbinyan Armen,fiurst,Darbinyan Armen - Grigoryan Erik,80,37,43,6,-6,19,19,18,24,0,3,-3,4,2,0,6,8:11 - 11:8 - 7:11 - 11:13 - 0:0
14654740,2023-10-17 15:35:00,Mkrtchyan Andranik - Petrosyan Davit,3:1,11:5 - 11:6 - 8:11 - 11:6 - 0:0,3,1,Mkrtchyan Andranik,Petrosyan Davit,fiurst,Mkrtchyan Andranik - Petrosyan Davit,69,41,28,-13,13,16,17,19,17,0,-6,-5,3,-5,0,-13,11:5 - 11:6 - 8:11 - 11:6 - 0:0
14654732,2023-10-17 15:15:00,Avakimyan Davit - Grigoryan Erik,3:0,11:7 - 11:5 - 11:4 - 0:0 - 0:0,3,0,Avakimyan Davit,Grigoryan Erik,fiurst,Avakimyan Davit - Grigoryan Erik,49,33,16,-17,17,18,16,15,0,0,-4,-6,-7,0,0,-17,11:7 - 11:5 - 11:4 - 0:0 - 0:0
14654647,2023-10-17 15:00:00,Arutyunov Ruben - Papyan Karen,1:3,7:11 - 15:13 - 7:11 - 8:11 - 0:0,1,3,Arutyunov Ruben,Papyan Karen,fiurst,Arutyunov Ruben - Papyan Karen,83,37,46,9,-9,18,28,18,19,0,4,-2,4,3,0,9,7:11 - 15:13 - 7:11 - 8:11 - 0:0
14654644,2023-10-17 14:55:00,Nikoghosyan Narek - Nazaryan Mushegh,0:3,11:5 - 11:7 - 11:5 - 0:0 - 0:0,3,0,Nikoghosyan Narek,Nazaryan Mushegh,fiurst,Nazaryan Mushegh - Nikoghosyan Narek,50,17,33,16,-16,16,18,16,0,0,6,4,6,0,0,16,5:11 - 7:11 - 5:11 - 0:0 - 0:0
14654625,2023-10-17 14:30:00,Antonyan Eduard - Arutyunov Ruben,3:2,11:6 - 15:17 - 8:11 - 11:9 - 12:10,3,2,Antonyan Eduard,Arutyunov Ruben,fiurst,Antonyan Eduard - Arutyunov Ruben,110,57,53,-4,4,17,32,19,20,22,-5,2,3,-2,-2,-4,11:6 - 15:17 - 8:11 - 11:9 - 12:10
14654622,2023-10-17 14:25:00,Papyan Karen - Nikoghosyan Narek,0:3,12:10 - 13:11 - 13:11 - 0:0 - 0:0,3,0,Papyan Karen,Nikoghosyan Narek,fiurst,Nikoghosyan Narek - Papyan Karen,70,32,38,6,-6,22,24,24,0,0,2,2,2,0,0,6,10:12 - 11:13 - 11:13 - 0:0 - 0:0
14654618,2023-10-17 14:05:00,Antonyan Eduard - Nazaryan Mushegh,3:1,11:9 - 8:11 - 11:7 - 11:5 - 0:0,3,1,Antonyan Eduard,Nazaryan Mushegh,fiurst,Antonyan Eduard - Nazaryan Mushegh,73,41,32,-9,9,20,19,18,16,0,-2,3,-4,-6,0,-9,11:9 - 8:11 - 11:7 - 11:5 - 0:0
14654616,2023-10-17 14:00:00,Arutyunov Ruben - Nikoghosyan Narek,3:0,11:6 - 15:13 - 12:10 - 0:0 - 0:0,3,0,Arutyunov Ruben,Nikoghosyan Narek,fiurst,Arutyunov Ruben - Nikoghosyan Narek,67,38,29,-9,9,17,28,22,0,0,-5,-2,-2,0,0,-9,11:6 - 15:13 - 12:10 - 0:0 - 0:0
14654612,2023-10-17 13:40:00,Papyan Karen - Antonyan Eduard,1:3,13:11 - 11:7 - 9:11 - 11:9 - 0:0,3,1,Papyan Karen,Antonyan Eduard,fiurst,Antonyan Eduard - Papyan Karen,82,38,44,6,-6,24,18,20,20,0,2,4,-2,2,0,6,11:13 - 7:11 - 11:9 - 9:11 - 0:0
14654610,2023-10-17 13:25:00,Nazaryan Mushegh - Arutyunov Ruben,2:3,11:7 - 8:11 - 11:7 - 3:11 - 11:8,3,2,Nazaryan Mushegh,Arutyunov Ruben,fiurst,Arutyunov Ruben - Nazaryan Mushegh,88,44,44,0,0,18,19,18,14,19,4,-3,4,-8,3,0,7:11 - 11:8 - 7:11 - 11:3 - 8:11
14654598,2023-10-17 13:10:00,Nikoghosyan Narek - Antonyan Eduard,1:3,4:11 - 11:3 - 11:3 - 11:7 - 0:0,3,1,Nikoghosyan Narek,Antonyan Eduard,fiurst,Antonyan Eduard - Nikoghosyan Narek,61,24,37,13,-13,15,14,14,18,0,-7,8,8,4,0,13,11:4 - 3:11 - 3:11 - 7:11 - 0:0
14654595,2023-10-17 12:50:00,Nazaryan Mushegh - Papyan Karen,2:3,11:7 - 8:11 - 10:12 - 11:6 - 9:11,2,3,Nazaryan Mushegh,Papyan Karen,fiurst,Nazaryan Mushegh - Papyan Karen,96,49,47,-2,2,18,19,22,17,20,-4,3,2,-5,2,-2,11:7 - 8:11 - 10:12 - 11:6 - 9:11
14654594,2023-10-17 12:25:00,Arutyunov Ruben - Antonyan Eduard,2:3,5:11 - 11:0 - 11:8 - 7:11 - 11:6,3,2,Arutyunov Ruben,Antonyan Eduard,fiurst,Antonyan Eduard - Arutyunov Ruben,81,36,45,9,-9,16,11,19,18,17,-6,11,3,-4,5,9,11:5 - 0:11 - 8:11 - 11:7 - 6:11
14654592,2023-10-17 12:00:00,Nazaryan Mushegh - Nikoghosyan Narek,0:3,5:11 - 4:11 - 7:11 - 0:0 - 0:0,0,3,Nazaryan Mushegh,Nikoghosyan Narek,fiurst,Nazaryan Mushegh - Nikoghosyan Narek,49,16,33,17,-17,16,15,18,0,0,6,7,4,0,0,17,5:11 - 4:11 - 7:11 - 0:0 - 0:0
14654560,2023-10-17 11:45:00,Papyan Karen - Arutyunov Ruben,1:3,10:12 - 11:8 - 11:9 - 11:9 - 0:0,3,1,Papyan Karen,Arutyunov Ruben,fiurst,Arutyunov Ruben - Papyan Karen,81,38,43,5,-5,22,19,20,20,0,-2,3,2,2,0,5,12:10 - 8:11 - 9:11 - 9:11 - 0:0
14654548,2023-10-17 11:30:00,Nazaryan Mushegh - Antonyan Eduard,3:1,11:13 - 11:5 - 6:11 - 5:11 - 0:0,1,3,Nazaryan Mushegh,Antonyan Eduard,fiurst,Antonyan Eduard - Nazaryan Mushegh,73,40,33,-7,7,24,16,17,16,0,-2,6,-5,-6,0,-7,13:11 - 5:11 - 11:6 - 11:5 - 0:0
14654546,2023-10-17 11:20:00,Nikoghosyan Narek - Papyan Karen,3:1,11:8 - 12:10 - 10:12 - 11:2 - 0:0,3,1,Nikoghosyan Narek,Papyan Karen,fiurst,Nikoghosyan Narek - Papyan Karen,76,44,32,-12,12,19,22,22,13,0,-3,-2,2,-9,0,-12,11:8 - 12:10 - 10:12 - 11:2 - 0:0
14654423,2023-10-17 11:15:00,Arutyunov Ruben - Nazaryan Mushegh,0:3,9:11 - 8:11 - 9:11 - 0:0 - 0:0,0,3,Arutyunov Ruben,Nazaryan Mushegh,fiurst,Arutyunov Ruben - Nazaryan Mushegh,59,26,33,7,-7,20,19,20,0,0,2,3,2,0,0,7,9:11 - 8:11 - 9:11 - 0:0 - 0:0
14654421,2023-10-17 10:50:00,Nikoghosyan Narek - Arutyunov Ruben,0:3,11:3 - 12:10 - 11:8 - 0:0 - 0:0,3,0,Nikoghosyan Narek,Arutyunov Ruben,fiurst,Arutyunov Ruben - Nikoghosyan Narek,55,21,34,13,-13,14,22,19,0,0,8,2,3,0,0,13,3:11 - 10:12 - 8:11 - 0:0 - 0:0
14654422,2023-10-17 10:50:00,Antonyan Eduard - Papyan Karen,3:1,11:13 - 11:6 - 11:8 - 11:9 - 0:0,3,1,Antonyan Eduard,Papyan Karen,fiurst,Antonyan Eduard - Papyan Karen,80,44,36,-8,8,24,17,19,20,0,2,-5,-3,-2,0,-8,11:13 - 11:6 - 11:8 - 11:9 - 0:0
14654420,2023-10-17 10:15:00,Papyan Karen - Nazaryan Mushegh,2:3,11:5 - 9:11 - 11:8 - 5:11 - 11:7,3,2,Papyan Karen,Nazaryan Mushegh,fiurst,Nazaryan Mushegh - Papyan Karen,89,42,47,5,-5,16,20,19,16,18,6,-2,3,-6,4,5,5:11 - 11:9 - 8:11 - 11:5 - 7:11
14654409,2023-10-17 10:00:00,Antonyan Eduard - Nikoghosyan Narek,0:0,0:0 - 0:0 - 0:0 - 0:0 - 0:0,0,0,Antonyan Eduard,Nikoghosyan Narek,fiurst,Antonyan Eduard - Nikoghosyan Narek,0,0,0,0,0,0,0,0,0,0,0,0,0,0,0,0,0:0 - 0:0 - 0:0 - 0:0 - 0:0
14636242,2023-10-16 17:30:00,Soghomonyan Hrayr - Petrosyan Davit,0:3,11:9 - 11:9 - 12:10 - 0:0 - 0:0,3,0,Soghomonyan Hrayr,Petrosyan Davit,fiurst,Petrosyan Davit - Soghomonyan Hrayr,62,28,34,6,-6,20,20,22,0,0,2,2,2,0,0,6,9:11 - 9:11 - 10:12 - 0:0 - 0:0
14636238,2023-10-16 17:20:00,Mkrtchyan Andranik - Gevorgyan Hayk,3:0,11:13 - 6:11 - 3:11 - 0:0 - 0:0,0,3,Mkrtchyan Andranik,Gevorgyan Hayk,fiurst,Gevorgyan Hayk - Mkrtchyan Andranik,55,35,20,-15,15,24,17,14,0,0,-2,-5,-8,0,0,-15,13:11 - 11:6 - 11:3 - 0:0 - 0:0
14636230,2023-10-16 17:00:00,Avakimyan Davit - Soghomonyan Hrayr,1:3,11:6 - 6:11 - 5:11 - 7:11 - 0:0,1,3,Avakimyan Davit,Soghomonyan Hrayr,fiurst,Avakimyan Davit - Soghomonyan Hrayr,68,29,39,10,-10,17,17,16,18,0,-5,5,6,4,0,10,11:6 - 6:11 - 5:11 - 7:11 - 0:0
14636222,2023-10-16 16:50:00,Mkrtchyan Andranik - Petrosyan Davit,1:3,11:9 - 6:11 - 8:11 - 10:12 - 0:0,1,3,Mkrtchyan Andranik,Petrosyan Davit,fiurst,Mkrtchyan Andranik - Petrosyan Davit,78,35,43,8,-8,20,17,19,22,0,-2,5,3,2,0,8,11:9 - 6:11 - 8:11 - 10:12 - 0:0
14636216,2023-10-16 16:30:00,Gevorgyan Hayk - Avakimyan Davit,2:3,6:11 - 11:8 - 7:11 - 11:5 - 11:9,3,2,Gevorgyan Hayk,Avakimyan Davit,fiurst,Avakimyan Davit - Gevorgyan Hayk,90,44,46,2,-2,17,19,18,16,20,-5,3,-4,6,2,2,11:6 - 8:11 - 11:7 - 5:11 - 9:11
14636215,2023-10-16 16:20:00,Soghomonyan Hrayr - Mkrtchyan Andranik,1:3,11:8 - 14:12 - 9:11 - 11:6 - 0:0,3,1,Soghomonyan Hrayr,Mkrtchyan Andranik,fiurst,Mkrtchyan Andranik - Soghomonyan Hrayr,82,37,45,8,-8,19,26,20,17,0,3,2,-2,5,0,8,8:11 - 12:14 - 11:9 - 6:11 - 0:0
14636212,2023-10-16 16:00:00,Petrosyan Davit - Avakimyan Davit,3:1,8:11 - 11:13 - 13:11 - 9:11 - 0:0,1,3,Petrosyan Davit,Avakimyan Davit,fiurst,Avakimyan Davit - Petrosyan Davit,87,46,41,-5,5,19,24,24,20,0,-3,-2,2,-2,0,-5,11:8 - 13:11 - 11:13 - 11:9 - 0:0
14636207,2023-10-16 15:45:00,Gevorgyan Hayk - Soghomonyan Hrayr,2:3,15:13 - 11:8 - 7:11 - 4:11 - 2:11,2,3,Gevorgyan Hayk,Soghomonyan Hrayr,fiurst,Gevorgyan Hayk - Soghomonyan Hrayr,93,39,54,15,-15,28,19,18,15,13,-2,-3,4,7,9,15,15:13 - 11:8 - 7:11 - 4:11 - 2:11
14636202,2023-10-16 15:30:00,Avakimyan Davit - Mkrtchyan Andranik,3:2,11:7 - 7:11 - 11:8 - 4:11 - 11:8,3,2,Avakimyan Davit,Mkrtchyan Andranik,fiurst,Avakimyan Davit - Mkrtchyan Andranik,89,44,45,1,-1,18,18,19,15,19,-4,4,-3,7,-3,1,11:7 - 7:11 - 11:8 - 4:11 - 11:8
14636194,2023-10-16 15:15:00,Petrosyan Davit - Gevorgyan Hayk,3:0,6:11 - 10:12 - 5:11 - 0:0 - 0:0,0,3,Petrosyan Davit,Gevorgyan Hayk,fiurst,Gevorgyan Hayk - Petrosyan Davit,55,34,21,-13,13,17,22,16,0,0,-5,-2,-6,0,0,-13,11:6 - 12:10 - 11:5 - 0:0 - 0:0
14636191,2023-10-16 15:00:00,Arutyunov Ruben - Nazaryan Mushegh,3:1,9:11 - 11:8 - 11:8 - 11:2 - 0:0,3,1,Arutyunov Ruben,Nazaryan Mushegh,fiurst,Arutyunov Ruben - Nazaryan Mushegh,71,42,29,-13,13,20,19,19,13,0,2,-3,-3,-9,0,-13,9:11 - 11:8 - 11:8 - 11:2 - 0:0
14636188,2023-10-16 14:55:00,Papyan Karen - Diaryan Aleksandr,3:1,12:10 - 12:14 - 4:11 - 8:11 - 0:0,1,3,Papyan Karen,Diaryan Aleksandr,fiurst,Diaryan Aleksandr - Papyan Karen,82,46,36,-10,10,22,26,15,19,0,2,-2,-7,-3,0,-10,10:12 - 14:12 - 11:4 - 11:8 - 0:0
14636181,2023-10-16 14:30:00,Rafayelyan Edgar - Arutyunov Ruben,0:3,11:7 - 11:6 - 11:5 - 0:0 - 0:0,3,0,Rafayelyan Edgar,Arutyunov Ruben,fiurst,Arutyunov Ruben - Rafayelyan Edgar,51,18,33,15,-15,18,17,16,0,0,4,5,6,0,0,15,7:11 - 6:11 - 5:11 - 0:0 - 0:0
14636179,2023-10-16 14:25:00,Nazaryan Mushegh - Papyan Karen,2:3,11:4 - 8:11 - 11:8 - 3:11 - 9:11,2,3,Nazaryan Mushegh,Papyan Karen,fiurst,Nazaryan Mushegh - Papyan Karen,87,42,45,3,-3,15,19,19,14,20,-7,3,-3,8,2,3,11:4 - 8:11 - 11:8 - 3:11 - 9:11
14636173,2023-10-16 14:00:00,Rafayelyan Edgar - Diaryan Aleksandr,3:0,5:11 - 9:11 - 4:11 - 0:0 - 0:0,0,3,Rafayelyan Edgar,Diaryan Aleksandr,fiurst,Diaryan Aleksandr - Rafayelyan Edgar,51,33,18,-15,15,16,20,15,0,0,-6,-2,-7,0,0,-15,11:5 - 11:9 - 11:4 - 0:0 - 0:0
14636166,2023-10-16 13:55:00,Arutyunov Ruben - Papyan Karen,0:3,11:13 - 7:11 - 9:11 - 0:0 - 0:0,0,3,Arutyunov Ruben,Papyan Karen,fiurst,Arutyunov Ruben - Papyan Karen,62,27,35,8,-8,24,18,20,0,0,2,4,2,0,0,8,11:13 - 7:11 - 9:11 - 0:0 - 0:0
14636162,2023-10-16 13:30:00,Nazaryan Mushegh - Rafayelyan Edgar,2:3,11:5 - 7:11 - 11:6 - 4:11 - 12:14,2,3,Nazaryan Mushegh,Rafayelyan Edgar,fiurst,Nazaryan Mushegh - Rafayelyan Edgar,92,45,47,2,-2,16,18,17,15,26,-6,4,-5,7,2,2,11:5 - 7:11 - 11:6 - 4:11 - 12:14
14636148,2023-10-16 13:15:00,Diaryan Aleksandr - Arutyunov Ruben,2:3,11:7 - 10:12 - 10:12 - 11:7 - 14:12,3,2,Diaryan Aleksandr,Arutyunov Ruben,fiurst,Arutyunov Ruben - Diaryan Aleksandr,106,50,56,6,-6,18,22,22,18,26,4,-2,-2,4,2,6,7:11 - 12:10 - 12:10 - 7:11 - 12:14
14636146,2023-10-16 13:00:00,Papyan Karen - Rafayelyan Edgar,3:2,6:11 - 5:11 - 14:12 - 11:8 - 11:5,3,2,Papyan Karen,Rafayelyan Edgar,fiurst,Papyan Karen - Rafayelyan Edgar,94,47,47,0,0,17,16,26,19,16,5,6,-2,-3,-6,0,6:11 - 5:11 - 14:12 - 11:8 - 11:5
14636141,2023-10-16 12:45:00,Diaryan Aleksandr - Nazaryan Mushegh,3:0,11:5 - 11:2 - 11:5 - 0:0 - 0:0,3,0,Diaryan Aleksandr,Nazaryan Mushegh,fiurst,Diaryan Aleksandr - Nazaryan Mushegh,45,33,12,-21,21,16,13,16,0,0,-6,-9,-6,0,0,-21,11:5 - 11:2 - 11:5 - 0:0 - 0:0
14636137,2023-10-16 12:25:00,Arutyunov Ruben - Rafayelyan Edgar,1:3,6:11 - 11:8 - 6:11 - 7:11 - 0:0,1,3,Arutyunov Ruben,Rafayelyan Edgar,fiurst,Arutyunov Ruben - Rafayelyan Edgar,71,30,41,11,-11,17,19,17,18,0,5,-3,5,4,0,11,6:11 - 11:8 - 6:11 - 7:11 - 0:0
14636132,2023-10-16 12:00:00,Diaryan Aleksandr - Papyan Karen,3:1,11:7 - 6:11 - 11:8 - 11:4 - 0:0,3,1,Diaryan Aleksandr,Papyan Karen,fiurst,Diaryan Aleksandr - Papyan Karen,69,39,30,-9,9,18,17,19,15,0,-4,5,-3,-7,0,-9,11:7 - 6:11 - 11:8 - 11:4 - 0:0
14636119,2023-10-16 11:45:00,Nazaryan Mushegh - Arutyunov Ruben,1:3,11:9 - 14:12 - 9:11 - 11:6 - 0:0,3,1,Nazaryan Mushegh,Arutyunov Ruben,fiurst,Arutyunov Ruben - Nazaryan Mushegh,83,38,45,7,-7,20,26,20,17,0,2,2,-2,5,0,7,9:11 - 12:14 - 11:9 - 6:11 - 0:0
14636106,2023-10-16 11:35:00,Diaryan Aleksandr - Rafayelyan Edgar,0:3,11:13 - 7:11 - 5:11 - 0:0 - 0:0,0,3,Diaryan Aleksandr,Rafayelyan Edgar,fiurst,Diaryan Aleksandr - Rafayelyan Edgar,58,23,35,12,-12,24,18,16,0,0,2,4,6,0,0,12,11:13 - 7:11 - 5:11 - 0:0 - 0:0
14636104,2023-10-16 11:20:00,Papyan Karen - Nazaryan Mushegh,0:3,11:5 - 11:5 - 11:9 - 0:0 - 0:0,3,0,Papyan Karen,Nazaryan Mushegh,fiurst,Nazaryan Mushegh - Papyan Karen,52,19,33,14,-14,16,16,20,0,0,6,6,2,0,0,14,5:11 - 5:11 - 9:11 - 0:0 - 0:0
14636100,2023-10-16 11:10:00,Arutyunov Ruben - Diaryan Aleksandr,1:3,16:14 - 8:11 - 3:11 - 7:11 - 0:0,1,3,Arutyunov Ruben,Diaryan Aleksandr,fiurst,Arutyunov Ruben - Diaryan Aleksandr,81,34,47,13,-13,30,19,14,18,0,-2,3,8,4,0,13,16:14 - 8:11 - 3:11 - 7:11 - 0:0
14636093,2023-10-16 10:45:00,Rafayelyan Edgar - Nazaryan Mushegh,3:1,6:11 - 11:5 - 14:16 - 11:13 - 0:0,1,3,Rafayelyan Edgar,Nazaryan Mushegh,fiurst,Nazaryan Mushegh - Rafayelyan Edgar,87,45,42,-3,3,17,16,30,24,0,-5,6,-2,-2,0,-3,11:6 - 5:11 - 16:14 - 13:11 - 0:0
14636092,2023-10-16 10:30:00,Papyan Karen - Arutyunov Ruben,3:2,9:11 - 11:7 - 9:11 - 12:10 - 10:12,2,3,Papyan Karen,Arutyunov Ruben,fiurst,Arutyunov Ruben - Papyan Karen,102,51,51,0,0,20,18,20,22,22,-2,4,-2,2,-2,0,11:9 - 7:11 - 11:9 - 10:12 - 12:10
14636081,2023-10-16 10:15:00,Nazaryan Mushegh - Diaryan Aleksandr,3:0,8:11 - 9:11 - 5:11 - 0:0 - 0:0,0,3,Nazaryan Mushegh,Diaryan Aleksandr,fiurst,Diaryan Aleksandr - Nazaryan Mushegh,55,33,22,-11,11,19,20,16,0,0,-3,-2,-6,0,0,-11,11:8 - 11:9 - 11:5 - 0:0 - 0:0
14636080,2023-10-16 10:00:00,Rafayelyan Edgar - Papyan Karen,1:3,11:5 - 6:11 - 13:11 - 11:8 - 0:0,3,1,Rafayelyan Edgar,Papyan Karen,fiurst,Papyan Karen - Rafayelyan Edgar,76,35,41,6,-6,16,17,24,19,0,6,-5,2,3,0,6,5:11 - 11:6 - 11:13 - 8:11 - 0:0
14615891,2023-10-15 17:50:00,Grigoryan Erik - Darbinyan Armen,0:3,11:7 - 11:5 - 11:4 - 0:0 - 0:0,3,0,Grigoryan Erik,Darbinyan Armen,fiurst,Darbinyan Armen - Grigoryan Erik,49,16,33,17,-17,18,16,15,0,0,4,6,7,0,0,17,7:11 - 5:11 - 4:11 - 0:0 - 0:0
14615887,2023-10-15 17:20:00,Gevorgyan Hayk - Grigoryan Erik,2:3,11:9 - 7:11 - 9:11 - 11:5 - 9:11,2,3,Gevorgyan Hayk,Grigoryan Erik,fiurst,Gevorgyan Hayk - Grigoryan Erik,94,47,47,0,0,20,18,20,16,20,-2,4,2,-6,2,0,11:9 - 7:11 - 9:11 - 11:5 - 9:11
14615888,2023-10-15 17:15:00,Petrosyan Davit - Soghomonyan Hrayr,3:1,7:11 - 11:5 - 11:6 - 11:4 - 0:0,3,1,Petrosyan Davit,Soghomonyan Hrayr,fiurst,Petrosyan Davit - Soghomonyan Hrayr,66,40,26,-14,14,18,16,17,15,0,4,-6,-5,-7,0,-14,7:11 - 11:5 - 11:6 - 11:4 - 0:0
14615874,2023-10-15 17:00:00,Soghomonyan Hrayr - Gevorgyan Hayk,0:3,11:6 - 11:8 - 11:4 - 0:0 - 0:0,3,0,Soghomonyan Hrayr,Gevorgyan Hayk,fiurst,Gevorgyan Hayk - Soghomonyan Hrayr,51,18,33,15,-15,17,19,15,0,0,5,3,7,0,0,15,6:11 - 8:11 - 4:11 - 0:0 - 0:0
14615876,2023-10-15 17:00:00,Petrosyan Davit - Darbinyan Armen,1:3,11:5 - 11:4 - 12:14 - 11:6 - 0:0,3,1,Petrosyan Davit,Darbinyan Armen,fiurst,Darbinyan Armen - Petrosyan Davit,74,29,45,16,-16,16,15,26,17,0,6,7,-2,5,0,16,5:11 - 4:11 - 14:12 - 6:11 - 0:0
14615855,2023-10-15 16:30:00,Darbinyan Armen - Gevorgyan Hayk,2:3,11:9 - 9:11 - 5:11 - 11:9 - 6:11,2,3,Darbinyan Armen,Gevorgyan Hayk,fiurst,Darbinyan Armen - Gevorgyan Hayk,93,42,51,9,-9,20,20,16,20,17,-2,2,6,-2,5,9,11:9 - 9:11 - 5:11 - 11:9 - 6:11
14615872,2023-10-15 16:30:00,Grigoryan Erik - Petrosyan Davit,2:3,11:8 - 4:11 - 12:10 - 5:11 - 9:11,2,3,Grigoryan Erik,Petrosyan Davit,fiurst,Grigoryan Erik - Petrosyan Davit,92,41,51,10,-10,19,15,22,16,20,-3,7,-2,6,2,10,11:8 - 4:11 - 12:10 - 5:11 - 9:11
14615850,2023-10-15 16:00:00,Gevorgyan Hayk - Petrosyan Davit,2:3,11:4 - 10:12 - 11:5 - 9:11 - 3:11,2,3,Gevorgyan Hayk,Petrosyan Davit,fiurst,Gevorgyan Hayk - Petrosyan Davit,87,44,43,-1,1,15,22,16,20,14,-7,2,-6,2,8,-1,11:4 - 10:12 - 11:5 - 9:11 - 3:11
14615853,2023-10-15 15:45:00,Soghomonyan Hrayr - Grigoryan Erik,2:3,11:9 - 11:8 - 9:11 - 11:13 - 11:8,3,2,Soghomonyan Hrayr,Grigoryan Erik,fiurst,Grigoryan Erik - Soghomonyan Hrayr,102,49,53,4,-4,20,19,20,24,19,2,3,-2,-2,3,4,9:11 - 8:11 - 11:9 - 13:11 - 8:11
14615840,2023-10-15 15:30:00,Rafayelyan Edgar - Diaryan Aleksandr,2:3,7:11 - 11:8 - 11:13 - 11:9 - 11:9,3,2,Rafayelyan Edgar,Diaryan Aleksandr,fiurst,Diaryan Aleksandr - Rafayelyan Edgar,101,50,51,1,-1,18,19,24,20,20,-4,3,-2,2,2,1,11:7 - 8:11 - 13:11 - 9:11 - 9:11
14615846,2023-10-15 15:15:00,Darbinyan Armen - Soghomonyan Hrayr,1:3,11:8 - 6:11 - 8:11 - 6:11 - 0:0,1,3,Darbinyan Armen,Soghomonyan Hrayr,fiurst,Darbinyan Armen - Soghomonyan Hrayr,72,31,41,10,-10,19,17,19,17,0,-3,5,3,5,0,10,11:8 - 6:11 - 8:11 - 6:11 - 0:0
14615833,2023-10-15 14:55:00,Nikoghosyan Narek - Rafayelyan Edgar,3:1,12:10 - 11:8 - 9:11 - 11:8 - 0:0,3,1,Nikoghosyan Narek,Rafayelyan Edgar,fiurst,Nikoghosyan Narek - Rafayelyan Edgar,80,43,37,-6,6,22,19,20,19,0,-2,-3,2,-3,0,-6,12:10 - 11:8 - 9:11 - 11:8 - 0:0
14615835,2023-10-15 14:45:00,Nazaryan Mushegh - Antonyan Eduard,3:1,8:11 - 8:11 - 11:8 - 7:11 - 0:0,1,3,Nazaryan Mushegh,Antonyan Eduard,fiurst,Antonyan Eduard - Nazaryan Mushegh,75,41,34,-7,7,19,19,19,18,0,-3,-3,3,-4,0,-7,11:8 - 11:8 - 8:11 - 11:7 - 0:0
14615832,2023-10-15 14:15:00,Diaryan Aleksandr - Nazaryan Mushegh,3:1,11:6 - 9:11 - 11:4 - 11:5 - 0:0,3,1,Diaryan Aleksandr,Nazaryan Mushegh,fiurst,Diaryan Aleksandr - Nazaryan Mushegh,68,42,26,-16,16,17,20,15,16,0,-5,2,-7,-6,0,-16,11:6 - 9:11 - 11:4 - 11:5 - 0:0
14615821,2023-10-15 14:10:00,Nikoghosyan Narek - Antonyan Eduard,2:3,9:11 - 11:9 - 11:9 - 9:11 - 12:10,3,2,Nikoghosyan Narek,Antonyan Eduard,fiurst,Antonyan Eduard - Nikoghosyan Narek,102,50,52,2,-2,20,20,20,20,22,-2,2,2,-2,2,2,11:9 - 9:11 - 9:11 - 11:9 - 10:12
14615818,2023-10-15 13:50:00,Rafayelyan Edgar - Nazaryan Mushegh,0:3,11:3 - 11:9 - 11:1 - 0:0 - 0:0,3,0,Rafayelyan Edgar,Nazaryan Mushegh,fiurst,Nazaryan Mushegh - Rafayelyan Edgar,46,13,33,20,-20,14,20,12,0,0,8,2,10,0,0,20,3:11 - 9:11 - 1:11 - 0:0 - 0:0
14615814,2023-10-15 13:30:00,Diaryan Aleksandr - Nikoghosyan Narek,0:3,7:11 - 8:11 - 12:14 - 0:0 - 0:0,0,3,Diaryan Aleksandr,Nikoghosyan Narek,fiurst,Diaryan Aleksandr - Nikoghosyan Narek,63,27,36,9,-9,18,19,26,0,0,4,3,2,0,0,9,7:11 - 8:11 - 12:14 - 0:0 - 0:0
14615808,2023-10-15 13:20:00,Antonyan Eduard - Rafayelyan Edgar,0:3,9:11 - 9:11 - 7:11 - 0:0 - 0:0,0,3,Antonyan Eduard,Rafayelyan Edgar,fiurst,Antonyan Eduard - Rafayelyan Edgar,58,25,33,8,-8,20,20,18,0,0,2,2,4,0,0,8,9:11 - 9:11 - 7:11 - 0:0 - 0:0
14615805,2023-10-15 13:10:00,Nazaryan Mushegh - Nikoghosyan Narek,1:3,11:8 - 6:11 - 6:11 - 12:14 - 0:0,1,3,Nazaryan Mushegh,Nikoghosyan Narek,fiurst,Nazaryan Mushegh - Nikoghosyan Narek,79,35,44,9,-9,19,17,17,26,0,-3,5,5,2,0,9,11:8 - 6:11 - 6:11 - 12:14 - 0:0
14615798,2023-10-15 12:55:00,Antonyan Eduard - Diaryan Aleksandr,3:0,11:9 - 11:6 - 11:7 - 0:0 - 0:0,3,0,Antonyan Eduard,Diaryan Aleksandr,fiurst,Antonyan Eduard - Diaryan Aleksandr,55,33,22,-11,11,20,17,18,0,0,-2,-5,-4,0,0,-11,11:9 - 11:6 - 11:7 - 0:0 - 0:0
14615796,2023-10-15 12:25:00,Rafayelyan Edgar - Nikoghosyan Narek,3:2,11:6 - 5:11 - 11:6 - 6:11 - 8:11,2,3,Rafayelyan Edgar,Nikoghosyan Narek,fiurst,Nikoghosyan Narek - Rafayelyan Edgar,86,45,41,-4,4,17,16,17,17,19,5,-6,5,-5,-3,-4,6:11 - 11:5 - 6:11 - 11:6 - 11:8
14615793,2023-10-15 12:00:00,Antonyan Eduard - Nazaryan Mushegh,3:1,11:9 - 11:9 - 6:11 - 11:8 - 0:0,3,1,Antonyan Eduard,Nazaryan Mushegh,fiurst,Antonyan Eduard - Nazaryan Mushegh,76,39,37,-2,2,20,20,17,19,0,-2,-2,5,-3,0,-2,11:9 - 11:9 - 6:11 - 11:8 - 0:0
14615782,2023-10-15 11:45:00,Diaryan Aleksandr - Rafayelyan Edgar,2:3,10:12 - 11:8 - 11:8 - 9:11 - 9:11,2,3,Diaryan Aleksandr,Rafayelyan Edgar,fiurst,Diaryan Aleksandr - Rafayelyan Edgar,100,50,50,0,0,22,19,19,20,20,2,-3,-3,2,2,0,10:12 - 11:8 - 11:8 - 9:11 - 9:11
14615781,2023-10-15 11:30:00,Antonyan Eduard - Nikoghosyan Narek,0:3,4:11 - 5:11 - 9:11 - 0:0 - 0:0,0,3,Antonyan Eduard,Nikoghosyan Narek,fiurst,Antonyan Eduard - Nikoghosyan Narek,51,18,33,15,-15,15,16,20,0,0,7,6,2,0,0,15,4:11 - 5:11 - 9:11 - 0:0 - 0:0
14615779,2023-10-15 11:15:00,Nazaryan Mushegh - Diaryan Aleksandr,1:3,11:9 - 9:11 - 11:5 - 11:9 - 0:0,3,1,Nazaryan Mushegh,Diaryan Aleksandr,fiurst,Diaryan Aleksandr - Nazaryan Mushegh,76,34,42,8,-8,20,20,16,20,0,2,-2,6,2,0,8,9:11 - 11:9 - 5:11 - 9:11 - 0:0
14615778,2023-10-15 11:00:00,Rafayelyan Edgar - Antonyan Eduard,1:3,6:11 - 11:8 - 11:7 - 11:6 - 0:0,3,1,Rafayelyan Edgar,Antonyan Eduard,fiurst,Antonyan Eduard - Rafayelyan Edgar,71,32,39,7,-7,17,19,18,17,0,-5,3,4,5,0,7,11:6 - 8:11 - 7:11 - 6:11 - 0:0
14615775,2023-10-15 10:50:00,Nikoghosyan Narek - Diaryan Aleksandr,1:3,11:9 - 6:11 - 13:11 - 11:8 - 0:0,3,1,Nikoghosyan Narek,Diaryan Aleksandr,fiurst,Diaryan Aleksandr - Nikoghosyan Narek,80,39,41,2,-2,20,17,24,19,0,2,-5,2,3,0,2,9:11 - 11:6 - 11:13 - 8:11 - 0:0
14615774,2023-10-15 10:30:00,Nazaryan Mushegh - Rafayelyan Edgar,1:3,9:11 - 11:1 - 8:11 - 9:11 - 0:0,1,3,Nazaryan Mushegh,Rafayelyan Edgar,fiurst,Nazaryan Mushegh - Rafayelyan Edgar,71,37,34,-3,3,20,12,19,20,0,2,-10,3,2,0,-3,9:11 - 11:1 - 8:11 - 9:11 - 0:0
14615768,2023-10-15 10:15:00,Diaryan Aleksandr - Antonyan Eduard,2:3,9:11 - 7:11 - 11:9 - 11:6 - 11:4,3,2,Diaryan Aleksandr,Antonyan Eduard,fiurst,Antonyan Eduard - Diaryan Aleksandr,90,41,49,8,-8,20,18,20,17,15,-2,-4,2,5,7,8,11:9 - 11:7 - 9:11 - 6:11 - 4:11
14615760,2023-10-15 10:00:00,Nikoghosyan Narek - Nazaryan Mushegh,1:3,11:8 - 11:6 - 8:11 - 11:8 - 0:0,3,1,Nikoghosyan Narek,Nazaryan Mushegh,fiurst,Nazaryan Mushegh - Nikoghosyan Narek,74,33,41,8,-8,19,17,19,19,0,3,5,-3,3,0,8,8:11 - 6:11 - 11:8 - 8:11 - 0:0
14598028,2023-10-14 17:30:00,Soghomonyan Hrayr - Gevorgyan Hayk,0:3,11:7 - 11:9 - 11:9 - 0:0 - 0:0,3,0,Soghomonyan Hrayr,Gevorgyan Hayk,fiurst,Gevorgyan Hayk - Soghomonyan Hrayr,58,25,33,8,-8,18,20,20,0,0,4,2,2,0,0,8,7:11 - 9:11 - 9:11 - 0:0 - 0:0
14598024,2023-10-14 17:15:00,Avakimyan Davit - Darbinyan Armen,1:3,5:11 - 9:11 - 11:9 - 4:11 - 0:0,1,3,Avakimyan Davit,Darbinyan Armen,fiurst,Avakimyan Davit - Darbinyan Armen,71,29,42,13,-13,16,20,20,15,0,6,2,-2,7,0,13,5:11 - 9:11 - 11:9 - 4:11 - 0:0
14598010,2023-10-14 17:00:00,Mkrtchyan Andranik - Soghomonyan Hrayr,1:3,4:11 - 11:8 - 3:11 - 8:11 - 0:0,1,3,Mkrtchyan Andranik,Soghomonyan Hrayr,fiurst,Mkrtchyan Andranik - Soghomonyan Hrayr,67,26,41,15,-15,15,19,14,19,0,7,-3,8,3,0,15,4:11 - 11:8 - 3:11 - 8:11 - 0:0
14598006,2023-10-14 16:45:00,Avakimyan Davit - Gevorgyan Hayk,0:3,6:11 - 3:11 - 4:11 - 0:0 - 0:0,0,3,Avakimyan Davit,Gevorgyan Hayk,fiurst,Avakimyan Davit - Gevorgyan Hayk,46,13,33,20,-20,17,14,15,0,0,5,8,7,0,0,20,6:11 - 3:11 - 4:11 - 0:0 - 0:0
14597990,2023-10-14 16:30:00,Darbinyan Armen - Mkrtchyan Andranik,0:3,6:11 - 7:11 - 7:11 - 0:0 - 0:0,0,3,Darbinyan Armen,Mkrtchyan Andranik,fiurst,Darbinyan Armen - Mkrtchyan Andranik,53,20,33,13,-13,17,18,18,0,0,5,4,4,0,0,13,6:11 - 7:11 - 7:11 - 0:0 - 0:0
14597986,2023-10-14 16:15:00,Soghomonyan Hrayr - Avakimyan Davit,0:3,11:5 - 11:7 - 11:4 - 0:0 - 0:0,3,0,Soghomonyan Hrayr,Avakimyan Davit,fiurst,Avakimyan Davit - Soghomonyan Hrayr,49,16,33,17,-17,16,18,15,0,0,6,4,7,0,0,17,5:11 - 7:11 - 4:11 - 0:0 - 0:0
14597981,2023-10-14 16:00:00,Gevorgyan Hayk - Mkrtchyan Andranik,1:3,8:11 - 4:11 - 11:9 - 8:11 - 0:0,1,3,Gevorgyan Hayk,Mkrtchyan Andranik,fiurst,Gevorgyan Hayk - Mkrtchyan Andranik,73,31,42,11,-11,19,15,20,19,0,3,7,-2,3,0,11,8:11 - 4:11 - 11:9 - 8:11 - 0:0
14597928,2023-10-14 15:45:00,Darbinyan Armen - Soghomonyan Hrayr,0:3,2:11 - 10:12 - 5:11 - 0:0 - 0:0,0,3,Darbinyan Armen,Soghomonyan Hrayr,fiurst,Darbinyan Armen - Soghomonyan Hrayr,51,17,34,17,-17,13,22,16,0,0,9,2,6,0,0,17,2:11 - 10:12 - 5:11 - 0:0 - 0:0
14597921,2023-10-14 15:30:00,Mkrtchyan Andranik - Avakimyan Davit,0:3,11:5 - 13:11 - 11:9 - 0:0 - 0:0,3,0,Mkrtchyan Andranik,Avakimyan Davit,fiurst,Avakimyan Davit - Mkrtchyan Andranik,60,25,35,10,-10,16,24,20,0,0,6,2,2,0,0,10,5:11 - 11:13 - 9:11 - 0:0 - 0:0
14597900,2023-10-14 15:15:00,Gevorgyan Hayk - Darbinyan Armen,0:3,11:6 - 11:5 - 11:5 - 0:0 - 0:0,3,0,Gevorgyan Hayk,Darbinyan Armen,fiurst,Darbinyan Armen - Gevorgyan Hayk,49,16,33,17,-17,17,16,16,0,0,5,6,6,0,0,17,6:11 - 5:11 - 5:11 - 0:0 - 0:0
14597887,2023-10-14 15:05:00,Antonyan Eduard - Nikoghosyan Narek,3:1,11:7 - 6:11 - 11:8 - 11:7 - 0:0,3,1,Antonyan Eduard,Nikoghosyan Narek,fiurst,Antonyan Eduard - Nikoghosyan Narek,72,39,33,-6,6,18,17,19,18,0,-4,5,-3,-4,0,-6,11:7 - 6:11 - 11:8 - 11:7 - 0:0
14597879,2023-10-14 14:45:00,Rafayelyan Edgar - Arutyunov Ruben,1:3,10:12 - 11:8 - 11:5 - 11:6 - 0:0,3,1,Rafayelyan Edgar,Arutyunov Ruben,fiurst,Arutyunov Ruben - Rafayelyan Edgar,74,31,43,12,-12,22,19,16,17,0,-2,3,6,5,0,12,12:10 - 8:11 - 5:11 - 6:11 - 0:0
14597867,2023-10-14 14:35:00,Papyan Karen - Antonyan Eduard,3:2,10:12 - 11:9 - 11:9 - 15:17 - 3:11,2,3,Papyan Karen,Antonyan Eduard,fiurst,Antonyan Eduard - Papyan Karen,108,58,50,-8,8,22,20,20,32,14,-2,2,2,-2,-8,-8,12:10 - 9:11 - 9:11 - 17:15 - 11:3
14597843,2023-10-14 14:20:00,Nikoghosyan Narek - Rafayelyan Edgar,2:3,11:9 - 14:12 - 5:11 - 7:11 - 3:11,2,3,Nikoghosyan Narek,Rafayelyan Edgar,fiurst,Nikoghosyan Narek - Rafayelyan Edgar,94,40,54,14,-14,20,26,16,18,14,-2,-2,6,4,8,14,11:9 - 14:12 - 5:11 - 7:11 - 3:11
14597812,2023-10-14 14:10:00,Papyan Karen - Arutyunov Ruben,0:3,11:9 - 12:10 - 11:6 - 0:0 - 0:0,3,0,Papyan Karen,Arutyunov Ruben,fiurst,Arutyunov Ruben - Papyan Karen,59,25,34,9,-9,20,22,17,0,0,2,2,5,0,0,9,9:11 - 10:12 - 6:11 - 0:0 - 0:0
14597807,2023-10-14 13:55:00,Antonyan Eduard - Rafayelyan Edgar,0:3,10:12 - 8:11 - 7:11 - 0:0 - 0:0,0,3,Antonyan Eduard,Rafayelyan Edgar,fiurst,Antonyan Eduard - Rafayelyan Edgar,59,25,34,9,-9,22,19,18,0,0,2,3,4,0,0,9,10:12 - 8:11 - 7:11 - 0:0 - 0:0
14597802,2023-10-14 13:35:00,Nikoghosyan Narek - Papyan Karen,3:0,11:6 - 11:8 - 11:4 - 0:0 - 0:0,3,0,Nikoghosyan Narek,Papyan Karen,fiurst,Nikoghosyan Narek - Papyan Karen,51,33,18,-15,15,17,19,15,0,0,-5,-3,-7,0,0,-15,11:6 - 11:8 - 11:4 - 0:0 - 0:0
14597787,2023-10-14 13:25:00,Arutyunov Ruben - Antonyan Eduard,3:1,9:11 - 6:11 - 11:3 - 7:11 - 0:0,1,3,Arutyunov Ruben,Antonyan Eduard,fiurst,Antonyan Eduard - Arutyunov Ruben,69,36,33,-3,3,20,17,14,18,0,-2,-5,8,-4,0,-3,11:9 - 11:6 - 3:11 - 11:7 - 0:0
14597451,2023-10-14 13:00:00,Rafayelyan Edgar - Papyan Karen,1:3,9:11 - 11:6 - 11:8 - 11:7 - 0:0,3,1,Rafayelyan Edgar,Papyan Karen,fiurst,Papyan Karen - Rafayelyan Edgar,74,32,42,10,-10,20,17,19,18,0,-2,5,3,4,0,10,11:9 - 6:11 - 8:11 - 7:11 - 0:0
14597448,2023-10-14 12:50:00,Arutyunov Ruben - Nikoghosyan Narek,3:2,11:6 - 6:11 - 11:6 - 5:11 - 11:4,3,2,Arutyunov Ruben,Nikoghosyan Narek,fiurst,Arutyunov Ruben - Nikoghosyan Narek,82,44,38,-6,6,17,17,17,16,15,-5,5,-5,6,-7,-6,11:6 - 6:11 - 11:6 - 5:11 - 11:4
14597446,2023-10-14 12:15:00,Antonyan Eduard - Papyan Karen,3:1,11:6 - 19:21 - 11:9 - 11:3 - 0:0,3,1,Antonyan Eduard,Papyan Karen,fiurst,Antonyan Eduard - Papyan Karen,91,52,39,-13,13,17,40,20,14,0,-5,2,-2,-8,0,-13,11:6 - 19:21 - 11:9 - 11:3 - 0:0
14597445,2023-10-14 12:00:00,Arutyunov Ruben - Rafayelyan Edgar,3:2,11:9 - 4:11 - 12:10 - 7:11 - 11:6,3,2,Arutyunov Ruben,Rafayelyan Edgar,fiurst,Arutyunov Ruben - Rafayelyan Edgar,92,45,47,2,-2,20,15,22,18,17,-2,7,-2,4,-5,2,11:9 - 4:11 - 12:10 - 7:11 - 11:6
14597444,2023-10-14 11:45:00,Nikoghosyan Narek - Antonyan Eduard,1:3,11:8 - 11:5 - 7:11 - 11:9 - 0:0,3,1,Nikoghosyan Narek,Antonyan Eduard,fiurst,Antonyan Eduard - Nikoghosyan Narek,73,33,40,7,-7,19,16,18,20,0,3,6,-4,2,0,7,8:11 - 5:11 - 11:7 - 9:11 - 0:0
14597433,2023-10-14 11:40:00,Arutyunov Ruben - Papyan Karen,0:3,5:11 - 7:11 - 6:11 - 0:0 - 0:0,0,3,Arutyunov Ruben,Papyan Karen,fiurst,Arutyunov Ruben - Papyan Karen,51,18,33,15,-15,16,18,17,0,0,6,4,5,0,0,15,5:11 - 7:11 - 6:11 - 0:0 - 0:0
14597431,2023-10-14 11:15:00,Rafayelyan Edgar - Nikoghosyan Narek,1:3,11:7 - 13:11 - 4:11 - 13:11 - 0:0,3,1,Rafayelyan Edgar,Nikoghosyan Narek,fiurst,Nikoghosyan Narek - Rafayelyan Edgar,81,40,41,1,-1,18,24,15,24,0,4,2,-7,2,0,1,7:11 - 11:13 - 11:4 - 11:13 - 0:0
14597428,2023-10-14 11:00:00,Antonyan Eduard - Arutyunov Ruben,3:1,6:11 - 11:9 - 11:5 - 11:8 - 0:0,3,1,Antonyan Eduard,Arutyunov Ruben,fiurst,Antonyan Eduard - Arutyunov Ruben,72,39,33,-6,6,17,20,16,19,0,5,-2,-6,-3,0,-6,6:11 - 11:9 - 11:5 - 11:8 - 0:0
14597421,2023-10-14 10:45:00,Papyan Karen - Nikoghosyan Narek,3:2,8:11 - 7:11 - 11:8 - 11:4 - 4:11,2,3,Papyan Karen,Nikoghosyan Narek,fiurst,Nikoghosyan Narek - Papyan Karen,86,45,41,-4,4,19,18,19,15,15,-3,-4,3,7,-7,-4,11:8 - 11:7 - 8:11 - 4:11 - 11:4
14597420,2023-10-14 10:40:00,Rafayelyan Edgar - Antonyan Eduard,3:0,10:12 - 8:11 - 8:11 - 0:0 - 0:0,0,3,Rafayelyan Edgar,Antonyan Eduard,fiurst,Antonyan Eduard - Rafayelyan Edgar,60,34,26,-8,8,22,19,19,0,0,-2,-3,-3,0,0,-8,12:10 - 11:8 - 11:8 - 0:0 - 0:0
14597418,2023-10-14 10:15:00,Nikoghosyan Narek - Arutyunov Ruben,3:0,8:11 - 7:11 - 9:11 - 0:0 - 0:0,0,3,Nikoghosyan Narek,Arutyunov Ruben,fiurst,Arutyunov Ruben - Nikoghosyan Narek,57,33,24,-9,9,19,18,20,0,0,-3,-4,-2,0,0,-9,11:8 - 11:7 - 11:9 - 0:0 - 0:0
14597405,2023-10-14 10:00:00,Papyan Karen - Rafayelyan Edgar,2:3,11:8 - 11:8 - 12:14 - 15:17 - 2:11,2,3,Papyan Karen,Rafayelyan Edgar,fiurst,Papyan Karen - Rafayelyan Edgar,109,51,58,7,-7,19,19,26,32,13,-3,-3,2,2,9,7,11:8 - 11:8 - 12:14 - 15:17 - 2:11
14578294,2023-10-13 17:30:00,Darbinyan Armen - Soghomonyan Hrayr,1:3,17:15 - 6:11 - 7:11 - 2:11 - 0:0,1,3,Darbinyan Armen,Soghomonyan Hrayr,fiurst,Darbinyan Armen - Soghomonyan Hrayr,80,32,48,16,-16,32,17,18,13,0,-2,5,4,9,0,16,17:15 - 6:11 - 7:11 - 2:11 - 0:0
14578290,2023-10-13 17:15:00,Avakimyan Davit - Mkrtchyan Andranik,2:3,3:11 - 11:4 - 11:9 - 12:14 - 5:11,2,3,Avakimyan Davit,Mkrtchyan Andranik,fiurst,Avakimyan Davit - Mkrtchyan Andranik,91,42,49,7,-7,14,15,20,26,16,8,-7,-2,2,6,7,3:11 - 11:4 - 11:9 - 12:14 - 5:11
14578288,2023-10-13 17:00:00,Petrosyan Davit - Darbinyan Armen,0:3,11:4 - 11:3 - 11:2 - 0:0 - 0:0,3,0,Petrosyan Davit,Darbinyan Armen,fiurst,Darbinyan Armen - Petrosyan Davit,42,9,33,24,-24,15,14,13,0,0,7,8,9,0,0,24,4:11 - 3:11 - 2:11 - 0:0 - 0:0
14578284,2023-10-13 16:45:00,Avakimyan Davit - Soghomonyan Hrayr,1:3,6:11 - 11:8 - 6:11 - 2:11 - 0:0,1,3,Avakimyan Davit,Soghomonyan Hrayr,fiurst,Avakimyan Davit - Soghomonyan Hrayr,66,25,41,16,-16,17,19,17,13,0,5,-3,5,9,0,16,6:11 - 11:8 - 6:11 - 2:11 - 0:0
14578283,2023-10-13 16:30:00,Mkrtchyan Andranik - Petrosyan Davit,3:1,10:12 - 11:5 - 11:8 - 11:6 - 0:0,3,1,Mkrtchyan Andranik,Petrosyan Davit,fiurst,Mkrtchyan Andranik - Petrosyan Davit,74,43,31,-12,12,22,16,19,17,0,2,-6,-3,-5,0,-12,10:12 - 11:5 - 11:8 - 11:6 - 0:0
14578280,2023-10-13 16:15:00,Darbinyan Armen - Avakimyan Davit,3:1,11:7 - 5:11 - 8:11 - 6:11 - 0:0,1,3,Darbinyan Armen,Avakimyan Davit,fiurst,Avakimyan Davit - Darbinyan Armen,70,40,30,-10,10,18,16,19,17,0,4,-6,-3,-5,0,-10,7:11 - 11:5 - 11:8 - 11:6 - 0:0
14578275,2023-10-13 16:00:00,Soghomonyan Hrayr - Petrosyan Davit,0:3,11:9 - 12:10 - 13:11 - 0:0 - 0:0,3,0,Soghomonyan Hrayr,Petrosyan Davit,fiurst,Petrosyan Davit - Soghomonyan Hrayr,66,30,36,6,-6,20,22,24,0,0,2,2,2,0,0,6,9:11 - 10:12 - 11:13 - 0:0 - 0:0
14578268,2023-10-13 15:45:00,Mkrtchyan Andranik - Darbinyan Armen,0:3,11:4 - 11:3 - 11:6 - 0:0 - 0:0,3,0,Mkrtchyan Andranik,Darbinyan Armen,fiurst,Darbinyan Armen - Mkrtchyan Andranik,46,13,33,20,-20,15,14,17,0,0,7,8,5,0,0,20,4:11 - 3:11 - 6:11 - 0:0 - 0:0
14578266,2023-10-13 15:30:00,Petrosyan Davit - Avakimyan Davit,3:1,12:10 - 9:11 - 8:11 - 9:11 - 0:0,1,3,Petrosyan Davit,Avakimyan Davit,fiurst,Avakimyan Davit - Petrosyan Davit,81,43,38,-5,5,22,20,19,20,0,2,-2,-3,-2,0,-5,10:12 - 11:9 - 11:8 - 11:9 - 0:0
14578258,2023-10-13 15:15:00,Soghomonyan Hrayr - Mkrtchyan Andranik,1:3,11:3 - 11:5 - 10:12 - 11:4 - 0:0,3,1,Soghomonyan Hrayr,Mkrtchyan Andranik,fiurst,Mkrtchyan Andranik - Soghomonyan Hrayr,67,24,43,19,-19,14,16,22,15,0,8,6,-2,7,0,19,3:11 - 5:11 - 12:10 - 4:11 - 0:0
14578247,2023-10-13 15:00:00,Rafayelyan Edgar - Nazaryan Mushegh,0:3,11:9 - 11:8 - 11:9 - 0:0 - 0:0,3,0,Rafayelyan Edgar,Nazaryan Mushegh,fiurst,Nazaryan Mushegh - Rafayelyan Edgar,59,26,33,7,-7,20,19,20,0,0,2,3,2,0,0,7,9:11 - 8:11 - 9:11 - 0:0 - 0:0
14578246,2023-10-13 14:45:00,Nikoghosyan Narek - Diaryan Aleksandr,3:1,5:11 - 7:11 - 12:10 - 10:12 - 0:0,1,3,Nikoghosyan Narek,Diaryan Aleksandr,fiurst,Diaryan Aleksandr - Nikoghosyan Narek,78,44,34,-10,10,16,18,22,22,0,-6,-4,2,-2,0,-10,11:5 - 11:7 - 10:12 - 12:10 - 0:0
14578241,2023-10-13 14:30:00,Arutyunov Ruben - Rafayelyan Edgar,1:3,5:11 - 8:11 - 11:7 - 4:11 - 0:0,1,3,Arutyunov Ruben,Rafayelyan Edgar,fiurst,Arutyunov Ruben - Rafayelyan Edgar,68,28,40,12,-12,16,19,18,15,0,6,3,-4,7,0,12,5:11 - 8:11 - 11:7 - 4:11 - 0:0
14578239,2023-10-13 14:15:00,Nazaryan Mushegh - Nikoghosyan Narek,3:0,12:10 - 12:10 - 11:9 - 0:0 - 0:0,3,0,Nazaryan Mushegh,Nikoghosyan Narek,fiurst,Nazaryan Mushegh - Nikoghosyan Narek,64,35,29,-6,6,22,22,20,0,0,-2,-2,-2,0,0,-6,12:10 - 12:10 - 11:9 - 0:0 - 0:0
14578228,2023-10-13 14:10:00,Arutyunov Ruben - Diaryan Aleksandr,0:3,7:11 - 7:11 - 5:11 - 0:0 - 0:0,0,3,Arutyunov Ruben,Diaryan Aleksandr,fiurst,Arutyunov Ruben - Diaryan Aleksandr,52,19,33,14,-14,18,18,16,0,0,4,4,6,0,0,14,7:11 - 7:11 - 5:11 - 0:0 - 0:0
14578227,2023-10-13 13:55:00,Rafayelyan Edgar - Nikoghosyan Narek,0:3,11:7 - 11:6 - 11:6 - 0:0 - 0:0,3,0,Rafayelyan Edgar,Nikoghosyan Narek,fiurst,Nikoghosyan Narek - Rafayelyan Edgar,52,19,33,14,-14,18,17,17,0,0,4,5,5,0,0,14,7:11 - 6:11 - 6:11 - 0:0 - 0:0
14578226,2023-10-13 13:30:00,Nazaryan Mushegh - Arutyunov Ruben,2:3,11:7 - 14:12 - 6:11 - 9:11 - 11:8,3,2,Nazaryan Mushegh,Arutyunov Ruben,fiurst,Arutyunov Ruben - Nazaryan Mushegh,100,49,51,2,-2,18,26,17,20,19,4,2,-5,-2,3,2,7:11 - 12:14 - 11:6 - 11:9 - 8:11
14578222,2023-10-13 13:15:00,Diaryan Aleksandr - Rafayelyan Edgar,3:2,11:6 - 6:11 - 15:17 - 11:4 - 11:9,3,2,Diaryan Aleksandr,Rafayelyan Edgar,fiurst,Diaryan Aleksandr - Rafayelyan Edgar,101,54,47,-7,7,17,17,32,15,20,-5,5,2,-7,-2,-7,11:6 - 6:11 - 15:17 - 11:4 - 11:9
14578218,2023-10-13 13:00:00,Nikoghosyan Narek - Arutyunov Ruben,0:3,11:8 - 13:11 - 11:7 - 0:0 - 0:0,3,0,Nikoghosyan Narek,Arutyunov Ruben,fiurst,Arutyunov Ruben - Nikoghosyan Narek,61,26,35,9,-9,19,24,18,0,0,3,2,4,0,0,9,8:11 - 11:13 - 7:11 - 0:0 - 0:0
14578205,2023-10-13 12:50:00,Diaryan Aleksandr - Nazaryan Mushegh,3:0,11:9 - 11:8 - 11:4 - 0:0 - 0:0,3,0,Diaryan Aleksandr,Nazaryan Mushegh,fiurst,Diaryan Aleksandr - Nazaryan Mushegh,54,33,21,-12,12,20,19,15,0,0,-2,-3,-7,0,0,-12,11:9 - 11:8 - 11:4 - 0:0 - 0:0
14578199,2023-10-13 12:15:00,Rafayelyan Edgar - Arutyunov Ruben,1:3,4:11 - 11:8 - 11:6 - 11:4 - 0:0,3,1,Rafayelyan Edgar,Arutyunov Ruben,fiurst,Arutyunov Ruben - Rafayelyan Edgar,66,29,37,8,-8,15,19,17,15,0,-7,3,5,7,0,8,11:4 - 8:11 - 6:11 - 4:11 - 0:0
14578195,2023-10-13 12:00:00,Diaryan Aleksandr - Nikoghosyan Narek,2:3,8:11 - 11:8 - 14:16 - 11:6 - 8:11,2,3,Diaryan Aleksandr,Nikoghosyan Narek,fiurst,Diaryan Aleksandr - Nikoghosyan Narek,104,52,52,0,0,19,19,30,17,19,3,-3,2,-5,3,0,8:11 - 11:8 - 14:16 - 11:6 - 8:11
14578193,2023-10-13 11:45:00,Nazaryan Mushegh - Rafayelyan Edgar,0:3,10:12 - 5:11 - 7:11 - 0:0 - 0:0,0,3,Nazaryan Mushegh,Rafayelyan Edgar,fiurst,Nazaryan Mushegh - Rafayelyan Edgar,56,22,34,12,-12,22,16,18,0,0,2,6,4,0,0,12,10:12 - 5:11 - 7:11 - 0:0 - 0:0
14578192,2023-10-13 11:25:00,Diaryan Aleksandr - Arutyunov Ruben,0:3,11:8 - 11:8 - 11:4 - 0:0 - 0:0,3,0,Diaryan Aleksandr,Arutyunov Ruben,fiurst,Arutyunov Ruben - Diaryan Aleksandr,53,20,33,13,-13,19,19,15,0,0,3,3,7,0,0,13,8:11 - 8:11 - 4:11 - 0:0 - 0:0
14578179,2023-10-13 11:15:00,Nikoghosyan Narek - Nazaryan Mushegh,1:3,11:6 - 11:13 - 11:7 - 11:5 - 0:0,3,1,Nikoghosyan Narek,Nazaryan Mushegh,fiurst,Nazaryan Mushegh - Nikoghosyan Narek,75,31,44,13,-13,17,24,18,16,0,5,-2,4,6,0,13,6:11 - 13:11 - 7:11 - 5:11 - 0:0
14578165,2023-10-13 11:00:00,Rafayelyan Edgar - Diaryan Aleksandr,3:0,6:11 - 10:12 - 9:11 - 0:0 - 0:0,0,3,Rafayelyan Edgar,Diaryan Aleksandr,fiurst,Diaryan Aleksandr - Rafayelyan Edgar,59,34,25,-9,9,17,22,20,0,0,-5,-2,-2,0,0,-9,11:6 - 12:10 - 11:9 - 0:0 - 0:0
14578163,2023-10-13 10:45:00,Arutyunov Ruben - Nazaryan Mushegh,0:3,7:11 - 6:11 - 7:11 - 0:0 - 0:0,0,3,Arutyunov Ruben,Nazaryan Mushegh,fiurst,Arutyunov Ruben - Nazaryan Mushegh,53,20,33,13,-13,18,17,18,0,0,4,5,4,0,0,13,7:11 - 6:11 - 7:11 - 0:0 - 0:0
14578106,2023-10-13 10:35:00,Nikoghosyan Narek - Rafayelyan Edgar,0:3,6:11 - 8:11 - 3:11 - 0:0 - 0:0,0,3,Nikoghosyan Narek,Rafayelyan Edgar,fiurst,Nikoghosyan Narek - Rafayelyan Edgar,50,17,33,16,-16,17,19,14,0,0,5,3,8,0,0,16,6:11 - 8:11 - 3:11 - 0:0 - 0:0
14578099,2023-10-13 10:15:00,Nazaryan Mushegh - Diaryan Aleksandr,3:0,3:11 - 5:11 - 8:11 - 0:0 - 0:0,0,3,Nazaryan Mushegh,Diaryan Aleksandr,fiurst,Diaryan Aleksandr - Nazaryan Mushegh,49,33,16,-17,17,14,16,19,0,0,-8,-6,-3,0,0,-17,11:3 - 11:5 - 11:8 - 0:0 - 0:0
14578094,2023-10-13 10:00:00,Arutyunov Ruben - Nikoghosyan Narek,3:2,11:7 - 11:5 - 12:14 - 5:11 - 11:8,3,2,Arutyunov Ruben,Nikoghosyan Narek,fiurst,Arutyunov Ruben - Nikoghosyan Narek,95,50,45,-5,5,18,16,26,16,19,-4,-6,2,6,-3,-5,11:7 - 11:5 - 12:14 - 5:11 - 11:8
14560216,2023-10-12 17:15:00,Petrosyan Davit - Soghomonyan Hrayr,0:3,7:11 - 10:12 - 17:19 - 0:0 - 0:0,0,3,Petrosyan Davit,Soghomonyan Hrayr,fiurst,Petrosyan Davit - Soghomonyan Hrayr,76,34,42,8,-8,18,22,36,0,0,4,2,2,0,0,8,7:11 - 10:12 - 17:19 - 0:0 - 0:0
14560210,2023-10-12 17:00:00,Avakimyan Davit - Gevorgyan Hayk,1:3,11:9 - 6:11 - 8:11 - 1:11 - 0:0,1,3,Avakimyan Davit,Gevorgyan Hayk,fiurst,Avakimyan Davit - Gevorgyan Hayk,68,26,42,16,-16,20,17,19,12,0,-2,5,3,10,0,16,11:9 - 6:11 - 8:11 - 1:11 - 0:0
14560202,2023-10-12 16:30:00,Soghomonyan Hrayr - Avakimyan Davit,1:3,11:5 - 11:8 - 9:11 - 11:9 - 0:0,3,1,Soghomonyan Hrayr,Avakimyan Davit,fiurst,Avakimyan Davit - Soghomonyan Hrayr,75,33,42,9,-9,16,19,20,20,0,6,3,-2,2,0,9,5:11 - 8:11 - 11:9 - 9:11 - 0:0
14560195,2023-10-12 16:15:00,Gevorgyan Hayk - Petrosyan Davit,3:0,13:11 - 11:7 - 12:10 - 0:0 - 0:0,3,0,Gevorgyan Hayk,Petrosyan Davit,fiurst,Gevorgyan Hayk - Petrosyan Davit,64,36,28,-8,8,24,18,22,0,0,-2,-4,-2,0,0,-8,13:11 - 11:7 - 12:10 - 0:0 - 0:0
14560180,2023-10-12 15:45:00,Soghomonyan Hrayr - Gevorgyan Hayk,1:1,9:11 - 11:6 - 11:4 - 11:2 - 0:0,1,1,Soghomonyan Hrayr,Gevorgyan Hayk,fiurst,Gevorgyan Hayk - Soghomonyan Hrayr,65,23,42,19,-19,20,17,15,13,0,-2,5,7,9,0,19,11:9 - 6:11 - 4:11 - 2:11 - 0:0
14560177,2023-10-12 15:30:00,Avakimyan Davit - Petrosyan Davit,3:0,11:5 - 11:9 - 11:8 - 0:0 - 0:0,3,0,Avakimyan Davit,Petrosyan Davit,fiurst,Avakimyan Davit - Petrosyan Davit,55,33,22,-11,11,16,20,19,0,0,-6,-2,-3,0,0,-11,11:5 - 11:9 - 11:8 - 0:0 - 0:0
14560174,2023-10-12 15:15:00,Grigoryan Erik - Soghomonyan Hrayr,0:2,9:11 - 7:11 - 2:5 - 0:0 - 0:0,0,2,Grigoryan Erik,Soghomonyan Hrayr,fiurst,Grigoryan Erik - Soghomonyan Hrayr,45,18,27,9,-9,20,18,7,0,0,2,4,3,0,0,9,9:11 - 7:11 - 2:5 - 0:0 - 0:0
14560154,2023-10-12 15:00:00,Mkrtchyan Andranik - Diaryan Aleksandr,3:1,10:12 - 11:6 - 2:11 - 9:11 - 0:0,1,3,Mkrtchyan Andranik,Diaryan Aleksandr,fiurst,Diaryan Aleksandr - Mkrtchyan Andranik,72,40,32,-8,8,22,17,13,20,0,-2,5,-9,-2,0,-8,12:10 - 6:11 - 11:2 - 11:9 - 0:0
14560149,2023-10-12 14:50:00,Papyan Karen - Arutyunov Ruben,0:3,11:9 - 11:6 - 11:9 - 0:0 - 0:0,3,0,Papyan Karen,Arutyunov Ruben,fiurst,Arutyunov Ruben - Papyan Karen,57,24,33,9,-9,20,17,20,0,0,2,5,2,0,0,9,9:11 - 6:11 - 9:11 - 0:0 - 0:0
14560136,2023-10-12 14:30:00,Nazaryan Mushegh - Mkrtchyan Andranik,0:3,11:4 - 11:8 - 11:6 - 0:0 - 0:0,3,0,Nazaryan Mushegh,Mkrtchyan Andranik,fiurst,Mkrtchyan Andranik - Nazaryan Mushegh,51,18,33,15,-15,15,19,17,0,0,7,3,5,0,0,15,4:11 - 8:11 - 6:11 - 0:0 - 0:0
14560130,2023-10-12 14:15:00,Diaryan Aleksandr - Papyan Karen,3:1,9:11 - 13:11 - 11:9 - 11:3 - 0:0,3,1,Diaryan Aleksandr,Papyan Karen,fiurst,Diaryan Aleksandr - Papyan Karen,78,44,34,-10,10,20,24,20,14,0,2,-2,-2,-8,0,-10,9:11 - 13:11 - 11:9 - 11:3 - 0:0
14560126,2023-10-12 14:05:00,Nazaryan Mushegh - Arutyunov Ruben,0:3,11:8 - 11:9 - 11:8 - 0:0 - 0:0,3,0,Nazaryan Mushegh,Arutyunov Ruben,fiurst,Arutyunov Ruben - Nazaryan Mushegh,58,25,33,8,-8,19,20,19,0,0,3,2,3,0,0,8,8:11 - 9:11 - 8:11 - 0:0 - 0:0
14560125,2023-10-12 13:45:00,Mkrtchyan Andranik - Papyan Karen,2:3,7:11 - 11:9 - 11:8 - 9:11 - 10:12,2,3,Mkrtchyan Andranik,Papyan Karen,fiurst,Mkrtchyan Andranik - Papyan Karen,99,48,51,3,-3,18,20,19,20,22,4,-2,-3,2,2,3,7:11 - 11:9 - 11:8 - 9:11 - 10:12
14560114,2023-10-12 13:30:00,Diaryan Aleksandr - Nazaryan Mushegh,3:1,11:9 - 11:6 - 9:11 - 11:8 - 0:0,3,1,Diaryan Aleksandr,Nazaryan Mushegh,fiurst,Diaryan Aleksandr - Nazaryan Mushegh,76,42,34,-8,8,20,17,20,19,0,-2,-5,2,-3,0,-8,11:9 - 11:6 - 9:11 - 11:8 - 0:0
14560113,2023-10-12 13:15:00,Arutyunov Ruben - Mkrtchyan Andranik,3:0,11:9 - 11:5 - 11:9 - 0:0 - 0:0,3,0,Arutyunov Ruben,Mkrtchyan Andranik,fiurst,Arutyunov Ruben - Mkrtchyan Andranik,56,33,23,-10,10,20,16,20,0,0,-2,-6,-2,0,0,-10,11:9 - 11:5 - 11:9 - 0:0 - 0:0
14559975,2023-10-12 13:00:00,Papyan Karen - Nazaryan Mushegh,3:0,5:11 - 12:14 - 1:11 - 0:0 - 0:0,0,3,Papyan Karen,Nazaryan Mushegh,fiurst,Nazaryan Mushegh - Papyan Karen,54,36,18,-18,18,16,26,12,0,0,-6,-2,-10,0,0,-18,11:5 - 14:12 - 11:1 - 0:0 - 0:0
14559974,2023-10-12 12:45:00,Arutyunov Ruben - Diaryan Aleksandr,0:3,8:11 - 6:11 - 6:11 - 0:0 - 0:0,0,3,Arutyunov Ruben,Diaryan Aleksandr,fiurst,Arutyunov Ruben - Diaryan Aleksandr,53,20,33,13,-13,19,17,17,0,0,3,5,5,0,0,13,8:11 - 6:11 - 6:11 - 0:0 - 0:0
14559972,2023-10-12 12:15:00,Mkrtchyan Andranik - Nazaryan Mushegh,3:0,11:6 - 11:8 - 11:7 - 0:0 - 0:0,3,0,Mkrtchyan Andranik,Nazaryan Mushegh,fiurst,Mkrtchyan Andranik - Nazaryan Mushegh,54,33,21,-12,12,17,19,18,0,0,-5,-3,-4,0,0,-12,11:6 - 11:8 - 11:7 - 0:0 - 0:0
14559970,2023-10-12 12:00:00,Arutyunov Ruben - Papyan Karen,0:3,9:11 - 13:15 - 8:11 - 0:0 - 0:0,0,3,Arutyunov Ruben,Papyan Karen,fiurst,Arutyunov Ruben - Papyan Karen,67,30,37,7,-7,20,28,19,0,0,2,2,3,0,0,7,9:11 - 13:15 - 8:11 - 0:0 - 0:0
14559969,2023-10-12 11:45:00,Diaryan Aleksandr - Mkrtchyan Andranik,3:1,11:4 - 11:6 - 3:11 - 11:8 - 0:0,3,1,Diaryan Aleksandr,Mkrtchyan Andranik,fiurst,Diaryan Aleksandr - Mkrtchyan Andranik,65,36,29,-7,7,15,17,14,19,0,-7,-5,8,-3,0,-7,11:4 - 11:6 - 3:11 - 11:8 - 0:0
14559968,2023-10-12 11:30:00,Arutyunov Ruben - Nazaryan Mushegh,0:3,9:11 - 3:11 - 8:11 - 0:0 - 0:0,0,3,Arutyunov Ruben,Nazaryan Mushegh,fiurst,Arutyunov Ruben - Nazaryan Mushegh,53,20,33,13,-13,20,14,19,0,0,2,8,3,0,0,13,9:11 - 3:11 - 8:11 - 0:0 - 0:0
14559967,2023-10-12 11:15:00,Papyan Karen - Diaryan Aleksandr,3:0,9:11 - 10:12 - 8:11 - 0:0 - 0:0,0,3,Papyan Karen,Diaryan Aleksandr,fiurst,Diaryan Aleksandr - Papyan Karen,61,34,27,-7,7,20,22,19,0,0,-2,-2,-3,0,0,-7,11:9 - 12:10 - 11:8 - 0:0 - 0:0
14559966,2023-10-12 11:00:00,Mkrtchyan Andranik - Arutyunov Ruben,1:3,9:11 - 11:5 - 11:9 - 11:9 - 0:0,3,1,Mkrtchyan Andranik,Arutyunov Ruben,fiurst,Arutyunov Ruben - Mkrtchyan Andranik,76,34,42,8,-8,20,16,20,20,0,-2,6,2,2,0,8,11:9 - 5:11 - 9:11 - 9:11 - 0:0
14559965,2023-10-12 10:45:00,Nazaryan Mushegh - Diaryan Aleksandr,3:0,5:11 - 8:11 - 6:11 - 0:0 - 0:0,0,3,Nazaryan Mushegh,Diaryan Aleksandr,fiurst,Diaryan Aleksandr - Nazaryan Mushegh,52,33,19,-14,14,16,19,17,0,0,-6,-3,-5,0,0,-14,11:5 - 11:8 - 11:6 - 0:0 - 0:0
14559963,2023-10-12 10:30:00,Papyan Karen - Mkrtchyan Andranik,2:3,9:11 - 11:7 - 9:11 - 11:9 - 11:6,3,2,Papyan Karen,Mkrtchyan Andranik,fiurst,Mkrtchyan Andranik - Papyan Karen,95,44,51,7,-7,20,18,20,20,17,-2,4,-2,2,5,7,11:9 - 7:11 - 11:9 - 9:11 - 6:11
14559962,2023-10-12 10:15:00,Diaryan Aleksandr - Arutyunov Ruben,0:3,11:7 - 11:3 - 11:0 - 0:0 - 0:0,3,0,Diaryan Aleksandr,Arutyunov Ruben,fiurst,Arutyunov Ruben - Diaryan Aleksandr,43,10,33,23,-23,18,14,11,0,0,4,8,11,0,0,23,7:11 - 3:11 - 0:11 - 0:0 - 0:0
14559960,2023-10-12 10:05:00,Nazaryan Mushegh - Papyan Karen,0:3,8:11 - 7:11 - 7:11 - 0:0 - 0:0,0,3,Nazaryan Mushegh,Papyan Karen,fiurst,Nazaryan Mushegh - Papyan Karen,55,22,33,11,-11,19,18,18,0,0,3,4,4,0,0,11,8:11 - 7:11 - 7:11 - 0:0 - 0:0
14543364,2023-10-11 17:30:00,Darbinyan Armen - Mkrtchyan Andranik,0:3,1:11 - 3:11 - 7:11 - 0:0 - 0:0,0,3,Darbinyan Armen,Mkrtchyan Andranik,fiurst,Darbinyan Armen - Mkrtchyan Andranik,44,11,33,22,-22,12,14,18,0,0,10,8,4,0,0,22,1:11 - 3:11 - 7:11 - 0:0 - 0:0
14543350,2023-10-11 17:00:00,Soghomonyan Hrayr - Darbinyan Armen,0:3,11:9 - 11:5 - 11:3 - 0:0 - 0:0,3,0,Soghomonyan Hrayr,Darbinyan Armen,fiurst,Darbinyan Armen - Soghomonyan Hrayr,50,17,33,16,-16,20,16,14,0,0,2,6,8,0,0,16,9:11 - 5:11 - 3:11 - 0:0 - 0:0
14543347,2023-10-11 16:45:00,Grigoryan Erik - Mkrtchyan Andranik,3:1,11:8 - 8:11 - 12:10 - 14:12 - 0:0,3,1,Grigoryan Erik,Mkrtchyan Andranik,fiurst,Grigoryan Erik - Mkrtchyan Andranik,86,45,41,-4,4,19,19,22,26,0,-3,3,-2,-2,0,-4,11:8 - 8:11 - 12:10 - 14:12 - 0:0
14543337,2023-10-11 16:15:00,Darbinyan Armen - Grigoryan Erik,0:3,4:11 - 8:11 - 6:11 - 0:0 - 0:0,0,3,Darbinyan Armen,Grigoryan Erik,fiurst,Darbinyan Armen - Grigoryan Erik,51,18,33,15,-15,15,19,17,0,0,7,3,5,0,0,15,4:11 - 8:11 - 6:11 - 0:0 - 0:0
14543319,2023-10-11 16:00:00,Mkrtchyan Andranik - Soghomonyan Hrayr,1:3,9:11 - 6:11 - 11:9 - 5:11 - 0:0,1,3,Mkrtchyan Andranik,Soghomonyan Hrayr,fiurst,Mkrtchyan Andranik - Soghomonyan Hrayr,73,31,42,11,-11,20,17,20,16,0,2,5,-2,6,0,11,9:11 - 6:11 - 11:9 - 5:11 - 0:0
14543306,2023-10-11 15:25:00,Soghomonyan Hrayr - Grigoryan Erik,2:3,11:9 - 12:10 - 9:11 - 8:11 - 11:9,3,2,Soghomonyan Hrayr,Grigoryan Erik,fiurst,Grigoryan Erik - Soghomonyan Hrayr,101,50,51,1,-1,20,22,20,19,20,2,2,-2,-3,2,1,9:11 - 10:12 - 11:9 - 11:8 - 9:11
14542935,2023-10-11 15:00:00,Rafayelyan Edgar - Soghomonyan Hrayr,3:0,11:6 - 11:6 - 11:5 - 0:0 - 0:0,3,0,Rafayelyan Edgar,Soghomonyan Hrayr,fiurst,Rafayelyan Edgar - Soghomonyan Hrayr,50,33,17,-16,16,17,17,16,0,0,-5,-5,-6,0,0,-16,11:6 - 11:6 - 11:5 - 0:0 - 0:0
14542932,2023-10-11 14:45:00,Papyan Karen - Antonyan Eduard,3:0,7:11 - 7:11 - 2:11 - 0:0 - 0:0,0,3,Papyan Karen,Antonyan Eduard,fiurst,Antonyan Eduard - Papyan Karen,49,33,16,-17,17,18,18,13,0,0,-4,-4,-9,0,0,-17,11:7 - 11:7 - 11:2 - 0:0 - 0:0
14542928,2023-10-11 14:40:00,Diaryan Aleksandr - Rafayelyan Edgar,3:0,11:2 - 11:7 - 11:7 - 0:0 - 0:0,3,0,Diaryan Aleksandr,Rafayelyan Edgar,fiurst,Diaryan Aleksandr - Rafayelyan Edgar,49,33,16,-17,17,13,18,18,0,0,-9,-4,-4,0,0,-17,11:2 - 11:7 - 11:7 - 0:0 - 0:0
14542924,2023-10-11 14:15:00,Diaryan Aleksandr - Antonyan Eduard,1:3,8:11 - 11:3 - 11:8 - 11:0 - 0:0,3,1,Diaryan Aleksandr,Antonyan Eduard,fiurst,Antonyan Eduard - Diaryan Aleksandr,63,22,41,19,-19,19,14,19,11,0,-3,8,3,11,0,19,11:8 - 3:11 - 8:11 - 0:11 - 0:0
14542925,2023-10-11 14:15:00,Soghomonyan Hrayr - Papyan Karen,3:1,7:11 - 11:4 - 8:11 - 8:11 - 0:0,1,3,Soghomonyan Hrayr,Papyan Karen,fiurst,Papyan Karen - Soghomonyan Hrayr,71,37,34,-3,3,18,15,19,19,0,-4,7,-3,-3,0,-3,11:7 - 4:11 - 11:8 - 11:8 - 0:0
14542912,2023-10-11 13:50:00,Soghomonyan Hrayr - Diaryan Aleksandr,3:1,4:11 - 11:5 - 3:11 - 6:11 - 0:0,1,3,Soghomonyan Hrayr,Diaryan Aleksandr,fiurst,Diaryan Aleksandr - Soghomonyan Hrayr,62,38,24,-14,14,15,16,14,17,0,-7,6,-8,-5,0,-14,11:4 - 5:11 - 11:3 - 11:6 - 0:0
14542923,2023-10-11 13:45:00,Rafayelyan Edgar - Papyan Karen,3:2,8:11 - 11:9 - 11:2 - 3:11 - 6:11,2,3,Rafayelyan Edgar,Papyan Karen,fiurst,Papyan Karen - Rafayelyan Edgar,83,44,39,-5,5,19,20,13,14,17,-3,2,9,-8,-5,-5,11:8 - 9:11 - 2:11 - 11:3 - 11:6
14542911,2023-10-11 13:15:00,Antonyan Eduard - Rafayelyan Edgar,0:3,5:11 - 11:13 - 7:11 - 0:0 - 0:0,0,3,Antonyan Eduard,Rafayelyan Edgar,fiurst,Antonyan Eduard - Rafayelyan Edgar,58,23,35,12,-12,16,24,18,0,0,6,2,4,0,0,12,5:11 - 11:13 - 7:11 - 0:0 - 0:0
14542909,2023-10-11 13:05:00,Papyan Karen - Diaryan Aleksandr,3:0,3:11 - 4:11 - 9:11 - 0:0 - 0:0,0,3,Papyan Karen,Diaryan Aleksandr,fiurst,Diaryan Aleksandr - Papyan Karen,49,33,16,-17,17,14,15,20,0,0,-8,-7,-2,0,0,-17,11:3 - 11:4 - 11:9 - 0:0 - 0:0
14542902,2023-10-11 12:30:00,Rafayelyan Edgar - Diaryan Aleksandr,3:1,9:11 - 7:11 - 12:10 - 4:11 - 0:0,1,3,Rafayelyan Edgar,Diaryan Aleksandr,fiurst,Diaryan Aleksandr - Rafayelyan Edgar,75,43,32,-11,11,20,18,22,15,0,-2,-4,2,-7,0,-11,11:9 - 11:7 - 10:12 - 11:4 - 0:0
14542898,2023-10-11 12:20:00,Nikoghosyan Narek - Rafayelyan Edgar,0:3,4:11 - 6:11 - 5:11 - 0:0 - 0:0,0,3,Nikoghosyan Narek,Rafayelyan Edgar,fiurst,Nikoghosyan Narek - Rafayelyan Edgar,48,15,33,18,-18,15,17,16,0,0,7,5,6,0,0,18,4:11 - 6:11 - 5:11 - 0:0 - 0:0
14542901,2023-10-11 12:10:00,Antonyan Eduard - Papyan Karen,1:3,10:12 - 13:11 - 9:11 - 11:13 - 0:0,1,3,Antonyan Eduard,Papyan Karen,fiurst,Antonyan Eduard - Papyan Karen,90,43,47,4,-4,22,24,20,24,0,2,-2,2,2,0,4,10:12 - 13:11 - 9:11 - 11:13 - 0:0
14542896,2023-10-11 11:30:00,Antonyan Eduard - Diaryan Aleksandr,0:3,5:11 - 9:11 - 10:12 - 0:0 - 0:0,0,3,Antonyan Eduard,Diaryan Aleksandr,fiurst,Antonyan Eduard - Diaryan Aleksandr,58,24,34,10,-10,16,20,22,0,0,6,2,2,0,0,10,5:11 - 9:11 - 10:12 - 0:0 - 0:0
14542886,2023-10-11 11:25:00,Papyan Karen - Nikoghosyan Narek,2:3,9:11 - 11:9 - 7:11 - 12:10 - 13:11,3,2,Papyan Karen,Nikoghosyan Narek,fiurst,Nikoghosyan Narek - Papyan Karen,104,52,52,0,0,20,20,18,22,24,-2,2,-4,2,2,0,11:9 - 9:11 - 11:7 - 10:12 - 11:13
14542880,2023-10-11 11:00:00,Rafayelyan Edgar - Antonyan Eduard,3:1,8:11 - 5:11 - 12:10 - 9:11 - 0:0,1,3,Rafayelyan Edgar,Antonyan Eduard,fiurst,Antonyan Eduard - Rafayelyan Edgar,77,43,34,-9,9,19,16,22,20,0,-3,-6,2,-2,0,-9,11:8 - 11:5 - 10:12 - 11:9 - 0:0
14542879,2023-10-11 10:50:00,Diaryan Aleksandr - Nikoghosyan Narek,3:2,11:13 - 5:11 - 11:4 - 11:9 - 11:5,3,2,Diaryan Aleksandr,Nikoghosyan Narek,fiurst,Diaryan Aleksandr - Nikoghosyan Narek,91,49,42,-7,7,24,16,15,20,16,2,6,-7,-2,-6,-7,11:13 - 5:11 - 11:4 - 11:9 - 11:5
14542876,2023-10-11 10:30:00,Papyan Karen - Rafayelyan Edgar,2:3,11:5 - 13:15 - 11:7 - 7:11 - 5:11,2,3,Papyan Karen,Rafayelyan Edgar,fiurst,Papyan Karen - Rafayelyan Edgar,96,47,49,2,-2,16,28,18,18,16,-6,2,-4,4,6,2,11:5 - 13:15 - 11:7 - 7:11 - 5:11
14542873,2023-10-11 10:15:00,Nikoghosyan Narek - Antonyan Eduard,3:2,11:8 - 12:14 - 3:11 - 11:8 - 8:11,2,3,Nikoghosyan Narek,Antonyan Eduard,fiurst,Antonyan Eduard - Nikoghosyan Narek,97,52,45,-7,7,19,26,14,19,19,3,-2,-8,3,-3,-7,8:11 - 14:12 - 11:3 - 8:11 - 11:8
14542864,2023-10-11 10:00:00,Diaryan Aleksandr - Papyan Karen,3:2,11:13 - 11:9 - 11:9 - 8:11 - 11:8,3,2,Diaryan Aleksandr,Papyan Karen,fiurst,Diaryan Aleksandr - Papyan Karen,102,52,50,-2,2,24,20,20,19,19,2,-2,-2,3,-3,-2,11:13 - 11:9 - 11:9 - 8:11 - 11:8
14521244,2023-10-10 17:30:00,Soghomonyan Hrayr - Avakimyan Davit,1:3,13:11 - 11:9 - 9:11 - 11:6 - 0:0,3,1,Soghomonyan Hrayr,Avakimyan Davit,fiurst,Avakimyan Davit - Soghomonyan Hrayr,81,37,44,7,-7,24,20,20,17,0,2,2,-2,5,0,7,11:13 - 9:11 - 11:9 - 6:11 - 0:0
14521241,2023-10-10 17:15:00,Mkrtchyan Andranik - Grigoryan Erik,3:2,9:11 - 11:9 - 8:11 - 11:8 - 6:11,2,3,Mkrtchyan Andranik,Grigoryan Erik,fiurst,Grigoryan Erik - Mkrtchyan Andranik,95,50,45,-5,5,20,20,19,19,17,-2,2,-3,3,-5,-5,11:9 - 9:11 - 11:8 - 8:11 - 11:6
14521237,2023-10-10 17:00:00,Petrosyan Davit - Soghomonyan Hrayr,2:3,11:9 - 9:11 - 11:4 - 4:11 - 9:11,2,3,Petrosyan Davit,Soghomonyan Hrayr,fiurst,Petrosyan Davit - Soghomonyan Hrayr,90,44,46,2,-2,20,20,15,15,20,-2,2,-7,7,2,2,11:9 - 9:11 - 11:4 - 4:11 - 9:11
14521235,2023-10-10 16:45:00,Mkrtchyan Andranik - Avakimyan Davit,3:2,7:11 - 13:11 - 14:16 - 11:3 - 2:11,2,3,Mkrtchyan Andranik,Avakimyan Davit,fiurst,Avakimyan Davit - Mkrtchyan Andranik,99,52,47,-5,5,18,24,30,14,13,-4,2,-2,8,-9,-5,11:7 - 11:13 - 16:14 - 3:11 - 11:2
14521224,2023-10-10 16:30:00,Grigoryan Erik - Petrosyan Davit,3:0,11:7 - 11:9 - 14:12 - 0:0 - 0:0,3,0,Grigoryan Erik,Petrosyan Davit,fiurst,Grigoryan Erik - Petrosyan Davit,64,36,28,-8,8,18,20,26,0,0,-4,-2,-2,0,0,-8,11:7 - 11:9 - 14:12 - 0:0 - 0:0
14521222,2023-10-10 16:15:00,Soghomonyan Hrayr - Mkrtchyan Andranik,1:3,11:2 - 8:11 - 11:5 - 11:9 - 0:0,3,1,Soghomonyan Hrayr,Mkrtchyan Andranik,fiurst,Mkrtchyan Andranik - Soghomonyan Hrayr,68,27,41,14,-14,13,19,16,20,0,9,-3,6,2,0,14,2:11 - 11:8 - 5:11 - 9:11 - 0:0
14521221,2023-10-10 16:00:00,Avakimyan Davit - Petrosyan Davit,3:1,9:11 - 11:4 - 11:9 - 12:10 - 0:0,3,1,Avakimyan Davit,Petrosyan Davit,fiurst,Avakimyan Davit - Petrosyan Davit,77,43,34,-9,9,20,15,20,22,0,2,-7,-2,-2,0,-9,9:11 - 11:4 - 11:9 - 12:10 - 0:0
14521219,2023-10-10 15:45:00,Grigoryan Erik - Soghomonyan Hrayr,0:3,8:11 - 7:11 - 6:11 - 0:0 - 0:0,0,3,Grigoryan Erik,Soghomonyan Hrayr,fiurst,Grigoryan Erik - Soghomonyan Hrayr,54,21,33,12,-12,19,18,17,0,0,3,4,5,0,0,12,8:11 - 7:11 - 6:11 - 0:0 - 0:0
14521208,2023-10-10 15:40:00,Petrosyan Davit - Mkrtchyan Andranik,3:0,8:11 - 4:11 - 11:13 - 0:0 - 0:0,0,3,Petrosyan Davit,Mkrtchyan Andranik,fiurst,Mkrtchyan Andranik - Petrosyan Davit,58,35,23,-12,12,19,15,24,0,0,-3,-7,-2,0,0,-12,11:8 - 11:4 - 13:11 - 0:0 - 0:0
14521205,2023-10-10 15:15:00,Avakimyan Davit - Grigoryan Erik,1:3,11:7 - 11:13 - 11:13 - 11:13 - 0:0,1,3,Avakimyan Davit,Grigoryan Erik,fiurst,Avakimyan Davit - Grigoryan Erik,90,44,46,2,-2,18,24,24,24,0,-4,2,2,2,0,2,11:7 - 11:13 - 11:13 - 11:13 - 0:0
14521204,2023-10-10 15:00:00,Papyan Karen - Arutyunov Ruben,0:3,11:9 - 11:6 - 11:9 - 0:0 - 0:0,3,0,Papyan Karen,Arutyunov Ruben,fiurst,Arutyunov Ruben - Papyan Karen,57,24,33,9,-9,20,17,20,0,0,2,5,2,0,0,9,9:11 - 6:11 - 9:11 - 0:0 - 0:0
14521193,2023-10-10 14:45:00,Nazaryan Mushegh - Nikoghosyan Narek,1:3,11:9 - 6:11 - 6:11 - 5:11 - 0:0,1,3,Nazaryan Mushegh,Nikoghosyan Narek,fiurst,Nazaryan Mushegh - Nikoghosyan Narek,70,28,42,14,-14,20,17,17,16,0,-2,5,5,6,0,14,11:9 - 6:11 - 6:11 - 5:11 - 0:0
14521189,2023-10-10 14:35:00,Antonyan Eduard - Papyan Karen,3:0,11:3 - 11:2 - 11:7 - 0:0 - 0:0,3,0,Antonyan Eduard,Papyan Karen,fiurst,Antonyan Eduard - Papyan Karen,45,33,12,-21,21,14,13,18,0,0,-8,-9,-4,0,0,-21,11:3 - 11:2 - 11:7 - 0:0 - 0:0
14521187,2023-10-10 14:25:00,Arutyunov Ruben - Nazaryan Mushegh,0:3,11:13 - 14:16 - 8:11 - 0:0 - 0:0,0,3,Arutyunov Ruben,Nazaryan Mushegh,fiurst,Arutyunov Ruben - Nazaryan Mushegh,73,33,40,7,-7,24,30,19,0,0,2,2,3,0,0,7,11:13 - 14:16 - 8:11 - 0:0 - 0:0
14521185,2023-10-10 14:10:00,Antonyan Eduard - Nikoghosyan Narek,1:3,11:7 - 9:11 - 5:11 - 8:11 - 0:0,1,3,Antonyan Eduard,Nikoghosyan Narek,fiurst,Antonyan Eduard - Nikoghosyan Narek,73,33,40,7,-7,18,20,16,19,0,-4,2,6,3,0,7,11:7 - 9:11 - 5:11 - 8:11 - 0:0
14521182,2023-10-10 13:45:00,Papyan Karen - Nazaryan Mushegh,3:1,11:9 - 5:11 - 6:11 - 14:16 - 0:0,1,3,Papyan Karen,Nazaryan Mushegh,fiurst,Nazaryan Mushegh - Papyan Karen,83,47,36,-11,11,20,16,17,30,0,2,-6,-5,-2,0,-11,9:11 - 11:5 - 11:6 - 16:14 - 0:0
14521180,2023-10-10 13:30:00,Arutyunov Ruben - Antonyan Eduard,2:3,8:11 - 15:13 - 8:11 - 15:13 - 16:14,3,2,Arutyunov Ruben,Antonyan Eduard,fiurst,Antonyan Eduard - Arutyunov Ruben,124,62,62,0,0,19,28,19,28,30,-3,2,-3,2,2,0,11:8 - 13:15 - 11:8 - 13:15 - 14:16
14521169,2023-10-10 13:15:00,Nikoghosyan Narek - Papyan Karen,3:1,11:7 - 8:11 - 11:7 - 11:4 - 0:0,3,1,Nikoghosyan Narek,Papyan Karen,fiurst,Nikoghosyan Narek - Papyan Karen,70,41,29,-12,12,18,19,18,15,0,-4,3,-4,-7,0,-12,11:7 - 8:11 - 11:7 - 11:4 - 0:0
14521168,2023-10-10 13:05:00,Nazaryan Mushegh - Antonyan Eduard,0:3,11:9 - 11:9 - 11:4 - 0:0 - 0:0,3,0,Nazaryan Mushegh,Antonyan Eduard,fiurst,Antonyan Eduard - Nazaryan Mushegh,55,22,33,11,-11,20,20,15,0,0,2,2,7,0,0,11,9:11 - 9:11 - 4:11 - 0:0 - 0:0
14521166,2023-10-10 12:50:00,Nikoghosyan Narek - Arutyunov Ruben,0:3,11:5 - 11:8 - 11:6 - 0:0 - 0:0,3,0,Nikoghosyan Narek,Arutyunov Ruben,fiurst,Arutyunov Ruben - Nikoghosyan Narek,52,19,33,14,-14,16,19,17,0,0,6,3,5,0,0,14,5:11 - 8:11 - 6:11 - 0:0 - 0:0
14521159,2023-10-10 12:20:00,Papyan Karen - Antonyan Eduard,3:2,11:8 - 4:11 - 9:11 - 11:5 - 6:11,2,3,Papyan Karen,Antonyan Eduard,fiurst,Antonyan Eduard - Papyan Karen,87,46,41,-5,5,19,15,20,16,17,3,-7,-2,6,-5,-5,8:11 - 11:4 - 11:9 - 5:11 - 11:6
14521146,2023-10-10 12:05:00,Arutyunov Ruben - Papyan Karen,0:3,8:11 - 5:11 - 7:11 - 0:0 - 0:0,0,3,Arutyunov Ruben,Papyan Karen,fiurst,Arutyunov Ruben - Papyan Karen,53,20,33,13,-13,19,16,18,0,0,3,6,4,0,0,13,8:11 - 5:11 - 7:11 - 0:0 - 0:0
14521152,2023-10-10 12:05:00,Nikoghosyan Narek - Nazaryan Mushegh,0:3,11:8 - 11:7 - 11:9 - 0:0 - 0:0,3,0,Nikoghosyan Narek,Nazaryan Mushegh,fiurst,Nazaryan Mushegh - Nikoghosyan Narek,57,24,33,9,-9,19,18,20,0,0,3,4,2,0,0,9,8:11 - 7:11 - 9:11 - 0:0 - 0:0
14521144,2023-10-10 11:40:00,Nikoghosyan Narek - Antonyan Eduard,0:3,11:4 - 11:9 - 11:5 - 0:0 - 0:0,3,0,Nikoghosyan Narek,Antonyan Eduard,fiurst,Antonyan Eduard - Nikoghosyan Narek,51,18,33,15,-15,15,20,16,0,0,7,2,6,0,0,15,4:11 - 9:11 - 5:11 - 0:0 - 0:0
14521141,2023-10-10 11:30:00,Nazaryan Mushegh - Arutyunov Ruben,2:3,6:11 - 11:3 - 5:11 - 11:9 - 11:7,3,2,Nazaryan Mushegh,Arutyunov Ruben,fiurst,Arutyunov Ruben - Nazaryan Mushegh,85,41,44,3,-3,17,14,16,20,18,-5,8,-6,2,4,3,11:6 - 3:11 - 11:5 - 9:11 - 7:11
14521139,2023-10-10 11:00:00,Papyan Karen - Nikoghosyan Narek,1:3,11:9 - 13:11 - 10:12 - 12:10 - 0:0,3,1,Papyan Karen,Nikoghosyan Narek,fiurst,Nikoghosyan Narek - Papyan Karen,88,42,46,4,-4,20,24,22,22,0,2,2,-2,2,0,4,9:11 - 11:13 - 12:10 - 10:12 - 0:0
14521137,2023-10-10 10:55:00,Antonyan Eduard - Arutyunov Ruben,3:1,11:7 - 10:12 - 15:13 - 11:7 - 0:0,3,1,Antonyan Eduard,Arutyunov Ruben,fiurst,Antonyan Eduard - Arutyunov Ruben,86,47,39,-8,8,18,22,28,18,0,-4,2,-2,-4,0,-8,11:7 - 10:12 - 15:13 - 11:7 - 0:0
14521124,2023-10-10 10:30:00,Nazaryan Mushegh - Papyan Karen,3:0,11:6 - 11:8 - 11:7 - 0:0 - 0:0,3,0,Nazaryan Mushegh,Papyan Karen,fiurst,Nazaryan Mushegh - Papyan Karen,54,33,21,-12,12,17,19,18,0,0,-5,-3,-4,0,0,-12,11:6 - 11:8 - 11:7 - 0:0 - 0:0
14521122,2023-10-10 10:15:00,Arutyunov Ruben - Nikoghosyan Narek,1:3,10:12 - 13:11 - 10:12 - 8:11 - 0:0,1,3,Arutyunov Ruben,Nikoghosyan Narek,fiurst,Arutyunov Ruben - Nikoghosyan Narek,87,41,46,5,-5,22,24,22,19,0,2,-2,2,3,0,5,10:12 - 13:11 - 10:12 - 8:11 - 0:0
14521118,2023-10-10 10:05:00,Antonyan Eduard - Nazaryan Mushegh,3:1,11:9 - 11:6 - 7:11 - 11:8 - 0:0,3,1,Antonyan Eduard,Nazaryan Mushegh,fiurst,Antonyan Eduard - Nazaryan Mushegh,74,40,34,-6,6,20,17,18,19,0,-2,-5,4,-3,0,-6,11:9 - 11:6 - 7:11 - 11:8 - 0:0
14501798,2023-10-09 17:30:00,Grigoryan Erik - Petrosyan Davit,0:3,1:11 - 3:11 - 3:11 - 0:0 - 0:0,0,3,Grigoryan Erik,Petrosyan Davit,fiurst,Grigoryan Erik - Petrosyan Davit,40,7,33,26,-26,12,14,14,0,0,10,8,8,0,0,26,1:11 - 3:11 - 3:11 - 0:0 - 0:0
14501797,2023-10-09 17:15:00,Gevorgyan Hayk - Avakimyan Davit,2:3,10:12 - 11:6 - 4:11 - 11:4 - 11:4,3,2,Gevorgyan Hayk,Avakimyan Davit,fiurst,Avakimyan Davit - Gevorgyan Hayk,84,37,47,10,-10,22,17,15,15,15,-2,5,-7,7,7,10,12:10 - 6:11 - 11:4 - 4:11 - 4:11
14501795,2023-10-09 17:00:00,Mkrtchyan Andranik - Grigoryan Erik,1:3,12:14 - 11:9 - 11:8 - 12:10 - 0:0,3,1,Mkrtchyan Andranik,Grigoryan Erik,fiurst,Grigoryan Erik - Mkrtchyan Andranik,87,41,46,5,-5,26,20,19,22,0,-2,2,3,2,0,5,14:12 - 9:11 - 8:11 - 10:12 - 0:0
14501792,2023-10-09 16:45:00,Gevorgyan Hayk - Petrosyan Davit,0:3,9:11 - 8:11 - 3:11 - 0:0 - 0:0,0,3,Gevorgyan Hayk,Petrosyan Davit,fiurst,Gevorgyan Hayk - Petrosyan Davit,53,20,33,13,-13,20,19,14,0,0,2,3,8,0,0,13,9:11 - 8:11 - 3:11 - 0:0 - 0:0
14501787,2023-10-09 16:40:00,Avakimyan Davit - Mkrtchyan Andranik,3:0,11:9 - 11:9 - 11:6 - 0:0 - 0:0,3,0,Avakimyan Davit,Mkrtchyan Andranik,fiurst,Avakimyan Davit - Mkrtchyan Andranik,57,33,24,-9,9,20,20,17,0,0,-2,-2,-5,0,0,-9,11:9 - 11:9 - 11:6 - 0:0 - 0:0
14501786,2023-10-09 16:05:00,Petrosyan Davit - Mkrtchyan Andranik,2:3,11:6 - 11:7 - 8:11 - 8:11 - 12:10,3,2,Petrosyan Davit,Mkrtchyan Andranik,fiurst,Mkrtchyan Andranik - Petrosyan Davit,95,45,50,5,-5,17,18,19,19,22,5,4,-3,-3,2,5,6:11 - 7:11 - 11:8 - 11:8 - 10:12
14501775,2023-10-09 15:30:00,Mkrtchyan Andranik - Gevorgyan Hayk,2:3,11:4 - 11:13 - 17:15 - 7:11 - 11:9,3,2,Mkrtchyan Andranik,Gevorgyan Hayk,fiurst,Gevorgyan Hayk - Mkrtchyan Andranik,109,52,57,5,-5,15,24,32,18,20,7,-2,2,-4,2,5,4:11 - 13:11 - 15:17 - 11:7 - 9:11
14501773,2023-10-09 15:15:00,Petrosyan Davit - Avakimyan Davit,3:0,7:11 - 8:11 - 7:11 - 0:0 - 0:0,0,3,Petrosyan Davit,Avakimyan Davit,fiurst,Avakimyan Davit - Petrosyan Davit,55,33,22,-11,11,18,19,18,0,0,-4,-3,-4,0,0,-11,11:7 - 11:8 - 11:7 - 0:0 - 0:0
14501771,2023-10-09 15:10:00,Arutyunov Ruben - Nazaryan Mushegh,3:0,11:6 - 12:10 - 11:3 - 0:0 - 0:0,3,0,Arutyunov Ruben,Nazaryan Mushegh,fiurst,Arutyunov Ruben - Nazaryan Mushegh,53,34,19,-15,15,17,22,14,0,0,-5,-2,-8,0,0,-15,11:6 - 12:10 - 11:3 - 0:0 - 0:0
14501768,2023-10-09 14:45:00,Soghomonyan Hrayr - Diaryan Aleksandr,3:0,7:11 - 7:11 - 10:12 - 0:0 - 0:0,0,3,Soghomonyan Hrayr,Diaryan Aleksandr,fiurst,Diaryan Aleksandr - Soghomonyan Hrayr,58,34,24,-10,10,18,18,22,0,0,-4,-4,-2,0,0,-10,11:7 - 11:7 - 12:10 - 0:0 - 0:0
14501767,2023-10-09 14:30:00,Papyan Karen - Arutyunov Ruben,3:2,8:11 - 11:5 - 11:6 - 10:12 - 7:11,2,3,Papyan Karen,Arutyunov Ruben,fiurst,Arutyunov Ruben - Papyan Karen,92,45,47,2,-2,19,16,17,22,18,-3,6,5,-2,-4,2,11:8 - 5:11 - 6:11 - 12:10 - 11:7
14501765,2023-10-09 14:15:00,Nazaryan Mushegh - Soghomonyan Hrayr,3:0,11:7 - 11:7 - 11:8 - 0:0 - 0:0,3,0,Nazaryan Mushegh,Soghomonyan Hrayr,fiurst,Nazaryan Mushegh - Soghomonyan Hrayr,55,33,22,-11,11,18,18,19,0,0,-4,-4,-3,0,0,-11,11:7 - 11:7 - 11:8 - 0:0 - 0:0
14501754,2023-10-09 14:00:00,Papyan Karen - Diaryan Aleksandr,1:3,12:10 - 11:8 - 7:11 - 11:9 - 0:0,3,1,Papyan Karen,Diaryan Aleksandr,fiurst,Diaryan Aleksandr - Papyan Karen,79,38,41,3,-3,22,19,18,20,0,2,3,-4,2,0,3,10:12 - 8:11 - 11:7 - 9:11 - 0:0
14501752,2023-10-09 13:45:00,Arutyunov Ruben - Soghomonyan Hrayr,3:0,11:5 - 11:7 - 11:8 - 0:0 - 0:0,3,0,Arutyunov Ruben,Soghomonyan Hrayr,fiurst,Arutyunov Ruben - Soghomonyan Hrayr,53,33,20,-13,13,16,18,19,0,0,-6,-4,-3,0,0,-13,11:5 - 11:7 - 11:8 - 0:0 - 0:0
14501748,2023-10-09 13:30:00,Nazaryan Mushegh - Papyan Karen,3:2,11:6 - 11:8 - 8:11 - 9:11 - 11:8,3,2,Nazaryan Mushegh,Papyan Karen,fiurst,Nazaryan Mushegh - Papyan Karen,94,50,44,-6,6,17,19,19,20,19,-5,-3,3,2,-3,-6,11:6 - 11:8 - 8:11 - 9:11 - 11:8
14501647,2023-10-09 13:15:00,Diaryan Aleksandr - Arutyunov Ruben,0:3,11:6 - 11:2 - 11:6 - 0:0 - 0:0,3,0,Diaryan Aleksandr,Arutyunov Ruben,fiurst,Arutyunov Ruben - Diaryan Aleksandr,47,14,33,19,-19,17,13,17,0,0,5,9,5,0,0,19,6:11 - 2:11 - 6:11 - 0:0 - 0:0
14501622,2023-10-09 13:00:00,Soghomonyan Hrayr - Papyan Karen,3:0,9:11 - 9:11 - 8:11 - 0:0 - 0:0,0,3,Soghomonyan Hrayr,Papyan Karen,fiurst,Papyan Karen - Soghomonyan Hrayr,59,33,26,-7,7,20,20,19,0,0,-2,-2,-3,0,0,-7,11:9 - 11:9 - 11:8 - 0:0 - 0:0
14501608,2023-10-09 12:45:00,Diaryan Aleksandr - Nazaryan Mushegh,0:3,5:11 - 6:11 - 9:11 - 0:0 - 0:0,0,3,Diaryan Aleksandr,Nazaryan Mushegh,fiurst,Diaryan Aleksandr - Nazaryan Mushegh,53,20,33,13,-13,16,17,20,0,0,6,5,2,0,0,13,5:11 - 6:11 - 9:11 - 0:0 - 0:0
14501605,2023-10-09 12:15:00,Arutyunov Ruben - Papyan Karen,3:1,11:9 - 7:11 - 11:3 - 11:9 - 0:0,3,1,Arutyunov Ruben,Papyan Karen,fiurst,Arutyunov Ruben - Papyan Karen,72,40,32,-8,8,20,18,14,20,0,-2,4,-8,-2,0,-8,11:9 - 7:11 - 11:3 - 11:9 - 0:0
14501600,2023-10-09 12:00:00,Diaryan Aleksandr - Soghomonyan Hrayr,3:2,12:10 - 7:11 - 11:9 - 9:11 - 11:4,3,2,Diaryan Aleksandr,Soghomonyan Hrayr,fiurst,Diaryan Aleksandr - Soghomonyan Hrayr,95,50,45,-5,5,22,18,20,20,15,-2,4,-2,2,-7,-5,12:10 - 7:11 - 11:9 - 9:11 - 11:4
14501591,2023-10-09 11:55:00,Nazaryan Mushegh - Arutyunov Ruben,0:3,11:7 - 11:9 - 11:9 - 0:0 - 0:0,3,0,Nazaryan Mushegh,Arutyunov Ruben,fiurst,Arutyunov Ruben - Nazaryan Mushegh,58,25,33,8,-8,18,20,20,0,0,4,2,2,0,0,8,7:11 - 9:11 - 9:11 - 0:0 - 0:0
14501590,2023-10-09 11:35:00,Diaryan Aleksandr - Papyan Karen,3:1,11:6 - 12:14 - 11:6 - 11:7 - 0:0,3,1,Diaryan Aleksandr,Papyan Karen,fiurst,Diaryan Aleksandr - Papyan Karen,78,45,33,-12,12,17,26,17,18,0,-5,2,-5,-4,0,-12,11:6 - 12:14 - 11:6 - 11:7 - 0:0
14501588,2023-10-09 11:25:00,Soghomonyan Hrayr - Nazaryan Mushegh,3:1,9:11 - 11:7 - 5:11 - 6:11 - 0:0,1,3,Soghomonyan Hrayr,Nazaryan Mushegh,fiurst,Nazaryan Mushegh - Soghomonyan Hrayr,71,40,31,-9,9,20,18,16,17,0,-2,4,-6,-5,0,-9,11:9 - 7:11 - 11:5 - 11:6 - 0:0
14501576,2023-10-09 11:10:00,Arutyunov Ruben - Diaryan Aleksandr,2:3,9:11 - 11:8 - 9:11 - 11:4 - 5:11,2,3,Arutyunov Ruben,Diaryan Aleksandr,fiurst,Arutyunov Ruben - Diaryan Aleksandr,90,45,45,0,0,20,19,20,15,16,2,-3,2,-7,6,0,9:11 - 11:8 - 9:11 - 11:4 - 5:11
14501568,2023-10-09 10:55:00,Papyan Karen - Nazaryan Mushegh,2:3,5:11 - 4:11 - 11:8 - 11:7 - 11:8,3,2,Papyan Karen,Nazaryan Mushegh,fiurst,Nazaryan Mushegh - Papyan Karen,87,45,42,-3,3,16,15,19,18,19,-6,-7,3,4,3,-3,11:5 - 11:4 - 8:11 - 7:11 - 8:11
14501557,2023-10-09 10:40:00,Soghomonyan Hrayr - Arutyunov Ruben,1:3,11:5 - 11:2 - 7:11 - 14:12 - 0:0,3,1,Soghomonyan Hrayr,Arutyunov Ruben,fiurst,Arutyunov Ruben - Soghomonyan Hrayr,73,30,43,13,-13,16,13,18,26,0,6,9,-4,2,0,13,5:11 - 2:11 - 11:7 - 12:14 - 0:0
14501551,2023-10-09 10:15:00,Nazaryan Mushegh - Diaryan Aleksandr,3:1,8:11 - 11:6 - 9:11 - 11:13 - 0:0,1,3,Nazaryan Mushegh,Diaryan Aleksandr,fiurst,Diaryan Aleksandr - Nazaryan Mushegh,80,41,39,-2,2,19,17,20,24,0,-3,5,-2,-2,0,-2,11:8 - 6:11 - 11:9 - 13:11 - 0:0
14501539,2023-10-09 10:10:00,Papyan Karen - Soghomonyan Hrayr,3:2,11:4 - 11:4 - 9:11 - 7:11 - 11:5,3,2,Papyan Karen,Soghomonyan Hrayr,fiurst,Papyan Karen - Soghomonyan Hrayr,84,49,35,-14,14,15,15,20,18,16,-7,-7,2,4,-6,-14,11:4 - 11:4 - 9:11 - 7:11 - 11:5
14482047,2023-10-08 17:30:00,Gevorgyan Hayk - Soghomonyan Hrayr,2:3,11:9 - 11:8 - 7:11 - 8:11 - 9:11,2,3,Gevorgyan Hayk,Soghomonyan Hrayr,fiurst,Gevorgyan Hayk - Soghomonyan Hrayr,96,46,50,4,-4,20,19,18,19,20,-2,-3,4,3,2,4,11:9 - 11:8 - 7:11 - 8:11 - 9:11
14482045,2023-10-08 17:15:00,Petrosyan Davit - Darbinyan Armen,0:3,11:6 - 15:13 - 11:1 - 0:0 - 0:0,3,0,Petrosyan Davit,Darbinyan Armen,fiurst,Darbinyan Armen - Petrosyan Davit,57,20,37,17,-17,17,28,12,0,0,5,2,10,0,0,17,6:11 - 13:15 - 1:11 - 0:0 - 0:0
14482044,2023-10-08 17:00:00,Grigoryan Erik - Gevorgyan Hayk,3:0,4:11 - 9:11 - 13:15 - 0:0 - 0:0,0,3,Grigoryan Erik,Gevorgyan Hayk,fiurst,Gevorgyan Hayk - Grigoryan Erik,63,37,26,-11,11,15,20,28,0,0,-7,-2,-2,0,0,-11,11:4 - 11:9 - 15:13 - 0:0 - 0:0
14482039,2023-10-08 16:45:00,Petrosyan Davit - Soghomonyan Hrayr,0:3,7:11 - 7:11 - 7:11 - 0:0 - 0:0,0,3,Petrosyan Davit,Soghomonyan Hrayr,fiurst,Petrosyan Davit - Soghomonyan Hrayr,54,21,33,12,-12,18,18,18,0,0,4,4,4,0,0,12,7:11 - 7:11 - 7:11 - 0:0 - 0:0
14482032,2023-10-08 16:30:00,Darbinyan Armen - Grigoryan Erik,1:3,11:6 - 9:11 - 6:11 - 8:11 - 0:0,1,3,Darbinyan Armen,Grigoryan Erik,fiurst,Darbinyan Armen - Grigoryan Erik,73,34,39,5,-5,17,20,17,19,0,-5,2,5,3,0,5,11:6 - 9:11 - 6:11 - 8:11 - 0:0
14482030,2023-10-08 16:15:00,Gevorgyan Hayk - Petrosyan Davit,3:0,13:11 - 11:5 - 11:4 - 0:0 - 0:0,3,0,Gevorgyan Hayk,Petrosyan Davit,fiurst,Gevorgyan Hayk - Petrosyan Davit,55,35,20,-15,15,24,16,15,0,0,-2,-6,-7,0,0,-15,13:11 - 11:5 - 11:4 - 0:0 - 0:0
14482027,2023-10-08 16:10:00,Soghomonyan Hrayr - Grigoryan Erik,0:3,11:8 - 11:7 - 11:7 - 0:0 - 0:0,3,0,Soghomonyan Hrayr,Grigoryan Erik,fiurst,Grigoryan Erik - Soghomonyan Hrayr,55,22,33,11,-11,19,18,18,0,0,3,4,4,0,0,11,8:11 - 7:11 - 7:11 - 0:0 - 0:0
14482005,2023-10-08 15:45:00,Darbinyan Armen - Gevorgyan Hayk,0:3,10:12 - 9:11 - 7:11 - 0:0 - 0:0,0,3,Darbinyan Armen,Gevorgyan Hayk,fiurst,Darbinyan Armen - Gevorgyan Hayk,60,26,34,8,-8,22,20,18,0,0,2,2,4,0,0,8,10:12 - 9:11 - 7:11 - 0:0 - 0:0
14482004,2023-10-08 15:30:00,Grigoryan Erik - Petrosyan Davit,2:3,11:1 - 12:14 - 8:11 - 11:8 - 5:11,2,3,Grigoryan Erik,Petrosyan Davit,fiurst,Grigoryan Erik - Petrosyan Davit,92,47,45,-2,2,12,26,19,19,16,-10,2,3,-3,6,-2,11:1 - 12:14 - 8:11 - 11:8 - 5:11
14481998,2023-10-08 15:15:00,Soghomonyan Hrayr - Darbinyan Armen,1:3,11:5 - 11:3 - 8:11 - 12:10 - 0:0,3,1,Soghomonyan Hrayr,Darbinyan Armen,fiurst,Darbinyan Armen - Soghomonyan Hrayr,71,29,42,13,-13,16,14,19,22,0,6,8,-3,2,0,13,5:11 - 3:11 - 11:8 - 10:12 - 0:0
14481994,2023-10-08 15:00:00,Rafayelyan Edgar - Papyan Karen,1:3,11:5 - 11:6 - 9:11 - 11:9 - 0:0,3,1,Rafayelyan Edgar,Papyan Karen,fiurst,Papyan Karen - Rafayelyan Edgar,73,31,42,11,-11,16,17,20,20,0,6,5,-2,2,0,11,5:11 - 6:11 - 11:9 - 9:11 - 0:0
14481991,2023-10-08 14:45:00,Nazaryan Mushegh - Antonyan Eduard,3:1,11:7 - 6:11 - 7:11 - 8:11 - 0:0,1,3,Nazaryan Mushegh,Antonyan Eduard,fiurst,Antonyan Eduard - Nazaryan Mushegh,72,40,32,-8,8,18,17,18,19,0,4,-5,-4,-3,0,-8,7:11 - 11:6 - 11:7 - 11:8 - 0:0
14481988,2023-10-08 14:35:00,Nikoghosyan Narek - Rafayelyan Edgar,1:3,4:11 - 11:9 - 7:11 - 4:11 - 0:0,1,3,Nikoghosyan Narek,Rafayelyan Edgar,fiurst,Nikoghosyan Narek - Rafayelyan Edgar,68,26,42,16,-16,15,20,18,15,0,7,-2,4,7,0,16,4:11 - 11:9 - 7:11 - 4:11 - 0:0
14481984,2023-10-08 14:20:00,Papyan Karen - Nazaryan Mushegh,1:3,11:4 - 11:7 - 9:11 - 11:8 - 0:0,3,1,Papyan Karen,Nazaryan Mushegh,fiurst,Nazaryan Mushegh - Papyan Karen,72,30,42,12,-12,15,18,20,19,0,7,4,-2,3,0,12,4:11 - 7:11 - 11:9 - 8:11 - 0:0
14481981,2023-10-08 14:10:00,Nikoghosyan Narek - Antonyan Eduard,3:1,9:11 - 11:7 - 9:11 - 4:11 - 0:0,1,3,Nikoghosyan Narek,Antonyan Eduard,fiurst,Antonyan Eduard - Nikoghosyan Narek,73,40,33,-7,7,20,18,20,15,0,-2,4,-2,-7,0,-7,11:9 - 7:11 - 11:9 - 11:4 - 0:0
14481977,2023-10-08 13:55:00,Rafayelyan Edgar - Nazaryan Mushegh,0:3,11:5 - 11:6 - 11:6 - 0:0 - 0:0,3,0,Rafayelyan Edgar,Nazaryan Mushegh,fiurst,Nazaryan Mushegh - Rafayelyan Edgar,50,17,33,16,-16,16,17,17,0,0,6,5,5,0,0,16,5:11 - 6:11 - 6:11 - 0:0 - 0:0
14481973,2023-10-08 13:45:00,Papyan Karen - Nikoghosyan Narek,1:3,13:11 - 11:8 - 6:11 - 11:8 - 0:0,3,1,Papyan Karen,Nikoghosyan Narek,fiurst,Nikoghosyan Narek - Papyan Karen,79,38,41,3,-3,24,19,17,19,0,2,3,-5,3,0,3,11:13 - 8:11 - 11:6 - 8:11 - 0:0
14481961,2023-10-08 13:30:00,Antonyan Eduard - Rafayelyan Edgar,1:3,7:11 - 11:8 - 7:11 - 7:11 - 0:0,1,3,Antonyan Eduard,Rafayelyan Edgar,fiurst,Antonyan Eduard - Rafayelyan Edgar,73,32,41,9,-9,18,19,18,18,0,4,-3,4,4,0,9,7:11 - 11:8 - 7:11 - 7:11 - 0:0
14481960,2023-10-08 13:10:00,Nazaryan Mushegh - Nikoghosyan Narek,3:2,11:7 - 11:4 - 7:11 - 6:11 - 11:8,3,2,Nazaryan Mushegh,Nikoghosyan Narek,fiurst,Nazaryan Mushegh - Nikoghosyan Narek,87,46,41,-5,5,18,15,18,17,19,-4,-7,4,5,-3,-5,11:7 - 11:4 - 7:11 - 6:11 - 11:8
14481943,2023-10-08 12:55:00,Antonyan Eduard - Papyan Karen,2:3,11:5 - 5:11 - 3:11 - 14:12 - 9:11,2,3,Antonyan Eduard,Papyan Karen,fiurst,Antonyan Eduard - Papyan Karen,92,42,50,8,-8,16,16,14,26,20,-6,6,8,-2,2,8,11:5 - 5:11 - 3:11 - 14:12 - 9:11
14481939,2023-10-08 12:15:00,Rafayelyan Edgar - Nikoghosyan Narek,3:2,9:11 - 5:11 - 11:9 - 15:13 - 14:16,2,3,Rafayelyan Edgar,Nikoghosyan Narek,fiurst,Nikoghosyan Narek - Rafayelyan Edgar,114,60,54,-6,6,20,16,20,28,30,-2,-6,2,2,-2,-6,11:9 - 11:5 - 9:11 - 13:15 - 16:14
14481934,2023-10-08 12:05:00,Antonyan Eduard - Nazaryan Mushegh,3:1,11:8 - 11:4 - 7:11 - 11:7 - 0:0,3,1,Antonyan Eduard,Nazaryan Mushegh,fiurst,Antonyan Eduard - Nazaryan Mushegh,70,40,30,-10,10,19,15,18,18,0,-3,-7,4,-4,0,-10,11:8 - 11:4 - 7:11 - 11:7 - 0:0
14481930,2023-10-08 11:50:00,Papyan Karen - Rafayelyan Edgar,3:0,11:9 - 11:9 - 11:8 - 0:0 - 0:0,3,0,Papyan Karen,Rafayelyan Edgar,fiurst,Papyan Karen - Rafayelyan Edgar,59,33,26,-7,7,20,20,19,0,0,-2,-2,-3,0,0,-7,11:9 - 11:9 - 11:8 - 0:0 - 0:0
14481929,2023-10-08 11:30:00,Antonyan Eduard - Nikoghosyan Narek,3:2,11:6 - 3:11 - 11:8 - 8:11 - 11:9,3,2,Antonyan Eduard,Nikoghosyan Narek,fiurst,Antonyan Eduard - Nikoghosyan Narek,89,44,45,1,-1,17,14,19,19,20,-5,8,-3,3,-2,1,11:6 - 3:11 - 11:8 - 8:11 - 11:9
14481928,2023-10-08 11:15:00,Nazaryan Mushegh - Papyan Karen,2:3,9:11 - 11:9 - 11:13 - 11:8 - 10:12,2,3,Nazaryan Mushegh,Papyan Karen,fiurst,Nazaryan Mushegh - Papyan Karen,105,52,53,1,-1,20,20,24,19,22,2,-2,2,-3,2,1,9:11 - 11:9 - 11:13 - 11:8 - 10:12
14481917,2023-10-08 11:00:00,Rafayelyan Edgar - Antonyan Eduard,1:3,5:11 - 11:9 - 11:5 - 11:5 - 0:0,3,1,Rafayelyan Edgar,Antonyan Eduard,fiurst,Antonyan Eduard - Rafayelyan Edgar,68,30,38,8,-8,16,20,16,16,0,-6,2,6,6,0,8,11:5 - 9:11 - 5:11 - 5:11 - 0:0
14481904,2023-10-08 10:45:00,Nikoghosyan Narek - Papyan Karen,1:3,6:11 - 11:6 - 9:11 - 9:11 - 0:0,1,3,Nikoghosyan Narek,Papyan Karen,fiurst,Nikoghosyan Narek - Papyan Karen,74,35,39,4,-4,17,17,20,20,0,5,-5,2,2,0,4,6:11 - 11:6 - 9:11 - 9:11 - 0:0
14481914,2023-10-08 10:35:00,Nazaryan Mushegh - Rafayelyan Edgar,0:3,10:12 - 4:11 - 7:11 - 0:0 - 0:0,0,3,Nazaryan Mushegh,Rafayelyan Edgar,fiurst,Nazaryan Mushegh - Rafayelyan Edgar,55,21,34,13,-13,22,15,18,0,0,2,7,4,0,0,13,10:12 - 4:11 - 7:11 - 0:0 - 0:0
14481899,2023-10-08 10:15:00,Papyan Karen - Antonyan Eduard,0:3,11:5 - 11:9 - 11:3 - 0:0 - 0:0,3,0,Papyan Karen,Antonyan Eduard,fiurst,Antonyan Eduard - Papyan Karen,50,17,33,16,-16,16,20,14,0,0,6,2,8,0,0,16,5:11 - 9:11 - 3:11 - 0:0 - 0:0
14481896,2023-10-08 10:10:00,Nikoghosyan Narek - Nazaryan Mushegh,0:3,11:8 - 11:4 - 11:6 - 0:0 - 0:0,3,0,Nikoghosyan Narek,Nazaryan Mushegh,fiurst,Nazaryan Mushegh - Nikoghosyan Narek,51,18,33,15,-15,19,15,17,0,0,3,7,5,0,0,15,8:11 - 4:11 - 6:11 - 0:0 - 0:0
14467486,2023-10-07 17:30:00,Mkrtchyan Andranik - Darbinyan Armen,0:3,12:10 - 18:16 - 11:6 - 0:0 - 0:0,3,0,Mkrtchyan Andranik,Darbinyan Armen,fiurst,Darbinyan Armen - Mkrtchyan Andranik,73,32,41,9,-9,22,34,17,0,0,2,2,5,0,0,9,10:12 - 16:18 - 6:11 - 0:0 - 0:0
14467484,2023-10-07 17:20:00,Grigoryan Erik - Petrosyan Davit,1:3,2:11 - 11:9 - 3:11 - 5:11 - 0:0,1,3,Grigoryan Erik,Petrosyan Davit,fiurst,Grigoryan Erik - Petrosyan Davit,63,21,42,21,-21,13,20,14,16,0,9,-2,8,6,0,21,2:11 - 11:9 - 3:11 - 5:11 - 0:0
14467480,2023-10-07 17:00:00,Soghomonyan Hrayr - Mkrtchyan Andranik,0:3,12:10 - 11:5 - 11:8 - 0:0 - 0:0,3,0,Soghomonyan Hrayr,Mkrtchyan Andranik,fiurst,Mkrtchyan Andranik - Soghomonyan Hrayr,57,23,34,11,-11,22,16,19,0,0,2,6,3,0,0,11,10:12 - 5:11 - 8:11 - 0:0 - 0:0
14467463,2023-10-07 16:45:00,Grigoryan Erik - Darbinyan Armen,3:2,11:7 - 10:12 - 9:11 - 12:10 - 10:12,2,3,Grigoryan Erik,Darbinyan Armen,fiurst,Darbinyan Armen - Grigoryan Erik,104,52,52,0,0,18,22,20,22,22,4,-2,-2,2,-2,0,7:11 - 12:10 - 11:9 - 10:12 - 12:10
14467453,2023-10-07 16:30:00,Petrosyan Davit - Soghomonyan Hrayr,2:3,9:11 - 9:11 - 11:9 - 11:8 - 5:11,2,3,Petrosyan Davit,Soghomonyan Hrayr,fiurst,Petrosyan Davit - Soghomonyan Hrayr,95,45,50,5,-5,20,20,20,19,16,2,2,-2,-3,6,5,9:11 - 9:11 - 11:9 - 11:8 - 5:11
14467438,2023-10-07 16:20:00,Mkrtchyan Andranik - Grigoryan Erik,3:0,3:11 - 3:11 - 9:11 - 0:0 - 0:0,0,3,Mkrtchyan Andranik,Grigoryan Erik,fiurst,Grigoryan Erik - Mkrtchyan Andranik,48,33,15,-18,18,14,14,20,0,0,-8,-8,-2,0,0,-18,11:3 - 11:3 - 11:9 - 0:0 - 0:0
14467436,2023-10-07 16:00:00,Darbinyan Armen - Soghomonyan Hrayr,0:3,7:11 - 6:11 - 5:11 - 0:0 - 0:0,0,3,Darbinyan Armen,Soghomonyan Hrayr,fiurst,Darbinyan Armen - Soghomonyan Hrayr,51,18,33,15,-15,18,17,16,0,0,4,5,6,0,0,15,7:11 - 6:11 - 5:11 - 0:0 - 0:0
14467435,2023-10-07 15:45:00,Petrosyan Davit - Mkrtchyan Andranik,1:3,11:7 - 9:11 - 11:9 - 11:5 - 0:0,3,1,Petrosyan Davit,Mkrtchyan Andranik,fiurst,Mkrtchyan Andranik - Petrosyan Davit,74,32,42,10,-10,18,20,20,16,0,4,-2,2,6,0,10,7:11 - 11:9 - 9:11 - 5:11 - 0:0
14467431,2023-10-07 15:30:00,Soghomonyan Hrayr - Grigoryan Erik,1:3,10:12 - 16:14 - 11:7 - 12:10 - 0:0,3,1,Soghomonyan Hrayr,Grigoryan Erik,fiurst,Grigoryan Erik - Soghomonyan Hrayr,92,43,49,6,-6,22,30,18,22,0,-2,2,4,2,0,6,12:10 - 14:16 - 7:11 - 10:12 - 0:0
14467427,2023-10-07 15:15:00,Darbinyan Armen - Petrosyan Davit,0:3,7:11 - 9:11 - 9:11 - 0:0 - 0:0,0,3,Darbinyan Armen,Petrosyan Davit,fiurst,Darbinyan Armen - Petrosyan Davit,58,25,33,8,-8,18,20,20,0,0,4,2,2,0,0,8,7:11 - 9:11 - 9:11 - 0:0 - 0:0
14467424,2023-10-07 15:00:00,Nikoghosyan Narek - Antonyan Eduard,2:3,11:5 - 6:11 - 11:5 - 6:11 - 11:7,3,2,Nikoghosyan Narek,Antonyan Eduard,fiurst,Antonyan Eduard - Nikoghosyan Narek,84,39,45,6,-6,16,17,16,17,18,6,-5,6,-5,4,6,5:11 - 11:6 - 5:11 - 11:6 - 7:11
14467420,2023-10-07 14:45:00,Rafayelyan Edgar - Arutyunov Ruben,0:3,12:10 - 11:6 - 11:8 - 0:0 - 0:0,3,0,Rafayelyan Edgar,Arutyunov Ruben,fiurst,Arutyunov Ruben - Rafayelyan Edgar,58,24,34,10,-10,22,17,19,0,0,2,5,3,0,0,10,10:12 - 6:11 - 8:11 - 0:0 - 0:0
14467406,2023-10-07 14:30:00,Papyan Karen - Nikoghosyan Narek,1:3,12:10 - 17:15 - 5:11 - 11:9 - 0:0,3,1,Papyan Karen,Nikoghosyan Narek,fiurst,Nikoghosyan Narek - Papyan Karen,90,45,45,0,0,22,32,16,20,0,2,2,-6,2,0,0,10:12 - 15:17 - 11:5 - 9:11 - 0:0
14467404,2023-10-07 14:20:00,Antonyan Eduard - Rafayelyan Edgar,3:1,11:7 - 7:11 - 11:7 - 11:5 - 0:0,3,1,Antonyan Eduard,Rafayelyan Edgar,fiurst,Antonyan Eduard - Rafayelyan Edgar,70,40,30,-10,10,18,18,18,16,0,-4,4,-4,-6,0,-10,11:7 - 7:11 - 11:7 - 11:5 - 0:0
14467402,2023-10-07 14:00:00,Papyan Karen - Arutyunov Ruben,0:3,11:8 - 12:10 - 11:8 - 0:0 - 0:0,3,0,Papyan Karen,Arutyunov Ruben,fiurst,Arutyunov Ruben - Papyan Karen,60,26,34,8,-8,19,22,19,0,0,3,2,3,0,0,8,8:11 - 10:12 - 8:11 - 0:0 - 0:0
14467399,2023-10-07 13:50:00,Nikoghosyan Narek - Rafayelyan Edgar,1:3,11:8 - 7:11 - 7:11 - 1:11 - 0:0,1,3,Nikoghosyan Narek,Rafayelyan Edgar,fiurst,Nikoghosyan Narek - Rafayelyan Edgar,67,26,41,15,-15,19,18,18,12,0,-3,4,4,10,0,15,11:8 - 7:11 - 7:11 - 1:11 - 0:0
14467396,2023-10-07 13:30:00,Antonyan Eduard - Papyan Karen,3:0,11:9 - 11:8 - 11:8 - 0:0 - 0:0,3,0,Antonyan Eduard,Papyan Karen,fiurst,Antonyan Eduard - Papyan Karen,58,33,25,-8,8,20,19,19,0,0,-2,-3,-3,0,0,-8,11:9 - 11:8 - 11:8 - 0:0 - 0:0
14467395,2023-10-07 13:20:00,Arutyunov Ruben - Nikoghosyan Narek,1:3,6:11 - 7:11 - 11:7 - 9:11 - 0:0,1,3,Arutyunov Ruben,Nikoghosyan Narek,fiurst,Arutyunov Ruben - Nikoghosyan Narek,73,33,40,7,-7,17,18,18,20,0,5,4,-4,2,0,7,6:11 - 7:11 - 11:7 - 9:11 - 0:0
14467384,2023-10-07 13:00:00,Rafayelyan Edgar - Papyan Karen,3:1,2:11 - 11:6 - 8:11 - 10:12 - 0:0,1,3,Rafayelyan Edgar,Papyan Karen,fiurst,Papyan Karen - Rafayelyan Edgar,71,40,31,-9,9,13,17,19,22,0,-9,5,-3,-2,0,-9,11:2 - 6:11 - 11:8 - 12:10 - 0:0
14467381,2023-10-07 12:55:00,Arutyunov Ruben - Antonyan Eduard,3:0,6:11 - 8:11 - 5:11 - 0:0 - 0:0,0,3,Arutyunov Ruben,Antonyan Eduard,fiurst,Antonyan Eduard - Arutyunov Ruben,52,33,19,-14,14,17,19,16,0,0,-5,-3,-6,0,0,-14,11:6 - 11:8 - 11:5 - 0:0 - 0:0
14467380,2023-10-07 12:40:00,Nikoghosyan Narek - Papyan Karen,3:0,11:8 - 11:5 - 11:4 - 0:0 - 0:0,3,0,Nikoghosyan Narek,Papyan Karen,fiurst,Nikoghosyan Narek - Papyan Karen,50,33,17,-16,16,19,16,15,0,0,-3,-6,-7,0,0,-16,11:8 - 11:5 - 11:4 - 0:0 - 0:0
14467377,2023-10-07 12:05:00,Antonyan Eduard - Nikoghosyan Narek,3:2,11:6 - 5:11 - 12:14 - 11:9 - 11:9,3,2,Antonyan Eduard,Nikoghosyan Narek,fiurst,Antonyan Eduard - Nikoghosyan Narek,99,50,49,-1,1,17,16,26,20,20,-5,6,2,-2,-2,-1,11:6 - 5:11 - 12:14 - 11:9 - 11:9
14467378,2023-10-07 12:05:00,Arutyunov Ruben - Rafayelyan Edgar,0:3,11:13 - 10:12 - 6:11 - 0:0 - 0:0,0,3,Arutyunov Ruben,Rafayelyan Edgar,fiurst,Arutyunov Ruben - Rafayelyan Edgar,63,27,36,9,-9,24,22,17,0,0,2,2,5,0,0,9,11:13 - 10:12 - 6:11 - 0:0 - 0:0
14467376,2023-10-07 11:40:00,Arutyunov Ruben - Papyan Karen,3:0,11:5 - 11:5 - 11:1 - 0:0 - 0:0,3,0,Arutyunov Ruben,Papyan Karen,fiurst,Arutyunov Ruben - Papyan Karen,44,33,11,-22,22,16,16,12,0,0,-6,-6,-10,0,0,-22,11:5 - 11:5 - 11:1 - 0:0 - 0:0
14467329,2023-10-07 11:25:00,Rafayelyan Edgar - Antonyan Eduard,2:3,7:11 - 3:11 - 11:7 - 11:5 - 11:9,3,2,Rafayelyan Edgar,Antonyan Eduard,fiurst,Antonyan Eduard - Rafayelyan Edgar,86,43,43,0,0,18,14,18,16,20,-4,-8,4,6,2,0,11:7 - 11:3 - 7:11 - 5:11 - 9:11
14467323,2023-10-07 11:00:00,Nikoghosyan Narek - Arutyunov Ruben,2:3,11:7 - 7:11 - 11:7 - 8:11 - 11:7,3,2,Nikoghosyan Narek,Arutyunov Ruben,fiurst,Arutyunov Ruben - Nikoghosyan Narek,91,43,48,5,-5,18,18,18,19,18,4,-4,4,-3,4,5,7:11 - 11:7 - 7:11 - 11:8 - 7:11
14467322,2023-10-07 10:45:00,Papyan Karen - Antonyan Eduard,2:3,11:6 - 10:12 - 11:5 - 9:11 - 14:12,3,2,Papyan Karen,Antonyan Eduard,fiurst,Antonyan Eduard - Papyan Karen,101,46,55,9,-9,17,22,16,20,26,5,-2,6,-2,2,9,6:11 - 12:10 - 5:11 - 11:9 - 12:14
14467317,2023-10-07 10:30:00,Rafayelyan Edgar - Nikoghosyan Narek,0:3,11:7 - 11:9 - 14:12 - 0:0 - 0:0,3,0,Rafayelyan Edgar,Nikoghosyan Narek,fiurst,Nikoghosyan Narek - Rafayelyan Edgar,64,28,36,8,-8,18,20,26,0,0,4,2,2,0,0,8,7:11 - 9:11 - 12:14 - 0:0 - 0:0
14467304,2023-10-07 10:15:00,Antonyan Eduard - Arutyunov Ruben,3:1,10:12 - 11:8 - 14:12 - 11:5 - 0:0,3,1,Antonyan Eduard,Arutyunov Ruben,fiurst,Antonyan Eduard - Arutyunov Ruben,83,46,37,-9,9,22,19,26,16,0,2,-3,-2,-6,0,-9,10:12 - 11:8 - 14:12 - 11:5 - 0:0
14467299,2023-10-07 10:05:00,Papyan Karen - Rafayelyan Edgar,0:3,10:12 - 12:14 - 10:12 - 0:0 - 0:0,0,3,Papyan Karen,Rafayelyan Edgar,fiurst,Papyan Karen - Rafayelyan Edgar,70,32,38,6,-6,22,26,22,0,0,2,2,2,0,0,6,10:12 - 12:14 - 10:12 - 0:0 - 0:0
14449515,2023-10-06 17:30:00,Darbinyan Armen - Gevorgyan Hayk,0:3,10:12 - 7:11 - 4:11 - 0:0 - 0:0,0,3,Darbinyan Armen,Gevorgyan Hayk,fiurst,Darbinyan Armen - Gevorgyan Hayk,55,21,34,13,-13,22,18,15,0,0,2,4,7,0,0,13,10:12 - 7:11 - 4:11 - 0:0 - 0:0
14449509,2023-10-06 17:15:00,Petrosyan Davit - Mkrtchyan Andranik,3:1,7:11 - 11:8 - 11:13 - 8:11 - 0:0,1,3,Petrosyan Davit,Mkrtchyan Andranik,fiurst,Mkrtchyan Andranik - Petrosyan Davit,80,43,37,-6,6,18,19,24,19,0,-4,3,-2,-3,0,-6,11:7 - 8:11 - 13:11 - 11:8 - 0:0
14449488,2023-10-06 17:00:00,Avakimyan Davit - Darbinyan Armen,3:0,11:6 - 11:6 - 11:8 - 0:0 - 0:0,3,0,Avakimyan Davit,Darbinyan Armen,fiurst,Avakimyan Davit - Darbinyan Armen,53,33,20,-13,13,17,17,19,0,0,-5,-5,-3,0,0,-13,11:6 - 11:6 - 11:8 - 0:0 - 0:0
14449486,2023-10-06 16:45:00,Petrosyan Davit - Gevorgyan Hayk,3:0,10:12 - 9:11 - 5:11 - 0:0 - 0:0,0,3,Petrosyan Davit,Gevorgyan Hayk,fiurst,Gevorgyan Hayk - Petrosyan Davit,58,34,24,-10,10,22,20,16,0,0,-2,-2,-6,0,0,-10,12:10 - 11:9 - 11:5 - 0:0 - 0:0
14449485,2023-10-06 16:40:00,Mkrtchyan Andranik - Avakimyan Davit,3:1,11:9 - 7:11 - 11:13 - 10:12 - 0:0,1,3,Mkrtchyan Andranik,Avakimyan Davit,fiurst,Avakimyan Davit - Mkrtchyan Andranik,84,45,39,-6,6,20,18,24,22,0,2,-4,-2,-2,0,-6,9:11 - 11:7 - 13:11 - 12:10 - 0:0
14449483,2023-10-06 16:15:00,Darbinyan Armen - Petrosyan Davit,0:3,4:11 - 5:11 - 5:11 - 0:0 - 0:0,0,3,Darbinyan Armen,Petrosyan Davit,fiurst,Darbinyan Armen - Petrosyan Davit,47,14,33,19,-19,15,16,16,0,0,7,6,6,0,0,19,4:11 - 5:11 - 5:11 - 0:0 - 0:0
14449478,2023-10-06 16:05:00,Gevorgyan Hayk - Avakimyan Davit,2:3,5:11 - 9:11 - 12:10 - 11:8 - 11:6,3,2,Gevorgyan Hayk,Avakimyan Davit,fiurst,Avakimyan Davit - Gevorgyan Hayk,94,46,48,2,-2,16,20,22,19,17,-6,-2,2,3,5,2,11:5 - 11:9 - 10:12 - 8:11 - 6:11
14449465,2023-10-06 15:45:00,Mkrtchyan Andranik - Darbinyan Armen,1:3,11:7 - 9:11 - 11:3 - 11:8 - 1:0,3,1,Mkrtchyan Andranik,Darbinyan Armen,fiurst,Darbinyan Armen - Mkrtchyan Andranik,72,29,43,14,-14,18,20,14,19,1,4,-2,8,3,1,14,7:11 - 11:9 - 3:11 - 8:11 - 0:1
14449464,2023-10-06 15:30:00,Avakimyan Davit - Petrosyan Davit,3:2,9:11 - 7:11 - 11:5 - 11:8 - 11:7,3,2,Avakimyan Davit,Petrosyan Davit,fiurst,Avakimyan Davit - Petrosyan Davit,91,49,42,-7,7,20,18,16,19,18,2,4,-6,-3,-4,-7,9:11 - 7:11 - 11:5 - 11:8 - 11:7
14449463,2023-10-06 15:15:00,Gevorgyan Hayk - Mkrtchyan Andranik,3:0,11:4 - 11:6 - 11:8 - 0:0 - 0:0,3,0,Gevorgyan Hayk,Mkrtchyan Andranik,fiurst,Gevorgyan Hayk - Mkrtchyan Andranik,51,33,18,-15,15,15,17,19,0,0,-7,-5,-3,0,0,-15,11:4 - 11:6 - 11:8 - 0:0 - 0:0
14449314,2023-10-06 15:05:00,Papyan Karen - Nazaryan Mushegh,0:3,11:3 - 11:4 - 11:5 - 0:0 - 0:0,3,0,Papyan Karen,Nazaryan Mushegh,fiurst,Nazaryan Mushegh - Papyan Karen,45,12,33,21,-21,14,15,16,0,0,8,7,6,0,0,21,3:11 - 4:11 - 5:11 - 0:0 - 0:0
14449313,2023-10-06 14:50:00,Nikoghosyan Narek - Diaryan Aleksandr,3:1,11:7 - 4:11 - 8:11 - 4:11 - 0:0,1,3,Nikoghosyan Narek,Diaryan Aleksandr,fiurst,Diaryan Aleksandr - Nikoghosyan Narek,67,40,27,-13,13,18,15,19,15,0,4,-7,-3,-7,0,-13,7:11 - 11:4 - 11:8 - 11:4 - 0:0
14449304,2023-10-06 14:30:00,Arutyunov Ruben - Papyan Karen,2:3,9:11 - 11:6 - 8:11 - 11:9 - 5:11,2,3,Arutyunov Ruben,Papyan Karen,fiurst,Arutyunov Ruben - Papyan Karen,92,44,48,4,-4,20,17,19,20,16,2,-5,3,-2,6,4,9:11 - 11:6 - 8:11 - 11:9 - 5:11
14449302,2023-10-06 14:20:00,Nazaryan Mushegh - Nikoghosyan Narek,3:1,11:7 - 4:11 - 11:6 - 11:9 - 0:0,3,1,Nazaryan Mushegh,Nikoghosyan Narek,fiurst,Nazaryan Mushegh - Nikoghosyan Narek,70,37,33,-4,4,18,15,17,20,0,-4,7,-5,-2,0,-4,11:7 - 4:11 - 11:6 - 11:9 - 0:0
14449301,2023-10-06 14:00:00,Arutyunov Ruben - Diaryan Aleksandr,0:3,9:11 - 7:11 - 6:11 - 0:0 - 0:0,0,3,Arutyunov Ruben,Diaryan Aleksandr,fiurst,Arutyunov Ruben - Diaryan Aleksandr,55,22,33,11,-11,20,18,17,0,0,2,4,5,0,0,11,9:11 - 7:11 - 6:11 - 0:0 - 0:0
14449287,2023-10-06 13:45:00,Papyan Karen - Nikoghosyan Narek,3:2,2:11 - 11:9 - 11:8 - 5:11 - 10:12,2,3,Papyan Karen,Nikoghosyan Narek,fiurst,Nikoghosyan Narek - Papyan Karen,90,51,39,-12,12,13,20,19,16,22,-9,2,3,-6,-2,-12,11:2 - 9:11 - 8:11 - 11:5 - 12:10
14449284,2023-10-06 13:30:00,Nazaryan Mushegh - Arutyunov Ruben,0:3,11:9 - 11:5 - 11:7 - 0:0 - 0:0,3,0,Nazaryan Mushegh,Arutyunov Ruben,fiurst,Arutyunov Ruben - Nazaryan Mushegh,54,21,33,12,-12,20,16,18,0,0,2,6,4,0,0,12,9:11 - 5:11 - 7:11 - 0:0 - 0:0
14449283,2023-10-06 13:15:00,Diaryan Aleksandr - Papyan Karen,3:0,11:4 - 11:3 - 11:6 - 0:0 - 0:0,3,0,Diaryan Aleksandr,Papyan Karen,fiurst,Diaryan Aleksandr - Papyan Karen,46,33,13,-20,20,15,14,17,0,0,-7,-8,-5,0,0,-20,11:4 - 11:3 - 11:6 - 0:0 - 0:0
14449267,2023-10-06 13:05:00,Nikoghosyan Narek - Arutyunov Ruben,0:3,11:6 - 11:7 - 11:5 - 0:0 - 0:0,3,0,Nikoghosyan Narek,Arutyunov Ruben,fiurst,Arutyunov Ruben - Nikoghosyan Narek,51,18,33,15,-15,17,18,16,0,0,5,4,6,0,0,15,6:11 - 7:11 - 5:11 - 0:0 - 0:0
14449264,2023-10-06 12:55:00,Diaryan Aleksandr - Nazaryan Mushegh,3:1,11:7 - 11:6 - 8:11 - 11:5 - 0:0,3,1,Diaryan Aleksandr,Nazaryan Mushegh,fiurst,Diaryan Aleksandr - Nazaryan Mushegh,70,41,29,-12,12,18,17,19,16,0,-4,-5,3,-6,0,-12,11:7 - 11:6 - 8:11 - 11:5 - 0:0
14449262,2023-10-06 12:30:00,Papyan Karen - Arutyunov Ruben,1:3,13:11 - 11:13 - 13:11 - 11:7 - 0:0,3,1,Papyan Karen,Arutyunov Ruben,fiurst,Arutyunov Ruben - Papyan Karen,90,42,48,6,-6,24,24,24,18,0,2,-2,2,4,0,6,11:13 - 13:11 - 11:13 - 7:11 - 0:0
14449230,2023-10-06 12:00:00,Nazaryan Mushegh - Papyan Karen,2:3,16:14 - 11:6 - 9:11 - 7:11 - 8:11,2,3,Nazaryan Mushegh,Papyan Karen,fiurst,Nazaryan Mushegh - Papyan Karen,104,51,53,2,-2,30,17,20,18,19,-2,-5,2,4,3,2,16:14 - 11:6 - 9:11 - 7:11 - 8:11
14449232,2023-10-06 12:00:00,Diaryan Aleksandr - Nikoghosyan Narek,3:2,11:7 - 9:11 - 11:7 - 8:11 - 11:9,3,2,Diaryan Aleksandr,Nikoghosyan Narek,fiurst,Diaryan Aleksandr - Nikoghosyan Narek,95,50,45,-5,5,18,20,18,19,20,-4,2,-4,3,-2,-5,11:7 - 9:11 - 11:7 - 8:11 - 11:9
14449215,2023-10-06 11:30:00,Nikoghosyan Narek - Nazaryan Mushegh,1:3,11:8 - 10:12 - 11:5 - 11:7 - 0:0,3,1,Nikoghosyan Narek,Nazaryan Mushegh,fiurst,Nazaryan Mushegh - Nikoghosyan Narek,75,32,43,11,-11,19,22,16,18,0,3,-2,6,4,0,11,8:11 - 12:10 - 5:11 - 7:11 - 0:0
14449219,2023-10-06 11:30:00,Diaryan Aleksandr - Arutyunov Ruben,0:3,14:12 - 11:6 - 11:4 - 0:0 - 0:0,3,0,Diaryan Aleksandr,Arutyunov Ruben,fiurst,Arutyunov Ruben - Diaryan Aleksandr,58,22,36,14,-14,26,17,15,0,0,2,5,7,0,0,14,12:14 - 6:11 - 4:11 - 0:0 - 0:0
14449214,2023-10-06 11:00:00,Papyan Karen - Diaryan Aleksandr,1:3,11:4 - 11:9 - 4:11 - 11:1 - 0:0,3,1,Papyan Karen,Diaryan Aleksandr,fiurst,Diaryan Aleksandr - Papyan Karen,62,25,37,12,-12,15,20,15,12,0,7,2,-7,10,0,12,4:11 - 9:11 - 11:4 - 1:11 - 0:0
14449208,2023-10-06 10:45:00,Arutyunov Ruben - Nazaryan Mushegh,0:3,8:11 - 9:11 - 9:11 - 0:0 - 0:0,0,3,Arutyunov Ruben,Nazaryan Mushegh,fiurst,Arutyunov Ruben - Nazaryan Mushegh,59,26,33,7,-7,19,20,20,0,0,3,2,2,0,0,7,8:11 - 9:11 - 9:11 - 0:0 - 0:0
14449204,2023-10-06 10:35:00,Nikoghosyan Narek - Papyan Karen,3:1,11:6 - 4:11 - 11:3 - 11:8 - 0:0,3,1,Nikoghosyan Narek,Papyan Karen,fiurst,Nikoghosyan Narek - Papyan Karen,65,37,28,-9,9,17,15,14,19,0,-5,7,-8,-3,0,-9,11:6 - 4:11 - 11:3 - 11:8 - 0:0
14449193,2023-10-06 10:15:00,Nazaryan Mushegh - Diaryan Aleksandr,3:1,10:12 - 9:11 - 11:8 - 5:11 - 0:0,1,3,Nazaryan Mushegh,Diaryan Aleksandr,fiurst,Diaryan Aleksandr - Nazaryan Mushegh,77,42,35,-7,7,22,20,19,16,0,-2,-2,3,-6,0,-7,12:10 - 11:9 - 8:11 - 11:5 - 0:0
14449191,2023-10-06 10:05:00,Arutyunov Ruben - Nikoghosyan Narek,0:3,8:11 - 12:14 - 4:11 - 0:0 - 0:0,0,3,Arutyunov Ruben,Nikoghosyan Narek,fiurst,Arutyunov Ruben - Nikoghosyan Narek,60,24,36,12,-12,19,26,15,0,0,3,2,7,0,0,12,8:11 - 12:14 - 4:11 - 0:0 - 0:0
14428369,2023-10-05 17:30:00,Grigoryan Erik - Petrosyan Davit,0:3,11:13 - 3:11 - 4:11 - 0:0 - 0:0,0,3,Grigoryan Erik,Petrosyan Davit,fiurst,Grigoryan Erik - Petrosyan Davit,53,18,35,17,-17,24,14,15,0,0,2,8,7,0,0,17,11:13 - 3:11 - 4:11 - 0:0 - 0:0
14428359,2023-10-05 17:15:00,Soghomonyan Hrayr - Avakimyan Davit,3:1,11:8 - 9:11 - 8:11 - 7:11 - 0:0,1,3,Soghomonyan Hrayr,Avakimyan Davit,fiurst,Avakimyan Davit - Soghomonyan Hrayr,76,41,35,-6,6,19,20,19,18,0,3,-2,-3,-4,0,-6,8:11 - 11:9 - 11:8 - 11:7 - 0:0
14428358,2023-10-05 17:00:00,Gevorgyan Hayk - Grigoryan Erik,3:0,11:7 - 11:5 - 11:5 - 0:0 - 0:0,3,0,Gevorgyan Hayk,Grigoryan Erik,fiurst,Gevorgyan Hayk - Grigoryan Erik,50,33,17,-16,16,18,16,16,0,0,-4,-6,-6,0,0,-16,11:7 - 11:5 - 11:5 - 0:0 - 0:0
14428354,2023-10-05 16:45:00,Soghomonyan Hrayr - Petrosyan Davit,0:3,11:3 - 11:3 - 11:3 - 0:0 - 0:0,3,0,Soghomonyan Hrayr,Petrosyan Davit,fiurst,Petrosyan Davit - Soghomonyan Hrayr,42,9,33,24,-24,14,14,14,0,0,8,8,8,0,0,24,3:11 - 3:11 - 3:11 - 0:0 - 0:0
14428353,2023-10-05 16:30:00,Avakimyan Davit - Gevorgyan Hayk,0:3,11:13 - 8:11 - 8:11 - 0:0 - 0:0,0,3,Avakimyan Davit,Gevorgyan Hayk,fiurst,Avakimyan Davit - Gevorgyan Hayk,62,27,35,8,-8,24,19,19,0,0,2,3,3,0,0,8,11:13 - 8:11 - 8:11 - 0:0 - 0:0
14428349,2023-10-05 16:15:00,Grigoryan Erik - Soghomonyan Hrayr,1:3,8:11 - 6:11 - 14:12 - 6:11 - 0:0,1,3,Grigoryan Erik,Soghomonyan Hrayr,fiurst,Grigoryan Erik - Soghomonyan Hrayr,79,34,45,11,-11,19,17,26,17,0,3,5,-2,5,0,11,8:11 - 6:11 - 14:12 - 6:11 - 0:0
14428338,2023-10-05 16:05:00,Petrosyan Davit - Gevorgyan Hayk,3:0,6:11 - 7:11 - 6:11 - 0:0 - 0:0,0,3,Petrosyan Davit,Gevorgyan Hayk,fiurst,Gevorgyan Hayk - Petrosyan Davit,52,33,19,-14,14,17,18,17,0,0,-5,-4,-5,0,0,-14,11:6 - 11:7 - 11:6 - 0:0 - 0:0
14428336,2023-10-05 15:45:00,Avakimyan Davit - Grigoryan Erik,3:0,11:6 - 11:9 - 11:8 - 0:0 - 0:0,3,0,Avakimyan Davit,Grigoryan Erik,fiurst,Avakimyan Davit - Grigoryan Erik,56,33,23,-10,10,17,20,19,0,0,-5,-2,-3,0,0,-10,11:6 - 11:9 - 11:8 - 0:0 - 0:0
14428335,2023-10-05 15:30:00,Gevorgyan Hayk - Soghomonyan Hrayr,2:3,12:14 - 11:7 - 11:7 - 10:12 - 4:11,2,3,Gevorgyan Hayk,Soghomonyan Hrayr,fiurst,Gevorgyan Hayk - Soghomonyan Hrayr,99,48,51,3,-3,26,18,18,22,15,2,-4,-4,2,7,3,12:14 - 11:7 - 11:7 - 10:12 - 4:11
14428333,2023-10-05 15:15:00,Petrosyan Davit - Avakimyan Davit,3:0,8:11 - 3:11 - 9:11 - 0:0 - 0:0,0,3,Petrosyan Davit,Avakimyan Davit,fiurst,Avakimyan Davit - Petrosyan Davit,53,33,20,-13,13,19,14,20,0,0,-3,-8,-2,0,0,-13,11:8 - 11:3 - 11:9 - 0:0 - 0:0
14428330,2023-10-05 15:00:00,Antonyan Eduard - Diaryan Aleksandr,3:0,11:6 - 11:6 - 11:7 - 0:0 - 0:0,3,0,Antonyan Eduard,Diaryan Aleksandr,fiurst,Antonyan Eduard - Diaryan Aleksandr,52,33,19,-14,14,17,17,18,0,0,-5,-5,-4,0,0,-14,11:6 - 11:6 - 11:7 - 0:0 - 0:0
14428327,2023-10-05 14:55:00,Arutyunov Ruben - Rafayelyan Edgar,1:3,4:11 - 7:11 - 11:9 - 3:11 - 0:0,1,3,Arutyunov Ruben,Rafayelyan Edgar,fiurst,Arutyunov Ruben - Rafayelyan Edgar,67,25,42,17,-17,15,18,20,14,0,7,4,-2,8,0,17,4:11 - 7:11 - 11:9 - 3:11 - 0:0
14428326,2023-10-05 14:35:00,Nazaryan Mushegh - Antonyan Eduard,3:1,11:8 - 8:11 - 5:11 - 6:11 - 0:0,1,3,Nazaryan Mushegh,Antonyan Eduard,fiurst,Antonyan Eduard - Nazaryan Mushegh,71,41,30,-11,11,19,19,16,17,0,3,-3,-6,-5,0,-11,8:11 - 11:8 - 11:5 - 11:6 - 0:0
14428315,2023-10-05 14:25:00,Diaryan Aleksandr - Arutyunov Ruben,0:3,12:10 - 11:9 - 11:6 - 0:0 - 0:0,3,0,Diaryan Aleksandr,Arutyunov Ruben,fiurst,Arutyunov Ruben - Diaryan Aleksandr,59,25,34,9,-9,22,20,17,0,0,2,2,5,0,0,9,10:12 - 9:11 - 6:11 - 0:0 - 0:0
14428312,2023-10-05 14:00:00,Nazaryan Mushegh - Rafayelyan Edgar,3:1,17:15 - 9:11 - 11:8 - 11:9 - 0:0,3,1,Nazaryan Mushegh,Rafayelyan Edgar,fiurst,Nazaryan Mushegh - Rafayelyan Edgar,91,48,43,-5,5,32,20,19,20,0,-2,2,-3,-2,0,-5,17:15 - 9:11 - 11:8 - 11:9 - 0:0
14428310,2023-10-05 13:45:00,Antonyan Eduard - Arutyunov Ruben,2:3,11:9 - 8:11 - 11:4 - 9:11 - 9:11,2,3,Antonyan Eduard,Arutyunov Ruben,fiurst,Antonyan Eduard - Arutyunov Ruben,94,48,46,-2,2,20,19,15,20,20,-2,3,-7,2,2,-2,11:9 - 8:11 - 11:4 - 9:11 - 9:11
14428308,2023-10-05 13:35:00,Diaryan Aleksandr - Nazaryan Mushegh,3:1,11:6 - 6:11 - 11:4 - 11:2 - 0:0,3,1,Diaryan Aleksandr,Nazaryan Mushegh,fiurst,Diaryan Aleksandr - Nazaryan Mushegh,62,39,23,-16,16,17,17,15,13,0,-5,5,-7,-9,0,-16,11:6 - 6:11 - 11:4 - 11:2 - 0:0
14428304,2023-10-05 13:15:00,Rafayelyan Edgar - Antonyan Eduard,1:3,3:11 - 11:6 - 11:9 - 11:8 - 0:0,3,1,Rafayelyan Edgar,Antonyan Eduard,fiurst,Antonyan Eduard - Rafayelyan Edgar,70,34,36,2,-2,14,17,20,19,0,-8,5,2,3,0,2,11:3 - 6:11 - 9:11 - 8:11 - 0:0
14428302,2023-10-05 13:00:00,Arutyunov Ruben - Nazaryan Mushegh,3:1,11:5 - 11:8 - 7:11 - 12:10 - 0:0,3,1,Arutyunov Ruben,Nazaryan Mushegh,fiurst,Arutyunov Ruben - Nazaryan Mushegh,75,41,34,-7,7,16,19,18,22,0,-6,-3,4,-2,0,-7,11:5 - 11:8 - 7:11 - 12:10 - 0:0
14428291,2023-10-05 12:45:00,Rafayelyan Edgar - Diaryan Aleksandr,1:3,5:11 - 11:8 - 11:8 - 11:6 - 0:0,3,1,Rafayelyan Edgar,Diaryan Aleksandr,fiurst,Diaryan Aleksandr - Rafayelyan Edgar,71,33,38,5,-5,16,19,19,17,0,-6,3,3,5,0,5,11:5 - 8:11 - 8:11 - 6:11 - 0:0
14428255,2023-10-05 12:15:00,Antonyan Eduard - Nazaryan Mushegh,3:0,11:6 - 11:4 - 11:7 - 0:0 - 0:0,3,0,Antonyan Eduard,Nazaryan Mushegh,fiurst,Antonyan Eduard - Nazaryan Mushegh,50,33,17,-16,16,17,15,18,0,0,-5,-7,-4,0,0,-16,11:6 - 11:4 - 11:7 - 0:0 - 0:0
14428250,2023-10-05 12:00:00,Rafayelyan Edgar - Arutyunov Ruben,1:3,8:11 - 11:5 - 11:7 - 11:6 - 0:0,3,1,Rafayelyan Edgar,Arutyunov Ruben,fiurst,Arutyunov Ruben - Rafayelyan Edgar,70,29,41,12,-12,19,16,18,17,0,-3,6,4,5,0,12,11:8 - 5:11 - 7:11 - 6:11 - 0:0
14428248,2023-10-05 11:50:00,Diaryan Aleksandr - Antonyan Eduard,0:3,11:3 - 11:7 - 11:5 - 0:0 - 0:0,3,0,Diaryan Aleksandr,Antonyan Eduard,fiurst,Antonyan Eduard - Diaryan Aleksandr,48,15,33,18,-18,14,18,16,0,0,8,4,6,0,0,18,3:11 - 7:11 - 5:11 - 0:0 - 0:0
14428243,2023-10-05 11:30:00,Rafayelyan Edgar - Nazaryan Mushegh,0:3,11:9 - 11:5 - 11:5 - 0:0 - 0:0,3,0,Rafayelyan Edgar,Nazaryan Mushegh,fiurst,Nazaryan Mushegh - Rafayelyan Edgar,52,19,33,14,-14,20,16,16,0,0,2,6,6,0,0,14,9:11 - 5:11 - 5:11 - 0:0 - 0:0
14428234,2023-10-05 11:20:00,Arutyunov Ruben - Diaryan Aleksandr,2:3,11:8 - 11:9 - 4:11 - 8:11 - 5:11,2,3,Arutyunov Ruben,Diaryan Aleksandr,fiurst,Arutyunov Ruben - Diaryan Aleksandr,89,39,50,11,-11,19,20,15,19,16,-3,-2,7,3,6,11,11:8 - 11:9 - 4:11 - 8:11 - 5:11
14428233,2023-10-05 11:05:00,Antonyan Eduard - Rafayelyan Edgar,0:3,7:11 - 5:11 - 5:11 - 0:0 - 0:0,0,3,Antonyan Eduard,Rafayelyan Edgar,fiurst,Antonyan Eduard - Rafayelyan Edgar,50,17,33,16,-16,18,16,16,0,0,4,6,6,0,0,16,7:11 - 5:11 - 5:11 - 0:0 - 0:0
14428231,2023-10-05 10:45:00,Nazaryan Mushegh - Diaryan Aleksandr,3:1,7:11 - 6:11 - 11:9 - 8:11 - 0:0,1,3,Nazaryan Mushegh,Diaryan Aleksandr,fiurst,Diaryan Aleksandr - Nazaryan Mushegh,74,42,32,-10,10,18,17,20,19,0,-4,-5,2,-3,0,-10,11:7 - 11:6 - 9:11 - 11:8 - 0:0
14427166,2023-10-05 10:30:00,Arutyunov Ruben - Antonyan Eduard,3:2,8:11 - 14:12 - 4:11 - 11:4 - 8:11,2,3,Arutyunov Ruben,Antonyan Eduard,fiurst,Antonyan Eduard - Arutyunov Ruben,94,49,45,-4,4,19,26,15,15,19,-3,2,-7,7,-3,-4,11:8 - 12:14 - 11:4 - 4:11 - 11:8
14427153,2023-10-05 10:15:00,Diaryan Aleksandr - Rafayelyan Edgar,2:3,11:5 - 11:13 - 11:8 - 4:11 - 4:11,2,3,Diaryan Aleksandr,Rafayelyan Edgar,fiurst,Diaryan Aleksandr - Rafayelyan Edgar,89,41,48,7,-7,16,24,19,15,15,-6,2,-3,7,7,7,11:5 - 11:13 - 11:8 - 4:11 - 4:11
14427149,2023-10-05 10:00:00,Nazaryan Mushegh - Arutyunov Ruben,3:1,8:11 - 10:12 - 11:6 - 8:11 - 0:0,1,3,Nazaryan Mushegh,Arutyunov Ruben,fiurst,Arutyunov Ruben - Nazaryan Mushegh,77,40,37,-3,3,19,22,17,19,0,-3,-2,5,-3,0,-3,11:8 - 12:10 - 6:11 - 11:8 - 0:0
14411986,2023-10-04 17:30:00,Darbinyan Armen - Grigoryan Erik,0:3,6:11 - 10:12 - 6:11 - 0:0 - 0:0,0,3,Darbinyan Armen,Grigoryan Erik,fiurst,Darbinyan Armen - Grigoryan Erik,56,22,34,12,-12,17,22,17,0,0,5,2,5,0,0,12,6:11 - 10:12 - 6:11 - 0:0 - 0:0
14411985,2023-10-04 17:15:00,Gevorgyan Hayk - Soghomonyan Hrayr,0:3,11:13 - 4:11 - 10:12 - 0:0 - 0:0,0,3,Gevorgyan Hayk,Soghomonyan Hrayr,fiurst,Gevorgyan Hayk - Soghomonyan Hrayr,61,25,36,11,-11,24,15,22,0,0,2,7,2,0,0,11,11:13 - 4:11 - 10:12 - 0:0 - 0:0
14411981,2023-10-04 17:00:00,Mkrtchyan Andranik - Darbinyan Armen,1:3,11:5 - 10:12 - 11:6 - 11:4 - 0:0,3,1,Mkrtchyan Andranik,Darbinyan Armen,fiurst,Darbinyan Armen - Mkrtchyan Andranik,70,27,43,16,-16,16,22,17,15,0,6,-2,5,7,0,16,5:11 - 12:10 - 6:11 - 4:11 - 0:0
14411980,2023-10-04 16:45:00,Gevorgyan Hayk - Grigoryan Erik,3:1,11:7 - 9:11 - 11:7 - 11:3 - 0:0,3,1,Gevorgyan Hayk,Grigoryan Erik,fiurst,Gevorgyan Hayk - Grigoryan Erik,70,42,28,-14,14,18,20,18,14,0,-4,2,-4,-8,0,-14,11:7 - 9:11 - 11:7 - 11:3 - 0:0
14411974,2023-10-04 16:30:00,Soghomonyan Hrayr - Mkrtchyan Andranik,3:1,8:11 - 11:5 - 6:11 - 6:11 - 0:0,1,3,Soghomonyan Hrayr,Mkrtchyan Andranik,fiurst,Mkrtchyan Andranik - Soghomonyan Hrayr,69,38,31,-7,7,19,16,17,17,0,-3,6,-5,-5,0,-7,11:8 - 5:11 - 11:6 - 11:6 - 0:0
14411970,2023-10-04 16:15:00,Darbinyan Armen - Gevorgyan Hayk,0:3,7:11 - 4:11 - 5:11 - 0:0 - 0:0,0,3,Darbinyan Armen,Gevorgyan Hayk,fiurst,Darbinyan Armen - Gevorgyan Hayk,49,16,33,17,-17,18,15,16,0,0,4,7,6,0,0,17,7:11 - 4:11 - 5:11 - 0:0 - 0:0
14411969,2023-10-04 16:00:00,Grigoryan Erik - Mkrtchyan Andranik,0:3,10:12 - 8:11 - 8:11 - 0:0 - 0:0,0,3,Grigoryan Erik,Mkrtchyan Andranik,fiurst,Grigoryan Erik - Mkrtchyan Andranik,60,26,34,8,-8,22,19,19,0,0,2,3,3,0,0,8,10:12 - 8:11 - 8:11 - 0:0 - 0:0
14411968,2023-10-04 15:45:00,Soghomonyan Hrayr - Darbinyan Armen,0:3,11:9 - 11:4 - 12:10 - 0:0 - 0:0,3,0,Soghomonyan Hrayr,Darbinyan Armen,fiurst,Darbinyan Armen - Soghomonyan Hrayr,57,23,34,11,-11,20,15,22,0,0,2,7,2,0,0,11,9:11 - 4:11 - 10:12 - 0:0 - 0:0
14411957,2023-10-04 15:30:00,Mkrtchyan Andranik - Gevorgyan Hayk,0:3,11:6 - 11:7 - 12:10 - 0:0 - 0:0,3,0,Mkrtchyan Andranik,Gevorgyan Hayk,fiurst,Gevorgyan Hayk - Mkrtchyan Andranik,57,23,34,11,-11,17,18,22,0,0,5,4,2,0,0,11,6:11 - 7:11 - 10:12 - 0:0 - 0:0
14411953,2023-10-04 15:15:00,Grigoryan Erik - Soghomonyan Hrayr,1:3,5:11 - 11:8 - 9:11 - 5:11 - 0:0,1,3,Grigoryan Erik,Soghomonyan Hrayr,fiurst,Grigoryan Erik - Soghomonyan Hrayr,71,30,41,11,-11,16,19,20,16,0,6,-3,2,6,0,11,5:11 - 11:8 - 9:11 - 5:11 - 0:0
14411949,2023-10-04 14:45:00,Antonyan Eduard - Papyan Karen,3:1,11:5 - 6:11 - 11:8 - 11:5 - 0:0,3,1,Antonyan Eduard,Papyan Karen,fiurst,Antonyan Eduard - Papyan Karen,68,39,29,-10,10,16,17,19,16,0,-6,5,-3,-6,0,-10,11:5 - 6:11 - 11:8 - 11:5 - 0:0
14411947,2023-10-04 14:30:00,Diaryan Aleksandr - Rafayelyan Edgar,2:3,11:5 - 12:14 - 5:11 - 13:11 - 5:11,2,3,Diaryan Aleksandr,Rafayelyan Edgar,fiurst,Diaryan Aleksandr - Rafayelyan Edgar,98,46,52,6,-6,16,26,16,24,16,-6,2,6,-2,6,6,11:5 - 12:14 - 5:11 - 13:11 - 5:11
14411942,2023-10-04 14:00:00,Diaryan Aleksandr - Papyan Karen,3:0,11:5 - 12:10 - 11:5 - 0:0 - 0:0,3,0,Diaryan Aleksandr,Papyan Karen,fiurst,Diaryan Aleksandr - Papyan Karen,54,34,20,-14,14,16,22,16,0,0,-6,-2,-6,0,0,-14,11:5 - 12:10 - 11:5 - 0:0 - 0:0
14411939,2023-10-04 13:45:00,Rafayelyan Edgar - Antonyan Eduard,1:3,11:6 - 11:5 - 9:11 - 11:7 - 0:0,3,1,Rafayelyan Edgar,Antonyan Eduard,fiurst,Antonyan Eduard - Rafayelyan Edgar,71,29,42,13,-13,17,16,20,18,0,5,6,-2,4,0,13,6:11 - 5:11 - 11:9 - 7:11 - 0:0
14411930,2023-10-04 13:40:00,Nikoghosyan Narek - Diaryan Aleksandr,2:0,5:11 - 12:14 - 0:0 - 0:0 - 0:0,0,2,Nikoghosyan Narek,Diaryan Aleksandr,fiurst,Diaryan Aleksandr - Nikoghosyan Narek,42,25,17,-8,8,16,26,0,0,0,-6,-2,0,0,0,-8,11:5 - 14:12 - 0:0 - 0:0 - 0:0
14411929,2023-10-04 13:15:00,Papyan Karen - Rafayelyan Edgar,1:3,11:7 - 7:11 - 8:11 - 5:11 - 0:0,1,3,Papyan Karen,Rafayelyan Edgar,fiurst,Papyan Karen - Rafayelyan Edgar,71,31,40,9,-9,18,18,19,16,0,-4,4,3,6,0,9,11:7 - 7:11 - 8:11 - 5:11 - 0:0
14411928,2023-10-04 13:00:00,Antonyan Eduard - Diaryan Aleksandr,2:3,15:17 - 12:10 - 7:11 - 11:8 - 9:11,2,3,Antonyan Eduard,Diaryan Aleksandr,fiurst,Antonyan Eduard - Diaryan Aleksandr,111,54,57,3,-3,32,22,18,19,20,2,-2,4,-3,2,3,15:17 - 12:10 - 7:11 - 11:8 - 9:11
14411921,2023-10-04 12:45:00,Papyan Karen - Nikoghosyan Narek,3:0,9:11 - 10:12 - 11:13 - 0:0 - 0:0,0,3,Papyan Karen,Nikoghosyan Narek,fiurst,Nikoghosyan Narek - Papyan Karen,66,36,30,-6,6,20,22,24,0,0,-2,-2,-2,0,0,-6,11:9 - 12:10 - 13:11 - 0:0 - 0:0
14411919,2023-10-04 12:20:00,Rafayelyan Edgar - Diaryan Aleksandr,3:1,4:11 - 11:9 - 6:11 - 5:11 - 0:0,1,3,Rafayelyan Edgar,Diaryan Aleksandr,fiurst,Diaryan Aleksandr - Rafayelyan Edgar,68,42,26,-16,16,15,20,17,16,0,-7,2,-5,-6,0,-16,11:4 - 9:11 - 11:6 - 11:5 - 0:0
14411907,2023-10-04 12:00:00,Papyan Karen - Antonyan Eduard,0:3,11:7 - 12:10 - 12:10 - 0:0 - 0:0,3,0,Papyan Karen,Antonyan Eduard,fiurst,Antonyan Eduard - Papyan Karen,62,27,35,8,-8,18,22,22,0,0,4,2,2,0,0,8,7:11 - 10:12 - 10:12 - 0:0 - 0:0
14411906,2023-10-04 11:50:00,Nikoghosyan Narek - Rafayelyan Edgar,3:1,11:6 - 11:9 - 9:11 - 11:8 - 0:0,3,1,Nikoghosyan Narek,Rafayelyan Edgar,fiurst,Nikoghosyan Narek - Rafayelyan Edgar,76,42,34,-8,8,17,20,20,19,0,-5,-2,2,-3,0,-8,11:6 - 11:9 - 9:11 - 11:8 - 0:0
14411905,2023-10-04 11:35:00,Papyan Karen - Diaryan Aleksandr,3:0,5:11 - 6:11 - 7:11 - 0:0 - 0:0,0,3,Papyan Karen,Diaryan Aleksandr,fiurst,Diaryan Aleksandr - Papyan Karen,51,33,18,-15,15,16,17,18,0,0,-6,-5,-4,0,0,-15,11:5 - 11:6 - 11:7 - 0:0 - 0:0
14411710,2023-10-04 11:20:00,Antonyan Eduard - Nikoghosyan Narek,1:3,8:11 - 8:11 - 11:7 - 5:11 - 0:0,1,3,Antonyan Eduard,Nikoghosyan Narek,fiurst,Antonyan Eduard - Nikoghosyan Narek,72,32,40,8,-8,19,19,18,16,0,3,3,-4,6,0,8,8:11 - 8:11 - 11:7 - 5:11 - 0:0
14411707,2023-10-04 11:05:00,Rafayelyan Edgar - Papyan Karen,1:3,11:6 - 7:11 - 11:7 - 11:4 - 0:0,3,1,Rafayelyan Edgar,Papyan Karen,fiurst,Papyan Karen - Rafayelyan Edgar,68,28,40,12,-12,17,18,18,15,0,5,-4,4,7,0,12,6:11 - 11:7 - 7:11 - 4:11 - 0:0
14411695,2023-10-04 10:55:00,Diaryan Aleksandr - Nikoghosyan Narek,3:0,11:9 - 12:10 - 11:4 - 0:0 - 0:0,3,0,Diaryan Aleksandr,Nikoghosyan Narek,fiurst,Diaryan Aleksandr - Nikoghosyan Narek,57,34,23,-11,11,20,22,15,0,0,-2,-2,-7,0,0,-11,11:9 - 12:10 - 11:4 - 0:0 - 0:0
14411693,2023-10-04 10:30:00,Antonyan Eduard - Rafayelyan Edgar,2:3,9:11 - 6:11 - 11:9 - 11:5 - 8:11,2,3,Antonyan Eduard,Rafayelyan Edgar,fiurst,Antonyan Eduard - Rafayelyan Edgar,92,45,47,2,-2,20,17,20,16,19,2,5,-2,-6,3,2,9:11 - 6:11 - 11:9 - 11:5 - 8:11
14411691,2023-10-04 10:15:00,Nikoghosyan Narek - Papyan Karen,2:3,10:12 - 9:11 - 11:9 - 11:4 - 9:11,2,3,Nikoghosyan Narek,Papyan Karen,fiurst,Nikoghosyan Narek - Papyan Karen,97,50,47,-3,3,22,20,20,15,20,2,2,-2,-7,2,-3,10:12 - 9:11 - 11:9 - 11:4 - 9:11
14411687,2023-10-04 10:00:00,Diaryan Aleksandr - Antonyan Eduard,0:3,11:9 - 11:9 - 11:5 - 0:0 - 0:0,3,0,Diaryan Aleksandr,Antonyan Eduard,fiurst,Antonyan Eduard - Diaryan Aleksandr,56,23,33,10,-10,20,20,16,0,0,2,2,6,0,0,10,9:11 - 9:11 - 5:11 - 0:0 - 0:0
14394624,2023-10-03 17:00:00,Darbinyan Armen - Mkrtchyan Andranik,0:3,6:11 - 3:11 - 6:11 - 0:0 - 0:0,0,3,Darbinyan Armen,Mkrtchyan Andranik,fiurst,Darbinyan Armen - Mkrtchyan Andranik,48,15,33,18,-18,17,14,17,0,0,5,8,5,0,0,18,6:11 - 3:11 - 6:11 - 0:0 - 0:0
14412369,2023-10-03 16:45:00,Grigoryan Erik - Avakimyan Davit,3:0,8:11 - 7:11 - 5:11 - 0:0 - 0:0,0,3,Grigoryan Erik,Avakimyan Davit,fiurst,Avakimyan Davit - Grigoryan Erik,53,33,20,-13,13,19,18,16,0,0,-3,-4,-6,0,0,-13,11:8 - 11:7 - 11:5 - 0:0 - 0:0
14394231,2023-10-03 16:40:00,Grigoryan Erik - Avakimyan Davit,0:0,0:0 - 0:0 - 0:0 - 0:0 - 0:0,0,0,Grigoryan Erik,Avakimyan Davit,fiurst,Avakimyan Davit - Grigoryan Erik,0,0,0,0,0,0,0,0,0,0,0,0,0,0,0,0,0:0 - 0:0 - 0:0 - 0:0 - 0:0
14394185,2023-10-03 16:25:00,Grigoryan Erik - Darbinyan Armen,3:1,7:11 - 11:4 - 9:11 - 11:13 - 0:0,1,3,Grigoryan Erik,Darbinyan Armen,fiurst,Darbinyan Armen - Grigoryan Erik,77,39,38,-1,1,18,15,20,24,0,-4,7,-2,-2,0,-1,11:7 - 4:11 - 11:9 - 13:11 - 0:0
14394203,2023-10-03 16:25:00,Mkrtchyan Andranik - Avakimyan Davit,0:3,11:8 - 11:5 - 11:3 - 0:0 - 0:0,3,0,Mkrtchyan Andranik,Avakimyan Davit,fiurst,Avakimyan Davit - Mkrtchyan Andranik,49,16,33,17,-17,19,16,14,0,0,3,6,8,0,0,17,8:11 - 5:11 - 3:11 - 0:0 - 0:0
14394179,2023-10-03 16:05:00,Mkrtchyan Andranik - Grigoryan Erik,0:3,11:8 - 11:8 - 13:11 - 0:0 - 0:0,3,0,Mkrtchyan Andranik,Grigoryan Erik,fiurst,Grigoryan Erik - Mkrtchyan Andranik,62,27,35,8,-8,19,19,24,0,0,3,3,2,0,0,8,8:11 - 8:11 - 11:13 - 0:0 - 0:0
14394620,2023-10-03 15:50:00,Avakimyan Davit - Darbinyan Armen,3:0,12:10 - 11:8 - 11:7 - 0:0 - 0:0,3,0,Avakimyan Davit,Darbinyan Armen,fiurst,Avakimyan Davit - Darbinyan Armen,59,34,25,-9,9,22,19,18,0,0,-2,-3,-4,0,0,-9,12:10 - 11:8 - 11:7 - 0:0 - 0:0
14394184,2023-10-03 15:30:00,Avakimyan Davit - Petrosyan Davit,0:0,0:0 - 0:0 - 0:0 - 0:0 - 0:0,0,0,Avakimyan Davit,Petrosyan Davit,fiurst,Avakimyan Davit - Petrosyan Davit,0,0,0,0,0,0,0,0,0,0,0,0,0,0,0,0,0:0 - 0:0 - 0:0 - 0:0 - 0:0
14394177,2023-10-03 15:10:00,Arutyunov Ruben - Papyan Karen,3:0,11:7 - 11:9 - 11:8 - 0:0 - 0:0,3,0,Arutyunov Ruben,Papyan Karen,fiurst,Arutyunov Ruben - Papyan Karen,57,33,24,-9,9,18,20,19,0,0,-4,-2,-3,0,0,-9,11:7 - 11:9 - 11:8 - 0:0 - 0:0
14394176,2023-10-03 15:00:00,Nikoghosyan Narek - Nazaryan Mushegh,0:3,11:4 - 11:4 - 12:10 - 0:0 - 0:0,3,0,Nikoghosyan Narek,Nazaryan Mushegh,fiurst,Nazaryan Mushegh - Nikoghosyan Narek,52,18,34,16,-16,15,15,22,0,0,7,7,2,0,0,16,4:11 - 4:11 - 10:12 - 0:0 - 0:0
14394173,2023-10-03 14:35:00,Antonyan Eduard - Arutyunov Ruben,3:1,11:7 - 9:11 - 12:10 - 17:15 - 0:0,3,1,Antonyan Eduard,Arutyunov Ruben,fiurst,Antonyan Eduard - Arutyunov Ruben,92,49,43,-6,6,18,20,22,32,0,-4,2,-2,-2,0,-6,11:7 - 9:11 - 12:10 - 17:15 - 0:0
14394148,2023-10-03 14:25:00,Papyan Karen - Nikoghosyan Narek,3:2,13:11 - 7:11 - 13:11 - 6:11 - 6:11,2,3,Papyan Karen,Nikoghosyan Narek,fiurst,Nikoghosyan Narek - Papyan Karen,100,55,45,-10,10,24,18,24,17,17,2,-4,2,-5,-5,-10,11:13 - 11:7 - 11:13 - 11:6 - 11:6
14394147,2023-10-03 14:05:00,Antonyan Eduard - Nazaryan Mushegh,3:0,11:5 - 11:5 - 11:9 - 0:0 - 0:0,3,0,Antonyan Eduard,Nazaryan Mushegh,fiurst,Antonyan Eduard - Nazaryan Mushegh,52,33,19,-14,14,16,16,20,0,0,-6,-6,-2,0,0,-14,11:5 - 11:5 - 11:9 - 0:0 - 0:0
14394146,2023-10-03 13:55:00,Arutyunov Ruben - Nikoghosyan Narek,2:3,6:11 - 4:11 - 11:7 - 11:7 - 3:11,2,3,Arutyunov Ruben,Nikoghosyan Narek,fiurst,Arutyunov Ruben - Nikoghosyan Narek,82,35,47,12,-12,17,15,18,18,14,5,7,-4,-4,8,12,6:11 - 4:11 - 11:7 - 11:7 - 3:11
14394141,2023-10-03 13:40:00,Papyan Karen - Antonyan Eduard,3:1,12:14 - 2:11 - 11:5 - 8:11 - 0:0,1,3,Papyan Karen,Antonyan Eduard,fiurst,Antonyan Eduard - Papyan Karen,74,41,33,-8,8,26,13,16,19,0,-2,-9,6,-3,0,-8,14:12 - 11:2 - 5:11 - 11:8 - 0:0
14394136,2023-10-03 13:15:00,Nazaryan Mushegh - Arutyunov Ruben,3:2,13:11 - 11:4 - 12:14 - 8:11 - 8:11,2,3,Nazaryan Mushegh,Arutyunov Ruben,fiurst,Arutyunov Ruben - Nazaryan Mushegh,103,51,52,1,-1,24,15,26,19,19,2,7,-2,-3,-3,1,11:13 - 4:11 - 14:12 - 11:8 - 11:8
14394134,2023-10-03 13:00:00,Nikoghosyan Narek - Antonyan Eduard,2:3,11:8 - 8:11 - 9:11 - 11:9 - 12:10,3,2,Nikoghosyan Narek,Antonyan Eduard,fiurst,Antonyan Eduard - Nikoghosyan Narek,100,49,51,2,-2,19,19,20,20,22,3,-3,-2,2,2,2,8:11 - 11:8 - 11:9 - 9:11 - 10:12
14394132,2023-10-03 12:50:00,Nazaryan Mushegh - Papyan Karen,3:1,11:5 - 11:9 - 4:11 - 11:7 - 0:0,3,1,Nazaryan Mushegh,Papyan Karen,fiurst,Nazaryan Mushegh - Papyan Karen,69,37,32,-5,5,16,20,15,18,0,-6,-2,7,-4,0,-5,11:5 - 11:9 - 4:11 - 11:7 - 0:0
14394129,2023-10-03 12:15:00,Arutyunov Ruben - Antonyan Eduard,3:0,11:13 - 6:11 - 6:11 - 0:0 - 0:0,0,3,Arutyunov Ruben,Antonyan Eduard,fiurst,Antonyan Eduard - Arutyunov Ruben,58,35,23,-12,12,24,17,17,0,0,-2,-5,-5,0,0,-12,13:11 - 11:6 - 11:6 - 0:0 - 0:0
14394126,2023-10-03 12:10:00,Nazaryan Mushegh - Nikoghosyan Narek,0:3,7:11 - 5:11 - 6:11 - 0:0 - 0:0,0,3,Nazaryan Mushegh,Nikoghosyan Narek,fiurst,Nazaryan Mushegh - Nikoghosyan Narek,51,18,33,15,-15,18,16,17,0,0,4,6,5,0,0,15,7:11 - 5:11 - 6:11 - 0:0 - 0:0
14394124,2023-10-03 11:50:00,Papyan Karen - Arutyunov Ruben,0:3,11:9 - 14:12 - 11:9 - 0:0 - 0:0,3,0,Papyan Karen,Arutyunov Ruben,fiurst,Arutyunov Ruben - Papyan Karen,66,30,36,6,-6,20,26,20,0,0,2,2,2,0,0,6,9:11 - 12:14 - 9:11 - 0:0 - 0:0
14394122,2023-10-03 11:35:00,Nazaryan Mushegh - Antonyan Eduard,3:1,11:4 - 8:11 - 8:11 - 6:11 - 0:0,1,3,Nazaryan Mushegh,Antonyan Eduard,fiurst,Antonyan Eduard - Nazaryan Mushegh,70,37,33,-4,4,15,19,19,17,0,7,-3,-3,-5,0,-4,4:11 - 11:8 - 11:8 - 11:6 - 0:0
14394111,2023-10-03 11:20:00,Nikoghosyan Narek - Papyan Karen,1:3,8:11 - 12:10 - 9:11 - 9:11 - 0:0,1,3,Nikoghosyan Narek,Papyan Karen,fiurst,Nikoghosyan Narek - Papyan Karen,81,38,43,5,-5,19,22,20,20,0,3,-2,2,2,0,5,8:11 - 12:10 - 9:11 - 9:11 - 0:0
14394103,2023-10-03 11:05:00,Arutyunov Ruben - Nazaryan Mushegh,3:2,11:6 - 11:5 - 7:11 - 8:11 - 11:8,3,2,Arutyunov Ruben,Nazaryan Mushegh,fiurst,Arutyunov Ruben - Nazaryan Mushegh,89,48,41,-7,7,17,16,18,19,19,-5,-6,4,3,-3,-7,11:6 - 11:5 - 7:11 - 8:11 - 11:8
14394101,2023-10-03 10:45:00,Antonyan Eduard - Papyan Karen,3:2,11:4 - 8:11 - 11:6 - 9:11 - 11:4,3,2,Antonyan Eduard,Papyan Karen,fiurst,Antonyan Eduard - Papyan Karen,86,50,36,-14,14,15,19,17,20,15,-7,3,-5,2,-7,-14,11:4 - 8:11 - 11:6 - 9:11 - 11:4
14394096,2023-10-03 10:30:00,Nikoghosyan Narek - Arutyunov Ruben,1:3,11:7 - 11:7 - 6:11 - 11:9 - 0:0,3,1,Nikoghosyan Narek,Arutyunov Ruben,fiurst,Arutyunov Ruben - Nikoghosyan Narek,73,34,39,5,-5,18,18,17,20,0,4,4,-5,2,0,5,7:11 - 7:11 - 11:6 - 9:11 - 0:0
14394084,2023-10-03 10:15:00,Papyan Karen - Nazaryan Mushegh,0:3,12:10 - 11:9 - 11:4 - 0:0 - 0:0,3,0,Papyan Karen,Nazaryan Mushegh,fiurst,Nazaryan Mushegh - Papyan Karen,57,23,34,11,-11,22,20,15,0,0,2,2,7,0,0,11,10:12 - 9:11 - 4:11 - 0:0 - 0:0
14394069,2023-10-03 10:00:00,Antonyan Eduard - Nikoghosyan Narek,3:1,11:5 - 11:6 - 7:11 - 11:5 - 0:0,3,1,Antonyan Eduard,Nikoghosyan Narek,fiurst,Antonyan Eduard - Nikoghosyan Narek,67,40,27,-13,13,16,17,18,16,0,-6,-5,4,-6,0,-13,11:5 - 11:6 - 7:11 - 11:5 - 0:0
14372668,2023-10-02 17:30:00,Darbinyan Armen - Avakimyan Davit,2:3,11:8 - 2:11 - 13:11 - 9:11 - 12:10,3,2,Darbinyan Armen,Avakimyan Davit,fiurst,Avakimyan Davit - Darbinyan Armen,98,51,47,-4,4,19,13,24,20,22,3,-9,2,-2,2,-4,8:11 - 11:2 - 11:13 - 11:9 - 10:12
14372663,2023-10-02 17:15:00,Gevorgyan Hayk - Mkrtchyan Andranik,0:3,5:11 - 8:11 - 9:11 - 0:0 - 0:0,0,3,Gevorgyan Hayk,Mkrtchyan Andranik,fiurst,Gevorgyan Hayk - Mkrtchyan Andranik,55,22,33,11,-11,16,19,20,0,0,6,3,2,0,0,11,5:11 - 8:11 - 9:11 - 0:0 - 0:0
14372661,2023-10-02 17:00:00,Petrosyan Davit - Darbinyan Armen,1:3,11:5 - 11:3 - 11:13 - 11:8 - 0:0,3,1,Petrosyan Davit,Darbinyan Armen,fiurst,Darbinyan Armen - Petrosyan Davit,73,29,44,15,-15,16,14,24,19,0,6,8,-2,3,0,15,5:11 - 3:11 - 13:11 - 8:11 - 0:0
14372659,2023-10-02 16:50:00,Gevorgyan Hayk - Avakimyan Davit,3:1,6:11 - 3:11 - 13:11 - 8:11 - 0:0,1,3,Gevorgyan Hayk,Avakimyan Davit,fiurst,Avakimyan Davit - Gevorgyan Hayk,74,44,30,-14,14,17,14,24,19,0,-5,-8,2,-3,0,-14,11:6 - 11:3 - 11:13 - 11:8 - 0:0
14372647,2023-10-02 16:30:00,Mkrtchyan Andranik - Petrosyan Davit,3:0,11:7 - 11:4 - 11:7 - 0:0 - 0:0,3,0,Mkrtchyan Andranik,Petrosyan Davit,fiurst,Mkrtchyan Andranik - Petrosyan Davit,51,33,18,-15,15,18,15,18,0,0,-4,-7,-4,0,0,-15,11:7 - 11:4 - 11:7 - 0:0 - 0:0
14372645,2023-10-02 16:15:00,Darbinyan Armen - Gevorgyan Hayk,3:2,11:13 - 14:12 - 7:11 - 12:10 - 11:9,3,2,Darbinyan Armen,Gevorgyan Hayk,fiurst,Darbinyan Armen - Gevorgyan Hayk,110,55,55,0,0,24,26,18,22,20,2,-2,4,-2,-2,0,11:13 - 14:12 - 7:11 - 12:10 - 11:9
14372643,2023-10-02 16:00:00,Avakimyan Davit - Petrosyan Davit,3:0,11:5 - 11:5 - 11:9 - 0:0 - 0:0,3,0,Avakimyan Davit,Petrosyan Davit,fiurst,Avakimyan Davit - Petrosyan Davit,52,33,19,-14,14,16,16,20,0,0,-6,-6,-2,0,0,-14,11:5 - 11:5 - 11:9 - 0:0 - 0:0
14372635,2023-10-02 15:45:00,Mkrtchyan Andranik - Darbinyan Armen,0:3,11:2 - 11:1 - 11:1 - 0:0 - 0:0,3,0,Mkrtchyan Andranik,Darbinyan Armen,fiurst,Darbinyan Armen - Mkrtchyan Andranik,37,4,33,29,-29,13,12,12,0,0,9,10,10,0,0,29,2:11 - 1:11 - 1:11 - 0:0 - 0:0
14372632,2023-10-02 15:30:00,Petrosyan Davit - Gevorgyan Hayk,3:1,11:6 - 7:11 - 7:11 - 6:11 - 0:0,1,3,Petrosyan Davit,Gevorgyan Hayk,fiurst,Gevorgyan Hayk - Petrosyan Davit,70,39,31,-8,8,17,18,18,17,0,5,-4,-4,-5,0,-8,6:11 - 11:7 - 11:7 - 11:6 - 0:0
14372624,2023-10-02 15:15:00,Avakimyan Davit - Mkrtchyan Andranik,3:0,11:8 - 11:9 - 11:9 - 0:0 - 0:0,3,0,Avakimyan Davit,Mkrtchyan Andranik,fiurst,Avakimyan Davit - Mkrtchyan Andranik,59,33,26,-7,7,19,20,20,0,0,-3,-2,-2,0,0,-7,11:8 - 11:9 - 11:9 - 0:0 - 0:0
14372611,2023-10-02 15:00:00,Arutyunov Ruben - Nazaryan Mushegh,2:3,9:11 - 8:11 - 12:10 - 11:3 - 8:11,2,3,Arutyunov Ruben,Nazaryan Mushegh,fiurst,Arutyunov Ruben - Nazaryan Mushegh,94,48,46,-2,2,20,19,22,14,19,2,3,-2,-8,3,-2,9:11 - 8:11 - 12:10 - 11:3 - 8:11
14372609,2023-10-02 14:45:00,Papyan Karen - Diaryan Aleksandr,3:0,2:11 - 8:11 - 12:14 - 0:0 - 0:0,0,3,Papyan Karen,Diaryan Aleksandr,fiurst,Diaryan Aleksandr - Papyan Karen,58,36,22,-14,14,13,19,26,0,0,-9,-3,-2,0,0,-14,11:2 - 11:8 - 14:12 - 0:0 - 0:0
14372604,2023-10-02 14:30:00,Rafayelyan Edgar - Arutyunov Ruben,3:0,8:11 - 7:11 - 5:11 - 0:0 - 0:0,0,3,Rafayelyan Edgar,Arutyunov Ruben,fiurst,Arutyunov Ruben - Rafayelyan Edgar,53,33,20,-13,13,19,18,16,0,0,-3,-4,-6,0,0,-13,11:8 - 11:7 - 11:5 - 0:0 - 0:0
14372600,2023-10-02 14:15:00,Nazaryan Mushegh - Papyan Karen,1:3,9:11 - 4:11 - 11:6 - 6:11 - 0:0,1,3,Nazaryan Mushegh,Papyan Karen,fiurst,Nazaryan Mushegh - Papyan Karen,69,30,39,9,-9,20,15,17,17,0,2,7,-5,5,0,9,9:11 - 4:11 - 11:6 - 6:11 - 0:0
14372595,2023-10-02 14:00:00,Rafayelyan Edgar - Diaryan Aleksandr,3:2,11:9 - 11:7 - 4:11 - 9:11 - 4:11,2,3,Rafayelyan Edgar,Diaryan Aleksandr,fiurst,Diaryan Aleksandr - Rafayelyan Edgar,88,49,39,-10,10,20,18,15,20,15,2,4,-7,-2,-7,-10,9:11 - 7:11 - 11:4 - 11:9 - 11:4
14372592,2023-10-02 13:45:00,Arutyunov Ruben - Papyan Karen,3:1,11:7 - 12:10 - 9:11 - 12:10 - 0:0,3,1,Arutyunov Ruben,Papyan Karen,fiurst,Arutyunov Ruben - Papyan Karen,82,44,38,-6,6,18,22,20,22,0,-4,-2,2,-2,0,-6,11:7 - 12:10 - 9:11 - 12:10 - 0:0
14372580,2023-10-02 13:30:00,Nazaryan Mushegh - Rafayelyan Edgar,3:2,7:11 - 5:11 - 11:9 - 11:9 - 11:5,3,2,Nazaryan Mushegh,Rafayelyan Edgar,fiurst,Nazaryan Mushegh - Rafayelyan Edgar,90,45,45,0,0,18,16,20,20,16,4,6,-2,-2,-6,0,7:11 - 5:11 - 11:9 - 11:9 - 11:5
14372577,2023-10-02 13:15:00,Diaryan Aleksandr - Arutyunov Ruben,0:3,11:8 - 11:3 - 11:7 - 0:0 - 0:0,3,0,Diaryan Aleksandr,Arutyunov Ruben,fiurst,Arutyunov Ruben - Diaryan Aleksandr,51,18,33,15,-15,19,14,18,0,0,3,8,4,0,0,15,8:11 - 3:11 - 7:11 - 0:0 - 0:0
14372573,2023-10-02 13:00:00,Papyan Karen - Rafayelyan Edgar,0:3,8:11 - 10:12 - 7:11 - 0:0 - 0:0,0,3,Papyan Karen,Rafayelyan Edgar,fiurst,Papyan Karen - Rafayelyan Edgar,59,25,34,9,-9,19,22,18,0,0,3,2,4,0,0,9,8:11 - 10:12 - 7:11 - 0:0 - 0:0
14372570,2023-10-02 12:45:00,Diaryan Aleksandr - Nazaryan Mushegh,3:1,11:4 - 11:7 - 7:11 - 11:3 - 0:0,3,1,Diaryan Aleksandr,Nazaryan Mushegh,fiurst,Diaryan Aleksandr - Nazaryan Mushegh,65,40,25,-15,15,15,18,18,14,0,-7,-4,4,-8,0,-15,11:4 - 11:7 - 7:11 - 11:3 - 0:0
14372558,2023-10-02 12:20:00,Arutyunov Ruben - Rafayelyan Edgar,1:3,4:11 - 7:11 - 11:9 - 7:11 - 0:0,1,3,Arutyunov Ruben,Rafayelyan Edgar,fiurst,Arutyunov Ruben - Rafayelyan Edgar,71,29,42,13,-13,15,18,20,18,0,7,4,-2,4,0,13,4:11 - 7:11 - 11:9 - 7:11 - 0:0
14372547,2023-10-02 12:00:00,Diaryan Aleksandr - Papyan Karen,3:0,11:3 - 11:2 - 13:11 - 0:0 - 0:0,3,0,Diaryan Aleksandr,Papyan Karen,fiurst,Diaryan Aleksandr - Papyan Karen,51,35,16,-19,19,14,13,24,0,0,-8,-9,-2,0,0,-19,11:3 - 11:2 - 13:11 - 0:0 - 0:0
14372544,2023-10-02 11:55:00,Nazaryan Mushegh - Arutyunov Ruben,3:1,8:11 - 11:9 - 2:11 - 6:11 - 0:0,1,3,Nazaryan Mushegh,Arutyunov Ruben,fiurst,Arutyunov Ruben - Nazaryan Mushegh,69,42,27,-15,15,19,20,13,17,0,-3,2,-9,-5,0,-15,11:8 - 9:11 - 11:2 - 11:6 - 0:0
14372542,2023-10-02 11:30:00,Diaryan Aleksandr - Rafayelyan Edgar,3:2,11:4 - 9:11 - 8:11 - 11:7 - 11:8,3,2,Diaryan Aleksandr,Rafayelyan Edgar,fiurst,Diaryan Aleksandr - Rafayelyan Edgar,91,50,41,-9,9,15,20,19,18,19,-7,2,3,-4,-3,-9,11:4 - 9:11 - 8:11 - 11:7 - 11:8
14372539,2023-10-02 11:25:00,Papyan Karen - Nazaryan Mushegh,3:1,4:11 - 10:12 - 11:9 - 8:11 - 0:0,1,3,Papyan Karen,Nazaryan Mushegh,fiurst,Nazaryan Mushegh - Papyan Karen,76,43,33,-10,10,15,22,20,19,0,-7,-2,2,-3,0,-10,11:4 - 12:10 - 9:11 - 11:8 - 0:0
14372538,2023-10-02 11:00:00,Arutyunov Ruben - Diaryan Aleksandr,0:3,12:14 - 1:11 - 8:11 - 0:0 - 0:0,0,3,Arutyunov Ruben,Diaryan Aleksandr,fiurst,Arutyunov Ruben - Diaryan Aleksandr,57,21,36,15,-15,26,12,19,0,0,2,10,3,0,0,15,12:14 - 1:11 - 8:11 - 0:0 - 0:0
14372525,2023-10-02 10:45:00,Rafayelyan Edgar - Nazaryan Mushegh,2:3,11:13 - 5:11 - 11:7 - 11:9 - 11:6,3,2,Rafayelyan Edgar,Nazaryan Mushegh,fiurst,Nazaryan Mushegh - Rafayelyan Edgar,95,46,49,3,-3,24,16,18,20,17,-2,-6,4,2,5,3,13:11 - 11:5 - 7:11 - 9:11 - 6:11
14372498,2023-10-02 10:30:00,Papyan Karen - Arutyunov Ruben,0:3,11:6 - 11:8 - 12:10 - 0:0 - 0:0,3,0,Papyan Karen,Arutyunov Ruben,fiurst,Arutyunov Ruben - Papyan Karen,58,24,34,10,-10,17,19,22,0,0,5,3,2,0,0,10,6:11 - 8:11 - 10:12 - 0:0 - 0:0
14372458,2023-10-02 10:15:00,Nazaryan Mushegh - Diaryan Aleksandr,3:0,6:11 - 9:11 - 4:11 - 0:0 - 0:0,0,3,Nazaryan Mushegh,Diaryan Aleksandr,fiurst,Diaryan Aleksandr - Nazaryan Mushegh,52,33,19,-14,14,17,20,15,0,0,-5,-2,-7,0,0,-14,11:6 - 11:9 - 11:4 - 0:0 - 0:0
14372456,2023-10-02 10:05:00,Rafayelyan Edgar - Papyan Karen,1:3,20:22 - 11:8 - 11:3 - 11:6 - 0:0,3,1,Rafayelyan Edgar,Papyan Karen,fiurst,Papyan Karen - Rafayelyan Edgar,92,39,53,14,-14,42,19,14,17,0,-2,3,8,5,0,14,22:20 - 8:11 - 3:11 - 6:11 - 0:0
14353913,2023-10-01 17:45:00,Gevorgyan Hayk - Avakimyan Davit,3:1,8:11 - 11:2 - 10:12 - 7:11 - 0:0,1,3,Gevorgyan Hayk,Avakimyan Davit,fiurst,Avakimyan Davit - Gevorgyan Hayk,72,36,36,0,0,19,13,22,18,0,-3,9,-2,-4,0,0,11:8 - 2:11 - 12:10 - 11:7 - 0:0
14353900,2023-10-01 17:30:00,Mkrtchyan Andranik - Darbinyan Armen,0:3,12:10 - 11:7 - 11:3 - 0:0 - 0:0,3,0,Mkrtchyan Andranik,Darbinyan Armen,fiurst,Darbinyan Armen - Mkrtchyan Andranik,54,20,34,14,-14,22,18,14,0,0,2,4,8,0,0,14,10:12 - 7:11 - 3:11 - 0:0 - 0:0
14353863,2023-10-01 17:00:00,Avakimyan Davit - Darbinyan Armen,1:3,11:9 - 9:11 - 10:12 - 5:11 - 0:0,1,3,Avakimyan Davit,Darbinyan Armen,fiurst,Avakimyan Davit - Darbinyan Armen,78,35,43,8,-8,20,20,22,16,0,-2,2,2,6,0,8,11:9 - 9:11 - 10:12 - 5:11 - 0:0
14353861,2023-10-01 16:45:00,Gevorgyan Hayk - Mkrtchyan Andranik,3:2,9:11 - 6:11 - 11:7 - 11:6 - 11:7,3,2,Gevorgyan Hayk,Mkrtchyan Andranik,fiurst,Gevorgyan Hayk - Mkrtchyan Andranik,90,48,42,-6,6,20,17,18,17,18,2,5,-4,-5,-4,-6,9:11 - 6:11 - 11:7 - 11:6 - 11:7
14353850,2023-10-01 16:15:00,Gevorgyan Hayk - Darbinyan Armen,0:3,11:5 - 11:8 - 11:5 - 0:0 - 0:0,3,0,Gevorgyan Hayk,Darbinyan Armen,fiurst,Darbinyan Armen - Gevorgyan Hayk,51,18,33,15,-15,16,19,16,0,0,6,3,6,0,0,15,5:11 - 8:11 - 5:11 - 0:0 - 0:0
14353849,2023-10-01 16:10:00,Mkrtchyan Andranik - Avakimyan Davit,0:3,14:12 - 12:10 - 11:3 - 0:0 - 0:0,3,0,Mkrtchyan Andranik,Avakimyan Davit,fiurst,Avakimyan Davit - Mkrtchyan Andranik,62,25,37,12,-12,26,22,14,0,0,2,2,8,0,0,12,12:14 - 10:12 - 3:11 - 0:0 - 0:0
14353845,2023-10-01 15:40:00,Avakimyan Davit - Gevorgyan Hayk,2:3,15:13 - 6:11 - 9:11 - 15:13 - 6:11,2,3,Avakimyan Davit,Gevorgyan Hayk,fiurst,Avakimyan Davit - Gevorgyan Hayk,110,51,59,8,-8,28,17,20,28,17,-2,5,2,-2,5,8,15:13 - 6:11 - 9:11 - 15:13 - 6:11
14353839,2023-10-01 15:15:00,Rafayelyan Edgar - Diaryan Aleksandr,2:3,5:11 - 4:11 - 11:5 - 11:9 - 11:8,3,2,Rafayelyan Edgar,Diaryan Aleksandr,fiurst,Diaryan Aleksandr - Rafayelyan Edgar,86,44,42,-2,2,16,15,16,20,19,-6,-7,6,2,3,-2,11:5 - 11:4 - 5:11 - 9:11 - 8:11
14353841,2023-10-01 15:15:00,Darbinyan Armen - Mkrtchyan Andranik,0:3,9:11 - 5:11 - 11:13 - 0:0 - 0:0,0,3,Darbinyan Armen,Mkrtchyan Andranik,fiurst,Darbinyan Armen - Mkrtchyan Andranik,60,25,35,10,-10,20,16,24,0,0,2,6,2,0,0,10,9:11 - 5:11 - 11:13 - 0:0 - 0:0
14353823,2023-10-01 14:55:00,Nikoghosyan Narek - Rafayelyan Edgar,3:0,11:7 - 11:9 - 11:6 - 0:0 - 0:0,3,0,Nikoghosyan Narek,Rafayelyan Edgar,fiurst,Nikoghosyan Narek - Rafayelyan Edgar,55,33,22,-11,11,18,20,17,0,0,-4,-2,-5,0,0,-11,11:7 - 11:9 - 11:6 - 0:0 - 0:0
14353822,2023-10-01 14:15:00,Diaryan Aleksandr - Nazaryan Mushegh,1:0,11:2 - 4:2 - 0:0 - 0:0 - 0:0,1,0,Diaryan Aleksandr,Nazaryan Mushegh,fiurst,Diaryan Aleksandr - Nazaryan Mushegh,19,15,4,-11,11,13,6,0,0,0,-9,-2,0,0,0,-11,11:2 - 4:2 - 0:0 - 0:0 - 0:0
14353821,2023-10-01 14:10:00,Nikoghosyan Narek - Antonyan Eduard,3:2,10:12 - 11:6 - 6:11 - 11:5 - 10:12,2,3,Nikoghosyan Narek,Antonyan Eduard,fiurst,Antonyan Eduard - Nikoghosyan Narek,94,46,48,2,-2,22,17,17,16,22,-2,5,-5,6,-2,2,12:10 - 6:11 - 11:6 - 5:11 - 12:10
14353807,2023-10-01 14:00:00,Rafayelyan Edgar - Nazaryan Mushegh,0:3,11:8 - 11:1 - 11:5 - 0:0 - 0:0,3,0,Rafayelyan Edgar,Nazaryan Mushegh,fiurst,Nazaryan Mushegh - Rafayelyan Edgar,47,14,33,19,-19,19,12,16,0,0,3,10,6,0,0,19,8:11 - 1:11 - 5:11 - 0:0 - 0:0
14353806,2023-10-01 13:30:00,Diaryan Aleksandr - Nikoghosyan Narek,2:3,12:10 - 11:4 - 5:11 - 7:11 - 5:11,2,3,Diaryan Aleksandr,Nikoghosyan Narek,fiurst,Diaryan Aleksandr - Nikoghosyan Narek,87,40,47,7,-7,22,15,16,18,16,-2,-7,6,4,6,7,12:10 - 11:4 - 5:11 - 7:11 - 5:11
14353803,2023-10-01 13:25:00,Antonyan Eduard - Rafayelyan Edgar,2:3,6:11 - 12:10 - 6:11 - 12:10 - 6:11,2,3,Antonyan Eduard,Rafayelyan Edgar,fiurst,Antonyan Eduard - Rafayelyan Edgar,95,42,53,11,-11,17,22,17,22,17,5,-2,5,-2,5,11,6:11 - 12:10 - 6:11 - 12:10 - 6:11
14353797,2023-10-01 13:00:00,Nazaryan Mushegh - Nikoghosyan Narek,0:3,7:11 - 6:11 - 10:12 - 0:0 - 0:0,0,3,Nazaryan Mushegh,Nikoghosyan Narek,fiurst,Nazaryan Mushegh - Nikoghosyan Narek,57,23,34,11,-11,18,17,22,0,0,4,5,2,0,0,11,7:11 - 6:11 - 10:12 - 0:0 - 0:0
14353781,2023-10-01 12:45:00,Antonyan Eduard - Diaryan Aleksandr,2:3,8:11 - 8:11 - 12:10 - 11:8 - 10:12,2,3,Antonyan Eduard,Diaryan Aleksandr,fiurst,Antonyan Eduard - Diaryan Aleksandr,101,49,52,3,-3,19,19,22,19,22,3,3,-2,-3,2,3,8:11 - 8:11 - 12:10 - 11:8 - 10:12
14353771,2023-10-01 12:20:00,Rafayelyan Edgar - Nikoghosyan Narek,3:1,5:11 - 4:11 - 11:8 - 8:11 - 0:0,1,3,Rafayelyan Edgar,Nikoghosyan Narek,fiurst,Nikoghosyan Narek - Rafayelyan Edgar,69,41,28,-13,13,16,15,19,19,0,-6,-7,3,-3,0,-13,11:5 - 11:4 - 8:11 - 11:8 - 0:0
14353770,2023-10-01 12:00:00,Antonyan Eduard - Nazaryan Mushegh,3:0,11:4 - 11:6 - 11:5 - 0:0 - 0:0,3,0,Antonyan Eduard,Nazaryan Mushegh,fiurst,Antonyan Eduard - Nazaryan Mushegh,48,33,15,-18,18,15,17,16,0,0,-7,-5,-6,0,0,-18,11:4 - 11:6 - 11:5 - 0:0 - 0:0
14353769,2023-10-01 11:45:00,Diaryan Aleksandr - Rafayelyan Edgar,2:3,12:10 - 7:11 - 2:11 - 11:6 - 7:11,2,3,Diaryan Aleksandr,Rafayelyan Edgar,fiurst,Diaryan Aleksandr - Rafayelyan Edgar,88,39,49,10,-10,22,18,13,17,18,-2,4,9,-5,4,10,12:10 - 7:11 - 2:11 - 11:6 - 7:11
14353768,2023-10-01 11:30:00,Antonyan Eduard - Nikoghosyan Narek,0:3,7:11 - 7:11 - 3:11 - 0:0 - 0:0,0,3,Antonyan Eduard,Nikoghosyan Narek,fiurst,Antonyan Eduard - Nikoghosyan Narek,50,17,33,16,-16,18,18,14,0,0,4,4,8,0,0,16,7:11 - 7:11 - 3:11 - 0:0 - 0:0
14353764,2023-10-01 11:25:00,Nazaryan Mushegh - Diaryan Aleksandr,3:0,5:11 - 5:11 - 4:11 - 0:0 - 0:0,0,3,Nazaryan Mushegh,Diaryan Aleksandr,fiurst,Diaryan Aleksandr - Nazaryan Mushegh,47,33,14,-19,19,16,16,15,0,0,-6,-6,-7,0,0,-19,11:5 - 11:5 - 11:4 - 0:0 - 0:0
14353760,2023-10-01 11:00:00,Rafayelyan Edgar - Antonyan Eduard,3:0,8:11 - 4:11 - 10:12 - 0:0 - 0:0,0,3,Rafayelyan Edgar,Antonyan Eduard,fiurst,Antonyan Eduard - Rafayelyan Edgar,56,34,22,-12,12,19,15,22,0,0,-3,-7,-2,0,0,-12,11:8 - 11:4 - 12:10 - 0:0 - 0:0
14353758,2023-10-01 10:45:00,Nikoghosyan Narek - Diaryan Aleksandr,3:2,8:11 - 8:11 - 11:9 - 11:8 - 3:11,2,3,Nikoghosyan Narek,Diaryan Aleksandr,fiurst,Diaryan Aleksandr - Nikoghosyan Narek,91,50,41,-9,9,19,19,20,19,14,-3,-3,2,3,-8,-9,11:8 - 11:8 - 9:11 - 8:11 - 11:3
14353744,2023-10-01 10:30:00,Nazaryan Mushegh - Rafayelyan Edgar,1:3,8:11 - 15:13 - 9:11 - 7:11 - 0:0,1,3,Nazaryan Mushegh,Rafayelyan Edgar,fiurst,Nazaryan Mushegh - Rafayelyan Edgar,85,39,46,7,-7,19,28,20,18,0,3,-2,2,4,0,7,8:11 - 15:13 - 9:11 - 7:11 - 0:0
14353730,2023-10-01 10:15:00,Diaryan Aleksandr - Antonyan Eduard,0:3,12:10 - 11:7 - 11:6 - 0:0 - 0:0,3,0,Diaryan Aleksandr,Antonyan Eduard,fiurst,Antonyan Eduard - Diaryan Aleksandr,57,23,34,11,-11,22,18,17,0,0,2,4,5,0,0,11,10:12 - 7:11 - 6:11 - 0:0 - 0:0
14353727,2023-10-01 10:00:00,Nikoghosyan Narek - Nazaryan Mushegh,1:3,11:13 - 11:6 - 11:3 - 11:8 - 0:0,3,1,Nikoghosyan Narek,Nazaryan Mushegh,fiurst,Nazaryan Mushegh - Nikoghosyan Narek,74,30,44,14,-14,24,17,14,19,0,-2,5,8,3,0,14,13:11 - 6:11 - 3:11 - 8:11 - 0:0
14334174,2023-09-30 17:45:00,Gevorgyan Hayk - Darbinyan Armen,0:3,11:6 - 11:8 - 11:3 - 0:0 - 0:0,3,0,Gevorgyan Hayk,Darbinyan Armen,fiurst,Darbinyan Armen - Gevorgyan Hayk,50,17,33,16,-16,17,19,14,0,0,5,3,8,0,0,16,6:11 - 8:11 - 3:11 - 0:0 - 0:0
14334170,2023-09-30 17:30:00,Mkrtchyan Andranik - Avakimyan Davit,1:3,11:6 - 9:11 - 11:6 - 11:6 - 0:0,3,1,Mkrtchyan Andranik,Avakimyan Davit,fiurst,Avakimyan Davit - Mkrtchyan Andranik,71,29,42,13,-13,17,20,17,17,0,5,-2,5,5,0,13,6:11 - 11:9 - 6:11 - 6:11 - 0:0
14334163,2023-09-30 17:00:00,Darbinyan Armen - Avakimyan Davit,3:0,6:11 - 8:11 - 7:11 - 0:0 - 0:0,0,3,Darbinyan Armen,Avakimyan Davit,fiurst,Avakimyan Davit - Darbinyan Armen,54,33,21,-12,12,17,19,18,0,0,-5,-3,-4,0,0,-12,11:6 - 11:8 - 11:7 - 0:0 - 0:0
14334157,2023-09-30 16:45:00,Gevorgyan Hayk - Mkrtchyan Andranik,1:3,11:5 - 7:11 - 7:11 - 9:11 - 0:0,1,3,Gevorgyan Hayk,Mkrtchyan Andranik,fiurst,Gevorgyan Hayk - Mkrtchyan Andranik,72,34,38,4,-4,16,18,18,20,0,-6,4,4,2,0,4,11:5 - 7:11 - 7:11 - 9:11 - 0:0
14334146,2023-09-30 16:15:00,Gevorgyan Hayk - Avakimyan Davit,0:3,11:3 - 11:3 - 11:5 - 0:0 - 0:0,3,0,Gevorgyan Hayk,Avakimyan Davit,fiurst,Avakimyan Davit - Gevorgyan Hayk,44,11,33,22,-22,14,14,16,0,0,8,8,6,0,0,22,3:11 - 3:11 - 5:11 - 0:0 - 0:0
14334145,2023-09-30 16:00:00,Mkrtchyan Andranik - Darbinyan Armen,1:3,11:6 - 9:11 - 11:7 - 11:7 - 0:0,3,1,Mkrtchyan Andranik,Darbinyan Armen,fiurst,Darbinyan Armen - Mkrtchyan Andranik,73,31,42,11,-11,17,20,18,18,0,5,-2,4,4,0,11,6:11 - 11:9 - 7:11 - 7:11 - 0:0
14334139,2023-09-30 15:35:00,Avakimyan Davit - Mkrtchyan Andranik,3:2,13:11 - 8:11 - 8:11 - 11:9 - 11:7,3,2,Avakimyan Davit,Mkrtchyan Andranik,fiurst,Avakimyan Davit - Mkrtchyan Andranik,100,51,49,-2,2,24,19,19,20,18,-2,3,3,-2,-4,-2,13:11 - 8:11 - 8:11 - 11:9 - 11:7
14334141,2023-09-30 15:35:00,Darbinyan Armen - Gevorgyan Hayk,1:3,11:8 - 10:12 - 7:11 - 10:12 - 0:0,1,3,Darbinyan Armen,Gevorgyan Hayk,fiurst,Darbinyan Armen - Gevorgyan Hayk,81,38,43,5,-5,19,22,18,22,0,-3,2,4,2,0,5,11:8 - 10:12 - 7:11 - 10:12 - 0:0
14334125,2023-09-30 15:05:00,Arutyunov Ruben - Rafayelyan Edgar,3:1,15:13 - 14:12 - 8:11 - 11:8 - 0:0,3,1,Arutyunov Ruben,Rafayelyan Edgar,fiurst,Arutyunov Ruben - Rafayelyan Edgar,92,48,44,-4,4,28,26,19,19,0,-2,-2,3,-3,0,-4,15:13 - 14:12 - 8:11 - 11:8 - 0:0
14334138,2023-09-30 15:00:00,Nikoghosyan Narek - Antonyan Eduard,3:0,3:11 - 8:11 - 4:11 - 0:0 - 0:0,0,3,Nikoghosyan Narek,Antonyan Eduard,fiurst,Antonyan Eduard - Nikoghosyan Narek,48,33,15,-18,18,14,19,15,0,0,-8,-3,-7,0,0,-18,11:3 - 11:8 - 11:4 - 0:0 - 0:0
14334117,2023-09-30 14:35:00,Diaryan Aleksandr - Nikoghosyan Narek,3:0,11:7 - 11:6 - 11:5 - 0:0 - 0:0,3,0,Diaryan Aleksandr,Nikoghosyan Narek,fiurst,Diaryan Aleksandr - Nikoghosyan Narek,51,33,18,-15,15,18,17,16,0,0,-4,-5,-6,0,0,-15,11:7 - 11:6 - 11:5 - 0:0 - 0:0
14334116,2023-09-30 14:25:00,Antonyan Eduard - Arutyunov Ruben,3:2,11:7 - 10:12 - 8:11 - 11:9 - 11:7,3,2,Antonyan Eduard,Arutyunov Ruben,fiurst,Antonyan Eduard - Arutyunov Ruben,97,51,46,-5,5,18,22,19,20,18,-4,2,3,-2,-4,-5,11:7 - 10:12 - 8:11 - 11:9 - 11:7
14334111,2023-09-30 14:00:00,Diaryan Aleksandr - Rafayelyan Edgar,3:0,11:9 - 11:7 - 11:6 - 0:0 - 0:0,3,0,Diaryan Aleksandr,Rafayelyan Edgar,fiurst,Diaryan Aleksandr - Rafayelyan Edgar,55,33,22,-11,11,20,18,17,0,0,-2,-4,-5,0,0,-11,11:9 - 11:7 - 11:6 - 0:0 - 0:0
14334103,2023-09-30 13:55:00,Nikoghosyan Narek - Arutyunov Ruben,1:3,6:11 - 11:4 - 11:9 - 11:7 - 0:0,3,1,Nikoghosyan Narek,Arutyunov Ruben,fiurst,Arutyunov Ruben - Nikoghosyan Narek,70,31,39,8,-8,17,15,20,18,0,-5,7,2,4,0,8,11:6 - 4:11 - 9:11 - 7:11 - 0:0
14334100,2023-09-30 13:30:00,Antonyan Eduard - Diaryan Aleksandr,0:3,5:11 - 0:11 - 3:11 - 0:0 - 0:0,0,3,Antonyan Eduard,Diaryan Aleksandr,fiurst,Antonyan Eduard - Diaryan Aleksandr,41,8,33,25,-25,16,11,14,0,0,6,11,8,0,0,25,5:11 - 0:11 - 3:11 - 0:0 - 0:0
14334098,2023-09-30 13:15:00,Rafayelyan Edgar - Nikoghosyan Narek,2:3,8:11 - 11:6 - 11:4 - 7:11 - 12:10,3,2,Rafayelyan Edgar,Nikoghosyan Narek,fiurst,Nikoghosyan Narek - Rafayelyan Edgar,91,42,49,7,-7,19,17,15,18,22,-3,5,7,-4,2,7,11:8 - 6:11 - 4:11 - 11:7 - 10:12
14334086,2023-09-30 13:00:00,Arutyunov Ruben - Diaryan Aleksandr,1:3,5:11 - 7:11 - 11:6 - 4:11 - 0:0,1,3,Arutyunov Ruben,Diaryan Aleksandr,fiurst,Arutyunov Ruben - Diaryan Aleksandr,66,27,39,12,-12,16,18,17,15,0,6,4,-5,7,0,12,5:11 - 7:11 - 11:6 - 4:11 - 0:0
14334085,2023-09-30 12:45:00,Rafayelyan Edgar - Antonyan Eduard,3:0,7:11 - 6:11 - 8:11 - 0:0 - 0:0,0,3,Rafayelyan Edgar,Antonyan Eduard,fiurst,Antonyan Eduard - Rafayelyan Edgar,54,33,21,-12,12,18,17,19,0,0,-4,-5,-3,0,0,-12,11:7 - 11:6 - 11:8 - 0:0 - 0:0
14334084,2023-09-30 12:15:00,Nikoghosyan Narek - Diaryan Aleksandr,3:0,6:11 - 4:11 - 3:11 - 0:0 - 0:0,0,3,Nikoghosyan Narek,Diaryan Aleksandr,fiurst,Diaryan Aleksandr - Nikoghosyan Narek,46,33,13,-20,20,17,15,14,0,0,-5,-7,-8,0,0,-20,11:6 - 11:4 - 11:3 - 0:0 - 0:0
14334082,2023-09-30 12:00:00,Rafayelyan Edgar - Arutyunov Ruben,0:3,11:6 - 11:9 - 11:8 - 0:0 - 0:0,3,0,Rafayelyan Edgar,Arutyunov Ruben,fiurst,Arutyunov Ruben - Rafayelyan Edgar,56,23,33,10,-10,17,20,19,0,0,5,2,3,0,0,10,6:11 - 9:11 - 8:11 - 0:0 - 0:0
14334079,2023-09-30 11:45:00,Antonyan Eduard - Nikoghosyan Narek,2:3,1:11 - 11:9 - 11:9 - 6:11 - 7:11,2,3,Antonyan Eduard,Nikoghosyan Narek,fiurst,Antonyan Eduard - Nikoghosyan Narek,87,36,51,15,-15,12,20,20,17,18,10,-2,-2,5,4,15,1:11 - 11:9 - 11:9 - 6:11 - 7:11
14334078,2023-09-30 11:30:00,Rafayelyan Edgar - Diaryan Aleksandr,3:1,11:9 - 3:11 - 8:11 - 5:11 - 0:0,1,3,Rafayelyan Edgar,Diaryan Aleksandr,fiurst,Diaryan Aleksandr - Rafayelyan Edgar,69,42,27,-15,15,20,14,19,16,0,2,-8,-3,-6,0,-15,9:11 - 11:3 - 11:8 - 11:5 - 0:0
14334074,2023-09-30 11:15:00,Arutyunov Ruben - Antonyan Eduard,2:3,8:11 - 11:5 - 7:11 - 11:8 - 11:8,3,2,Arutyunov Ruben,Antonyan Eduard,fiurst,Antonyan Eduard - Arutyunov Ruben,91,43,48,5,-5,19,16,18,19,19,-3,6,-4,3,3,5,11:8 - 5:11 - 11:7 - 8:11 - 8:11
14334063,2023-09-30 11:00:00,Nikoghosyan Narek - Rafayelyan Edgar,3:2,11:3 - 3:11 - 7:11 - 11:3 - 11:4,3,2,Nikoghosyan Narek,Rafayelyan Edgar,fiurst,Nikoghosyan Narek - Rafayelyan Edgar,75,43,32,-11,11,14,14,18,14,15,-8,8,4,-8,-7,-11,11:3 - 3:11 - 7:11 - 11:3 - 11:4
14334059,2023-09-30 10:45:00,Diaryan Aleksandr - Antonyan Eduard,0:3,11:9 - 11:4 - 11:3 - 0:0 - 0:0,3,0,Diaryan Aleksandr,Antonyan Eduard,fiurst,Antonyan Eduard - Diaryan Aleksandr,49,16,33,17,-17,20,15,14,0,0,2,7,8,0,0,17,9:11 - 4:11 - 3:11 - 0:0 - 0:0
14334055,2023-09-30 10:30:00,Arutyunov Ruben - Nikoghosyan Narek,1:3,4:11 - 13:11 - 8:11 - 7:11 - 0:0,1,3,Arutyunov Ruben,Nikoghosyan Narek,fiurst,Arutyunov Ruben - Nikoghosyan Narek,76,32,44,12,-12,15,24,19,18,0,7,-2,3,4,0,12,4:11 - 13:11 - 8:11 - 7:11 - 0:0
14334053,2023-09-30 10:15:00,Antonyan Eduard - Rafayelyan Edgar,3:1,11:8 - 11:6 - 6:11 - 11:6 - 0:0,3,1,Antonyan Eduard,Rafayelyan Edgar,fiurst,Antonyan Eduard - Rafayelyan Edgar,70,39,31,-8,8,19,17,17,17,0,-3,-5,5,-5,0,-8,11:8 - 11:6 - 6:11 - 11:6 - 0:0
14334034,2023-09-30 10:00:00,Diaryan Aleksandr - Arutyunov Ruben,1:3,6:11 - 11:4 - 11:7 - 13:11 - 0:0,3,1,Diaryan Aleksandr,Arutyunov Ruben,fiurst,Arutyunov Ruben - Diaryan Aleksandr,74,33,41,8,-8,17,15,18,24,0,-5,7,4,2,0,8,11:6 - 4:11 - 7:11 - 11:13 - 0:0
14315132,2023-09-29 17:30:00,Darbinyan Armen - Mkrtchyan Andranik,0:3,7:11 - 8:11 - 7:11 - 0:0 - 0:0,0,3,Darbinyan Armen,Mkrtchyan Andranik,fiurst,Darbinyan Armen - Mkrtchyan Andranik,55,22,33,11,-11,18,19,18,0,0,4,3,4,0,0,11,7:11 - 8:11 - 7:11 - 0:0 - 0:0
14315129,2023-09-29 17:15:00,Petrosyan Davit - Avakimyan Davit,3:0,6:11 - 6:11 - 5:11 - 0:0 - 0:0,0,3,Petrosyan Davit,Avakimyan Davit,fiurst,Avakimyan Davit - Petrosyan Davit,50,33,17,-16,16,17,17,16,0,0,-5,-5,-6,0,0,-16,11:6 - 11:6 - 11:5 - 0:0 - 0:0
14315120,2023-09-29 17:00:00,Gevorgyan Hayk - Darbinyan Armen,0:3,11:3 - 11:4 - 11:1 - 0:0 - 0:0,3,0,Gevorgyan Hayk,Darbinyan Armen,fiurst,Darbinyan Armen - Gevorgyan Hayk,41,8,33,25,-25,14,15,12,0,0,8,7,10,0,0,25,3:11 - 4:11 - 1:11 - 0:0 - 0:0
14315110,2023-09-29 16:45:00,Petrosyan Davit - Mkrtchyan Andranik,3:1,11:6 - 5:11 - 6:11 - 8:11 - 0:0,1,3,Petrosyan Davit,Mkrtchyan Andranik,fiurst,Mkrtchyan Andranik - Petrosyan Davit,69,39,30,-9,9,17,16,17,19,0,5,-6,-5,-3,0,-9,6:11 - 11:5 - 11:6 - 11:8 - 0:0
14315105,2023-09-29 16:30:00,Avakimyan Davit - Gevorgyan Hayk,2:3,11:5 - 11:8 - 6:11 - 12:14 - 8:11,2,3,Avakimyan Davit,Gevorgyan Hayk,fiurst,Avakimyan Davit - Gevorgyan Hayk,97,48,49,1,-1,16,19,17,26,19,-6,-3,5,2,3,1,11:5 - 11:8 - 6:11 - 12:14 - 8:11
14315098,2023-09-29 16:15:00,Darbinyan Armen - Petrosyan Davit,0:3,8:11 - 11:13 - 3:11 - 0:0 - 0:0,0,3,Darbinyan Armen,Petrosyan Davit,fiurst,Darbinyan Armen - Petrosyan Davit,57,22,35,13,-13,19,24,14,0,0,3,2,8,0,0,13,8:11 - 11:13 - 3:11 - 0:0 - 0:0
14315082,2023-09-29 16:00:00,Mkrtchyan Andranik - Gevorgyan Hayk,0:3,11:7 - 11:7 - 11:5 - 0:0 - 0:0,3,0,Mkrtchyan Andranik,Gevorgyan Hayk,fiurst,Gevorgyan Hayk - Mkrtchyan Andranik,52,19,33,14,-14,18,18,16,0,0,4,4,6,0,0,14,7:11 - 7:11 - 5:11 - 0:0 - 0:0
14315080,2023-09-29 15:45:00,Avakimyan Davit - Darbinyan Armen,3:0,11:5 - 11:3 - 11:8 - 0:0 - 0:0,3,0,Avakimyan Davit,Darbinyan Armen,fiurst,Avakimyan Davit - Darbinyan Armen,49,33,16,-17,17,16,14,19,0,0,-6,-8,-3,0,0,-17,11:5 - 11:3 - 11:8 - 0:0 - 0:0
14315077,2023-09-29 15:30:00,Gevorgyan Hayk - Petrosyan Davit,1:3,6:11 - 9:11 - 11:7 - 7:11 - 0:0,1,3,Gevorgyan Hayk,Petrosyan Davit,fiurst,Gevorgyan Hayk - Petrosyan Davit,73,33,40,7,-7,17,20,18,18,0,5,2,-4,4,0,7,6:11 - 9:11 - 11:7 - 7:11 - 0:0
14315073,2023-09-29 15:15:00,Mkrtchyan Andranik - Avakimyan Davit,3:0,8:11 - 2:11 - 8:11 - 0:0 - 0:0,0,3,Mkrtchyan Andranik,Avakimyan Davit,fiurst,Avakimyan Davit - Mkrtchyan Andranik,51,33,18,-15,15,19,13,19,0,0,-3,-9,-3,0,0,-15,11:8 - 11:2 - 11:8 - 0:0 - 0:0
14315062,2023-09-29 15:00:00,Nazaryan Mushegh - Papyan Karen,0:3,7:11 - 4:11 - 2:11 - 0:0 - 0:0,0,3,Nazaryan Mushegh,Papyan Karen,fiurst,Nazaryan Mushegh - Papyan Karen,46,13,33,20,-20,18,15,13,0,0,4,7,9,0,0,20,7:11 - 4:11 - 2:11 - 0:0 - 0:0
14315061,2023-09-29 14:45:00,Diaryan Aleksandr - Nikoghosyan Narek,0:3,13:15 - 10:12 - 4:11 - 0:0 - 0:0,0,3,Diaryan Aleksandr,Nikoghosyan Narek,fiurst,Diaryan Aleksandr - Nikoghosyan Narek,65,27,38,11,-11,28,22,15,0,0,2,2,7,0,0,11,13:15 - 10:12 - 4:11 - 0:0 - 0:0
14315054,2023-09-29 14:30:00,Rafayelyan Edgar - Nazaryan Mushegh,0:3,11:8 - 11:4 - 11:5 - 0:0 - 0:0,3,0,Rafayelyan Edgar,Nazaryan Mushegh,fiurst,Nazaryan Mushegh - Rafayelyan Edgar,50,17,33,16,-16,19,15,16,0,0,3,7,6,0,0,16,8:11 - 4:11 - 5:11 - 0:0 - 0:0
14315051,2023-09-29 14:15:00,Papyan Karen - Diaryan Aleksandr,3:1,13:11 - 5:11 - 6:11 - 7:11 - 0:0,1,3,Papyan Karen,Diaryan Aleksandr,fiurst,Diaryan Aleksandr - Papyan Karen,75,44,31,-13,13,24,16,17,18,0,2,-6,-5,-4,0,-13,11:13 - 11:5 - 11:6 - 11:7 - 0:0
14314739,2023-09-29 14:00:00,Rafayelyan Edgar - Nikoghosyan Narek,3:2,2:11 - 12:10 - 11:6 - 8:11 - 9:11,2,3,Rafayelyan Edgar,Nikoghosyan Narek,fiurst,Nikoghosyan Narek - Rafayelyan Edgar,91,49,42,-7,7,13,22,17,19,20,-9,2,5,-3,-2,-7,11:2 - 10:12 - 6:11 - 11:8 - 11:9
14314733,2023-09-29 13:45:00,Nazaryan Mushegh - Diaryan Aleksandr,3:0,6:11 - 4:11 - 0:11 - 0:0 - 0:0,0,3,Nazaryan Mushegh,Diaryan Aleksandr,fiurst,Diaryan Aleksandr - Nazaryan Mushegh,43,33,10,-23,23,17,15,11,0,0,-5,-7,-11,0,0,-23,11:6 - 11:4 - 11:0 - 0:0 - 0:0
14314728,2023-09-29 13:30:00,Papyan Karen - Rafayelyan Edgar,3:1,8:11 - 11:8 - 11:8 - 12:10 - 0:0,3,1,Papyan Karen,Rafayelyan Edgar,fiurst,Papyan Karen - Rafayelyan Edgar,79,42,37,-5,5,19,19,19,22,0,3,-3,-3,-2,0,-5,8:11 - 11:8 - 11:8 - 12:10 - 0:0
14314714,2023-09-29 13:25:00,Nikoghosyan Narek - Nazaryan Mushegh,0:3,11:9 - 11:5 - 11:7 - 0:0 - 0:0,3,0,Nikoghosyan Narek,Nazaryan Mushegh,fiurst,Nazaryan Mushegh - Nikoghosyan Narek,54,21,33,12,-12,20,16,18,0,0,2,6,4,0,0,12,9:11 - 5:11 - 7:11 - 0:0 - 0:0
14314711,2023-09-29 13:00:00,Diaryan Aleksandr - Rafayelyan Edgar,3:0,11:8 - 11:2 - 11:5 - 0:0 - 0:0,3,0,Diaryan Aleksandr,Rafayelyan Edgar,fiurst,Diaryan Aleksandr - Rafayelyan Edgar,48,33,15,-18,18,19,13,16,0,0,-3,-9,-6,0,0,-18,11:8 - 11:2 - 11:5 - 0:0 - 0:0
14314709,2023-09-29 12:55:00,Nikoghosyan Narek - Papyan Karen,3:2,11:8 - 7:11 - 8:11 - 11:4 - 11:2,3,2,Nikoghosyan Narek,Papyan Karen,fiurst,Nikoghosyan Narek - Papyan Karen,84,48,36,-12,12,19,18,19,15,13,-3,4,3,-7,-9,-12,11:8 - 7:11 - 8:11 - 11:4 - 11:2
14314704,2023-09-29 12:15:00,Nazaryan Mushegh - Rafayelyan Edgar,1:3,11:5 - 14:16 - 1:11 - 4:11 - 0:0,1,3,Nazaryan Mushegh,Rafayelyan Edgar,fiurst,Nazaryan Mushegh - Rafayelyan Edgar,73,30,43,13,-13,16,30,12,15,0,-6,2,10,7,0,13,11:5 - 14:16 - 1:11 - 4:11 - 0:0
14314700,2023-09-29 12:00:00,Nikoghosyan Narek - Diaryan Aleksandr,3:2,11:6 - 9:11 - 12:10 - 10:12 - 2:11,2,3,Nikoghosyan Narek,Diaryan Aleksandr,fiurst,Diaryan Aleksandr - Nikoghosyan Narek,94,50,44,-6,6,17,20,22,22,13,5,-2,2,-2,-9,-6,6:11 - 11:9 - 10:12 - 12:10 - 11:2
14314679,2023-09-29 11:45:00,Papyan Karen - Nazaryan Mushegh,1:3,11:7 - 13:15 - 11:3 - 11:5 - 0:0,3,1,Papyan Karen,Nazaryan Mushegh,fiurst,Nazaryan Mushegh - Papyan Karen,76,30,46,16,-16,18,28,14,16,0,4,-2,8,6,0,16,7:11 - 15:13 - 3:11 - 5:11 - 0:0
14314676,2023-09-29 11:30:00,Nikoghosyan Narek - Rafayelyan Edgar,3:0,11:9 - 11:9 - 11:3 - 0:0 - 0:0,3,0,Nikoghosyan Narek,Rafayelyan Edgar,fiurst,Nikoghosyan Narek - Rafayelyan Edgar,54,33,21,-12,12,20,20,14,0,0,-2,-2,-8,0,0,-12,11:9 - 11:9 - 11:3 - 0:0 - 0:0
14314673,2023-09-29 11:15:00,Diaryan Aleksandr - Papyan Karen,3:0,11:6 - 11:8 - 12:10 - 0:0 - 0:0,3,0,Diaryan Aleksandr,Papyan Karen,fiurst,Diaryan Aleksandr - Papyan Karen,58,34,24,-10,10,17,19,22,0,0,-5,-3,-2,0,0,-10,11:6 - 11:8 - 12:10 - 0:0 - 0:0
14314668,2023-09-29 11:00:00,Nazaryan Mushegh - Nikoghosyan Narek,0:3,9:11 - 7:11 - 5:11 - 0:0 - 0:0,0,3,Nazaryan Mushegh,Nikoghosyan Narek,fiurst,Nazaryan Mushegh - Nikoghosyan Narek,54,21,33,12,-12,20,18,16,0,0,2,4,6,0,0,12,9:11 - 7:11 - 5:11 - 0:0 - 0:0
14314664,2023-09-29 10:55:00,Rafayelyan Edgar - Papyan Karen,3:0,9:11 - 5:11 - 7:11 - 0:0 - 0:0,0,3,Rafayelyan Edgar,Papyan Karen,fiurst,Papyan Karen - Rafayelyan Edgar,54,33,21,-12,12,20,16,18,0,0,-2,-6,-4,0,0,-12,11:9 - 11:5 - 11:7 - 0:0 - 0:0
14314661,2023-09-29 10:30:00,Diaryan Aleksandr - Nazaryan Mushegh,3:1,11:7 - 6:11 - 11:8 - 11:7 - 0:0,3,1,Diaryan Aleksandr,Nazaryan Mushegh,fiurst,Diaryan Aleksandr - Nazaryan Mushegh,72,39,33,-6,6,18,17,19,18,0,-4,5,-3,-4,0,-6,11:7 - 6:11 - 11:8 - 11:7 - 0:0
14314658,2023-09-29 10:15:00,Papyan Karen - Nikoghosyan Narek,2:3,9:11 - 11:8 - 9:11 - 11:7 - 17:15,3,2,Papyan Karen,Nikoghosyan Narek,fiurst,Nikoghosyan Narek - Papyan Karen,109,52,57,5,-5,20,19,20,18,32,-2,3,-2,4,2,5,11:9 - 8:11 - 11:9 - 7:11 - 15:17
14314643,2023-09-29 10:00:00,Rafayelyan Edgar - Diaryan Aleksandr,3:2,12:10 - 6:11 - 11:4 - 4:11 - 8:11,2,3,Rafayelyan Edgar,Diaryan Aleksandr,fiurst,Diaryan Aleksandr - Rafayelyan Edgar,88,47,41,-6,6,22,17,15,15,19,2,-5,7,-7,-3,-6,10:12 - 11:6 - 4:11 - 11:4 - 11:8
14295393,2023-09-28 17:40:00,Darbinyan Armen - Avakimyan Davit,3:1,9:11 - 11:7 - 2:11 - 6:11 - 0:0,1,3,Darbinyan Armen,Avakimyan Davit,fiurst,Avakimyan Davit - Darbinyan Armen,68,40,28,-12,12,20,18,13,17,0,-2,4,-9,-5,0,-12,11:9 - 7:11 - 11:2 - 11:6 - 0:0
14295400,2023-09-28 17:15:00,Gevorgyan Hayk - Petrosyan Davit,0:3,9:11 - 8:11 - 9:11 - 0:0 - 0:0,0,3,Gevorgyan Hayk,Petrosyan Davit,fiurst,Gevorgyan Hayk - Petrosyan Davit,59,26,33,7,-7,20,19,20,0,0,2,3,2,0,0,7,9:11 - 8:11 - 9:11 - 0:0 - 0:0
14295403,2023-09-28 17:15:00,Mkrtchyan Andranik - Darbinyan Armen,2:3,8:11 - 10:12 - 11:7 - 11:8 - 11:5,3,2,Mkrtchyan Andranik,Darbinyan Armen,fiurst,Darbinyan Armen - Mkrtchyan Andranik,94,43,51,8,-8,19,22,18,19,16,-3,-2,4,3,6,8,11:8 - 12:10 - 7:11 - 8:11 - 5:11
14295409,2023-09-28 16:45:00,Gevorgyan Hayk - Avakimyan Davit,1:3,13:15 - 11:6 - 11:7 - 11:9 - 0:0,3,1,Gevorgyan Hayk,Avakimyan Davit,fiurst,Avakimyan Davit - Gevorgyan Hayk,83,37,46,9,-9,28,17,18,20,0,-2,5,4,2,0,9,15:13 - 6:11 - 7:11 - 9:11 - 0:0
14295614,2023-09-28 16:30:00,Petrosyan Davit - Mkrtchyan Andranik,3:2,14:16 - 12:10 - 11:6 - 10:12 - 7:11,2,3,Petrosyan Davit,Mkrtchyan Andranik,fiurst,Mkrtchyan Andranik - Petrosyan Davit,109,55,54,-1,1,30,22,17,22,18,-2,2,5,-2,-4,-1,16:14 - 10:12 - 6:11 - 12:10 - 11:7
14295599,2023-09-28 16:15:00,Darbinyan Armen - Gevorgyan Hayk,0:3,8:11 - 7:11 - 7:11 - 0:0 - 0:0,0,3,Darbinyan Armen,Gevorgyan Hayk,fiurst,Darbinyan Armen - Gevorgyan Hayk,55,22,33,11,-11,19,18,18,0,0,3,4,4,0,0,11,8:11 - 7:11 - 7:11 - 0:0 - 0:0
14295595,2023-09-28 16:00:00,Avakimyan Davit - Mkrtchyan Andranik,2:3,9:11 - 11:13 - 11:5 - 11:8 - 4:11,2,3,Avakimyan Davit,Mkrtchyan Andranik,fiurst,Avakimyan Davit - Mkrtchyan Andranik,94,46,48,2,-2,20,24,16,19,15,2,2,-6,-3,7,2,9:11 - 11:13 - 11:5 - 11:8 - 4:11
14295592,2023-09-28 15:45:00,Petrosyan Davit - Darbinyan Armen,0:3,11:8 - 11:9 - 11:5 - 0:0 - 0:0,3,0,Petrosyan Davit,Darbinyan Armen,fiurst,Darbinyan Armen - Petrosyan Davit,55,22,33,11,-11,19,20,16,0,0,3,2,6,0,0,11,8:11 - 9:11 - 5:11 - 0:0 - 0:0
14295589,2023-09-28 15:30:00,Mkrtchyan Andranik - Gevorgyan Hayk,0:3,11:4 - 11:2 - 11:4 - 0:0 - 0:0,3,0,Mkrtchyan Andranik,Gevorgyan Hayk,fiurst,Gevorgyan Hayk - Mkrtchyan Andranik,43,10,33,23,-23,15,13,15,0,0,7,9,7,0,0,23,4:11 - 2:11 - 4:11 - 0:0 - 0:0
14295588,2023-09-28 15:20:00,Avakimyan Davit - Petrosyan Davit,3:1,11:6 - 11:8 - 7:11 - 11:8 - 0:0,3,1,Avakimyan Davit,Petrosyan Davit,fiurst,Avakimyan Davit - Petrosyan Davit,73,40,33,-7,7,17,19,18,19,0,-5,-3,4,-3,0,-7,11:6 - 11:8 - 7:11 - 11:8 - 0:0
14295571,2023-09-28 15:05:00,Antonyan Eduard - Diaryan Aleksandr,1:3,11:7 - 2:11 - 8:11 - 7:11 - 0:0,1,3,Antonyan Eduard,Diaryan Aleksandr,fiurst,Antonyan Eduard - Diaryan Aleksandr,68,28,40,12,-12,18,13,19,18,0,-4,9,3,4,0,12,11:7 - 2:11 - 8:11 - 7:11 - 0:0
14295568,2023-09-28 14:55:00,Rafayelyan Edgar - Papyan Karen,3:2,5:11 - 11:2 - 5:11 - 11:9 - 5:11,2,3,Rafayelyan Edgar,Papyan Karen,fiurst,Papyan Karen - Rafayelyan Edgar,81,44,37,-7,7,16,13,16,20,16,-6,9,-6,2,-6,-7,11:5 - 2:11 - 11:5 - 9:11 - 11:5
14295567,2023-09-28 14:35:00,Nazaryan Mushegh - Antonyan Eduard,3:1,11:9 - 10:12 - 8:11 - 8:11 - 0:0,1,3,Nazaryan Mushegh,Antonyan Eduard,fiurst,Antonyan Eduard - Nazaryan Mushegh,80,43,37,-6,6,20,22,19,19,0,2,-2,-3,-3,0,-6,9:11 - 12:10 - 11:8 - 11:8 - 0:0
14295565,2023-09-28 14:15:00,Diaryan Aleksandr - Rafayelyan Edgar,1:3,8:11 - 11:8 - 9:11 - 8:11 - 0:0,1,3,Diaryan Aleksandr,Rafayelyan Edgar,fiurst,Diaryan Aleksandr - Rafayelyan Edgar,77,36,41,5,-5,19,19,20,19,0,3,-3,2,3,0,5,8:11 - 11:8 - 9:11 - 8:11 - 0:0
14295472,2023-09-28 14:10:00,Nazaryan Mushegh - Papyan Karen,1:3,9:11 - 8:11 - 11:4 - 4:11 - 0:0,1,3,Nazaryan Mushegh,Papyan Karen,fiurst,Nazaryan Mushegh - Papyan Karen,69,32,37,5,-5,20,19,15,15,0,2,3,-7,7,0,5,9:11 - 8:11 - 11:4 - 4:11 - 0:0
14295470,2023-09-28 13:45:00,Antonyan Eduard - Rafayelyan Edgar,1:3,8:11 - 8:11 - 12:10 - 10:12 - 0:0,1,3,Antonyan Eduard,Rafayelyan Edgar,fiurst,Antonyan Eduard - Rafayelyan Edgar,82,38,44,6,-6,19,19,22,22,0,3,3,-2,2,0,6,8:11 - 8:11 - 12:10 - 10:12 - 0:0
14295460,2023-09-28 13:35:00,Diaryan Aleksandr - Nazaryan Mushegh,1:3,11:13 - 11:6 - 6:11 - 7:11 - 0:0,1,3,Diaryan Aleksandr,Nazaryan Mushegh,fiurst,Diaryan Aleksandr - Nazaryan Mushegh,76,35,41,6,-6,24,17,17,18,0,2,-5,5,4,0,6,11:13 - 11:6 - 6:11 - 7:11 - 0:0
14295458,2023-09-28 13:15:00,Papyan Karen - Antonyan Eduard,1:3,12:14 - 11:5 - 13:11 - 11:7 - 0:0,3,1,Papyan Karen,Antonyan Eduard,fiurst,Antonyan Eduard - Papyan Karen,84,37,47,10,-10,26,16,24,18,0,-2,6,2,4,0,10,14:12 - 5:11 - 11:13 - 7:11 - 0:0
14295454,2023-09-28 13:00:00,Rafayelyan Edgar - Nazaryan Mushegh,1:3,8:11 - 11:5 - 13:11 - 11:8 - 0:0,3,1,Rafayelyan Edgar,Nazaryan Mushegh,fiurst,Nazaryan Mushegh - Rafayelyan Edgar,78,35,43,8,-8,19,16,24,19,0,-3,6,2,3,0,8,11:8 - 5:11 - 11:13 - 8:11 - 0:0
14295453,2023-09-28 12:45:00,Papyan Karen - Diaryan Aleksandr,3:1,11:8 - 12:14 - 6:11 - 3:11 - 0:0,1,3,Papyan Karen,Diaryan Aleksandr,fiurst,Diaryan Aleksandr - Papyan Karen,76,44,32,-12,12,19,26,17,14,0,3,-2,-5,-8,0,-12,8:11 - 14:12 - 11:6 - 11:3 - 0:0
14295444,2023-09-28 12:20:00,Antonyan Eduard - Nazaryan Mushegh,3:0,11:6 - 11:6 - 13:11 - 0:0 - 0:0,3,0,Antonyan Eduard,Nazaryan Mushegh,fiurst,Antonyan Eduard - Nazaryan Mushegh,58,35,23,-12,12,17,17,24,0,0,-5,-5,-2,0,0,-12,11:6 - 11:6 - 13:11 - 0:0 - 0:0
14295439,2023-09-28 12:00:00,Papyan Karen - Rafayelyan Edgar,1:3,11:6 - 8:11 - 2:11 - 9:11 - 0:0,1,3,Papyan Karen,Rafayelyan Edgar,fiurst,Papyan Karen - Rafayelyan Edgar,69,30,39,9,-9,17,19,13,20,0,-5,3,9,2,0,9,11:6 - 8:11 - 2:11 - 9:11 - 0:0
14295438,2023-09-28 11:45:00,Diaryan Aleksandr - Antonyan Eduard,2:3,11:5 - 12:14 - 11:4 - 7:11 - 11:3,3,2,Diaryan Aleksandr,Antonyan Eduard,fiurst,Antonyan Eduard - Diaryan Aleksandr,89,37,52,15,-15,16,26,15,18,14,6,-2,7,-4,8,15,5:11 - 14:12 - 4:11 - 11:7 - 3:11
14295433,2023-09-28 11:30:00,Papyan Karen - Nazaryan Mushegh,1:3,13:15 - 11:8 - 11:8 - 11:9 - 0:0,3,1,Papyan Karen,Nazaryan Mushegh,fiurst,Nazaryan Mushegh - Papyan Karen,86,40,46,6,-6,28,19,19,20,0,-2,3,3,2,0,6,15:13 - 8:11 - 8:11 - 9:11 - 0:0
14295425,2023-09-28 11:15:00,Rafayelyan Edgar - Diaryan Aleksandr,3:1,6:11 - 4:11 - 11:6 - 6:11 - 0:0,1,3,Rafayelyan Edgar,Diaryan Aleksandr,fiurst,Diaryan Aleksandr - Rafayelyan Edgar,66,39,27,-12,12,17,15,17,17,0,-5,-7,5,-5,0,-12,11:6 - 11:4 - 6:11 - 11:6 - 0:0
14295424,2023-09-28 11:00:00,Antonyan Eduard - Papyan Karen,3:1,11:9 - 9:11 - 11:1 - 11:5 - 0:0,3,1,Antonyan Eduard,Papyan Karen,fiurst,Antonyan Eduard - Papyan Karen,68,42,26,-16,16,20,20,12,16,0,-2,2,-10,-6,0,-16,11:9 - 9:11 - 11:1 - 11:5 - 0:0
14295405,2023-09-28 10:45:00,Nazaryan Mushegh - Diaryan Aleksandr,3:1,7:11 - 7:11 - 11:9 - 5:11 - 0:0,1,3,Nazaryan Mushegh,Diaryan Aleksandr,fiurst,Diaryan Aleksandr - Nazaryan Mushegh,72,42,30,-12,12,18,18,20,16,0,-4,-4,2,-6,0,-12,11:7 - 11:7 - 9:11 - 11:5 - 0:0
14295402,2023-09-28 10:30:00,Rafayelyan Edgar - Antonyan Eduard,3:1,5:11 - 11:7 - 6:11 - 2:11 - 0:0,1,3,Rafayelyan Edgar,Antonyan Eduard,fiurst,Antonyan Eduard - Rafayelyan Edgar,64,40,24,-16,16,16,18,17,13,0,-6,4,-5,-9,0,-16,11:5 - 7:11 - 11:6 - 11:2 - 0:0
14295398,2023-09-28 10:15:00,Diaryan Aleksandr - Papyan Karen,3:2,9:11 - 11:6 - 10:12 - 11:7 - 11:3,3,2,Diaryan Aleksandr,Papyan Karen,fiurst,Diaryan Aleksandr - Papyan Karen,91,52,39,-13,13,20,17,22,18,14,2,-5,2,-4,-8,-13,9:11 - 11:6 - 10:12 - 11:7 - 11:3
14295390,2023-09-28 10:00:00,Nazaryan Mushegh - Rafayelyan Edgar,1:3,7:11 - 11:7 - 3:11 - 6:11 - 0:0,1,3,Nazaryan Mushegh,Rafayelyan Edgar,fiurst,Nazaryan Mushegh - Rafayelyan Edgar,67,27,40,13,-13,18,18,14,17,0,4,-4,8,5,0,13,7:11 - 11:7 - 3:11 - 6:11 - 0:0
14276976,2023-09-27 17:30:00,Darbinyan Armen - Petrosyan Davit,0:3,6:11 - 9:11 - 11:13 - 0:0 - 0:0,0,3,Darbinyan Armen,Petrosyan Davit,fiurst,Darbinyan Armen - Petrosyan Davit,61,26,35,9,-9,17,20,24,0,0,5,2,2,0,0,9,6:11 - 9:11 - 11:13 - 0:0 - 0:0
14276975,2023-09-27 17:20:00,Mkrtchyan Andranik - Avakimyan Davit,0:3,11:9 - 12:10 - 11:4 - 0:0 - 0:0,3,0,Mkrtchyan Andranik,Avakimyan Davit,fiurst,Avakimyan Davit - Mkrtchyan Andranik,57,23,34,11,-11,20,22,15,0,0,2,2,7,0,0,11,9:11 - 10:12 - 4:11 - 0:0 - 0:0
14276964,2023-09-27 17:00:00,Gevorgyan Hayk - Darbinyan Armen,0:3,11:8 - 11:7 - 11:9 - 0:0 - 0:0,3,0,Gevorgyan Hayk,Darbinyan Armen,fiurst,Darbinyan Armen - Gevorgyan Hayk,57,24,33,9,-9,19,18,20,0,0,3,4,2,0,0,9,8:11 - 7:11 - 9:11 - 0:0 - 0:0
14276962,2023-09-27 16:45:00,Mkrtchyan Andranik - Petrosyan Davit,2:3,5:11 - 11:9 - 14:12 - 7:11 - 8:11,2,3,Mkrtchyan Andranik,Petrosyan Davit,fiurst,Mkrtchyan Andranik - Petrosyan Davit,99,45,54,9,-9,16,20,26,18,19,6,-2,-2,4,3,9,5:11 - 11:9 - 14:12 - 7:11 - 8:11
14276959,2023-09-27 16:30:00,Avakimyan Davit - Gevorgyan Hayk,1:3,11:7 - 9:11 - 8:11 - 6:11 - 0:0,1,3,Avakimyan Davit,Gevorgyan Hayk,fiurst,Avakimyan Davit - Gevorgyan Hayk,74,34,40,6,-6,18,20,19,17,0,-4,2,3,5,0,6,11:7 - 9:11 - 8:11 - 6:11 - 0:0
14276957,2023-09-27 16:15:00,Darbinyan Armen - Mkrtchyan Andranik,0:3,9:11 - 8:11 - 6:11 - 0:0 - 0:0,0,3,Darbinyan Armen,Mkrtchyan Andranik,fiurst,Darbinyan Armen - Mkrtchyan Andranik,56,23,33,10,-10,20,19,17,0,0,2,3,5,0,0,10,9:11 - 8:11 - 6:11 - 0:0 - 0:0
14276956,2023-09-27 16:00:00,Petrosyan Davit - Gevorgyan Hayk,3:1,11:8 - 10:12 - 13:15 - 9:11 - 0:0,1,3,Petrosyan Davit,Gevorgyan Hayk,fiurst,Gevorgyan Hayk - Petrosyan Davit,89,46,43,-3,3,19,22,28,20,0,3,-2,-2,-2,0,-3,8:11 - 12:10 - 15:13 - 11:9 - 0:0
14276926,2023-09-27 15:45:00,Avakimyan Davit - Darbinyan Armen,3:2,5:11 - 11:5 - 11:8 - 4:11 - 11:5,3,2,Avakimyan Davit,Darbinyan Armen,fiurst,Avakimyan Davit - Darbinyan Armen,82,42,40,-2,2,16,16,19,15,16,6,-6,-3,7,-6,-2,5:11 - 11:5 - 11:8 - 4:11 - 11:5
14276923,2023-09-27 15:30:00,Gevorgyan Hayk - Mkrtchyan Andranik,1:3,13:11 - 3:11 - 3:11 - 5:11 - 0:0,1,3,Gevorgyan Hayk,Mkrtchyan Andranik,fiurst,Gevorgyan Hayk - Mkrtchyan Andranik,68,24,44,20,-20,24,14,14,16,0,-2,8,8,6,0,20,13:11 - 3:11 - 3:11 - 5:11 - 0:0
14276912,2023-09-27 15:15:00,Petrosyan Davit - Avakimyan Davit,1:3,17:15 - 7:11 - 12:10 - 11:4 - 0:0,3,1,Petrosyan Davit,Avakimyan Davit,fiurst,Avakimyan Davit - Petrosyan Davit,87,40,47,7,-7,32,18,22,15,0,2,-4,2,7,0,7,15:17 - 11:7 - 10:12 - 4:11 - 0:0
14276900,2023-09-27 15:00:00,Nikoghosyan Narek - Rafayelyan Edgar,0:3,7:11 - 2:11 - 6:11 - 0:0 - 0:0,0,3,Nikoghosyan Narek,Rafayelyan Edgar,fiurst,Nikoghosyan Narek - Rafayelyan Edgar,48,15,33,18,-18,18,13,17,0,0,4,9,5,0,0,18,7:11 - 2:11 - 6:11 - 0:0 - 0:0
14276894,2023-09-27 14:45:00,Antonyan Eduard - Papyan Karen,3:1,11:8 - 5:11 - 11:4 - 11:8 - 0:0,3,1,Antonyan Eduard,Papyan Karen,fiurst,Antonyan Eduard - Papyan Karen,69,38,31,-7,7,19,16,15,19,0,-3,6,-7,-3,0,-7,11:8 - 5:11 - 11:4 - 11:8 - 0:0
14276890,2023-09-27 14:30:00,Diaryan Aleksandr - Nikoghosyan Narek,3:0,12:10 - 11:4 - 16:14 - 0:0 - 0:0,3,0,Diaryan Aleksandr,Nikoghosyan Narek,fiurst,Diaryan Aleksandr - Nikoghosyan Narek,67,39,28,-11,11,22,15,30,0,0,-2,-7,-2,0,0,-11,12:10 - 11:4 - 16:14 - 0:0 - 0:0
14276878,2023-09-27 14:15:00,Rafayelyan Edgar - Antonyan Eduard,0:3,11:5 - 11:7 - 11:4 - 0:0 - 0:0,3,0,Rafayelyan Edgar,Antonyan Eduard,fiurst,Antonyan Eduard - Rafayelyan Edgar,49,16,33,17,-17,16,18,15,0,0,6,4,7,0,0,17,5:11 - 7:11 - 4:11 - 0:0 - 0:0
14276876,2023-09-27 14:00:00,Diaryan Aleksandr - Papyan Karen,3:0,11:3 - 11:7 - 11:7 - 0:0 - 0:0,3,0,Diaryan Aleksandr,Papyan Karen,fiurst,Diaryan Aleksandr - Papyan Karen,50,33,17,-16,16,14,18,18,0,0,-8,-4,-4,0,0,-16,11:3 - 11:7 - 11:7 - 0:0 - 0:0
14276874,2023-09-27 13:50:00,Nikoghosyan Narek - Antonyan Eduard,3:0,3:11 - 5:11 - 10:12 - 0:0 - 0:0,0,3,Nikoghosyan Narek,Antonyan Eduard,fiurst,Antonyan Eduard - Nikoghosyan Narek,52,34,18,-16,16,14,16,22,0,0,-8,-6,-2,0,0,-16,11:3 - 11:5 - 12:10 - 0:0 - 0:0
14276868,2023-09-27 13:30:00,Rafayelyan Edgar - Diaryan Aleksandr,3:2,5:11 - 9:11 - 11:6 - 11:1 - 9:11,2,3,Rafayelyan Edgar,Diaryan Aleksandr,fiurst,Diaryan Aleksandr - Rafayelyan Edgar,85,40,45,5,-5,16,20,17,12,20,-6,-2,5,10,-2,5,11:5 - 11:9 - 6:11 - 1:11 - 11:9
14276867,2023-09-27 13:15:00,Papyan Karen - Nikoghosyan Narek,1:3,6:11 - 11:2 - 11:8 - 11:9 - 0:0,3,1,Papyan Karen,Nikoghosyan Narek,fiurst,Nikoghosyan Narek - Papyan Karen,69,30,39,9,-9,17,13,19,20,0,-5,9,3,2,0,9,11:6 - 2:11 - 8:11 - 9:11 - 0:0
14276856,2023-09-27 13:05:00,Antonyan Eduard - Diaryan Aleksandr,0:3,3:11 - 2:11 - 4:11 - 0:0 - 0:0,0,3,Antonyan Eduard,Diaryan Aleksandr,fiurst,Antonyan Eduard - Diaryan Aleksandr,42,9,33,24,-24,14,13,15,0,0,8,9,7,0,0,24,3:11 - 2:11 - 4:11 - 0:0 - 0:0
14276851,2023-09-27 12:55:00,Papyan Karen - Rafayelyan Edgar,0:3,7:11 - 6:11 - 8:11 - 0:0 - 0:0,0,3,Papyan Karen,Rafayelyan Edgar,fiurst,Papyan Karen - Rafayelyan Edgar,54,21,33,12,-12,18,17,19,0,0,4,5,3,0,0,12,7:11 - 6:11 - 8:11 - 0:0 - 0:0
14276843,2023-09-27 12:25:00,Nikoghosyan Narek - Diaryan Aleksandr,3:1,14:12 - 8:11 - 6:11 - 3:11 - 0:0,1,3,Nikoghosyan Narek,Diaryan Aleksandr,fiurst,Diaryan Aleksandr - Nikoghosyan Narek,76,45,31,-14,14,26,19,17,14,0,2,-3,-5,-8,0,-14,12:14 - 11:8 - 11:6 - 11:3 - 0:0
14276837,2023-09-27 12:10:00,Papyan Karen - Antonyan Eduard,2:3,11:7 - 4:11 - 11:6 - 4:11 - 11:6,3,2,Papyan Karen,Antonyan Eduard,fiurst,Antonyan Eduard - Papyan Karen,82,41,41,0,0,18,15,17,15,17,4,-7,5,-7,5,0,7:11 - 11:4 - 6:11 - 11:4 - 6:11
14276826,2023-09-27 11:50:00,Rafayelyan Edgar - Nikoghosyan Narek,2:3,11:7 - 6:11 - 12:10 - 5:11 - 11:5,3,2,Rafayelyan Edgar,Nikoghosyan Narek,fiurst,Nikoghosyan Narek - Rafayelyan Edgar,89,44,45,1,-1,18,17,22,16,16,4,-5,2,-6,6,1,7:11 - 11:6 - 10:12 - 11:5 - 5:11
14276821,2023-09-27 11:40:00,Papyan Karen - Diaryan Aleksandr,2:3,8:11 - 11:9 - 9:11 - 15:13 - 11:9,3,2,Papyan Karen,Diaryan Aleksandr,fiurst,Diaryan Aleksandr - Papyan Karen,107,53,54,1,-1,19,20,20,28,20,-3,2,-2,2,2,1,11:8 - 9:11 - 11:9 - 13:15 - 9:11
14276816,2023-09-27 11:15:00,Antonyan Eduard - Rafayelyan Edgar,3:1,7:11 - 11:5 - 15:13 - 12:10 - 0:0,3,1,Antonyan Eduard,Rafayelyan Edgar,fiurst,Antonyan Eduard - Rafayelyan Edgar,84,45,39,-6,6,18,16,28,22,0,4,-6,-2,-2,0,-6,7:11 - 11:5 - 15:13 - 12:10 - 0:0
14276811,2023-09-27 11:00:00,Nikoghosyan Narek - Papyan Karen,2:3,11:6 - 11:4 - 5:11 - 10:12 - 11:13,2,3,Nikoghosyan Narek,Papyan Karen,fiurst,Nikoghosyan Narek - Papyan Karen,94,48,46,-2,2,17,15,16,22,24,-5,-7,6,2,2,-2,11:6 - 11:4 - 5:11 - 10:12 - 11:13
14276808,2023-09-27 10:45:00,Diaryan Aleksandr - Rafayelyan Edgar,3:2,11:8 - 8:11 - 11:1 - 6:11 - 11:4,3,2,Diaryan Aleksandr,Rafayelyan Edgar,fiurst,Diaryan Aleksandr - Rafayelyan Edgar,82,47,35,-12,12,19,19,12,17,15,-3,3,-10,5,-7,-12,11:8 - 8:11 - 11:1 - 6:11 - 11:4
14276807,2023-09-27 10:30:00,Antonyan Eduard - Nikoghosyan Narek,1:3,11:5 - 11:13 - 3:11 - 5:11 - 0:0,1,3,Antonyan Eduard,Nikoghosyan Narek,fiurst,Antonyan Eduard - Nikoghosyan Narek,70,30,40,10,-10,16,24,14,16,0,-6,2,8,6,0,10,11:5 - 11:13 - 3:11 - 5:11 - 0:0
14276735,2023-09-27 10:15:00,Rafayelyan Edgar - Papyan Karen,3:2,7:11 - 6:11 - 11:7 - 11:3 - 9:11,2,3,Rafayelyan Edgar,Papyan Karen,fiurst,Papyan Karen - Rafayelyan Edgar,87,43,44,1,-1,18,17,18,14,20,-4,-5,4,8,-2,1,11:7 - 11:6 - 7:11 - 3:11 - 11:9
14276734,2023-09-27 10:00:00,Diaryan Aleksandr - Antonyan Eduard,1:3,11:8 - 11:7 - 3:11 - 11:4 - 0:0,3,1,Diaryan Aleksandr,Antonyan Eduard,fiurst,Antonyan Eduard - Diaryan Aleksandr,66,30,36,6,-6,19,18,14,15,0,3,4,-8,7,0,6,8:11 - 7:11 - 11:3 - 4:11 - 0:0
14258902,2023-09-26 17:30:00,Darbinyan Armen - Mkrtchyan Andranik,0:3,7:11 - 12:14 - 5:11 - 0:0 - 0:0,0,3,Darbinyan Armen,Mkrtchyan Andranik,fiurst,Darbinyan Armen - Mkrtchyan Andranik,60,24,36,12,-12,18,26,16,0,0,4,2,6,0,0,12,7:11 - 12:14 - 5:11 - 0:0 - 0:0
14258898,2023-09-26 17:15:00,Gevorgyan Hayk - Petrosyan Davit,3:0,11:6 - 11:8 - 12:10 - 0:0 - 0:0,3,0,Gevorgyan Hayk,Petrosyan Davit,fiurst,Gevorgyan Hayk - Petrosyan Davit,58,34,24,-10,10,17,19,22,0,0,-5,-3,-2,0,0,-10,11:6 - 11:8 - 12:10 - 0:0 - 0:0
14258857,2023-09-26 17:00:00,Avakimyan Davit - Darbinyan Armen,3:0,12:10 - 11:5 - 11:9 - 0:0 - 0:0,3,0,Avakimyan Davit,Darbinyan Armen,fiurst,Avakimyan Davit - Darbinyan Armen,58,34,24,-10,10,22,16,20,0,0,-2,-6,-2,0,0,-10,12:10 - 11:5 - 11:9 - 0:0 - 0:0
14258854,2023-09-26 16:45:00,Gevorgyan Hayk - Mkrtchyan Andranik,3:0,11:7 - 11:8 - 11:9 - 0:0 - 0:0,3,0,Gevorgyan Hayk,Mkrtchyan Andranik,fiurst,Gevorgyan Hayk - Mkrtchyan Andranik,57,33,24,-9,9,18,19,20,0,0,-4,-3,-2,0,0,-9,11:7 - 11:8 - 11:9 - 0:0 - 0:0
14258849,2023-09-26 16:30:00,Petrosyan Davit - Avakimyan Davit,3:0,5:11 - 3:11 - 6:11 - 0:0 - 0:0,0,3,Petrosyan Davit,Avakimyan Davit,fiurst,Avakimyan Davit - Petrosyan Davit,47,33,14,-19,19,16,14,17,0,0,-6,-8,-5,0,0,-19,11:5 - 11:3 - 11:6 - 0:0 - 0:0
14258843,2023-09-26 16:15:00,Darbinyan Armen - Gevorgyan Hayk,0:3,4:11 - 3:11 - 6:11 - 0:0 - 0:0,0,3,Darbinyan Armen,Gevorgyan Hayk,fiurst,Darbinyan Armen - Gevorgyan Hayk,46,13,33,20,-20,15,14,17,0,0,7,8,5,0,0,20,4:11 - 3:11 - 6:11 - 0:0 - 0:0
14258672,2023-09-26 16:00:00,Mkrtchyan Andranik - Avakimyan Davit,3:1,4:11 - 11:7 - 6:11 - 9:11 - 0:0,1,3,Mkrtchyan Andranik,Avakimyan Davit,fiurst,Avakimyan Davit - Mkrtchyan Andranik,70,40,30,-10,10,15,18,17,20,0,-7,4,-5,-2,0,-10,11:4 - 7:11 - 11:6 - 11:9 - 0:0
14258667,2023-09-26 15:45:00,Petrosyan Davit - Darbinyan Armen,1:3,11:3 - 8:11 - 11:6 - 12:10 - 0:0,3,1,Petrosyan Davit,Darbinyan Armen,fiurst,Darbinyan Armen - Petrosyan Davit,72,30,42,12,-12,14,19,17,22,0,8,-3,5,2,0,12,3:11 - 11:8 - 6:11 - 10:12 - 0:0
14258630,2023-09-26 15:30:00,Avakimyan Davit - Gevorgyan Hayk,0:3,8:11 - 6:11 - 7:11 - 0:0 - 0:0,0,3,Avakimyan Davit,Gevorgyan Hayk,fiurst,Avakimyan Davit - Gevorgyan Hayk,54,21,33,12,-12,19,17,18,0,0,3,5,4,0,0,12,8:11 - 6:11 - 7:11 - 0:0 - 0:0
14258622,2023-09-26 15:15:00,Mkrtchyan Andranik - Petrosyan Davit,3:0,11:7 - 11:6 - 11:9 - 0:0 - 0:0,3,0,Mkrtchyan Andranik,Petrosyan Davit,fiurst,Mkrtchyan Andranik - Petrosyan Davit,55,33,22,-11,11,18,17,20,0,0,-4,-5,-2,0,0,-11,11:7 - 11:6 - 11:9 - 0:0 - 0:0
14258618,2023-09-26 15:00:00,Papyan Karen - Arutyunov Ruben,2:3,6:11 - 14:12 - 11:9 - 9:11 - 11:9,3,2,Papyan Karen,Arutyunov Ruben,fiurst,Arutyunov Ruben - Papyan Karen,103,52,51,-1,1,17,26,20,20,20,-5,2,2,-2,2,-1,11:6 - 12:14 - 9:11 - 11:9 - 9:11
14258615,2023-09-26 14:50:00,Nikoghosyan Narek - Nazaryan Mushegh,0:3,11:2 - 11:5 - 11:6 - 0:0 - 0:0,3,0,Nikoghosyan Narek,Nazaryan Mushegh,fiurst,Nazaryan Mushegh - Nikoghosyan Narek,46,13,33,20,-20,13,16,17,0,0,9,6,5,0,0,20,2:11 - 5:11 - 6:11 - 0:0 - 0:0
14258600,2023-09-26 14:30:00,Antonyan Eduard - Papyan Karen,3:0,11:5 - 11:6 - 11:6 - 0:0 - 0:0,3,0,Antonyan Eduard,Papyan Karen,fiurst,Antonyan Eduard - Papyan Karen,50,33,17,-16,16,16,17,17,0,0,-6,-5,-5,0,0,-16,11:5 - 11:6 - 11:6 - 0:0 - 0:0
14258596,2023-09-26 14:25:00,Arutyunov Ruben - Nikoghosyan Narek,0:3,5:11 - 7:11 - 9:11 - 0:0 - 0:0,0,3,Arutyunov Ruben,Nikoghosyan Narek,fiurst,Arutyunov Ruben - Nikoghosyan Narek,54,21,33,12,-12,16,18,20,0,0,6,4,2,0,0,12,5:11 - 7:11 - 9:11 - 0:0 - 0:0
14258574,2023-09-26 14:05:00,Antonyan Eduard - Nazaryan Mushegh,3:0,11:8 - 11:8 - 11:9 - 0:0 - 0:0,3,0,Antonyan Eduard,Nazaryan Mushegh,fiurst,Antonyan Eduard - Nazaryan Mushegh,58,33,25,-8,8,19,19,20,0,0,-3,-3,-2,0,0,-8,11:8 - 11:8 - 11:9 - 0:0 - 0:0
14258569,2023-09-26 13:55:00,Papyan Karen - Nikoghosyan Narek,3:1,5:11 - 11:7 - 6:11 - 9:11 - 0:0,1,3,Papyan Karen,Nikoghosyan Narek,fiurst,Nikoghosyan Narek - Papyan Karen,71,40,31,-9,9,16,18,17,20,0,-6,4,-5,-2,0,-9,11:5 - 7:11 - 11:6 - 11:9 - 0:0
14258554,2023-09-26 13:45:00,Arutyunov Ruben - Antonyan Eduard,3:0,7:11 - 5:11 - 9:11 - 0:0 - 0:0,0,3,Arutyunov Ruben,Antonyan Eduard,fiurst,Antonyan Eduard - Arutyunov Ruben,54,33,21,-12,12,18,16,20,0,0,-4,-6,-2,0,0,-12,11:7 - 11:5 - 11:9 - 0:0 - 0:0
14258549,2023-09-26 13:25:00,Nazaryan Mushegh - Papyan Karen,1:3,12:10 - 5:11 - 9:11 - 10:12 - 0:0,1,3,Nazaryan Mushegh,Papyan Karen,fiurst,Nazaryan Mushegh - Papyan Karen,80,36,44,8,-8,22,16,20,22,0,-2,6,2,2,0,8,12:10 - 5:11 - 9:11 - 10:12 - 0:0
14258541,2023-09-26 13:05:00,Nikoghosyan Narek - Antonyan Eduard,2:3,9:11 - 7:11 - 11:2 - 11:7 - 11:8,3,2,Nikoghosyan Narek,Antonyan Eduard,fiurst,Antonyan Eduard - Nikoghosyan Narek,88,39,49,10,-10,20,18,13,18,19,-2,-4,9,4,3,10,11:9 - 11:7 - 2:11 - 7:11 - 8:11
14258533,2023-09-26 12:45:00,Nazaryan Mushegh - Arutyunov Ruben,2:3,6:11 - 11:3 - 14:16 - 11:9 - 11:6,3,2,Nazaryan Mushegh,Arutyunov Ruben,fiurst,Arutyunov Ruben - Nazaryan Mushegh,98,45,53,8,-8,17,14,30,20,17,-5,8,-2,2,5,8,11:6 - 3:11 - 16:14 - 9:11 - 6:11
14258529,2023-09-26 12:15:00,Papyan Karen - Antonyan Eduard,2:3,11:7 - 10:12 - 9:11 - 12:10 - 11:4,3,2,Papyan Karen,Antonyan Eduard,fiurst,Antonyan Eduard - Papyan Karen,97,44,53,9,-9,18,22,20,22,15,4,-2,-2,2,7,9,7:11 - 12:10 - 11:9 - 10:12 - 4:11
14258517,2023-09-26 12:10:00,Nazaryan Mushegh - Nikoghosyan Narek,1:3,5:11 - 8:11 - 11:9 - 7:11 - 0:0,1,3,Nazaryan Mushegh,Nikoghosyan Narek,fiurst,Nazaryan Mushegh - Nikoghosyan Narek,73,31,42,11,-11,16,19,20,18,0,6,3,-2,4,0,11,5:11 - 8:11 - 11:9 - 7:11 - 0:0
14258515,2023-09-26 11:45:00,Arutyunov Ruben - Papyan Karen,1:3,6:11 - 7:11 - 13:11 - 11:13 - 0:0,1,3,Arutyunov Ruben,Papyan Karen,fiurst,Arutyunov Ruben - Papyan Karen,83,37,46,9,-9,17,18,24,24,0,5,4,-2,2,0,9,6:11 - 7:11 - 13:11 - 11:13 - 0:0
14258490,2023-09-26 11:40:00,Nazaryan Mushegh - Antonyan Eduard,3:1,8:11 - 10:12 - 11:9 - 9:11 - 0:0,1,3,Nazaryan Mushegh,Antonyan Eduard,fiurst,Antonyan Eduard - Nazaryan Mushegh,81,43,38,-5,5,19,22,20,20,0,-3,-2,2,-2,0,-5,11:8 - 12:10 - 9:11 - 11:9 - 0:0
14258476,2023-09-26 11:15:00,Nikoghosyan Narek - Arutyunov Ruben,1:3,11:6 - 11:7 - 14:16 - 11:5 - 0:0,3,1,Nikoghosyan Narek,Arutyunov Ruben,fiurst,Arutyunov Ruben - Nikoghosyan Narek,81,34,47,13,-13,17,18,30,16,0,5,4,-2,6,0,13,6:11 - 7:11 - 16:14 - 5:11 - 0:0
14258474,2023-09-26 11:00:00,Papyan Karen - Nazaryan Mushegh,0:3,11:6 - 11:7 - 11:7 - 0:0 - 0:0,3,0,Papyan Karen,Nazaryan Mushegh,fiurst,Nazaryan Mushegh - Papyan Karen,53,20,33,13,-13,17,18,18,0,0,5,4,4,0,0,13,6:11 - 7:11 - 7:11 - 0:0 - 0:0
14258469,2023-09-26 10:45:00,Antonyan Eduard - Arutyunov Ruben,3:0,11:8 - 11:5 - 11:9 - 0:0 - 0:0,3,0,Antonyan Eduard,Arutyunov Ruben,fiurst,Antonyan Eduard - Arutyunov Ruben,55,33,22,-11,11,19,16,20,0,0,-3,-6,-2,0,0,-11,11:8 - 11:5 - 11:9 - 0:0 - 0:0
14258463,2023-09-26 10:30:00,Nikoghosyan Narek - Papyan Karen,0:3,10:12 - 11:13 - 6:11 - 0:0 - 0:0,0,3,Nikoghosyan Narek,Papyan Karen,fiurst,Nikoghosyan Narek - Papyan Karen,63,27,36,9,-9,22,24,17,0,0,2,2,5,0,0,9,10:12 - 11:13 - 6:11 - 0:0 - 0:0
14258453,2023-09-26 10:15:00,Arutyunov Ruben - Nazaryan Mushegh,1:3,6:11 - 11:9 - 9:11 - 7:11 - 0:0,1,3,Arutyunov Ruben,Nazaryan Mushegh,fiurst,Arutyunov Ruben - Nazaryan Mushegh,75,33,42,9,-9,17,20,20,18,0,5,-2,2,4,0,9,6:11 - 11:9 - 9:11 - 7:11 - 0:0
14258445,2023-09-26 10:00:00,Antonyan Eduard - Nikoghosyan Narek,3:1,6:11 - 11:3 - 11:3 - 11:7 - 0:0,3,1,Antonyan Eduard,Nikoghosyan Narek,fiurst,Antonyan Eduard - Nikoghosyan Narek,63,39,24,-15,15,17,14,14,18,0,5,-8,-8,-4,0,-15,6:11 - 11:3 - 11:3 - 11:7 - 0:0
14239547,2023-09-25 17:30:00,Darbinyan Armen - Gevorgyan Hayk,1:3,10:12 - 7:11 - 11:4 - 5:11 - 0:0,1,3,Darbinyan Armen,Gevorgyan Hayk,fiurst,Darbinyan Armen - Gevorgyan Hayk,71,33,38,5,-5,22,18,15,16,0,2,4,-7,6,0,5,10:12 - 7:11 - 11:4 - 5:11 - 0:0
14239544,2023-09-25 17:15:00,Petrosyan Davit - Avakimyan Davit,3:1,11:8 - 7:11 - 7:11 - 8:11 - 0:0,1,3,Petrosyan Davit,Avakimyan Davit,fiurst,Avakimyan Davit - Petrosyan Davit,74,41,33,-8,8,19,18,18,19,0,3,-4,-4,-3,0,-8,8:11 - 11:7 - 11:7 - 11:8 - 0:0
14239543,2023-09-25 17:00:00,Mkrtchyan Andranik - Darbinyan Armen,1:3,11:8 - 6:11 - 11:5 - 11:2 - 0:0,3,1,Mkrtchyan Andranik,Darbinyan Armen,fiurst,Darbinyan Armen - Mkrtchyan Andranik,65,26,39,13,-13,19,17,16,13,0,3,-5,6,9,0,13,8:11 - 11:6 - 5:11 - 2:11 - 0:0
14239542,2023-09-25 16:45:00,Petrosyan Davit - Gevorgyan Hayk,1:3,11:8 - 11:7 - 8:11 - 11:4 - 0:0,3,1,Petrosyan Davit,Gevorgyan Hayk,fiurst,Gevorgyan Hayk - Petrosyan Davit,71,30,41,11,-11,19,18,19,15,0,3,4,-3,7,0,11,8:11 - 7:11 - 11:8 - 4:11 - 0:0
14239541,2023-09-25 16:30:00,Avakimyan Davit - Mkrtchyan Andranik,3:0,11:7 - 11:9 - 12:10 - 0:0 - 0:0,3,0,Avakimyan Davit,Mkrtchyan Andranik,fiurst,Avakimyan Davit - Mkrtchyan Andranik,60,34,26,-8,8,18,20,22,0,0,-4,-2,-2,0,0,-8,11:7 - 11:9 - 12:10 - 0:0 - 0:0
14239538,2023-09-25 16:15:00,Darbinyan Armen - Petrosyan Davit,0:3,7:11 - 8:11 - 4:11 - 0:0 - 0:0,0,3,Darbinyan Armen,Petrosyan Davit,fiurst,Darbinyan Armen - Petrosyan Davit,52,19,33,14,-14,18,19,15,0,0,4,3,7,0,0,14,7:11 - 8:11 - 4:11 - 0:0 - 0:0
14239537,2023-09-25 16:00:00,Gevorgyan Hayk - Mkrtchyan Andranik,0:3,6:11 - 6:11 - 6:11 - 0:0 - 0:0,0,3,Gevorgyan Hayk,Mkrtchyan Andranik,fiurst,Gevorgyan Hayk - Mkrtchyan Andranik,51,18,33,15,-15,17,17,17,0,0,5,5,5,0,0,15,6:11 - 6:11 - 6:11 - 0:0 - 0:0
14239533,2023-09-25 15:45:00,Avakimyan Davit - Darbinyan Armen,3:1,12:10 - 11:6 - 9:11 - 14:12 - 0:0,3,1,Avakimyan Davit,Darbinyan Armen,fiurst,Avakimyan Davit - Darbinyan Armen,85,46,39,-7,7,22,17,20,26,0,-2,-5,2,-2,0,-7,12:10 - 11:6 - 9:11 - 14:12 - 0:0
14239526,2023-09-25 15:30:00,Mkrtchyan Andranik - Petrosyan Davit,3:1,11:8 - 5:11 - 11:6 - 11:9 - 0:0,3,1,Mkrtchyan Andranik,Petrosyan Davit,fiurst,Mkrtchyan Andranik - Petrosyan Davit,72,38,34,-4,4,19,16,17,20,0,-3,6,-5,-2,0,-4,11:8 - 5:11 - 11:6 - 11:9 - 0:0
14239505,2023-09-25 15:15:00,Gevorgyan Hayk - Avakimyan Davit,3:0,6:11 - 8:11 - 9:11 - 0:0 - 0:0,0,3,Gevorgyan Hayk,Avakimyan Davit,fiurst,Avakimyan Davit - Gevorgyan Hayk,56,33,23,-10,10,17,19,20,0,0,-5,-3,-2,0,0,-10,11:6 - 11:8 - 11:9 - 0:0 - 0:0
14239502,2023-09-25 15:00:00,Arutyunov Ruben - Nazaryan Mushegh,1:3,8:11 - 11:9 - 14:16 - 8:11 - 0:0,1,3,Arutyunov Ruben,Nazaryan Mushegh,fiurst,Arutyunov Ruben - Nazaryan Mushegh,88,41,47,6,-6,19,20,30,19,0,3,-2,2,3,0,6,8:11 - 11:9 - 14:16 - 8:11 - 0:0
14239495,2023-09-25 14:50:00,Papyan Karen - Diaryan Aleksandr,3:0,9:11 - 8:11 - 5:11 - 0:0 - 0:0,0,3,Papyan Karen,Diaryan Aleksandr,fiurst,Diaryan Aleksandr - Papyan Karen,55,33,22,-11,11,20,19,16,0,0,-2,-3,-6,0,0,-11,11:9 - 11:8 - 11:5 - 0:0 - 0:0
14239482,2023-09-25 14:35:00,Rafayelyan Edgar - Arutyunov Ruben,0:3,11:7 - 11:4 - 11:9 - 0:0 - 0:0,3,0,Rafayelyan Edgar,Arutyunov Ruben,fiurst,Arutyunov Ruben - Rafayelyan Edgar,53,20,33,13,-13,18,15,20,0,0,4,7,2,0,0,13,7:11 - 4:11 - 9:11 - 0:0 - 0:0
14239481,2023-09-25 14:15:00,Nazaryan Mushegh - Papyan Karen,3:2,8:11 - 13:11 - 11:6 - 6:11 - 13:11,3,2,Nazaryan Mushegh,Papyan Karen,fiurst,Nazaryan Mushegh - Papyan Karen,101,51,50,-1,1,19,24,17,17,24,3,-2,-5,5,-2,-1,8:11 - 13:11 - 11:6 - 6:11 - 13:11
14239293,2023-09-25 14:00:00,Rafayelyan Edgar - Diaryan Aleksandr,2:3,2:11 - 11:7 - 6:11 - 11:7 - 11:8,3,2,Rafayelyan Edgar,Diaryan Aleksandr,fiurst,Diaryan Aleksandr - Rafayelyan Edgar,85,44,41,-3,3,13,18,17,18,19,-9,4,-5,4,3,-3,11:2 - 7:11 - 11:6 - 7:11 - 8:11
14239282,2023-09-25 13:45:00,Arutyunov Ruben - Papyan Karen,0:3,9:11 - 11:13 - 5:11 - 0:0 - 0:0,0,3,Arutyunov Ruben,Papyan Karen,fiurst,Arutyunov Ruben - Papyan Karen,60,25,35,10,-10,20,24,16,0,0,2,2,6,0,0,10,9:11 - 11:13 - 5:11 - 0:0 - 0:0
14239270,2023-09-25 13:30:00,Nazaryan Mushegh - Rafayelyan Edgar,0:3,8:11 - 7:11 - 5:11 - 0:0 - 0:0,0,3,Nazaryan Mushegh,Rafayelyan Edgar,fiurst,Nazaryan Mushegh - Rafayelyan Edgar,53,20,33,13,-13,19,18,16,0,0,3,4,6,0,0,13,8:11 - 7:11 - 5:11 - 0:0 - 0:0
14239266,2023-09-25 13:15:00,Diaryan Aleksandr - Arutyunov Ruben,3:1,5:11 - 10:12 - 11:4 - 4:11 - 0:0,1,3,Diaryan Aleksandr,Arutyunov Ruben,fiurst,Arutyunov Ruben - Diaryan Aleksandr,68,38,30,-8,8,16,22,15,15,0,-6,-2,7,-7,0,-8,11:5 - 12:10 - 4:11 - 11:4 - 0:0
14239259,2023-09-25 13:00:00,Papyan Karen - Rafayelyan Edgar,2:3,11:5 - 4:11 - 9:11 - 11:9 - 9:11,2,3,Papyan Karen,Rafayelyan Edgar,fiurst,Papyan Karen - Rafayelyan Edgar,91,44,47,3,-3,16,15,20,20,20,-6,7,2,-2,2,3,11:5 - 4:11 - 9:11 - 11:9 - 9:11
14239258,2023-09-25 12:45:00,Diaryan Aleksandr - Nazaryan Mushegh,3:1,11:4 - 11:9 - 10:12 - 11:6 - 0:0,3,1,Diaryan Aleksandr,Nazaryan Mushegh,fiurst,Diaryan Aleksandr - Nazaryan Mushegh,74,43,31,-12,12,15,20,22,17,0,-7,-2,2,-5,0,-12,11:4 - 11:9 - 10:12 - 11:6 - 0:0
14239254,2023-09-25 12:25:00,Arutyunov Ruben - Rafayelyan Edgar,0:3,10:12 - 10:12 - 5:11 - 0:0 - 0:0,0,3,Arutyunov Ruben,Rafayelyan Edgar,fiurst,Arutyunov Ruben - Rafayelyan Edgar,60,25,35,10,-10,22,22,16,0,0,2,2,6,0,0,10,10:12 - 10:12 - 5:11 - 0:0 - 0:0
14239252,2023-09-25 12:00:00,Diaryan Aleksandr - Papyan Karen,3:2,11:4 - 7:11 - 11:6 - 4:11 - 13:11,3,2,Diaryan Aleksandr,Papyan Karen,fiurst,Diaryan Aleksandr - Papyan Karen,89,46,43,-3,3,15,18,17,15,24,-7,4,-5,7,-2,-3,11:4 - 7:11 - 11:6 - 4:11 - 13:11
14239241,2023-09-25 11:50:00,Nazaryan Mushegh - Arutyunov Ruben,3:1,9:11 - 6:11 - 11:9 - 9:11 - 0:0,1,3,Nazaryan Mushegh,Arutyunov Ruben,fiurst,Arutyunov Ruben - Nazaryan Mushegh,77,42,35,-7,7,20,17,20,20,0,-2,-5,2,-2,0,-7,11:9 - 11:6 - 9:11 - 11:9 - 0:0
14239237,2023-09-25 11:30:00,Diaryan Aleksandr - Rafayelyan Edgar,0:3,3:11 - 12:14 - 7:11 - 0:0 - 0:0,0,3,Diaryan Aleksandr,Rafayelyan Edgar,fiurst,Diaryan Aleksandr - Rafayelyan Edgar,58,22,36,14,-14,14,26,18,0,0,8,2,4,0,0,14,3:11 - 12:14 - 7:11 - 0:0 - 0:0
14239234,2023-09-25 11:20:00,Papyan Karen - Nazaryan Mushegh,1:3,4:11 - 11:4 - 11:4 - 11:6 - 0:0,3,1,Papyan Karen,Nazaryan Mushegh,fiurst,Nazaryan Mushegh - Papyan Karen,62,25,37,12,-12,15,15,15,17,0,-7,7,7,5,0,12,11:4 - 4:11 - 4:11 - 6:11 - 0:0
14239233,2023-09-25 11:00:00,Arutyunov Ruben - Diaryan Aleksandr,0:3,8:11 - 4:11 - 6:11 - 0:0 - 0:0,0,3,Arutyunov Ruben,Diaryan Aleksandr,fiurst,Arutyunov Ruben - Diaryan Aleksandr,51,18,33,15,-15,19,15,17,0,0,3,7,5,0,0,15,8:11 - 4:11 - 6:11 - 0:0 - 0:0
14239185,2023-09-25 10:50:00,Rafayelyan Edgar - Nazaryan Mushegh,1:3,5:11 - 13:11 - 11:8 - 11:7 - 0:0,3,1,Rafayelyan Edgar,Nazaryan Mushegh,fiurst,Nazaryan Mushegh - Rafayelyan Edgar,77,37,40,3,-3,16,24,19,18,0,-6,2,3,4,0,3,11:5 - 11:13 - 8:11 - 7:11 - 0:0
14239184,2023-09-25 10:30:00,Papyan Karen - Arutyunov Ruben,0:3,12:10 - 11:9 - 11:8 - 0:0 - 0:0,3,0,Papyan Karen,Arutyunov Ruben,fiurst,Arutyunov Ruben - Papyan Karen,61,27,34,7,-7,22,20,19,0,0,2,2,3,0,0,7,10:12 - 9:11 - 8:11 - 0:0 - 0:0
14239181,2023-09-25 10:15:00,Nazaryan Mushegh - Diaryan Aleksandr,2:3,2:11 - 11:8 - 4:11 - 11:5 - 11:7,3,2,Nazaryan Mushegh,Diaryan Aleksandr,fiurst,Diaryan Aleksandr - Nazaryan Mushegh,81,42,39,-3,3,13,19,15,16,18,-9,3,-7,6,4,-3,11:2 - 8:11 - 11:4 - 5:11 - 7:11
14239145,2023-09-25 10:00:00,Rafayelyan Edgar - Papyan Karen,2:3,8:11 - 7:11 - 11:7 - 11:8 - 11:7,3,2,Rafayelyan Edgar,Papyan Karen,fiurst,Papyan Karen - Rafayelyan Edgar,92,44,48,4,-4,19,18,18,19,18,-3,-4,4,3,4,4,11:8 - 11:7 - 7:11 - 8:11 - 7:11
14220452,2023-09-24 17:30:00,Avakimyan Davit - Darbinyan Armen,3:0,11:3 - 11:8 - 11:8 - 0:0 - 0:0,3,0,Avakimyan Davit,Darbinyan Armen,fiurst,Avakimyan Davit - Darbinyan Armen,52,33,19,-14,14,14,19,19,0,0,-8,-3,-3,0,0,-14,11:3 - 11:8 - 11:8 - 0:0 - 0:0
14220447,2023-09-24 17:15:00,Gevorgyan Hayk - Petrosyan Davit,3:2,9:11 - 9:11 - 13:11 - 12:10 - 11:9,3,2,Gevorgyan Hayk,Petrosyan Davit,fiurst,Gevorgyan Hayk - Petrosyan Davit,106,54,52,-2,2,20,20,24,22,20,2,2,-2,-2,-2,-2,9:11 - 9:11 - 13:11 - 12:10 - 11:9
14220417,2023-09-24 17:00:00,Mkrtchyan Andranik - Avakimyan Davit,3:2,11:3 - 9:11 - 15:13 - 9:11 - 10:12,2,3,Mkrtchyan Andranik,Avakimyan Davit,fiurst,Avakimyan Davit - Mkrtchyan Andranik,104,50,54,4,-4,14,20,28,20,22,8,-2,2,-2,-2,4,3:11 - 11:9 - 13:15 - 11:9 - 12:10
14220408,2023-09-24 16:45:00,Gevorgyan Hayk - Darbinyan Armen,0:3,11:5 - 11:7 - 11:8 - 0:0 - 0:0,3,0,Gevorgyan Hayk,Darbinyan Armen,fiurst,Darbinyan Armen - Gevorgyan Hayk,53,20,33,13,-13,16,18,19,0,0,6,4,3,0,0,13,5:11 - 7:11 - 8:11 - 0:0 - 0:0
14220407,2023-09-24 16:30:00,Petrosyan Davit - Mkrtchyan Andranik,3:1,11:7 - 8:11 - 8:11 - 9:11 - 0:0,1,3,Petrosyan Davit,Mkrtchyan Andranik,fiurst,Mkrtchyan Andranik - Petrosyan Davit,76,40,36,-4,4,18,19,19,20,0,4,-3,-3,-2,0,-4,7:11 - 11:8 - 11:8 - 11:9 - 0:0
14220405,2023-09-24 16:15:00,Avakimyan Davit - Gevorgyan Hayk,2:3,11:5 - 11:5 - 9:11 - 7:11 - 7:11,2,3,Avakimyan Davit,Gevorgyan Hayk,fiurst,Avakimyan Davit - Gevorgyan Hayk,88,45,43,-2,2,16,16,20,18,18,-6,-6,2,4,4,-2,11:5 - 11:5 - 9:11 - 7:11 - 7:11
14220387,2023-09-24 16:00:00,Darbinyan Armen - Mkrtchyan Andranik,1:3,11:8 - 8:11 - 4:11 - 6:11 - 0:0,1,3,Darbinyan Armen,Mkrtchyan Andranik,fiurst,Darbinyan Armen - Mkrtchyan Andranik,70,29,41,12,-12,19,19,15,17,0,-3,3,7,5,0,12,11:8 - 8:11 - 4:11 - 6:11 - 0:0
14220364,2023-09-24 15:45:00,Petrosyan Davit - Avakimyan Davit,3:0,5:11 - 5:11 - 5:11 - 0:0 - 0:0,0,3,Petrosyan Davit,Avakimyan Davit,fiurst,Avakimyan Davit - Petrosyan Davit,48,33,15,-18,18,16,16,16,0,0,-6,-6,-6,0,0,-18,11:5 - 11:5 - 11:5 - 0:0 - 0:0
14220331,2023-09-24 15:30:00,Mkrtchyan Andranik - Gevorgyan Hayk,0:3,13:11 - 13:11 - 11:5 - 0:0 - 0:0,3,0,Mkrtchyan Andranik,Gevorgyan Hayk,fiurst,Gevorgyan Hayk - Mkrtchyan Andranik,64,27,37,10,-10,24,24,16,0,0,2,2,6,0,0,10,11:13 - 11:13 - 5:11 - 0:0 - 0:0
14220321,2023-09-24 15:15:00,Darbinyan Armen - Petrosyan Davit,0:3,9:11 - 4:11 - 6:11 - 0:0 - 0:0,0,3,Darbinyan Armen,Petrosyan Davit,fiurst,Darbinyan Armen - Petrosyan Davit,52,19,33,14,-14,20,15,17,0,0,2,7,5,0,0,14,9:11 - 4:11 - 6:11 - 0:0 - 0:0
14219200,2023-09-24 15:00:00,Diaryan Aleksandr - Rafayelyan Edgar,0:3,5:11 - 8:11 - 5:11 - 0:0 - 0:0,0,3,Diaryan Aleksandr,Rafayelyan Edgar,fiurst,Diaryan Aleksandr - Rafayelyan Edgar,51,18,33,15,-15,16,19,16,0,0,6,3,6,0,0,15,5:11 - 8:11 - 5:11 - 0:0 - 0:0
14219197,2023-09-24 14:50:00,Nazaryan Mushegh - Antonyan Eduard,3:1,8:11 - 6:11 - 11:7 - 9:11 - 0:0,1,3,Nazaryan Mushegh,Antonyan Eduard,fiurst,Antonyan Eduard - Nazaryan Mushegh,74,40,34,-6,6,19,17,18,20,0,-3,-5,4,-2,0,-6,11:8 - 11:6 - 7:11 - 11:9 - 0:0
14219184,2023-09-24 14:30:00,Nikoghosyan Narek - Diaryan Aleksandr,3:1,8:11 - 11:8 - 7:11 - 7:11 - 0:0,1,3,Nikoghosyan Narek,Diaryan Aleksandr,fiurst,Diaryan Aleksandr - Nikoghosyan Narek,74,41,33,-8,8,19,19,18,18,0,-3,3,-4,-4,0,-8,11:8 - 8:11 - 11:7 - 11:7 - 0:0
14219182,2023-09-24 14:25:00,Rafayelyan Edgar - Nazaryan Mushegh,0:3,11:8 - 11:5 - 11:8 - 0:0 - 0:0,3,0,Rafayelyan Edgar,Nazaryan Mushegh,fiurst,Nazaryan Mushegh - Rafayelyan Edgar,54,21,33,12,-12,19,16,19,0,0,3,6,3,0,0,12,8:11 - 5:11 - 8:11 - 0:0 - 0:0
14219180,2023-09-24 14:05:00,Nikoghosyan Narek - Antonyan Eduard,1:3,11:6 - 9:11 - 11:4 - 11:5 - 0:0,3,1,Nikoghosyan Narek,Antonyan Eduard,fiurst,Antonyan Eduard - Nikoghosyan Narek,68,26,42,16,-16,17,20,15,16,0,5,-2,7,6,0,16,6:11 - 11:9 - 4:11 - 5:11 - 0:0
14219178,2023-09-24 13:45:00,Diaryan Aleksandr - Nazaryan Mushegh,3:1,11:9 - 11:4 - 7:11 - 11:3 - 0:0,3,1,Diaryan Aleksandr,Nazaryan Mushegh,fiurst,Diaryan Aleksandr - Nazaryan Mushegh,67,40,27,-13,13,20,15,18,14,0,-2,-7,4,-8,0,-13,11:9 - 11:4 - 7:11 - 11:3 - 0:0
14219173,2023-09-24 13:30:00,Rafayelyan Edgar - Nikoghosyan Narek,3:1,9:11 - 5:11 - 11:8 - 11:13 - 0:0,1,3,Rafayelyan Edgar,Nikoghosyan Narek,fiurst,Nikoghosyan Narek - Rafayelyan Edgar,79,43,36,-7,7,20,16,19,24,0,-2,-6,3,-2,0,-7,11:9 - 11:5 - 8:11 - 13:11 - 0:0
14219172,2023-09-24 13:20:00,Antonyan Eduard - Diaryan Aleksandr,3:2,11:8 - 10:12 - 11:4 - 9:11 - 11:6,3,2,Antonyan Eduard,Diaryan Aleksandr,fiurst,Antonyan Eduard - Diaryan Aleksandr,93,52,41,-11,11,19,22,15,20,17,-3,2,-7,2,-5,-11,11:8 - 10:12 - 11:4 - 9:11 - 11:6
14219170,2023-09-24 13:00:00,Nazaryan Mushegh - Nikoghosyan Narek,0:3,5:11 - 4:11 - 8:11 - 0:0 - 0:0,0,3,Nazaryan Mushegh,Nikoghosyan Narek,fiurst,Nazaryan Mushegh - Nikoghosyan Narek,50,17,33,16,-16,16,15,19,0,0,6,7,3,0,0,16,5:11 - 4:11 - 8:11 - 0:0 - 0:0
14219169,2023-09-24 12:45:00,Antonyan Eduard - Rafayelyan Edgar,2:3,8:11 - 11:7 - 11:7 - 5:11 - 7:11,2,3,Antonyan Eduard,Rafayelyan Edgar,fiurst,Antonyan Eduard - Rafayelyan Edgar,89,42,47,5,-5,19,18,18,16,18,3,-4,-4,6,4,5,8:11 - 11:7 - 11:7 - 5:11 - 7:11
14219158,2023-09-24 12:15:00,Diaryan Aleksandr - Nikoghosyan Narek,3:0,12:10 - 11:5 - 11:8 - 0:0 - 0:0,3,0,Diaryan Aleksandr,Nikoghosyan Narek,fiurst,Diaryan Aleksandr - Nikoghosyan Narek,57,34,23,-11,11,22,16,19,0,0,-2,-6,-3,0,0,-11,12:10 - 11:5 - 11:8 - 0:0 - 0:0
14219157,2023-09-24 12:10:00,Antonyan Eduard - Nazaryan Mushegh,1:3,4:11 - 11:5 - 7:11 - 12:14 - 0:0,1,3,Antonyan Eduard,Nazaryan Mushegh,fiurst,Antonyan Eduard - Nazaryan Mushegh,75,34,41,7,-7,15,16,18,26,0,7,-6,4,2,0,7,4:11 - 11:5 - 7:11 - 12:14 - 0:0
14219156,2023-09-24 11:45:00,Rafayelyan Edgar - Diaryan Aleksandr,3:0,5:11 - 8:11 - 9:11 - 0:0 - 0:0,0,3,Rafayelyan Edgar,Diaryan Aleksandr,fiurst,Diaryan Aleksandr - Rafayelyan Edgar,55,33,22,-11,11,16,19,20,0,0,-6,-3,-2,0,0,-11,11:5 - 11:8 - 11:9 - 0:0 - 0:0
14219154,2023-09-24 11:30:00,Antonyan Eduard - Nikoghosyan Narek,3:2,7:11 - 11:7 - 11:8 - 1:11 - 12:10,3,2,Antonyan Eduard,Nikoghosyan Narek,fiurst,Antonyan Eduard - Nikoghosyan Narek,89,42,47,5,-5,18,18,19,12,22,4,-4,-3,10,-2,5,7:11 - 11:7 - 11:8 - 1:11 - 12:10
14219151,2023-09-24 11:15:00,Nazaryan Mushegh - Rafayelyan Edgar,0:3,4:11 - 7:11 - 8:11 - 0:0 - 0:0,0,3,Nazaryan Mushegh,Rafayelyan Edgar,fiurst,Nazaryan Mushegh - Rafayelyan Edgar,52,19,33,14,-14,15,18,19,0,0,7,4,3,0,0,14,4:11 - 7:11 - 8:11 - 0:0 - 0:0
14219149,2023-09-24 11:00:00,Diaryan Aleksandr - Antonyan Eduard,1:3,11:4 - 12:10 - 7:11 - 11:8 - 0:0,3,1,Diaryan Aleksandr,Antonyan Eduard,fiurst,Antonyan Eduard - Diaryan Aleksandr,74,33,41,8,-8,15,22,18,19,0,7,2,-4,3,0,8,4:11 - 10:12 - 11:7 - 8:11 - 0:0
14219146,2023-09-24 10:45:00,Nikoghosyan Narek - Rafayelyan Edgar,0:3,10:12 - 3:11 - 6:11 - 0:0 - 0:0,0,3,Nikoghosyan Narek,Rafayelyan Edgar,fiurst,Nikoghosyan Narek - Rafayelyan Edgar,53,19,34,15,-15,22,14,17,0,0,2,8,5,0,0,15,10:12 - 3:11 - 6:11 - 0:0 - 0:0
14219145,2023-09-24 10:30:00,Nazaryan Mushegh - Diaryan Aleksandr,3:2,11:8 - 11:2 - 9:11 - 5:11 - 12:14,2,3,Nazaryan Mushegh,Diaryan Aleksandr,fiurst,Diaryan Aleksandr - Nazaryan Mushegh,94,46,48,2,-2,19,13,20,16,26,3,9,-2,-6,-2,2,8:11 - 2:11 - 11:9 - 11:5 - 14:12
14219141,2023-09-24 10:15:00,Rafayelyan Edgar - Antonyan Eduard,3:2,9:11 - 11:7 - 12:10 - 11:13 - 8:11,2,3,Rafayelyan Edgar,Antonyan Eduard,fiurst,Antonyan Eduard - Rafayelyan Edgar,103,52,51,-1,1,20,18,22,24,19,-2,4,2,-2,-3,-1,11:9 - 7:11 - 10:12 - 13:11 - 11:8
14219133,2023-09-24 10:00:00,Nikoghosyan Narek - Nazaryan Mushegh,1:3,11:3 - 11:5 - 6:11 - 11:5 - 0:0,3,1,Nikoghosyan Narek,Nazaryan Mushegh,fiurst,Nazaryan Mushegh - Nikoghosyan Narek,63,24,39,15,-15,14,16,17,16,0,8,6,-5,6,0,15,3:11 - 5:11 - 11:6 - 5:11 - 0:0
14200920,2023-09-23 17:30:00,Darbinyan Armen - Petrosyan Davit,0:3,4:11 - 10:12 - 4:11 - 0:0 - 0:0,0,3,Darbinyan Armen,Petrosyan Davit,fiurst,Darbinyan Armen - Petrosyan Davit,52,18,34,16,-16,15,22,15,0,0,7,2,7,0,0,16,4:11 - 10:12 - 4:11 - 0:0 - 0:0
14200918,2023-09-23 17:25:00,Mkrtchyan Andranik - Soghomonyan Hrayr,3:1,7:11 - 11:6 - 11:6 - 11:6 - 0:0,3,1,Mkrtchyan Andranik,Soghomonyan Hrayr,fiurst,Mkrtchyan Andranik - Soghomonyan Hrayr,69,40,29,-11,11,18,17,17,17,0,4,-5,-5,-5,0,-11,7:11 - 11:6 - 11:6 - 11:6 - 0:0
14200906,2023-09-23 17:00:00,Gevorgyan Hayk - Darbinyan Armen,0:3,11:6 - 11:6 - 11:6 - 0:0 - 0:0,3,0,Gevorgyan Hayk,Darbinyan Armen,fiurst,Darbinyan Armen - Gevorgyan Hayk,51,18,33,15,-15,17,17,17,0,0,5,5,5,0,0,15,6:11 - 6:11 - 6:11 - 0:0 - 0:0
14200905,2023-09-23 16:45:00,Mkrtchyan Andranik - Petrosyan Davit,2:3,11:9 - 7:11 - 8:11 - 11:6 - 11:13,2,3,Mkrtchyan Andranik,Petrosyan Davit,fiurst,Mkrtchyan Andranik - Petrosyan Davit,98,48,50,2,-2,20,18,19,17,24,-2,4,3,-5,2,2,11:9 - 7:11 - 8:11 - 11:6 - 11:13
14200901,2023-09-23 16:30:00,Soghomonyan Hrayr - Gevorgyan Hayk,3:0,9:11 - 10:12 - 8:11 - 0:0 - 0:0,0,3,Soghomonyan Hrayr,Gevorgyan Hayk,fiurst,Gevorgyan Hayk - Soghomonyan Hrayr,61,34,27,-7,7,20,22,19,0,0,-2,-2,-3,0,0,-7,11:9 - 12:10 - 11:8 - 0:0 - 0:0
14200890,2023-09-23 16:15:00,Darbinyan Armen - Mkrtchyan Andranik,1:3,7:11 - 2:11 - 11:9 - 8:11 - 0:0,1,3,Darbinyan Armen,Mkrtchyan Andranik,fiurst,Darbinyan Armen - Mkrtchyan Andranik,70,28,42,14,-14,18,13,20,19,0,4,9,-2,3,0,14,7:11 - 2:11 - 11:9 - 8:11 - 0:0
14200889,2023-09-23 16:00:00,Petrosyan Davit - Gevorgyan Hayk,3:0,11:13 - 8:11 - 3:11 - 0:0 - 0:0,0,3,Petrosyan Davit,Gevorgyan Hayk,fiurst,Gevorgyan Hayk - Petrosyan Davit,57,35,22,-13,13,24,19,14,0,0,-2,-3,-8,0,0,-13,13:11 - 11:8 - 11:3 - 0:0 - 0:0
14200879,2023-09-23 15:45:00,Soghomonyan Hrayr - Darbinyan Armen,3:0,7:11 - 9:11 - 9:11 - 0:0 - 0:0,0,3,Soghomonyan Hrayr,Darbinyan Armen,fiurst,Darbinyan Armen - Soghomonyan Hrayr,58,33,25,-8,8,18,20,20,0,0,-4,-2,-2,0,0,-8,11:7 - 11:9 - 11:9 - 0:0 - 0:0
14200874,2023-09-23 15:30:00,Gevorgyan Hayk - Mkrtchyan Andranik,3:1,11:6 - 11:9 - 10:12 - 11:8 - 0:0,3,1,Gevorgyan Hayk,Mkrtchyan Andranik,fiurst,Gevorgyan Hayk - Mkrtchyan Andranik,78,43,35,-8,8,17,20,22,19,0,-5,-2,2,-3,0,-8,11:6 - 11:9 - 10:12 - 11:8 - 0:0
14200873,2023-09-23 15:20:00,Petrosyan Davit - Soghomonyan Hrayr,2:3,11:9 - 11:13 - 5:11 - 11:6 - 8:11,2,3,Petrosyan Davit,Soghomonyan Hrayr,fiurst,Petrosyan Davit - Soghomonyan Hrayr,96,46,50,4,-4,20,24,16,17,19,-2,2,6,-5,3,4,11:9 - 11:13 - 5:11 - 11:6 - 8:11
14200860,2023-09-23 15:10:00,Arutyunov Ruben - Nikoghosyan Narek,0:3,6:11 - 9:11 - 4:11 - 0:0 - 0:0,0,3,Arutyunov Ruben,Nikoghosyan Narek,fiurst,Arutyunov Ruben - Nikoghosyan Narek,52,19,33,14,-14,17,20,15,0,0,5,2,7,0,0,14,6:11 - 9:11 - 4:11 - 0:0 - 0:0
14200859,2023-09-23 14:50:00,Rafayelyan Edgar - Antonyan Eduard,2:3,5:11 - 11:5 - 10:12 - 11:7 - 12:10,3,2,Rafayelyan Edgar,Antonyan Eduard,fiurst,Antonyan Eduard - Rafayelyan Edgar,94,45,49,4,-4,16,16,22,18,22,-6,6,-2,4,2,4,11:5 - 5:11 - 12:10 - 7:11 - 10:12
14200857,2023-09-23 14:30:00,Papyan Karen - Arutyunov Ruben,3:2,11:9 - 7:11 - 11:8 - 6:11 - 10:12,2,3,Papyan Karen,Arutyunov Ruben,fiurst,Arutyunov Ruben - Papyan Karen,96,51,45,-6,6,20,18,19,17,22,2,-4,3,-5,-2,-6,9:11 - 11:7 - 8:11 - 11:6 - 12:10
14200847,2023-09-23 14:25:00,Nikoghosyan Narek - Rafayelyan Edgar,1:3,4:11 - 6:11 - 11:6 - 6:11 - 0:0,1,3,Nikoghosyan Narek,Rafayelyan Edgar,fiurst,Nikoghosyan Narek - Rafayelyan Edgar,66,27,39,12,-12,15,17,17,17,0,7,5,-5,5,0,12,4:11 - 6:11 - 11:6 - 6:11 - 0:0
14200836,2023-09-23 14:00:00,Papyan Karen - Antonyan Eduard,3:1,11:6 - 10:12 - 12:14 - 3:11 - 0:0,1,3,Papyan Karen,Antonyan Eduard,fiurst,Antonyan Eduard - Papyan Karen,79,43,36,-7,7,17,22,26,14,0,5,-2,-2,-8,0,-7,6:11 - 12:10 - 14:12 - 11:3 - 0:0
14200833,2023-09-23 13:55:00,Arutyunov Ruben - Rafayelyan Edgar,1:3,11:4 - 7:11 - 5:11 - 12:14 - 0:0,1,3,Arutyunov Ruben,Rafayelyan Edgar,fiurst,Arutyunov Ruben - Rafayelyan Edgar,75,35,40,5,-5,15,18,16,26,0,-7,4,6,2,0,5,11:4 - 7:11 - 5:11 - 12:14 - 0:0
14200828,2023-09-23 13:30:00,Nikoghosyan Narek - Papyan Karen,3:1,11:8 - 7:11 - 12:10 - 11:6 - 0:0,3,1,Nikoghosyan Narek,Papyan Karen,fiurst,Nikoghosyan Narek - Papyan Karen,76,41,35,-6,6,19,18,22,17,0,-3,4,-2,-5,0,-6,11:8 - 7:11 - 12:10 - 11:6 - 0:0
14200817,2023-09-23 13:20:00,Antonyan Eduard - Arutyunov Ruben,3:1,11:6 - 6:11 - 13:11 - 11:4 - 0:0,3,1,Antonyan Eduard,Arutyunov Ruben,fiurst,Antonyan Eduard - Arutyunov Ruben,73,41,32,-9,9,17,17,24,15,0,-5,5,-2,-7,0,-9,11:6 - 6:11 - 13:11 - 11:4 - 0:0
14200814,2023-09-23 13:00:00,Rafayelyan Edgar - Papyan Karen,0:3,11:4 - 11:6 - 11:7 - 0:0 - 0:0,3,0,Rafayelyan Edgar,Papyan Karen,fiurst,Papyan Karen - Rafayelyan Edgar,50,17,33,16,-16,15,17,18,0,0,7,5,4,0,0,16,4:11 - 6:11 - 7:11 - 0:0 - 0:0
14200806,2023-09-23 12:45:00,Antonyan Eduard - Nikoghosyan Narek,3:1,11:5 - 7:11 - 11:8 - 11:9 - 0:0,3,1,Antonyan Eduard,Nikoghosyan Narek,fiurst,Antonyan Eduard - Nikoghosyan Narek,73,40,33,-7,7,16,18,19,20,0,-6,4,-3,-2,0,-7,11:5 - 7:11 - 11:8 - 11:9 - 0:0
14200798,2023-09-23 12:30:00,Arutyunov Ruben - Papyan Karen,0:3,6:11 - 9:11 - 10:12 - 0:0 - 0:0,0,3,Arutyunov Ruben,Papyan Karen,fiurst,Arutyunov Ruben - Papyan Karen,59,25,34,9,-9,17,20,22,0,0,5,2,2,0,0,9,6:11 - 9:11 - 10:12 - 0:0 - 0:0
14200792,2023-09-23 12:00:00,Antonyan Eduard - Rafayelyan Edgar,3:1,11:8 - 3:11 - 11:8 - 11:4 - 0:0,3,1,Antonyan Eduard,Rafayelyan Edgar,fiurst,Antonyan Eduard - Rafayelyan Edgar,67,36,31,-5,5,19,14,19,15,0,-3,8,-3,-7,0,-5,11:8 - 3:11 - 11:8 - 11:4 - 0:0
14200742,2023-09-23 11:50:00,Nikoghosyan Narek - Arutyunov Ruben,3:2,7:11 - 11:9 - 13:15 - 11:7 - 7:11,2,3,Nikoghosyan Narek,Arutyunov Ruben,fiurst,Arutyunov Ruben - Nikoghosyan Narek,102,53,49,-4,4,18,20,28,18,18,-4,2,-2,4,-4,-4,11:7 - 9:11 - 15:13 - 7:11 - 11:7
14200740,2023-09-23 11:40:00,Antonyan Eduard - Papyan Karen,3:0,11:1 - 11:7 - 11:6 - 0:0 - 0:0,3,0,Antonyan Eduard,Papyan Karen,fiurst,Antonyan Eduard - Papyan Karen,47,33,14,-19,19,12,18,17,0,0,-10,-4,-5,0,0,-19,11:1 - 11:7 - 11:6 - 0:0 - 0:0
14200737,2023-09-23 11:15:00,Rafayelyan Edgar - Nikoghosyan Narek,2:3,6:11 - 11:5 - 11:5 - 9:11 - 11:9,3,2,Rafayelyan Edgar,Nikoghosyan Narek,fiurst,Nikoghosyan Narek - Rafayelyan Edgar,89,41,48,7,-7,17,16,16,20,20,-5,6,6,-2,2,7,11:6 - 5:11 - 5:11 - 11:9 - 9:11
14200713,2023-09-23 11:00:00,Arutyunov Ruben - Antonyan Eduard,3:2,11:8 - 12:10 - 8:11 - 11:13 - 3:11,2,3,Arutyunov Ruben,Antonyan Eduard,fiurst,Antonyan Eduard - Arutyunov Ruben,98,53,45,-8,8,19,22,19,24,14,3,2,-3,-2,-8,-8,8:11 - 10:12 - 11:8 - 13:11 - 11:3
14200711,2023-09-23 10:45:00,Papyan Karen - Nikoghosyan Narek,3:0,4:11 - 3:11 - 6:11 - 0:0 - 0:0,0,3,Papyan Karen,Nikoghosyan Narek,fiurst,Nikoghosyan Narek - Papyan Karen,46,33,13,-20,20,15,14,17,0,0,-7,-8,-5,0,0,-20,11:4 - 11:3 - 11:6 - 0:0 - 0:0
14200707,2023-09-23 10:30:00,Rafayelyan Edgar - Arutyunov Ruben,0:3,14:12 - 11:7 - 11:4 - 0:0 - 0:0,3,0,Rafayelyan Edgar,Arutyunov Ruben,fiurst,Arutyunov Ruben - Rafayelyan Edgar,59,23,36,13,-13,26,18,15,0,0,2,4,7,0,0,13,12:14 - 7:11 - 4:11 - 0:0 - 0:0
14200704,2023-09-23 10:15:00,Nikoghosyan Narek - Antonyan Eduard,0:3,11:6 - 14:12 - 11:8 - 0:0 - 0:0,3,0,Nikoghosyan Narek,Antonyan Eduard,fiurst,Antonyan Eduard - Nikoghosyan Narek,62,26,36,10,-10,17,26,19,0,0,5,2,3,0,0,10,6:11 - 12:14 - 8:11 - 0:0 - 0:0
14200698,2023-09-23 10:00:00,Papyan Karen - Rafayelyan Edgar,1:3,11:9 - 13:15 - 4:11 - 5:11 - 0:0,1,3,Papyan Karen,Rafayelyan Edgar,fiurst,Papyan Karen - Rafayelyan Edgar,79,33,46,13,-13,20,28,15,16,0,-2,2,7,6,0,13,11:9 - 13:15 - 4:11 - 5:11 - 0:0
14182303,2023-09-22 17:30:00,Darbinyan Armen - Avakimyan Davit,3:0,8:11 - 9:11 - 7:11 - 0:0 - 0:0,0,3,Darbinyan Armen,Avakimyan Davit,fiurst,Avakimyan Davit - Darbinyan Armen,57,33,24,-9,9,19,20,18,0,0,-3,-2,-4,0,0,-9,11:8 - 11:9 - 11:7 - 0:0 - 0:0
14182301,2023-09-22 17:15:00,Soghomonyan Hrayr - Gevorgyan Hayk,1:3,11:9 - 11:4 - 6:11 - 11:7 - 0:0,3,1,Soghomonyan Hrayr,Gevorgyan Hayk,fiurst,Gevorgyan Hayk - Soghomonyan Hrayr,70,31,39,8,-8,20,15,17,18,0,2,7,-5,4,0,8,9:11 - 4:11 - 11:6 - 7:11 - 0:0
14182289,2023-09-22 17:00:00,Mkrtchyan Andranik - Darbinyan Armen,0:3,11:1 - 11:3 - 11:6 - 0:0 - 0:0,3,0,Mkrtchyan Andranik,Darbinyan Armen,fiurst,Darbinyan Armen - Mkrtchyan Andranik,43,10,33,23,-23,12,14,17,0,0,10,8,5,0,0,23,1:11 - 3:11 - 6:11 - 0:0 - 0:0
14182288,2023-09-22 16:45:00,Soghomonyan Hrayr - Avakimyan Davit,3:1,3:11 - 11:9 - 12:14 - 4:11 - 0:0,1,3,Soghomonyan Hrayr,Avakimyan Davit,fiurst,Avakimyan Davit - Soghomonyan Hrayr,75,45,30,-15,15,14,20,26,15,0,-8,2,-2,-7,0,-15,11:3 - 9:11 - 14:12 - 11:4 - 0:0
14182286,2023-09-22 16:30:00,Gevorgyan Hayk - Mkrtchyan Andranik,1:3,9:11 - 5:11 - 15:13 - 5:11 - 0:0,1,3,Gevorgyan Hayk,Mkrtchyan Andranik,fiurst,Gevorgyan Hayk - Mkrtchyan Andranik,80,34,46,12,-12,20,16,28,16,0,2,6,-2,6,0,12,9:11 - 5:11 - 15:13 - 5:11 - 0:0
14182285,2023-09-22 16:15:00,Darbinyan Armen - Soghomonyan Hrayr,0:3,10:12 - 9:11 - 6:11 - 0:0 - 0:0,0,3,Darbinyan Armen,Soghomonyan Hrayr,fiurst,Darbinyan Armen - Soghomonyan Hrayr,59,25,34,9,-9,22,20,17,0,0,2,2,5,0,0,9,10:12 - 9:11 - 6:11 - 0:0 - 0:0
14182283,2023-09-22 16:10:00,Avakimyan Davit - Mkrtchyan Andranik,3:0,11:7 - 11:8 - 11:5 - 0:0 - 0:0,3,0,Avakimyan Davit,Mkrtchyan Andranik,fiurst,Avakimyan Davit - Mkrtchyan Andranik,53,33,20,-13,13,18,19,16,0,0,-4,-3,-6,0,0,-13,11:7 - 11:8 - 11:5 - 0:0 - 0:0
14182279,2023-09-22 15:45:00,Gevorgyan Hayk - Darbinyan Armen,1:3,11:2 - 11:4 - 10:12 - 11:7 - 0:0,3,1,Gevorgyan Hayk,Darbinyan Armen,fiurst,Darbinyan Armen - Gevorgyan Hayk,68,25,43,18,-18,13,15,22,18,0,9,7,-2,4,0,18,2:11 - 4:11 - 12:10 - 7:11 - 0:0
14182276,2023-09-22 15:30:00,Mkrtchyan Andranik - Soghomonyan Hrayr,2:3,11:9 - 10:12 - 19:17 - 11:13 - 6:11,2,3,Mkrtchyan Andranik,Soghomonyan Hrayr,fiurst,Mkrtchyan Andranik - Soghomonyan Hrayr,119,57,62,5,-5,20,22,36,24,17,-2,2,-2,2,5,5,11:9 - 10:12 - 19:17 - 11:13 - 6:11
14182274,2023-09-22 15:15:00,Avakimyan Davit - Gevorgyan Hayk,3:1,11:4 - 3:11 - 11:7 - 11:7 - 0:0,3,1,Avakimyan Davit,Gevorgyan Hayk,fiurst,Avakimyan Davit - Gevorgyan Hayk,65,36,29,-7,7,15,14,18,18,0,-7,8,-4,-4,0,-7,11:4 - 3:11 - 11:7 - 11:7 - 0:0
14182272,2023-09-22 15:00:00,Nazaryan Mushegh - Papyan Karen,1:3,8:11 - 9:11 - 11:8 - 5:11 - 0:0,1,3,Nazaryan Mushegh,Papyan Karen,fiurst,Nazaryan Mushegh - Papyan Karen,74,33,41,8,-8,19,20,19,16,0,3,2,-3,6,0,8,8:11 - 9:11 - 11:8 - 5:11 - 0:0
14182271,2023-09-22 14:45:00,Nikoghosyan Narek - Diaryan Aleksandr,3:2,11:6 - 3:11 - 7:11 - 11:8 - 8:11,2,3,Nikoghosyan Narek,Diaryan Aleksandr,fiurst,Diaryan Aleksandr - Nikoghosyan Narek,87,47,40,-7,7,17,14,18,19,19,5,-8,-4,3,-3,-7,6:11 - 11:3 - 11:7 - 8:11 - 11:8
14182258,2023-09-22 14:30:00,Arutyunov Ruben - Nazaryan Mushegh,0:3,14:16 - 7:11 - 6:11 - 0:0 - 0:0,0,3,Arutyunov Ruben,Nazaryan Mushegh,fiurst,Arutyunov Ruben - Nazaryan Mushegh,65,27,38,11,-11,30,18,17,0,0,2,4,5,0,0,11,14:16 - 7:11 - 6:11 - 0:0 - 0:0
14182249,2023-09-22 14:15:00,Papyan Karen - Nikoghosyan Narek,3:0,4:11 - 5:11 - 9:11 - 0:0 - 0:0,0,3,Papyan Karen,Nikoghosyan Narek,fiurst,Nikoghosyan Narek - Papyan Karen,51,33,18,-15,15,15,16,20,0,0,-7,-6,-2,0,0,-15,11:4 - 11:5 - 11:9 - 0:0 - 0:0
14180980,2023-09-22 14:00:00,Arutyunov Ruben - Diaryan Aleksandr,1:3,8:11 - 11:9 - 6:11 - 4:11 - 0:0,1,3,Arutyunov Ruben,Diaryan Aleksandr,fiurst,Arutyunov Ruben - Diaryan Aleksandr,71,29,42,13,-13,19,20,17,15,0,3,-2,5,7,0,13,8:11 - 11:9 - 6:11 - 4:11 - 0:0
14180970,2023-09-22 13:45:00,Nazaryan Mushegh - Nikoghosyan Narek,0:3,8:11 - 5:11 - 6:11 - 0:0 - 0:0,0,3,Nazaryan Mushegh,Nikoghosyan Narek,fiurst,Nazaryan Mushegh - Nikoghosyan Narek,52,19,33,14,-14,19,16,17,0,0,3,6,5,0,0,14,8:11 - 5:11 - 6:11 - 0:0 - 0:0
14180959,2023-09-22 13:35:00,Papyan Karen - Arutyunov Ruben,3:0,10:12 - 5:11 - 7:11 - 0:0 - 0:0,0,3,Papyan Karen,Arutyunov Ruben,fiurst,Arutyunov Ruben - Papyan Karen,56,34,22,-12,12,22,16,18,0,0,-2,-6,-4,0,0,-12,12:10 - 11:5 - 11:7 - 0:0 - 0:0
14180942,2023-09-22 13:15:00,Diaryan Aleksandr - Nazaryan Mushegh,3:0,11:7 - 11:7 - 11:7 - 0:0 - 0:0,3,0,Diaryan Aleksandr,Nazaryan Mushegh,fiurst,Diaryan Aleksandr - Nazaryan Mushegh,54,33,21,-12,12,18,18,18,0,0,-4,-4,-4,0,0,-12,11:7 - 11:7 - 11:7 - 0:0 - 0:0
14180933,2023-09-22 13:00:00,Nikoghosyan Narek - Arutyunov Ruben,3:1,12:14 - 11:8 - 9:11 - 3:11 - 0:0,1,3,Nikoghosyan Narek,Arutyunov Ruben,fiurst,Arutyunov Ruben - Nikoghosyan Narek,79,44,35,-9,9,26,19,20,14,0,-2,3,-2,-8,0,-9,14:12 - 8:11 - 11:9 - 11:3 - 0:0
14180923,2023-09-22 12:45:00,Diaryan Aleksandr - Papyan Karen,3:2,10:12 - 11:9 - 9:11 - 11:6 - 11:9,3,2,Diaryan Aleksandr,Papyan Karen,fiurst,Diaryan Aleksandr - Papyan Karen,99,52,47,-5,5,22,20,20,17,20,2,-2,2,-5,-2,-5,10:12 - 11:9 - 9:11 - 11:6 - 11:9
14180922,2023-09-22 12:20:00,Nazaryan Mushegh - Arutyunov Ruben,1:3,11:2 - 11:6 - 7:11 - 11:4 - 0:0,3,1,Nazaryan Mushegh,Arutyunov Ruben,fiurst,Arutyunov Ruben - Nazaryan Mushegh,63,23,40,17,-17,13,17,18,15,0,9,5,-4,7,0,17,2:11 - 6:11 - 11:7 - 4:11 - 0:0
14180592,2023-09-22 12:05:00,Diaryan Aleksandr - Nikoghosyan Narek,3:0,11:3 - 11:4 - 11:9 - 0:0 - 0:0,3,0,Diaryan Aleksandr,Nikoghosyan Narek,fiurst,Diaryan Aleksandr - Nikoghosyan Narek,49,33,16,-17,17,14,15,20,0,0,-8,-7,-2,0,0,-17,11:3 - 11:4 - 11:9 - 0:0 - 0:0
14180589,2023-09-22 11:50:00,Papyan Karen - Nazaryan Mushegh,2:3,9:11 - 11:7 - 5:11 - 11:8 - 11:7,3,2,Papyan Karen,Nazaryan Mushegh,fiurst,Nazaryan Mushegh - Papyan Karen,91,44,47,3,-3,20,18,16,19,18,-2,4,-6,3,4,3,11:9 - 7:11 - 11:5 - 8:11 - 7:11
14180586,2023-09-22 11:35:00,Diaryan Aleksandr - Arutyunov Ruben,1:3,11:13 - 11:4 - 11:4 - 11:8 - 0:0,3,1,Diaryan Aleksandr,Arutyunov Ruben,fiurst,Arutyunov Ruben - Diaryan Aleksandr,73,29,44,15,-15,24,15,15,19,0,-2,7,7,3,0,15,13:11 - 4:11 - 4:11 - 8:11 - 0:0
14180564,2023-09-22 11:15:00,Nikoghosyan Narek - Papyan Karen,0:3,7:11 - 14:16 - 12:14 - 0:0 - 0:0,0,3,Nikoghosyan Narek,Papyan Karen,fiurst,Nikoghosyan Narek - Papyan Karen,74,33,41,8,-8,18,30,26,0,0,4,2,2,0,0,8,7:11 - 14:16 - 12:14 - 0:0 - 0:0
14180563,2023-09-22 11:10:00,Nazaryan Mushegh - Diaryan Aleksandr,3:0,5:11 - 8:11 - 5:11 - 0:0 - 0:0,0,3,Nazaryan Mushegh,Diaryan Aleksandr,fiurst,Diaryan Aleksandr - Nazaryan Mushegh,51,33,18,-15,15,16,19,16,0,0,-6,-3,-6,0,0,-15,11:5 - 11:8 - 11:5 - 0:0 - 0:0
14180541,2023-09-22 10:45:00,Arutyunov Ruben - Papyan Karen,1:3,8:11 - 7:11 - 11:7 - 10:12 - 0:0,1,3,Arutyunov Ruben,Papyan Karen,fiurst,Arutyunov Ruben - Papyan Karen,77,36,41,5,-5,19,18,18,22,0,3,4,-4,2,0,5,8:11 - 7:11 - 11:7 - 10:12 - 0:0
14180539,2023-09-22 10:35:00,Nikoghosyan Narek - Nazaryan Mushegh,2:3,11:9 - 9:11 - 11:6 - 4:11 - 11:6,3,2,Nikoghosyan Narek,Nazaryan Mushegh,fiurst,Nazaryan Mushegh - Nikoghosyan Narek,89,43,46,3,-3,20,20,17,15,17,2,-2,5,-7,5,3,9:11 - 11:9 - 6:11 - 11:4 - 6:11
14180532,2023-09-22 10:15:00,Papyan Karen - Diaryan Aleksandr,3:1,3:11 - 11:9 - 4:11 - 7:11 - 0:0,1,3,Papyan Karen,Diaryan Aleksandr,fiurst,Diaryan Aleksandr - Papyan Karen,67,42,25,-17,17,14,20,15,18,0,-8,2,-7,-4,0,-17,11:3 - 9:11 - 11:4 - 11:7 - 0:0
14180530,2023-09-22 10:00:00,Arutyunov Ruben - Nikoghosyan Narek,1:3,11:6 - 8:11 - 8:11 - 5:11 - 0:0,1,3,Arutyunov Ruben,Nikoghosyan Narek,fiurst,Arutyunov Ruben - Nikoghosyan Narek,71,32,39,7,-7,17,19,19,16,0,-5,3,3,6,0,7,11:6 - 8:11 - 8:11 - 5:11 - 0:0
14159343,2023-09-21 17:30:00,Avakimyan Davit - Soghomonyan Hrayr,2:3,11:8 - 11:9 - 5:11 - 7:11 - 5:11,2,3,Avakimyan Davit,Soghomonyan Hrayr,fiurst,Avakimyan Davit - Soghomonyan Hrayr,89,39,50,11,-11,19,20,16,18,16,-3,-2,6,4,6,11,11:8 - 11:9 - 5:11 - 7:11 - 5:11
14159342,2023-09-21 17:15:00,Petrosyan Davit - Darbinyan Armen,1:3,11:3 - 12:10 - 8:11 - 11:7 - 0:0,3,1,Petrosyan Davit,Darbinyan Armen,fiurst,Darbinyan Armen - Petrosyan Davit,73,31,42,11,-11,14,22,19,18,0,8,2,-3,4,0,11,3:11 - 10:12 - 11:8 - 7:11 - 0:0
14159339,2023-09-21 17:00:00,Gevorgyan Hayk - Avakimyan Davit,0:3,11:8 - 11:9 - 12:10 - 0:0 - 0:0,3,0,Gevorgyan Hayk,Avakimyan Davit,fiurst,Avakimyan Davit - Gevorgyan Hayk,61,27,34,7,-7,19,20,22,0,0,3,2,2,0,0,7,8:11 - 9:11 - 10:12 - 0:0 - 0:0
14159334,2023-09-21 16:45:00,Petrosyan Davit - Soghomonyan Hrayr,0:3,6:11 - 7:11 - 7:11 - 0:0 - 0:0,0,3,Petrosyan Davit,Soghomonyan Hrayr,fiurst,Petrosyan Davit - Soghomonyan Hrayr,53,20,33,13,-13,17,18,18,0,0,5,4,4,0,0,13,6:11 - 7:11 - 7:11 - 0:0 - 0:0
14159331,2023-09-21 16:30:00,Darbinyan Armen - Gevorgyan Hayk,0:3,6:11 - 9:11 - 3:11 - 0:0 - 0:0,0,3,Darbinyan Armen,Gevorgyan Hayk,fiurst,Darbinyan Armen - Gevorgyan Hayk,51,18,33,15,-15,17,20,14,0,0,5,2,8,0,0,15,6:11 - 9:11 - 3:11 - 0:0 - 0:0
14159328,2023-09-21 16:15:00,Avakimyan Davit - Petrosyan Davit,3:1,11:9 - 5:11 - 11:8 - 11:7 - 0:0,3,1,Avakimyan Davit,Petrosyan Davit,fiurst,Avakimyan Davit - Petrosyan Davit,73,38,35,-3,3,20,16,19,18,0,-2,6,-3,-4,0,-3,11:9 - 5:11 - 11:8 - 11:7 - 0:0
14159327,2023-09-21 16:00:00,Soghomonyan Hrayr - Gevorgyan Hayk,1:3,11:13 - 11:4 - 11:7 - 11:5 - 0:0,3,1,Soghomonyan Hrayr,Gevorgyan Hayk,fiurst,Gevorgyan Hayk - Soghomonyan Hrayr,73,29,44,15,-15,24,15,18,16,0,-2,7,4,6,0,15,13:11 - 4:11 - 7:11 - 5:11 - 0:0
14159315,2023-09-21 15:45:00,Darbinyan Armen - Avakimyan Davit,3:0,7:11 - 8:11 - 4:11 - 0:0 - 0:0,0,3,Darbinyan Armen,Avakimyan Davit,fiurst,Avakimyan Davit - Darbinyan Armen,52,33,19,-14,14,18,19,15,0,0,-4,-3,-7,0,0,-14,11:7 - 11:8 - 11:4 - 0:0 - 0:0
14159314,2023-09-21 15:30:00,Gevorgyan Hayk - Petrosyan Davit,3:1,7:11 - 11:7 - 11:5 - 11:5 - 0:0,3,1,Gevorgyan Hayk,Petrosyan Davit,fiurst,Gevorgyan Hayk - Petrosyan Davit,68,40,28,-12,12,18,18,16,16,0,4,-4,-6,-6,0,-12,7:11 - 11:7 - 11:5 - 11:5 - 0:0
14159309,2023-09-21 15:20:00,Soghomonyan Hrayr - Darbinyan Armen,0:3,11:6 - 11:8 - 11:7 - 0:0 - 0:0,3,0,Soghomonyan Hrayr,Darbinyan Armen,fiurst,Darbinyan Armen - Soghomonyan Hrayr,54,21,33,12,-12,17,19,18,0,0,5,3,4,0,0,12,6:11 - 8:11 - 7:11 - 0:0 - 0:0
14159293,2023-09-21 15:00:00,Antonyan Eduard - Diaryan Aleksandr,0:3,6:11 - 9:11 - 1:11 - 0:0 - 0:0,0,3,Antonyan Eduard,Diaryan Aleksandr,fiurst,Antonyan Eduard - Diaryan Aleksandr,49,16,33,17,-17,17,20,12,0,0,5,2,10,0,0,17,6:11 - 9:11 - 1:11 - 0:0 - 0:0
14159291,2023-09-21 14:55:00,Arutyunov Ruben - Papyan Karen,2:3,11:9 - 11:7 - 9:11 - 6:11 - 9:11,2,3,Arutyunov Ruben,Papyan Karen,fiurst,Arutyunov Ruben - Papyan Karen,95,46,49,3,-3,20,18,20,17,20,-2,-4,2,5,2,3,11:9 - 11:7 - 9:11 - 6:11 - 9:11
14159286,2023-09-21 14:30:00,Nazaryan Mushegh - Antonyan Eduard,3:0,8:11 - 5:11 - 7:11 - 0:0 - 0:0,0,3,Nazaryan Mushegh,Antonyan Eduard,fiurst,Antonyan Eduard - Nazaryan Mushegh,53,33,20,-13,13,19,16,18,0,0,-3,-6,-4,0,0,-13,11:8 - 11:5 - 11:7 - 0:0 - 0:0
14159273,2023-09-21 14:25:00,Diaryan Aleksandr - Arutyunov Ruben,1:3,7:11 - 11:8 - 11:8 - 11:8 - 0:0,3,1,Diaryan Aleksandr,Arutyunov Ruben,fiurst,Arutyunov Ruben - Diaryan Aleksandr,75,35,40,5,-5,18,19,19,19,0,-4,3,3,3,0,5,11:7 - 8:11 - 8:11 - 8:11 - 0:0
14159271,2023-09-21 14:00:00,Nazaryan Mushegh - Papyan Karen,0:3,9:11 - 10:12 - 7:11 - 0:0 - 0:0,0,3,Nazaryan Mushegh,Papyan Karen,fiurst,Nazaryan Mushegh - Papyan Karen,60,26,34,8,-8,20,22,18,0,0,2,2,4,0,0,8,9:11 - 10:12 - 7:11 - 0:0 - 0:0
14159258,2023-09-21 13:50:00,Antonyan Eduard - Arutyunov Ruben,3:0,15:13 - 15:13 - 11:8 - 0:0 - 0:0,3,0,Antonyan Eduard,Arutyunov Ruben,fiurst,Antonyan Eduard - Arutyunov Ruben,75,41,34,-7,7,28,28,19,0,0,-2,-2,-3,0,0,-7,15:13 - 15:13 - 11:8 - 0:0 - 0:0
14159256,2023-09-21 13:30:00,Diaryan Aleksandr - Nazaryan Mushegh,3:0,11:7 - 11:6 - 11:3 - 0:0 - 0:0,3,0,Diaryan Aleksandr,Nazaryan Mushegh,fiurst,Diaryan Aleksandr - Nazaryan Mushegh,49,33,16,-17,17,18,17,14,0,0,-4,-5,-8,0,0,-17,11:7 - 11:6 - 11:3 - 0:0 - 0:0
14159254,2023-09-21 13:15:00,Papyan Karen - Antonyan Eduard,3:2,9:11 - 11:7 - 11:7 - 9:11 - 5:11,2,3,Papyan Karen,Antonyan Eduard,fiurst,Antonyan Eduard - Papyan Karen,92,47,45,-2,2,20,18,18,20,16,-2,4,4,-2,-6,-2,11:9 - 7:11 - 7:11 - 11:9 - 11:5
14159251,2023-09-21 13:00:00,Arutyunov Ruben - Nazaryan Mushegh,1:3,9:11 - 11:13 - 12:10 - 8:11 - 0:0,1,3,Arutyunov Ruben,Nazaryan Mushegh,fiurst,Arutyunov Ruben - Nazaryan Mushegh,85,40,45,5,-5,20,24,22,19,0,2,2,-2,3,0,5,9:11 - 11:13 - 12:10 - 8:11 - 0:0
14159246,2023-09-21 12:45:00,Papyan Karen - Diaryan Aleksandr,3:0,7:11 - 2:11 - 3:11 - 0:0 - 0:0,0,3,Papyan Karen,Diaryan Aleksandr,fiurst,Diaryan Aleksandr - Papyan Karen,45,33,12,-21,21,18,13,14,0,0,-4,-9,-8,0,0,-21,11:7 - 11:2 - 11:3 - 0:0 - 0:0
14159243,2023-09-21 12:15:00,Antonyan Eduard - Nazaryan Mushegh,3:1,6:11 - 11:5 - 11:6 - 11:7 - 0:0,3,1,Antonyan Eduard,Nazaryan Mushegh,fiurst,Antonyan Eduard - Nazaryan Mushegh,68,39,29,-10,10,17,16,17,18,0,5,-6,-5,-4,0,-10,6:11 - 11:5 - 11:6 - 11:7 - 0:0
14159240,2023-09-21 12:00:00,Papyan Karen - Arutyunov Ruben,3:0,20:22 - 7:11 - 9:11 - 0:0 - 0:0,0,3,Papyan Karen,Arutyunov Ruben,fiurst,Arutyunov Ruben - Papyan Karen,80,44,36,-8,8,42,18,20,0,0,-2,-4,-2,0,0,-8,22:20 - 11:7 - 11:9 - 0:0 - 0:0
14159227,2023-09-21 11:45:00,Diaryan Aleksandr - Antonyan Eduard,1:3,11:7 - 11:0 - 10:12 - 11:8 - 0:0,3,1,Diaryan Aleksandr,Antonyan Eduard,fiurst,Antonyan Eduard - Diaryan Aleksandr,70,27,43,16,-16,18,11,22,19,0,4,11,-2,3,0,16,7:11 - 0:11 - 12:10 - 8:11 - 0:0
14159226,2023-09-21 11:35:00,Papyan Karen - Nazaryan Mushegh,0:3,12:10 - 12:10 - 11:6 - 0:0 - 0:0,3,0,Papyan Karen,Nazaryan Mushegh,fiurst,Nazaryan Mushegh - Papyan Karen,61,26,35,9,-9,22,22,17,0,0,2,2,5,0,0,9,10:12 - 10:12 - 6:11 - 0:0 - 0:0
14159223,2023-09-21 11:20:00,Arutyunov Ruben - Diaryan Aleksandr,0:3,9:11 - 6:11 - 9:11 - 0:0 - 0:0,0,3,Arutyunov Ruben,Diaryan Aleksandr,fiurst,Arutyunov Ruben - Diaryan Aleksandr,57,24,33,9,-9,20,17,20,0,0,2,5,2,0,0,9,9:11 - 6:11 - 9:11 - 0:0 - 0:0
14159221,2023-09-21 11:10:00,Antonyan Eduard - Papyan Karen,0:3,10:12 - 10:12 - 12:14 - 0:0 - 0:0,0,3,Antonyan Eduard,Papyan Karen,fiurst,Antonyan Eduard - Papyan Karen,70,32,38,6,-6,22,22,26,0,0,2,2,2,0,0,6,10:12 - 10:12 - 12:14 - 0:0 - 0:0
14159213,2023-09-21 10:45:00,Nazaryan Mushegh - Diaryan Aleksandr,3:0,6:11 - 13:15 - 7:11 - 0:0 - 0:0,0,3,Nazaryan Mushegh,Diaryan Aleksandr,fiurst,Diaryan Aleksandr - Nazaryan Mushegh,63,37,26,-11,11,17,28,18,0,0,-5,-2,-4,0,0,-11,11:6 - 15:13 - 11:7 - 0:0 - 0:0
14159206,2023-09-21 10:30:00,Arutyunov Ruben - Antonyan Eduard,3:2,13:11 - 8:11 - 13:15 - 11:7 - 5:11,2,3,Arutyunov Ruben,Antonyan Eduard,fiurst,Antonyan Eduard - Arutyunov Ruben,105,55,50,-5,5,24,19,28,18,16,2,-3,-2,4,-6,-5,11:13 - 11:8 - 15:13 - 7:11 - 11:5
14159199,2023-09-21 10:15:00,Diaryan Aleksandr - Papyan Karen,3:0,11:4 - 11:7 - 11:5 - 0:0 - 0:0,3,0,Diaryan Aleksandr,Papyan Karen,fiurst,Diaryan Aleksandr - Papyan Karen,49,33,16,-17,17,15,18,16,0,0,-7,-4,-6,0,0,-17,11:4 - 11:7 - 11:5 - 0:0 - 0:0
14159192,2023-09-21 10:00:00,Nazaryan Mushegh - Arutyunov Ruben,2:3,6:11 - 8:11 - 11:5 - 11:4 - 11:9,3,2,Nazaryan Mushegh,Arutyunov Ruben,fiurst,Arutyunov Ruben - Nazaryan Mushegh,87,40,47,7,-7,17,19,16,15,20,-5,-3,6,7,2,7,11:6 - 11:8 - 5:11 - 4:11 - 9:11
14145836,2023-09-20 17:35:00,Soghomonyan Hrayr - Mkrtchyan Andranik,0:3,12:10 - 14:12 - 14:12 - 0:0 - 0:0,3,0,Soghomonyan Hrayr,Mkrtchyan Andranik,fiurst,Mkrtchyan Andranik - Soghomonyan Hrayr,74,34,40,6,-6,22,26,26,0,0,2,2,2,0,0,6,10:12 - 12:14 - 12:14 - 0:0 - 0:0
14145835,2023-09-20 17:15:00,Gevorgyan Hayk - Avakimyan Davit,0:0,0:0 - 0:0 - 0:0 - 0:0 - 0:0,0,0,Gevorgyan Hayk,Avakimyan Davit,fiurst,Avakimyan Davit - Gevorgyan Hayk,0,0,0,0,0,0,0,0,0,0,0,0,0,0,0,0,0:0 - 0:0 - 0:0 - 0:0 - 0:0
14145828,2023-09-20 17:00:00,Petrosyan Davit - Soghomonyan Hrayr,3:2,8:11 - 11:8 - 11:9 - 8:11 - 11:7,3,2,Petrosyan Davit,Soghomonyan Hrayr,fiurst,Petrosyan Davit - Soghomonyan Hrayr,95,49,46,-3,3,19,19,20,19,18,3,-3,-2,3,-4,-3,8:11 - 11:8 - 11:9 - 8:11 - 11:7
14145805,2023-09-20 16:45:00,Gevorgyan Hayk - Mkrtchyan Andranik,3:2,11:9 - 11:9 - 10:12 - 3:11 - 11:7,3,2,Gevorgyan Hayk,Mkrtchyan Andranik,fiurst,Gevorgyan Hayk - Mkrtchyan Andranik,94,46,48,2,-2,20,20,22,14,18,-2,-2,2,8,-4,2,11:9 - 11:9 - 10:12 - 3:11 - 11:7
14145803,2023-09-20 16:30:00,Avakimyan Davit - Petrosyan Davit,3:0,11:5 - 11:8 - 11:8 - 0:0 - 0:0,3,0,Avakimyan Davit,Petrosyan Davit,fiurst,Avakimyan Davit - Petrosyan Davit,54,33,21,-12,12,16,19,19,0,0,-6,-3,-3,0,0,-12,11:5 - 11:8 - 11:8 - 0:0 - 0:0
14145788,2023-09-20 16:15:00,Soghomonyan Hrayr - Gevorgyan Hayk,2:3,9:11 - 4:11 - 11:4 - 11:8 - 11:7,3,2,Soghomonyan Hrayr,Gevorgyan Hayk,fiurst,Gevorgyan Hayk - Soghomonyan Hrayr,87,41,46,5,-5,20,15,15,19,18,-2,-7,7,3,4,5,11:9 - 11:4 - 4:11 - 8:11 - 7:11
14145779,2023-09-20 16:00:00,Mkrtchyan Andranik - Petrosyan Davit,3:0,11:9 - 11:6 - 11:7 - 0:0 - 0:0,3,0,Mkrtchyan Andranik,Petrosyan Davit,fiurst,Mkrtchyan Andranik - Petrosyan Davit,55,33,22,-11,11,20,17,18,0,0,-2,-5,-4,0,0,-11,11:9 - 11:6 - 11:7 - 0:0 - 0:0
14145773,2023-09-20 15:45:00,Avakimyan Davit - Soghomonyan Hrayr,1:3,8:11 - 11:5 - 10:12 - 9:11 - 0:0,1,3,Avakimyan Davit,Soghomonyan Hrayr,fiurst,Avakimyan Davit - Soghomonyan Hrayr,77,38,39,1,-1,19,16,22,20,0,3,-6,2,2,0,1,8:11 - 11:5 - 10:12 - 9:11 - 0:0
14145772,2023-09-20 15:30:00,Petrosyan Davit - Gevorgyan Hayk,2:3,11:6 - 5:11 - 9:11 - 14:12 - 11:7,3,2,Petrosyan Davit,Gevorgyan Hayk,fiurst,Gevorgyan Hayk - Petrosyan Davit,97,47,50,3,-3,17,16,20,26,18,5,-6,-2,2,4,3,6:11 - 11:5 - 11:9 - 12:14 - 7:11
14145765,2023-09-20 15:15:00,Mkrtchyan Andranik - Avakimyan Davit,3:1,4:11 - 13:15 - 11:9 - 7:11 - 0:0,1,3,Mkrtchyan Andranik,Avakimyan Davit,fiurst,Avakimyan Davit - Mkrtchyan Andranik,81,46,35,-11,11,15,28,20,18,0,-7,-2,2,-4,0,-11,11:4 - 15:13 - 9:11 - 11:7 - 0:0
14145764,2023-09-20 15:00:00,Nazaryan Mushegh - Rafayelyan Edgar,0:3,5:11 - 5:11 - 7:11 - 0:0 - 0:0,0,3,Nazaryan Mushegh,Rafayelyan Edgar,fiurst,Nazaryan Mushegh - Rafayelyan Edgar,50,17,33,16,-16,16,16,18,0,0,6,6,4,0,0,16,5:11 - 5:11 - 7:11 - 0:0 - 0:0
14145756,2023-09-20 14:50:00,Nikoghosyan Narek - Papyan Karen,3:1,11:5 - 11:8 - 9:11 - 11:3 - 0:0,3,1,Nikoghosyan Narek,Papyan Karen,fiurst,Nikoghosyan Narek - Papyan Karen,69,42,27,-15,15,16,19,20,14,0,-6,-3,2,-8,0,-15,11:5 - 11:8 - 9:11 - 11:3 - 0:0
14145748,2023-09-20 14:30:00,Diaryan Aleksandr - Nazaryan Mushegh,3:0,11:7 - 11:4 - 11:4 - 0:0 - 0:0,3,0,Diaryan Aleksandr,Nazaryan Mushegh,fiurst,Diaryan Aleksandr - Nazaryan Mushegh,48,33,15,-18,18,18,15,15,0,0,-4,-7,-7,0,0,-18,11:7 - 11:4 - 11:4 - 0:0 - 0:0
14145746,2023-09-20 14:20:00,Rafayelyan Edgar - Nikoghosyan Narek,3:0,10:12 - 8:11 - 5:11 - 0:0 - 0:0,0,3,Rafayelyan Edgar,Nikoghosyan Narek,fiurst,Nikoghosyan Narek - Rafayelyan Edgar,57,34,23,-11,11,22,19,16,0,0,-2,-3,-6,0,0,-11,12:10 - 11:8 - 11:5 - 0:0 - 0:0
14145582,2023-09-20 14:00:00,Diaryan Aleksandr - Papyan Karen,3:1,11:4 - 11:6 - 8:11 - 11:7 - 0:0,3,1,Diaryan Aleksandr,Papyan Karen,fiurst,Diaryan Aleksandr - Papyan Karen,69,41,28,-13,13,15,17,19,18,0,-7,-5,3,-4,0,-13,11:4 - 11:6 - 8:11 - 11:7 - 0:0
14145577,2023-09-20 13:50:00,Nazaryan Mushegh - Nikoghosyan Narek,0:3,6:11 - 5:11 - 5:11 - 0:0 - 0:0,0,3,Nazaryan Mushegh,Nikoghosyan Narek,fiurst,Nazaryan Mushegh - Nikoghosyan Narek,49,16,33,17,-17,17,16,16,0,0,5,6,6,0,0,17,6:11 - 5:11 - 5:11 - 0:0 - 0:0
14145574,2023-09-20 13:30:00,Rafayelyan Edgar - Diaryan Aleksandr,3:0,7:11 - 6:11 - 5:11 - 0:0 - 0:0,0,3,Rafayelyan Edgar,Diaryan Aleksandr,fiurst,Diaryan Aleksandr - Rafayelyan Edgar,51,33,18,-15,15,18,17,16,0,0,-4,-5,-6,0,0,-15,11:7 - 11:6 - 11:5 - 0:0 - 0:0
14145570,2023-09-20 13:25:00,Papyan Karen - Nazaryan Mushegh,3:1,6:11 - 4:11 - 11:4 - 4:11 - 0:0,1,3,Papyan Karen,Nazaryan Mushegh,fiurst,Nazaryan Mushegh - Papyan Karen,62,37,25,-12,12,17,15,15,15,0,-5,-7,7,-7,0,-12,11:6 - 11:4 - 4:11 - 11:4 - 0:0
14145557,2023-09-20 13:00:00,Nikoghosyan Narek - Diaryan Aleksandr,2:3,1:11 - 9:11 - 11:7 - 11:6 - 12:10,3,2,Nikoghosyan Narek,Diaryan Aleksandr,fiurst,Diaryan Aleksandr - Nikoghosyan Narek,89,45,44,-1,1,12,20,18,17,22,-10,-2,4,5,2,-1,11:1 - 11:9 - 7:11 - 6:11 - 10:12
14145555,2023-09-20 12:55:00,Papyan Karen - Rafayelyan Edgar,2:3,11:5 - 11:3 - 5:11 - 6:11 - 2:11,2,3,Papyan Karen,Rafayelyan Edgar,fiurst,Papyan Karen - Rafayelyan Edgar,76,35,41,6,-6,16,14,16,17,13,-6,-8,6,5,9,6,11:5 - 11:3 - 5:11 - 6:11 - 2:11
14145538,2023-09-20 12:20:00,Nazaryan Mushegh - Diaryan Aleksandr,3:0,6:11 - 7:11 - 4:11 - 0:0 - 0:0,0,3,Nazaryan Mushegh,Diaryan Aleksandr,fiurst,Diaryan Aleksandr - Nazaryan Mushegh,50,33,17,-16,16,17,18,15,0,0,-5,-4,-7,0,0,-16,11:6 - 11:7 - 11:4 - 0:0 - 0:0
14145517,2023-09-20 12:00:00,Papyan Karen - Nikoghosyan Narek,3:2,11:8 - 15:13 - 9:11 - 4:11 - 7:11,2,3,Papyan Karen,Nikoghosyan Narek,fiurst,Nikoghosyan Narek - Papyan Karen,100,54,46,-8,8,19,28,20,15,18,3,2,-2,-7,-4,-8,8:11 - 13:15 - 11:9 - 11:4 - 11:7
14145516,2023-09-20 11:50:00,Rafayelyan Edgar - Nazaryan Mushegh,3:0,8:11 - 7:11 - 12:14 - 0:0 - 0:0,0,3,Rafayelyan Edgar,Nazaryan Mushegh,fiurst,Nazaryan Mushegh - Rafayelyan Edgar,63,36,27,-9,9,19,18,26,0,0,-3,-4,-2,0,0,-9,11:8 - 11:7 - 14:12 - 0:0 - 0:0
14145513,2023-09-20 11:40:00,Papyan Karen - Diaryan Aleksandr,3:2,9:11 - 11:9 - 9:11 - 11:6 - 9:11,2,3,Papyan Karen,Diaryan Aleksandr,fiurst,Diaryan Aleksandr - Papyan Karen,97,48,49,1,-1,20,20,20,17,20,-2,2,-2,5,-2,1,11:9 - 9:11 - 11:9 - 6:11 - 11:9
14145506,2023-09-20 11:15:00,Nikoghosyan Narek - Rafayelyan Edgar,0:3,6:11 - 9:11 - 5:11 - 0:0 - 0:0,0,3,Nikoghosyan Narek,Rafayelyan Edgar,fiurst,Nikoghosyan Narek - Rafayelyan Edgar,53,20,33,13,-13,17,20,16,0,0,5,2,6,0,0,13,6:11 - 9:11 - 5:11 - 0:0 - 0:0
14145505,2023-09-20 11:05:00,Nazaryan Mushegh - Papyan Karen,2:3,9:11 - 11:7 - 11:3 - 10:12 - 12:14,2,3,Nazaryan Mushegh,Papyan Karen,fiurst,Nazaryan Mushegh - Papyan Karen,100,53,47,-6,6,20,18,14,22,26,2,-4,-8,2,2,-6,9:11 - 11:7 - 11:3 - 10:12 - 12:14
14145500,2023-09-20 10:45:00,Diaryan Aleksandr - Rafayelyan Edgar,0:3,8:11 - 5:11 - 10:12 - 0:0 - 0:0,0,3,Diaryan Aleksandr,Rafayelyan Edgar,fiurst,Diaryan Aleksandr - Rafayelyan Edgar,57,23,34,11,-11,19,16,22,0,0,3,6,2,0,0,11,8:11 - 5:11 - 10:12 - 0:0 - 0:0
14145499,2023-09-20 10:30:00,Nikoghosyan Narek - Nazaryan Mushegh,3:1,8:11 - 10:12 - 11:5 - 13:15 - 0:0,1,3,Nikoghosyan Narek,Nazaryan Mushegh,fiurst,Nazaryan Mushegh - Nikoghosyan Narek,85,43,42,-1,1,19,22,16,28,0,-3,-2,6,-2,0,-1,11:8 - 12:10 - 5:11 - 15:13 - 0:0
14145466,2023-09-20 10:15:00,Rafayelyan Edgar - Papyan Karen,3:2,11:13 - 11:4 - 9:11 - 11:2 - 9:11,2,3,Rafayelyan Edgar,Papyan Karen,fiurst,Papyan Karen - Rafayelyan Edgar,92,41,51,10,-10,24,15,20,13,20,-2,7,-2,9,-2,10,13:11 - 4:11 - 11:9 - 2:11 - 11:9
14145459,2023-09-20 10:00:00,Diaryan Aleksandr - Nikoghosyan Narek,3:1,11:5 - 9:11 - 11:7 - 11:7 - 0:0,3,1,Diaryan Aleksandr,Nikoghosyan Narek,fiurst,Diaryan Aleksandr - Nikoghosyan Narek,72,42,30,-12,12,16,20,18,18,0,-6,2,-4,-4,0,-12,11:5 - 9:11 - 11:7 - 11:7 - 0:0
14126305,2023-09-19 17:30:00,Avakimyan Davit - Gevorgyan Hayk,3:2,11:7 - 11:7 - 10:12 - 10:12 - 17:15,3,2,Avakimyan Davit,Gevorgyan Hayk,fiurst,Avakimyan Davit - Gevorgyan Hayk,112,59,53,-6,6,18,18,22,22,32,-4,-4,2,2,-2,-6,11:7 - 11:7 - 10:12 - 10:12 - 17:15
14126297,2023-09-19 17:15:00,Soghomonyan Hrayr - Petrosyan Davit,2:3,6:11 - 14:12 - 11:8 - 10:12 - 11:8,3,2,Soghomonyan Hrayr,Petrosyan Davit,fiurst,Petrosyan Davit - Soghomonyan Hrayr,103,51,52,1,-1,17,26,19,22,19,-5,2,3,-2,3,1,11:6 - 12:14 - 8:11 - 12:10 - 8:11
14126293,2023-09-19 17:10:00,Mkrtchyan Andranik - Avakimyan Davit,3:1,7:11 - 11:9 - 4:11 - 9:11 - 0:0,1,3,Mkrtchyan Andranik,Avakimyan Davit,fiurst,Avakimyan Davit - Mkrtchyan Andranik,73,42,31,-11,11,18,20,15,20,0,-4,2,-7,-2,0,-11,11:7 - 9:11 - 11:4 - 11:9 - 0:0
14126288,2023-09-19 16:45:00,Petrosyan Davit - Mkrtchyan Andranik,3:1,7:11 - 7:11 - 11:9 - 7:11 - 0:0,1,3,Petrosyan Davit,Mkrtchyan Andranik,fiurst,Mkrtchyan Andranik - Petrosyan Davit,74,42,32,-10,10,18,18,20,18,0,-4,-4,2,-4,0,-10,11:7 - 11:7 - 9:11 - 11:7 - 0:0
14126291,2023-09-19 16:45:00,Soghomonyan Hrayr - Gevorgyan Hayk,2:3,6:11 - 11:8 - 11:9 - 9:11 - 12:10,3,2,Soghomonyan Hrayr,Gevorgyan Hayk,fiurst,Gevorgyan Hayk - Soghomonyan Hrayr,98,49,49,0,0,17,19,20,20,22,-5,3,2,-2,2,0,11:6 - 8:11 - 9:11 - 11:9 - 10:12
14126266,2023-09-19 16:15:00,Gevorgyan Hayk - Mkrtchyan Andranik,2:3,10:12 - 11:8 - 10:12 - 11:8 - 5:11,2,3,Gevorgyan Hayk,Mkrtchyan Andranik,fiurst,Gevorgyan Hayk - Mkrtchyan Andranik,98,47,51,4,-4,22,19,22,19,16,2,-3,2,-3,6,4,10:12 - 11:8 - 10:12 - 11:8 - 5:11
14126269,2023-09-19 16:15:00,Avakimyan Davit - Soghomonyan Hrayr,3:2,8:11 - 12:10 - 7:11 - 11:7 - 11:9,3,2,Avakimyan Davit,Soghomonyan Hrayr,fiurst,Avakimyan Davit - Soghomonyan Hrayr,97,49,48,-1,1,19,22,18,18,20,3,-2,4,-4,-2,-1,8:11 - 12:10 - 7:11 - 11:7 - 11:9
14126256,2023-09-19 15:45:00,Mkrtchyan Andranik - Soghomonyan Hrayr,3:1,11:6 - 12:10 - 7:11 - 11:8 - 0:0,3,1,Mkrtchyan Andranik,Soghomonyan Hrayr,fiurst,Mkrtchyan Andranik - Soghomonyan Hrayr,76,41,35,-6,6,17,22,18,19,0,-5,-2,4,-3,0,-6,11:6 - 12:10 - 7:11 - 11:8 - 0:0
14126262,2023-09-19 15:45:00,Petrosyan Davit - Avakimyan Davit,3:0,9:11 - 10:12 - 7:11 - 0:0 - 0:0,0,3,Petrosyan Davit,Avakimyan Davit,fiurst,Avakimyan Davit - Petrosyan Davit,60,34,26,-8,8,20,22,18,0,0,-2,-2,-4,0,0,-8,11:9 - 12:10 - 11:7 - 0:0 - 0:0
14126254,2023-09-19 15:15:00,Gevorgyan Hayk - Petrosyan Davit,1:3,6:11 - 11:8 - 9:11 - 7:11 - 0:0,1,3,Gevorgyan Hayk,Petrosyan Davit,fiurst,Gevorgyan Hayk - Petrosyan Davit,74,33,41,8,-8,17,19,20,18,0,5,-3,2,4,0,8,6:11 - 11:8 - 9:11 - 7:11 - 0:0
14126248,2023-09-19 15:10:00,Arutyunov Ruben - Nikoghosyan Narek,2:3,12:10 - 7:11 - 13:11 - 6:11 - 7:11,2,3,Arutyunov Ruben,Nikoghosyan Narek,fiurst,Arutyunov Ruben - Nikoghosyan Narek,99,45,54,9,-9,22,18,24,17,18,-2,4,-2,5,4,9,12:10 - 7:11 - 13:11 - 6:11 - 7:11
14126238,2023-09-19 14:55:00,Rafayelyan Edgar - Nazaryan Mushegh,0:3,11:3 - 11:6 - 11:3 - 0:0 - 0:0,3,0,Rafayelyan Edgar,Nazaryan Mushegh,fiurst,Nazaryan Mushegh - Rafayelyan Edgar,45,12,33,21,-21,14,17,14,0,0,8,5,8,0,0,21,3:11 - 6:11 - 3:11 - 0:0 - 0:0
14126217,2023-09-19 14:30:00,Antonyan Eduard - Arutyunov Ruben,3:1,9:11 - 13:11 - 14:12 - 11:9 - 0:0,3,1,Antonyan Eduard,Arutyunov Ruben,fiurst,Antonyan Eduard - Arutyunov Ruben,90,47,43,-4,4,20,24,26,20,0,2,-2,-2,-2,0,-4,9:11 - 13:11 - 14:12 - 11:9 - 0:0
14126214,2023-09-19 14:15:00,Nikoghosyan Narek - Rafayelyan Edgar,3:2,11:8 - 10:12 - 4:11 - 11:6 - 12:10,3,2,Nikoghosyan Narek,Rafayelyan Edgar,fiurst,Nikoghosyan Narek - Rafayelyan Edgar,95,48,47,-1,1,19,22,15,17,22,-3,2,7,-5,-2,-1,11:8 - 10:12 - 4:11 - 11:6 - 12:10
14126024,2023-09-19 14:00:00,Antonyan Eduard - Nazaryan Mushegh,3:2,11:9 - 4:11 - 9:11 - 11:5 - 11:7,3,2,Antonyan Eduard,Nazaryan Mushegh,fiurst,Antonyan Eduard - Nazaryan Mushegh,89,46,43,-3,3,20,15,20,16,18,-2,7,2,-6,-4,-3,11:9 - 4:11 - 9:11 - 11:5 - 11:7
14126020,2023-09-19 13:45:00,Arutyunov Ruben - Rafayelyan Edgar,1:3,9:11 - 8:11 - 11:8 - 3:11 - 0:0,1,3,Arutyunov Ruben,Rafayelyan Edgar,fiurst,Arutyunov Ruben - Rafayelyan Edgar,72,31,41,10,-10,20,19,19,14,0,2,3,-3,8,0,10,9:11 - 8:11 - 11:8 - 3:11 - 0:0
14126017,2023-09-19 13:30:00,Nikoghosyan Narek - Antonyan Eduard,0:3,11:8 - 12:10 - 11:5 - 0:0 - 0:0,3,0,Nikoghosyan Narek,Antonyan Eduard,fiurst,Antonyan Eduard - Nikoghosyan Narek,57,23,34,11,-11,19,22,16,0,0,3,2,6,0,0,11,8:11 - 10:12 - 5:11 - 0:0 - 0:0
14126005,2023-09-19 13:20:00,Nazaryan Mushegh - Arutyunov Ruben,3:2,9:11 - 5:11 - 11:6 - 11:6 - 7:11,2,3,Nazaryan Mushegh,Arutyunov Ruben,fiurst,Arutyunov Ruben - Nazaryan Mushegh,88,45,43,-2,2,20,16,17,17,18,-2,-6,5,5,-4,-2,11:9 - 11:5 - 6:11 - 6:11 - 11:7
14125910,2023-09-19 13:00:00,Rafayelyan Edgar - Antonyan Eduard,0:3,12:10 - 11:9 - 11:5 - 0:0 - 0:0,3,0,Rafayelyan Edgar,Antonyan Eduard,fiurst,Antonyan Eduard - Rafayelyan Edgar,58,24,34,10,-10,22,20,16,0,0,2,2,6,0,0,10,10:12 - 9:11 - 5:11 - 0:0 - 0:0
14125890,2023-09-19 12:50:00,Nazaryan Mushegh - Nikoghosyan Narek,0:3,5:11 - 4:11 - 9:11 - 0:0 - 0:0,0,3,Nazaryan Mushegh,Nikoghosyan Narek,fiurst,Nazaryan Mushegh - Nikoghosyan Narek,51,18,33,15,-15,16,15,20,0,0,6,7,2,0,0,15,5:11 - 4:11 - 9:11 - 0:0 - 0:0
14125845,2023-09-19 12:25:00,Arutyunov Ruben - Antonyan Eduard,3:1,6:11 - 12:10 - 9:11 - 5:11 - 0:0,1,3,Arutyunov Ruben,Antonyan Eduard,fiurst,Antonyan Eduard - Arutyunov Ruben,75,43,32,-11,11,17,22,20,16,0,-5,2,-2,-6,0,-11,11:6 - 10:12 - 11:9 - 11:5 - 0:0
14125798,2023-09-19 12:05:00,Nazaryan Mushegh - Rafayelyan Edgar,1:3,11:9 - 8:11 - 9:11 - 7:11 - 0:0,1,3,Nazaryan Mushegh,Rafayelyan Edgar,fiurst,Nazaryan Mushegh - Rafayelyan Edgar,77,35,42,7,-7,20,19,20,18,0,-2,3,2,4,0,7,11:9 - 8:11 - 9:11 - 7:11 - 0:0
14125735,2023-09-19 11:55:00,Nikoghosyan Narek - Arutyunov Ruben,0:3,11:7 - 16:14 - 11:7 - 0:0 - 0:0,3,0,Nikoghosyan Narek,Arutyunov Ruben,fiurst,Arutyunov Ruben - Nikoghosyan Narek,66,28,38,10,-10,18,30,18,0,0,4,2,4,0,0,10,7:11 - 14:16 - 7:11 - 0:0 - 0:0
14125704,2023-09-19 11:35:00,Nazaryan Mushegh - Antonyan Eduard,3:0,7:11 - 8:11 - 6:11 - 0:0 - 0:0,0,3,Nazaryan Mushegh,Antonyan Eduard,fiurst,Antonyan Eduard - Nazaryan Mushegh,54,33,21,-12,12,18,19,17,0,0,-4,-3,-5,0,0,-12,11:7 - 11:8 - 11:6 - 0:0 - 0:0
14125702,2023-09-19 11:25:00,Rafayelyan Edgar - Nikoghosyan Narek,3:0,5:11 - 3:11 - 9:11 - 0:0 - 0:0,0,3,Rafayelyan Edgar,Nikoghosyan Narek,fiurst,Nikoghosyan Narek - Rafayelyan Edgar,50,33,17,-16,16,16,14,20,0,0,-6,-8,-2,0,0,-16,11:5 - 11:3 - 11:9 - 0:0 - 0:0
14125555,2023-09-19 11:00:00,Arutyunov Ruben - Nazaryan Mushegh,3:2,6:11 - 11:4 - 11:13 - 13:11 - 11:7,3,2,Arutyunov Ruben,Nazaryan Mushegh,fiurst,Arutyunov Ruben - Nazaryan Mushegh,98,52,46,-6,6,17,15,24,24,18,5,-7,2,-2,-4,-6,6:11 - 11:4 - 11:13 - 13:11 - 11:7
14125511,2023-09-19 10:45:00,Antonyan Eduard - Nikoghosyan Narek,2:3,11:8 - 5:11 - 11:7 - 9:11 - 8:11,2,3,Antonyan Eduard,Nikoghosyan Narek,fiurst,Antonyan Eduard - Nikoghosyan Narek,92,44,48,4,-4,19,16,18,20,19,-3,6,-4,2,3,4,11:8 - 5:11 - 11:7 - 9:11 - 8:11
14125576,2023-09-19 10:30:00,Rafayelyan Edgar - Arutyunov Ruben,0:3,11:8 - 11:9 - 11:8 - 0:0 - 0:0,3,0,Rafayelyan Edgar,Arutyunov Ruben,fiurst,Arutyunov Ruben - Rafayelyan Edgar,58,25,33,8,-8,19,20,19,0,0,3,2,3,0,0,8,8:11 - 9:11 - 8:11 - 0:0 - 0:0
14125482,2023-09-19 10:15:00,Nikoghosyan Narek - Nazaryan Mushegh,1:3,11:8 - 9:11 - 11:5 - 11:2 - 0:0,3,1,Nikoghosyan Narek,Nazaryan Mushegh,fiurst,Nazaryan Mushegh - Nikoghosyan Narek,68,26,42,16,-16,19,20,16,13,0,3,-2,6,9,0,16,8:11 - 11:9 - 5:11 - 2:11 - 0:0
14125481,2023-09-19 10:00:00,Antonyan Eduard - Rafayelyan Edgar,0:3,6:11 - 12:14 - 12:14 - 0:0 - 0:0,0,3,Antonyan Eduard,Rafayelyan Edgar,fiurst,Antonyan Eduard - Rafayelyan Edgar,69,30,39,9,-9,17,26,26,0,0,5,2,2,0,0,9,6:11 - 12:14 - 12:14 - 0:0 - 0:0
14106352,2023-09-18 17:30:00,Gevorgyan Hayk - Avakimyan Davit,0:3,11:8 - 13:11 - 11:7 - 0:0 - 0:0,3,0,Gevorgyan Hayk,Avakimyan Davit,fiurst,Avakimyan Davit - Gevorgyan Hayk,61,26,35,9,-9,19,24,18,0,0,3,2,4,0,0,9,8:11 - 11:13 - 7:11 - 0:0 - 0:0
14106335,2023-09-18 17:15:00,Darbinyan Armen - Mkrtchyan Andranik,3:2,13:11 - 17:15 - 7:11 - 9:11 - 13:11,3,2,Darbinyan Armen,Mkrtchyan Andranik,fiurst,Darbinyan Armen - Mkrtchyan Andranik,118,59,59,0,0,24,32,18,20,24,-2,-2,4,2,-2,0,13:11 - 17:15 - 7:11 - 9:11 - 13:11
14106333,2023-09-18 17:00:00,Petrosyan Davit - Gevorgyan Hayk,3:1,3:11 - 11:7 - 10:12 - 9:11 - 0:0,1,3,Petrosyan Davit,Gevorgyan Hayk,fiurst,Gevorgyan Hayk - Petrosyan Davit,74,41,33,-8,8,14,18,22,20,0,-8,4,-2,-2,0,-8,11:3 - 7:11 - 12:10 - 11:9 - 0:0
14106329,2023-09-18 16:45:00,Darbinyan Armen - Avakimyan Davit,1:3,11:8 - 7:11 - 11:8 - 11:9 - 0:0,3,1,Darbinyan Armen,Avakimyan Davit,fiurst,Avakimyan Davit - Darbinyan Armen,76,36,40,4,-4,19,18,19,20,0,3,-4,3,2,0,4,8:11 - 11:7 - 8:11 - 9:11 - 0:0
14106317,2023-09-18 16:30:00,Mkrtchyan Andranik - Petrosyan Davit,3:2,11:5 - 5:11 - 11:9 - 10:12 - 11:9,3,2,Mkrtchyan Andranik,Petrosyan Davit,fiurst,Mkrtchyan Andranik - Petrosyan Davit,94,48,46,-2,2,16,16,20,22,20,-6,6,-2,2,-2,-2,11:5 - 5:11 - 11:9 - 10:12 - 11:9
14106316,2023-09-18 16:15:00,Gevorgyan Hayk - Darbinyan Armen,0:3,11:3 - 11:8 - 11:7 - 0:0 - 0:0,3,0,Gevorgyan Hayk,Darbinyan Armen,fiurst,Darbinyan Armen - Gevorgyan Hayk,51,18,33,15,-15,14,19,18,0,0,8,3,4,0,0,15,3:11 - 8:11 - 7:11 - 0:0 - 0:0
14106313,2023-09-18 16:00:00,Avakimyan Davit - Petrosyan Davit,3:0,11:7 - 11:6 - 11:6 - 0:0 - 0:0,3,0,Avakimyan Davit,Petrosyan Davit,fiurst,Avakimyan Davit - Petrosyan Davit,52,33,19,-14,14,18,17,17,0,0,-4,-5,-5,0,0,-14,11:7 - 11:6 - 11:6 - 0:0 - 0:0
14106309,2023-09-18 15:50:00,Mkrtchyan Andranik - Gevorgyan Hayk,0:3,11:9 - 14:12 - 11:5 - 0:0 - 0:0,3,0,Mkrtchyan Andranik,Gevorgyan Hayk,fiurst,Gevorgyan Hayk - Mkrtchyan Andranik,62,26,36,10,-10,20,26,16,0,0,2,2,6,0,0,10,9:11 - 12:14 - 5:11 - 0:0 - 0:0
14106308,2023-09-18 15:30:00,Petrosyan Davit - Darbinyan Armen,0:3,11:9 - 11:2 - 11:1 - 0:0 - 0:0,3,0,Petrosyan Davit,Darbinyan Armen,fiurst,Darbinyan Armen - Petrosyan Davit,45,12,33,21,-21,20,13,12,0,0,2,9,10,0,0,21,9:11 - 2:11 - 1:11 - 0:0 - 0:0
14106288,2023-09-18 15:15:00,Avakimyan Davit - Mkrtchyan Andranik,3:2,12:10 - 11:7 - 8:11 - 14:16 - 11:7,3,2,Avakimyan Davit,Mkrtchyan Andranik,fiurst,Avakimyan Davit - Mkrtchyan Andranik,107,56,51,-5,5,22,18,19,30,18,-2,-4,3,2,-4,-5,12:10 - 11:7 - 8:11 - 14:16 - 11:7
14106285,2023-09-18 15:00:00,Rafayelyan Edgar - Antonyan Eduard,3:1,5:11 - 11:9 - 7:11 - 5:11 - 0:0,1,3,Rafayelyan Edgar,Antonyan Eduard,fiurst,Antonyan Eduard - Rafayelyan Edgar,70,42,28,-14,14,16,20,18,16,0,-6,2,-4,-6,0,-14,11:5 - 9:11 - 11:7 - 11:5 - 0:0
14111989,2023-09-18 14:55:00,Diaryan Aleksandr - Arutyunov Ruben,0:3,11:8 - 11:6 - 11:4 - 0:0 - 0:0,3,0,Diaryan Aleksandr,Arutyunov Ruben,fiurst,Arutyunov Ruben - Diaryan Aleksandr,51,18,33,15,-15,19,17,15,0,0,3,5,7,0,0,15,8:11 - 6:11 - 4:11 - 0:0 - 0:0
14106278,2023-09-18 14:35:00,Nikoghosyan Narek - Rafayelyan Edgar,3:0,11:5 - 11:7 - 11:9 - 0:0 - 0:0,3,0,Nikoghosyan Narek,Rafayelyan Edgar,fiurst,Nikoghosyan Narek - Rafayelyan Edgar,54,33,21,-12,12,16,18,20,0,0,-6,-4,-2,0,0,-12,11:5 - 11:7 - 11:9 - 0:0 - 0:0
14106240,2023-09-18 14:25:00,Antonyan Eduard - Diaryan Aleksandr,2:3,4:11 - 11:9 - 2:11 - 11:3 - 7:11,2,3,Antonyan Eduard,Diaryan Aleksandr,fiurst,Antonyan Eduard - Diaryan Aleksandr,80,35,45,10,-10,15,20,13,14,18,7,-2,9,-8,4,10,4:11 - 11:9 - 2:11 - 11:3 - 7:11
14111976,2023-09-18 14:05:00,Nikoghosyan Narek - Arutyunov Ruben,3:1,4:11 - 11:5 - 10:12 - 6:11 - 0:0,1,3,Nikoghosyan Narek,Arutyunov Ruben,fiurst,Arutyunov Ruben - Nikoghosyan Narek,70,39,31,-8,8,15,16,22,17,0,-7,6,-2,-5,0,-8,11:4 - 5:11 - 12:10 - 11:6 - 0:0
14106238,2023-09-18 14:00:00,Rafayelyan Edgar - Diaryan Aleksandr,1:3,11:2 - 10:12 - 11:9 - 11:3 - 0:0,3,1,Rafayelyan Edgar,Diaryan Aleksandr,fiurst,Diaryan Aleksandr - Rafayelyan Edgar,69,26,43,17,-17,13,22,20,14,0,9,-2,2,8,0,17,2:11 - 12:10 - 9:11 - 3:11 - 0:0
14106234,2023-09-18 13:30:00,Antonyan Eduard - Nikoghosyan Narek,0:3,3:11 - 5:11 - 9:11 - 0:0 - 0:0,0,3,Antonyan Eduard,Nikoghosyan Narek,fiurst,Antonyan Eduard - Nikoghosyan Narek,50,17,33,16,-16,14,16,20,0,0,8,6,2,0,0,16,3:11 - 5:11 - 9:11 - 0:0 - 0:0
14111962,2023-09-18 13:30:00,Arutyunov Ruben - Rafayelyan Edgar,2:3,11:4 - 11:8 - 9:11 - 8:11 - 6:11,2,3,Arutyunov Ruben,Rafayelyan Edgar,fiurst,Arutyunov Ruben - Rafayelyan Edgar,90,45,45,0,0,15,19,20,19,17,-7,-3,2,3,5,0,11:4 - 11:8 - 9:11 - 8:11 - 6:11
14106218,2023-09-18 13:00:00,Diaryan Aleksandr - Nikoghosyan Narek,0:3,9:11 - 5:11 - 8:11 - 0:0 - 0:0,0,3,Diaryan Aleksandr,Nikoghosyan Narek,fiurst,Diaryan Aleksandr - Nikoghosyan Narek,55,22,33,11,-11,20,16,19,0,0,2,6,3,0,0,11,9:11 - 5:11 - 8:11 - 0:0 - 0:0
14111951,2023-09-18 12:50:00,Arutyunov Ruben - Antonyan Eduard,3:2,11:9 - 8:11 - 11:7 - 6:11 - 8:11,2,3,Arutyunov Ruben,Antonyan Eduard,fiurst,Antonyan Eduard - Arutyunov Ruben,93,49,44,-5,5,20,19,18,17,19,2,-3,4,-5,-3,-5,9:11 - 11:8 - 7:11 - 11:6 - 11:8
14106215,2023-09-18 12:15:00,Rafayelyan Edgar - Nikoghosyan Narek,1:3,11:8 - 11:4 - 7:11 - 11:9 - 0:0,3,1,Rafayelyan Edgar,Nikoghosyan Narek,fiurst,Nikoghosyan Narek - Rafayelyan Edgar,72,32,40,8,-8,19,15,18,20,0,3,7,-4,2,0,8,8:11 - 4:11 - 11:7 - 9:11 - 0:0
14111948,2023-09-18 12:10:00,Arutyunov Ruben - Diaryan Aleksandr,2:3,8:11 - 6:11 - 11:9 - 11:5 - 9:11,2,3,Arutyunov Ruben,Diaryan Aleksandr,fiurst,Arutyunov Ruben - Diaryan Aleksandr,92,45,47,2,-2,19,17,20,16,20,3,5,-2,-6,2,2,8:11 - 6:11 - 11:9 - 11:5 - 9:11
14106213,2023-09-18 11:45:00,Antonyan Eduard - Rafayelyan Edgar,0:3,7:11 - 10:12 - 8:11 - 0:0 - 0:0,0,3,Antonyan Eduard,Rafayelyan Edgar,fiurst,Antonyan Eduard - Rafayelyan Edgar,59,25,34,9,-9,18,22,19,0,0,4,2,3,0,0,9,7:11 - 10:12 - 8:11 - 0:0 - 0:0
14119600,2023-09-18 11:30:00,Arutyunov Ruben - Nikoghosyan Narek,3:2,8:11 - 11:6 - 11:7 - 8:11 - 13:11,3,2,Arutyunov Ruben,Nikoghosyan Narek,fiurst,Arutyunov Ruben - Nikoghosyan Narek,97,51,46,-5,5,19,17,18,19,24,3,-5,-4,3,-2,-5,8:11 - 11:6 - 11:7 - 8:11 - 13:11
14106212,2023-09-18 11:20:00,Diaryan Aleksandr - Antonyan Eduard,0:3,11:3 - 12:10 - 11:4 - 0:0 - 0:0,3,0,Diaryan Aleksandr,Antonyan Eduard,fiurst,Antonyan Eduard - Diaryan Aleksandr,51,17,34,17,-17,14,22,15,0,0,8,2,7,0,0,17,3:11 - 10:12 - 4:11 - 0:0 - 0:0
14111944,2023-09-18 11:00:00,Rafayelyan Edgar - Arutyunov Ruben,1:3,11:5 - 7:11 - 11:6 - 11:9 - 0:0,3,1,Rafayelyan Edgar,Arutyunov Ruben,fiurst,Arutyunov Ruben - Rafayelyan Edgar,71,31,40,9,-9,16,18,17,20,0,6,-4,5,2,0,9,5:11 - 11:7 - 6:11 - 9:11 - 0:0
14106200,2023-09-18 10:55:00,Nikoghosyan Narek - Antonyan Eduard,3:0,9:11 - 4:11 - 7:11 - 0:0 - 0:0,0,3,Nikoghosyan Narek,Antonyan Eduard,fiurst,Antonyan Eduard - Nikoghosyan Narek,53,33,20,-13,13,20,15,18,0,0,-2,-7,-4,0,0,-13,11:9 - 11:4 - 11:7 - 0:0 - 0:0
14106194,2023-09-18 10:30:00,Diaryan Aleksandr - Rafayelyan Edgar,3:1,11:3 - 7:11 - 11:8 - 11:7 - 0:0,3,1,Diaryan Aleksandr,Rafayelyan Edgar,fiurst,Diaryan Aleksandr - Rafayelyan Edgar,69,40,29,-11,11,14,18,19,18,0,-8,4,-3,-4,0,-11,11:3 - 7:11 - 11:8 - 11:7 - 0:0
14111942,2023-09-18 10:15:00,Antonyan Eduard - Arutyunov Ruben,2:3,9:11 - 8:11 - 11:9 - 11:7 - 9:11,2,3,Antonyan Eduard,Arutyunov Ruben,fiurst,Antonyan Eduard - Arutyunov Ruben,97,48,49,1,-1,20,19,20,18,20,2,3,-2,-4,2,1,9:11 - 8:11 - 11:9 - 11:7 - 9:11
14106047,2023-09-18 10:05:00,Nikoghosyan Narek - Diaryan Aleksandr,3:1,5:11 - 6:11 - 11:3 - 7:11 - 0:0,1,3,Nikoghosyan Narek,Diaryan Aleksandr,fiurst,Diaryan Aleksandr - Nikoghosyan Narek,65,36,29,-7,7,16,17,14,18,0,-6,-5,8,-4,0,-7,11:5 - 11:6 - 3:11 - 11:7 - 0:0
14087737,2023-09-17 17:30:00,Darbinyan Armen - Petrosyan Davit,0:3,4:11 - 8:11 - 12:14 - 0:0 - 0:0,0,3,Darbinyan Armen,Petrosyan Davit,fiurst,Darbinyan Armen - Petrosyan Davit,60,24,36,12,-12,15,19,26,0,0,7,3,2,0,0,12,4:11 - 8:11 - 12:14 - 0:0 - 0:0
14087734,2023-09-17 17:15:00,Soghomonyan Hrayr - Avakimyan Davit,0:3,11:6 - 11:5 - 11:6 - 0:0 - 0:0,3,0,Soghomonyan Hrayr,Avakimyan Davit,fiurst,Avakimyan Davit - Soghomonyan Hrayr,50,17,33,16,-16,17,16,17,0,0,5,6,5,0,0,16,6:11 - 5:11 - 6:11 - 0:0 - 0:0
14087723,2023-09-17 17:00:00,Mkrtchyan Andranik - Darbinyan Armen,0:3,11:8 - 11:4 - 11:7 - 0:0 - 0:0,3,0,Mkrtchyan Andranik,Darbinyan Armen,fiurst,Darbinyan Armen - Mkrtchyan Andranik,52,19,33,14,-14,19,15,18,0,0,3,7,4,0,0,14,8:11 - 4:11 - 7:11 - 0:0 - 0:0
14087722,2023-09-17 16:45:00,Soghomonyan Hrayr - Petrosyan Davit,0:3,11:3 - 11:7 - 11:9 - 0:0 - 0:0,3,0,Soghomonyan Hrayr,Petrosyan Davit,fiurst,Petrosyan Davit - Soghomonyan Hrayr,52,19,33,14,-14,14,18,20,0,0,8,4,2,0,0,14,3:11 - 7:11 - 9:11 - 0:0 - 0:0
14087718,2023-09-17 16:30:00,Avakimyan Davit - Mkrtchyan Andranik,1:3,11:9 - 9:11 - 10:12 - 4:11 - 0:0,1,3,Avakimyan Davit,Mkrtchyan Andranik,fiurst,Avakimyan Davit - Mkrtchyan Andranik,77,34,43,9,-9,20,20,22,15,0,-2,2,2,7,0,9,11:9 - 9:11 - 10:12 - 4:11 - 0:0
14087714,2023-09-17 16:15:00,Darbinyan Armen - Soghomonyan Hrayr,0:3,6:11 - 9:11 - 3:11 - 0:0 - 0:0,0,3,Darbinyan Armen,Soghomonyan Hrayr,fiurst,Darbinyan Armen - Soghomonyan Hrayr,51,18,33,15,-15,17,20,14,0,0,5,2,8,0,0,15,6:11 - 9:11 - 3:11 - 0:0 - 0:0
14087704,2023-09-17 16:00:00,Petrosyan Davit - Mkrtchyan Andranik,3:1,12:14 - 12:10 - 12:14 - 9:11 - 0:0,1,3,Petrosyan Davit,Mkrtchyan Andranik,fiurst,Mkrtchyan Andranik - Petrosyan Davit,94,49,45,-4,4,26,22,26,20,0,-2,2,-2,-2,0,-4,14:12 - 10:12 - 14:12 - 11:9 - 0:0
14087703,2023-09-17 15:45:00,Avakimyan Davit - Darbinyan Armen,3:0,11:7 - 11:6 - 12:10 - 0:0 - 0:0,3,0,Avakimyan Davit,Darbinyan Armen,fiurst,Avakimyan Davit - Darbinyan Armen,57,34,23,-11,11,18,17,22,0,0,-4,-5,-2,0,0,-11,11:7 - 11:6 - 12:10 - 0:0 - 0:0
14087702,2023-09-17 15:30:00,Mkrtchyan Andranik - Soghomonyan Hrayr,0:3,8:11 - 3:11 - 3:11 - 0:0 - 0:0,0,3,Mkrtchyan Andranik,Soghomonyan Hrayr,fiurst,Mkrtchyan Andranik - Soghomonyan Hrayr,47,14,33,19,-19,19,14,14,0,0,3,8,8,0,0,19,8:11 - 3:11 - 3:11 - 0:0 - 0:0
14087691,2023-09-17 15:15:00,Petrosyan Davit - Avakimyan Davit,3:0,7:11 - 7:11 - 7:11 - 0:0 - 0:0,0,3,Petrosyan Davit,Avakimyan Davit,fiurst,Avakimyan Davit - Petrosyan Davit,54,33,21,-12,12,18,18,18,0,0,-4,-4,-4,0,0,-12,11:7 - 11:7 - 11:7 - 0:0 - 0:0
14087680,2023-09-17 15:00:00,Nazaryan Mushegh - Diaryan Aleksandr,3:0,4:11 - 5:11 - 3:11 - 0:0 - 0:0,0,3,Nazaryan Mushegh,Diaryan Aleksandr,fiurst,Diaryan Aleksandr - Nazaryan Mushegh,45,33,12,-21,21,15,16,14,0,0,-7,-6,-8,0,0,-21,11:4 - 11:5 - 11:3 - 0:0 - 0:0
14087672,2023-09-17 14:45:00,Papyan Karen - Antonyan Eduard,3:2,6:11 - 3:11 - 11:9 - 11:8 - 7:11,2,3,Papyan Karen,Antonyan Eduard,fiurst,Antonyan Eduard - Papyan Karen,88,50,38,-12,12,17,14,20,19,18,-5,-8,2,3,-4,-12,11:6 - 11:3 - 9:11 - 8:11 - 11:7
14087670,2023-09-17 14:30:00,Rafayelyan Edgar - Nazaryan Mushegh,0:3,11:6 - 11:6 - 11:2 - 0:0 - 0:0,3,0,Rafayelyan Edgar,Nazaryan Mushegh,fiurst,Nazaryan Mushegh - Rafayelyan Edgar,47,14,33,19,-19,17,17,13,0,0,5,5,9,0,0,19,6:11 - 6:11 - 2:11 - 0:0 - 0:0
14087666,2023-09-17 14:15:00,Diaryan Aleksandr - Papyan Karen,3:0,11:2 - 11:5 - 11:4 - 0:0 - 0:0,3,0,Diaryan Aleksandr,Papyan Karen,fiurst,Diaryan Aleksandr - Papyan Karen,44,33,11,-22,22,13,16,15,0,0,-9,-6,-7,0,0,-22,11:2 - 11:5 - 11:4 - 0:0 - 0:0
14087655,2023-09-17 14:00:00,Rafayelyan Edgar - Antonyan Eduard,0:3,11:5 - 11:7 - 11:7 - 0:0 - 0:0,3,0,Rafayelyan Edgar,Antonyan Eduard,fiurst,Antonyan Eduard - Rafayelyan Edgar,52,19,33,14,-14,16,18,18,0,0,6,4,4,0,0,14,5:11 - 7:11 - 7:11 - 0:0 - 0:0
14087625,2023-09-17 13:50:00,Nazaryan Mushegh - Papyan Karen,2:3,11:9 - 11:8 - 8:11 - 8:11 - 7:11,2,3,Nazaryan Mushegh,Papyan Karen,fiurst,Nazaryan Mushegh - Papyan Karen,95,45,50,5,-5,20,19,19,19,18,-2,-3,3,3,4,5,11:9 - 11:8 - 8:11 - 8:11 - 7:11
14087604,2023-09-17 13:30:00,Diaryan Aleksandr - Rafayelyan Edgar,3:0,11:8 - 11:7 - 11:3 - 0:0 - 0:0,3,0,Diaryan Aleksandr,Rafayelyan Edgar,fiurst,Diaryan Aleksandr - Rafayelyan Edgar,51,33,18,-15,15,19,18,14,0,0,-3,-4,-8,0,0,-15,11:8 - 11:7 - 11:3 - 0:0 - 0:0
14087601,2023-09-17 13:15:00,Antonyan Eduard - Nazaryan Mushegh,3:1,11:4 - 12:10 - 7:11 - 11:6 - 0:0,3,1,Antonyan Eduard,Nazaryan Mushegh,fiurst,Antonyan Eduard - Nazaryan Mushegh,72,41,31,-10,10,15,22,18,17,0,-7,-2,4,-5,0,-10,11:4 - 12:10 - 7:11 - 11:6 - 0:0
14105303,2023-09-17 10:00:00,Rafayelyan Edgar - Papyan Karen,0:3,11:8 - 11:5 - 11:9 - 0:0 - 0:0,3,0,Rafayelyan Edgar,Papyan Karen,fiurst,Papyan Karen - Rafayelyan Edgar,55,22,33,11,-11,19,16,20,0,0,3,6,2,0,0,11,8:11 - 5:11 - 9:11 - 0:0 - 0:0
14068103,2023-09-16 17:30:00,Petrosyan Davit - Gevorgyan Hayk,1:3,11:3 - 13:11 - 4:11 - 11:8 - 0:0,3,1,Petrosyan Davit,Gevorgyan Hayk,fiurst,Gevorgyan Hayk - Petrosyan Davit,72,33,39,6,-6,14,24,15,19,0,8,2,-7,3,0,6,3:11 - 11:13 - 11:4 - 8:11 - 0:0
14068090,2023-09-16 17:15:00,Mkrtchyan Andranik - Grigoryan Erik,0:3,11:8 - 11:7 - 14:12 - 0:0 - 0:0,3,0,Mkrtchyan Andranik,Grigoryan Erik,fiurst,Grigoryan Erik - Mkrtchyan Andranik,63,27,36,9,-9,19,18,26,0,0,3,4,2,0,0,9,8:11 - 7:11 - 12:14 - 0:0 - 0:0
14068079,2023-09-16 17:00:00,Avakimyan Davit - Petrosyan Davit,2:3,10:12 - 11:6 - 7:11 - 11:5 - 5:11,2,3,Avakimyan Davit,Petrosyan Davit,fiurst,Avakimyan Davit - Petrosyan Davit,89,44,45,1,-1,22,17,18,16,16,2,-5,4,-6,6,1,10:12 - 11:6 - 7:11 - 11:5 - 5:11
14068078,2023-09-16 16:45:00,Mkrtchyan Andranik - Gevorgyan Hayk,0:3,11:5 - 11:4 - 11:6 - 0:0 - 0:0,3,0,Mkrtchyan Andranik,Gevorgyan Hayk,fiurst,Gevorgyan Hayk - Mkrtchyan Andranik,48,15,33,18,-18,16,15,17,0,0,6,7,5,0,0,18,5:11 - 4:11 - 6:11 - 0:0 - 0:0
14068076,2023-09-16 16:30:00,Grigoryan Erik - Avakimyan Davit,3:0,4:11 - 5:11 - 6:11 - 0:0 - 0:0,0,3,Grigoryan Erik,Avakimyan Davit,fiurst,Avakimyan Davit - Grigoryan Erik,48,33,15,-18,18,15,16,17,0,0,-7,-6,-5,0,0,-18,11:4 - 11:5 - 11:6 - 0:0 - 0:0
14068073,2023-09-16 16:15:00,Petrosyan Davit - Mkrtchyan Andranik,3:2,11:7 - 6:11 - 8:11 - 11:8 - 1:11,2,3,Petrosyan Davit,Mkrtchyan Andranik,fiurst,Mkrtchyan Andranik - Petrosyan Davit,85,48,37,-11,11,18,17,19,19,12,4,-5,-3,3,-10,-11,7:11 - 11:6 - 11:8 - 8:11 - 11:1
14068067,2023-09-16 16:00:00,Gevorgyan Hayk - Avakimyan Davit,3:0,10:12 - 7:11 - 12:14 - 0:0 - 0:0,0,3,Gevorgyan Hayk,Avakimyan Davit,fiurst,Avakimyan Davit - Gevorgyan Hayk,66,37,29,-8,8,22,18,26,0,0,-2,-4,-2,0,0,-8,12:10 - 11:7 - 14:12 - 0:0 - 0:0
14068056,2023-09-16 15:45:00,Grigoryan Erik - Petrosyan Davit,3:1,12:10 - 12:10 - 8:11 - 11:4 - 0:0,3,1,Grigoryan Erik,Petrosyan Davit,fiurst,Grigoryan Erik - Petrosyan Davit,78,43,35,-8,8,22,22,19,15,0,-2,-2,3,-7,0,-8,12:10 - 12:10 - 8:11 - 11:4 - 0:0
14068051,2023-09-16 15:30:00,Avakimyan Davit - Mkrtchyan Andranik,3:0,11:9 - 11:5 - 11:5 - 0:0 - 0:0,3,0,Avakimyan Davit,Mkrtchyan Andranik,fiurst,Avakimyan Davit - Mkrtchyan Andranik,52,33,19,-14,14,20,16,16,0,0,-2,-6,-6,0,0,-14,11:9 - 11:5 - 11:5 - 0:0 - 0:0
14068048,2023-09-16 15:15:00,Gevorgyan Hayk - Grigoryan Erik,1:3,4:11 - 11:13 - 11:4 - 9:11 - 0:0,1,3,Gevorgyan Hayk,Grigoryan Erik,fiurst,Gevorgyan Hayk - Grigoryan Erik,74,35,39,4,-4,15,24,15,20,0,7,2,-7,2,0,4,4:11 - 11:13 - 11:4 - 9:11 - 0:0
14068023,2023-09-16 15:00:00,Papyan Karen - Antonyan Eduard,3:1,11:9 - 6:11 - 5:11 - 10:12 - 0:0,1,3,Papyan Karen,Antonyan Eduard,fiurst,Antonyan Eduard - Papyan Karen,75,43,32,-11,11,20,17,16,22,0,2,-5,-6,-2,0,-11,9:11 - 11:6 - 11:5 - 12:10 - 0:0
14068011,2023-09-16 14:50:00,Nikoghosyan Narek - Rafayelyan Edgar,1:3,11:5 - 5:11 - 8:11 - 1:11 - 0:0,1,3,Nikoghosyan Narek,Rafayelyan Edgar,fiurst,Nikoghosyan Narek - Rafayelyan Edgar,63,25,38,13,-13,16,16,19,12,0,-6,6,3,10,0,13,11:5 - 5:11 - 8:11 - 1:11 - 0:0
14068010,2023-09-16 14:30:00,Soghomonyan Hrayr - Papyan Karen,3:0,3:11 - 5:11 - 8:11 - 0:0 - 0:0,0,3,Soghomonyan Hrayr,Papyan Karen,fiurst,Papyan Karen - Soghomonyan Hrayr,49,33,16,-17,17,14,16,19,0,0,-8,-6,-3,0,0,-17,11:3 - 11:5 - 11:8 - 0:0 - 0:0
14068007,2023-09-16 14:20:00,Antonyan Eduard - Nikoghosyan Narek,0:3,5:11 - 9:11 - 9:11 - 0:0 - 0:0,0,3,Antonyan Eduard,Nikoghosyan Narek,fiurst,Antonyan Eduard - Nikoghosyan Narek,56,23,33,10,-10,16,20,20,0,0,6,2,2,0,0,10,5:11 - 9:11 - 9:11 - 0:0 - 0:0
14068004,2023-09-16 14:00:00,Soghomonyan Hrayr - Rafayelyan Edgar,2:3,11:6 - 5:11 - 11:9 - 7:11 - 11:8,3,2,Soghomonyan Hrayr,Rafayelyan Edgar,fiurst,Rafayelyan Edgar - Soghomonyan Hrayr,90,45,45,0,0,17,16,20,18,19,5,-6,2,-4,3,0,6:11 - 11:5 - 9:11 - 11:7 - 8:11
14068003,2023-09-16 13:45:00,Papyan Karen - Nikoghosyan Narek,2:3,11:5 - 11:9 - 4:11 - 7:11 - 11:6,3,2,Papyan Karen,Nikoghosyan Narek,fiurst,Nikoghosyan Narek - Papyan Karen,86,42,44,2,-2,16,20,15,18,17,6,2,-7,-4,5,2,5:11 - 9:11 - 11:4 - 11:7 - 6:11
14067991,2023-09-16 13:30:00,Antonyan Eduard - Soghomonyan Hrayr,3:1,11:5 - 7:11 - 11:7 - 11:9 - 0:0,3,1,Antonyan Eduard,Soghomonyan Hrayr,fiurst,Antonyan Eduard - Soghomonyan Hrayr,72,40,32,-8,8,16,18,18,20,0,-6,4,-4,-2,0,-8,11:5 - 7:11 - 11:7 - 11:9 - 0:0
14067990,2023-09-16 13:15:00,Rafayelyan Edgar - Papyan Karen,0:3,11:7 - 11:3 - 11:3 - 0:0 - 0:0,3,0,Rafayelyan Edgar,Papyan Karen,fiurst,Papyan Karen - Rafayelyan Edgar,46,13,33,20,-20,18,14,14,0,0,4,8,8,0,0,20,7:11 - 3:11 - 3:11 - 0:0 - 0:0
14067988,2023-09-16 13:05:00,Rafayelyan Edgar - Antonyan Eduard,0:3,11:8 - 11:7 - 11:9 - 0:0 - 0:0,3,0,Rafayelyan Edgar,Antonyan Eduard,fiurst,Antonyan Eduard - Rafayelyan Edgar,57,24,33,9,-9,19,18,20,0,0,3,4,2,0,0,9,8:11 - 7:11 - 9:11 - 0:0 - 0:0
14067989,2023-09-16 13:00:00,Nikoghosyan Narek - Soghomonyan Hrayr,3:0,11:6 - 11:7 - 11:5 - 0:0 - 0:0,3,0,Nikoghosyan Narek,Soghomonyan Hrayr,fiurst,Nikoghosyan Narek - Soghomonyan Hrayr,51,33,18,-15,15,17,18,16,0,0,-5,-4,-6,0,0,-15,11:6 - 11:7 - 11:5 - 0:0 - 0:0
14067984,2023-09-16 12:45:00,Papyan Karen - Soghomonyan Hrayr,3:0,11:9 - 12:10 - 11:9 - 0:0 - 0:0,3,0,Papyan Karen,Soghomonyan Hrayr,fiurst,Papyan Karen - Soghomonyan Hrayr,62,34,28,-6,6,20,22,20,0,0,-2,-2,-2,0,0,-6,11:9 - 12:10 - 11:9 - 0:0 - 0:0
14067979,2023-09-16 12:00:00,Antonyan Eduard - Papyan Karen,2:3,11:7 - 11:7 - 14:16 - 9:11 - 8:11,2,3,Antonyan Eduard,Papyan Karen,fiurst,Antonyan Eduard - Papyan Karen,105,53,52,-1,1,18,18,30,20,19,-4,-4,2,2,3,-1,11:7 - 11:7 - 14:16 - 9:11 - 8:11
14067980,2023-09-16 12:00:00,Rafayelyan Edgar - Nikoghosyan Narek,3:2,15:17 - 5:11 - 11:5 - 12:10 - 4:11,2,3,Rafayelyan Edgar,Nikoghosyan Narek,fiurst,Nikoghosyan Narek - Rafayelyan Edgar,101,54,47,-7,7,32,16,16,22,15,-2,-6,6,2,-7,-7,17:15 - 11:5 - 5:11 - 10:12 - 11:4
14067976,2023-09-16 11:30:00,Rafayelyan Edgar - Soghomonyan Hrayr,3:1,8:11 - 11:8 - 16:14 - 11:3 - 0:0,3,1,Rafayelyan Edgar,Soghomonyan Hrayr,fiurst,Rafayelyan Edgar - Soghomonyan Hrayr,82,46,36,-10,10,19,19,30,14,0,3,-3,-2,-8,0,-10,8:11 - 11:8 - 16:14 - 11:3 - 0:0
14067965,2023-09-16 11:15:00,Nikoghosyan Narek - Antonyan Eduard,3:2,11:6 - 6:11 - 12:10 - 4:11 - 8:11,2,3,Nikoghosyan Narek,Antonyan Eduard,fiurst,Antonyan Eduard - Nikoghosyan Narek,90,49,41,-8,8,17,17,22,15,19,5,-5,2,-7,-3,-8,6:11 - 11:6 - 10:12 - 11:4 - 11:8
14067445,2023-09-16 11:00:00,Papyan Karen - Rafayelyan Edgar,3:1,11:9 - 3:11 - 11:6 - 11:9 - 0:0,3,1,Papyan Karen,Rafayelyan Edgar,fiurst,Papyan Karen - Rafayelyan Edgar,71,36,35,-1,1,20,14,17,20,0,-2,8,-5,-2,0,-1,11:9 - 3:11 - 11:6 - 11:9 - 0:0
14067436,2023-09-16 10:45:00,Soghomonyan Hrayr - Antonyan Eduard,3:1,13:11 - 4:11 - 9:11 - 6:11 - 0:0,1,3,Soghomonyan Hrayr,Antonyan Eduard,fiurst,Antonyan Eduard - Soghomonyan Hrayr,76,44,32,-12,12,24,15,20,17,0,2,-7,-2,-5,0,-12,11:13 - 11:4 - 11:9 - 11:6 - 0:0
14067433,2023-09-16 10:30:00,Nikoghosyan Narek - Papyan Karen,3:2,3:11 - 11:8 - 7:11 - 11:8 - 11:7,3,2,Nikoghosyan Narek,Papyan Karen,fiurst,Nikoghosyan Narek - Papyan Karen,88,43,45,2,-2,14,19,18,19,18,8,-3,4,-3,-4,2,3:11 - 11:8 - 7:11 - 11:8 - 11:7
14067421,2023-09-16 10:15:00,Antonyan Eduard - Rafayelyan Edgar,1:3,8:11 - 11:8 - 10:12 - 12:14 - 0:0,1,3,Antonyan Eduard,Rafayelyan Edgar,fiurst,Antonyan Eduard - Rafayelyan Edgar,86,41,45,4,-4,19,19,22,26,0,3,-3,2,2,0,4,8:11 - 11:8 - 10:12 - 12:14 - 0:0
14067410,2023-09-16 10:00:00,Soghomonyan Hrayr - Nikoghosyan Narek,3:0,5:11 - 6:11 - 6:11 - 0:0 - 0:0,0,3,Soghomonyan Hrayr,Nikoghosyan Narek,fiurst,Nikoghosyan Narek - Soghomonyan Hrayr,50,33,17,-16,16,16,17,17,0,0,-6,-5,-5,0,0,-16,11:5 - 11:6 - 11:6 - 0:0 - 0:0
14048794,2023-09-15 17:30:00,Grigoryan Erik - Mkrtchyan Andranik,0:3,9:11 - 8:11 - 12:14 - 0:0 - 0:0,0,3,Grigoryan Erik,Mkrtchyan Andranik,fiurst,Grigoryan Erik - Mkrtchyan Andranik,65,29,36,7,-7,20,19,26,0,0,2,3,2,0,0,7,9:11 - 8:11 - 12:14 - 0:0 - 0:0
14048776,2023-09-15 17:15:00,Darbinyan Armen - Petrosyan Davit,1:3,7:11 - 12:10 - 6:11 - 6:11 - 0:0,1,3,Darbinyan Armen,Petrosyan Davit,fiurst,Darbinyan Armen - Petrosyan Davit,74,31,43,12,-12,18,22,17,17,0,4,-2,5,5,0,12,7:11 - 12:10 - 6:11 - 6:11 - 0:0
14048771,2023-09-15 17:00:00,Gevorgyan Hayk - Grigoryan Erik,3:1,14:12 - 7:11 - 11:9 - 11:6 - 0:0,3,1,Gevorgyan Hayk,Grigoryan Erik,fiurst,Gevorgyan Hayk - Grigoryan Erik,81,43,38,-5,5,26,18,20,17,0,-2,4,-2,-5,0,-5,14:12 - 7:11 - 11:9 - 11:6 - 0:0
14048756,2023-09-15 16:45:00,Darbinyan Armen - Mkrtchyan Andranik,0:3,7:11 - 8:11 - 3:11 - 0:0 - 0:0,0,3,Darbinyan Armen,Mkrtchyan Andranik,fiurst,Darbinyan Armen - Mkrtchyan Andranik,51,18,33,15,-15,18,19,14,0,0,4,3,8,0,0,15,7:11 - 8:11 - 3:11 - 0:0 - 0:0
14048753,2023-09-15 16:30:00,Petrosyan Davit - Gevorgyan Hayk,1:3,11:9 - 5:11 - 11:7 - 11:7 - 0:0,3,1,Petrosyan Davit,Gevorgyan Hayk,fiurst,Gevorgyan Hayk - Petrosyan Davit,72,34,38,4,-4,20,16,18,18,0,2,-6,4,4,0,4,9:11 - 11:5 - 7:11 - 7:11 - 0:0
14048751,2023-09-15 16:20:00,Grigoryan Erik - Darbinyan Armen,0:3,11:5 - 11:4 - 11:4 - 0:0 - 0:0,3,0,Grigoryan Erik,Darbinyan Armen,fiurst,Darbinyan Armen - Grigoryan Erik,46,13,33,20,-20,16,15,15,0,0,6,7,7,0,0,20,5:11 - 4:11 - 4:11 - 0:0 - 0:0
14048738,2023-09-15 16:00:00,Mkrtchyan Andranik - Gevorgyan Hayk,2:3,9:11 - 11:9 - 9:11 - 11:6 - 11:7,3,2,Mkrtchyan Andranik,Gevorgyan Hayk,fiurst,Gevorgyan Hayk - Mkrtchyan Andranik,95,44,51,7,-7,20,20,20,17,18,-2,2,-2,5,4,7,11:9 - 9:11 - 11:9 - 6:11 - 7:11
14048734,2023-09-15 15:45:00,Petrosyan Davit - Grigoryan Erik,3:2,11:7 - 8:11 - 8:11 - 11:6 - 8:11,2,3,Petrosyan Davit,Grigoryan Erik,fiurst,Grigoryan Erik - Petrosyan Davit,92,46,46,0,0,18,19,19,17,19,4,-3,-3,5,-3,0,7:11 - 11:8 - 11:8 - 6:11 - 11:8
14048729,2023-09-15 15:30:00,Gevorgyan Hayk - Darbinyan Armen,1:3,4:11 - 12:10 - 11:8 - 13:11 - 0:0,3,1,Gevorgyan Hayk,Darbinyan Armen,fiurst,Darbinyan Armen - Gevorgyan Hayk,80,40,40,0,0,15,22,19,24,0,-7,2,3,2,0,0,11:4 - 10:12 - 8:11 - 11:13 - 0:0
14048725,2023-09-15 15:15:00,Mkrtchyan Andranik - Petrosyan Davit,3:2,8:11 - 11:5 - 8:11 - 11:6 - 11:9,3,2,Mkrtchyan Andranik,Petrosyan Davit,fiurst,Mkrtchyan Andranik - Petrosyan Davit,91,49,42,-7,7,19,16,19,17,20,3,-6,3,-5,-2,-7,8:11 - 11:5 - 8:11 - 11:6 - 11:9
14048714,2023-09-15 15:00:00,Diaryan Aleksandr - Nikoghosyan Narek,2:3,3:11 - 11:6 - 11:4 - 6:11 - 9:11,2,3,Diaryan Aleksandr,Nikoghosyan Narek,fiurst,Diaryan Aleksandr - Nikoghosyan Narek,83,40,43,3,-3,14,17,15,17,20,8,-5,-7,5,2,3,3:11 - 11:6 - 11:4 - 6:11 - 9:11
14048708,2023-09-15 14:50:00,Papyan Karen - Soghomonyan Hrayr,3:0,14:12 - 11:5 - 11:6 - 0:0 - 0:0,3,0,Papyan Karen,Soghomonyan Hrayr,fiurst,Papyan Karen - Soghomonyan Hrayr,59,36,23,-13,13,26,16,17,0,0,-2,-6,-5,0,0,-13,14:12 - 11:5 - 11:6 - 0:0 - 0:0
14048698,2023-09-15 14:30:00,Nazaryan Mushegh - Diaryan Aleksandr,3:1,5:11 - 7:11 - 11:7 - 4:11 - 0:0,1,3,Nazaryan Mushegh,Diaryan Aleksandr,fiurst,Diaryan Aleksandr - Nazaryan Mushegh,67,40,27,-13,13,16,18,18,15,0,-6,-4,4,-7,0,-13,11:5 - 11:7 - 7:11 - 11:4 - 0:0
14048697,2023-09-15 14:15:00,Nikoghosyan Narek - Papyan Karen,2:3,11:6 - 11:3 - 13:15 - 8:11 - 9:11,2,3,Nikoghosyan Narek,Papyan Karen,fiurst,Nikoghosyan Narek - Papyan Karen,98,52,46,-6,6,17,14,28,19,20,-5,-8,2,3,2,-6,11:6 - 11:3 - 13:15 - 8:11 - 9:11
14048695,2023-09-15 14:00:00,Nazaryan Mushegh - Soghomonyan Hrayr,3:0,11:7 - 11:9 - 11:8 - 0:0 - 0:0,3,0,Nazaryan Mushegh,Soghomonyan Hrayr,fiurst,Nazaryan Mushegh - Soghomonyan Hrayr,57,33,24,-9,9,18,20,19,0,0,-4,-2,-3,0,0,-9,11:7 - 11:9 - 11:8 - 0:0 - 0:0
14048683,2023-09-15 13:50:00,Diaryan Aleksandr - Papyan Karen,1:3,11:13 - 11:6 - 9:11 - 5:11 - 0:0,1,3,Diaryan Aleksandr,Papyan Karen,fiurst,Diaryan Aleksandr - Papyan Karen,77,36,41,5,-5,24,17,20,16,0,2,-5,2,6,0,5,11:13 - 11:6 - 9:11 - 5:11 - 0:0
14048676,2023-09-15 13:30:00,Nikoghosyan Narek - Nazaryan Mushegh,1:3,11:4 - 11:6 - 6:11 - 11:6 - 0:0,3,1,Nikoghosyan Narek,Nazaryan Mushegh,fiurst,Nazaryan Mushegh - Nikoghosyan Narek,66,27,39,12,-12,15,17,17,17,0,7,5,-5,5,0,12,4:11 - 6:11 - 11:6 - 6:11 - 0:0
14048672,2023-09-15 13:25:00,Soghomonyan Hrayr - Diaryan Aleksandr,3:0,4:11 - 11:13 - 4:11 - 0:0 - 0:0,0,3,Soghomonyan Hrayr,Diaryan Aleksandr,fiurst,Diaryan Aleksandr - Soghomonyan Hrayr,54,35,19,-16,16,15,24,15,0,0,-7,-2,-7,0,0,-16,11:4 - 13:11 - 11:4 - 0:0 - 0:0
14048662,2023-09-15 13:00:00,Papyan Karen - Nazaryan Mushegh,0:3,12:10 - 11:5 - 12:10 - 0:0 - 0:0,3,0,Papyan Karen,Nazaryan Mushegh,fiurst,Nazaryan Mushegh - Papyan Karen,60,25,35,10,-10,22,16,22,0,0,2,6,2,0,0,10,10:12 - 5:11 - 10:12 - 0:0 - 0:0
14048658,2023-09-15 12:45:00,Soghomonyan Hrayr - Nikoghosyan Narek,3:2,12:10 - 4:11 - 11:7 - 1:11 - 11:13,2,3,Soghomonyan Hrayr,Nikoghosyan Narek,fiurst,Nikoghosyan Narek - Soghomonyan Hrayr,91,52,39,-13,13,22,15,18,12,24,2,-7,4,-10,-2,-13,10:12 - 11:4 - 7:11 - 11:1 - 13:11
14048177,2023-09-15 12:15:00,Diaryan Aleksandr - Nazaryan Mushegh,3:1,11:5 - 10:12 - 11:9 - 11:5 - 0:0,3,1,Diaryan Aleksandr,Nazaryan Mushegh,fiurst,Diaryan Aleksandr - Nazaryan Mushegh,74,43,31,-12,12,16,22,20,16,0,-6,2,-2,-6,0,-12,11:5 - 10:12 - 11:9 - 11:5 - 0:0
14048153,2023-09-15 12:05:00,Soghomonyan Hrayr - Papyan Karen,3:0,10:12 - 8:11 - 5:11 - 0:0 - 0:0,0,3,Soghomonyan Hrayr,Papyan Karen,fiurst,Papyan Karen - Soghomonyan Hrayr,57,34,23,-11,11,22,19,16,0,0,-2,-3,-6,0,0,-11,12:10 - 11:8 - 11:5 - 0:0 - 0:0
14048150,2023-09-15 11:45:00,Nikoghosyan Narek - Diaryan Aleksandr,3:1,4:11 - 11:9 - 10:12 - 3:11 - 0:0,1,3,Nikoghosyan Narek,Diaryan Aleksandr,fiurst,Diaryan Aleksandr - Nikoghosyan Narek,71,43,28,-15,15,15,20,22,14,0,-7,2,-2,-8,0,-15,11:4 - 9:11 - 12:10 - 11:3 - 0:0
14048112,2023-09-15 11:30:00,Soghomonyan Hrayr - Nazaryan Mushegh,2:3,11:13 - 5:11 - 12:10 - 11:8 - 11:5,3,2,Soghomonyan Hrayr,Nazaryan Mushegh,fiurst,Nazaryan Mushegh - Soghomonyan Hrayr,97,47,50,3,-3,24,16,22,19,16,-2,-6,2,3,6,3,13:11 - 11:5 - 10:12 - 8:11 - 5:11
14048106,2023-09-15 11:20:00,Papyan Karen - Nikoghosyan Narek,3:0,8:11 - 5:11 - 4:11 - 0:0 - 0:0,0,3,Papyan Karen,Nikoghosyan Narek,fiurst,Nikoghosyan Narek - Papyan Karen,50,33,17,-16,16,19,16,15,0,0,-3,-6,-7,0,0,-16,11:8 - 11:5 - 11:4 - 0:0 - 0:0
14048081,2023-09-15 11:00:00,Diaryan Aleksandr - Soghomonyan Hrayr,3:0,11:4 - 11:6 - 11:1 - 0:0 - 0:0,3,0,Diaryan Aleksandr,Soghomonyan Hrayr,fiurst,Diaryan Aleksandr - Soghomonyan Hrayr,44,33,11,-22,22,15,17,12,0,0,-7,-5,-10,0,0,-22,11:4 - 11:6 - 11:1 - 0:0 - 0:0
14048060,2023-09-15 10:50:00,Nazaryan Mushegh - Nikoghosyan Narek,0:3,5:11 - 4:11 - 12:14 - 0:0 - 0:0,0,3,Nazaryan Mushegh,Nikoghosyan Narek,fiurst,Nazaryan Mushegh - Nikoghosyan Narek,57,21,36,15,-15,16,15,26,0,0,6,7,2,0,0,15,5:11 - 4:11 - 12:14 - 0:0 - 0:0
14048048,2023-09-15 10:30:00,Papyan Karen - Diaryan Aleksandr,3:0,6:11 - 8:11 - 10:12 - 0:0 - 0:0,0,3,Papyan Karen,Diaryan Aleksandr,fiurst,Diaryan Aleksandr - Papyan Karen,58,34,24,-10,10,17,19,22,0,0,-5,-3,-2,0,0,-10,11:6 - 11:8 - 12:10 - 0:0 - 0:0
14048040,2023-09-15 10:15:00,Nikoghosyan Narek - Soghomonyan Hrayr,3:2,11:5 - 7:11 - 7:11 - 11:8 - 11:9,3,2,Nikoghosyan Narek,Soghomonyan Hrayr,fiurst,Nikoghosyan Narek - Soghomonyan Hrayr,91,47,44,-3,3,16,18,18,19,20,-6,4,4,-3,-2,-3,11:5 - 7:11 - 7:11 - 11:8 - 11:9
14048039,2023-09-15 10:00:00,Nazaryan Mushegh - Papyan Karen,3:1,11:9 - 2:11 - 11:8 - 11:9 - 0:0,3,1,Nazaryan Mushegh,Papyan Karen,fiurst,Nazaryan Mushegh - Papyan Karen,72,35,37,2,-2,20,13,19,20,0,-2,9,-3,-2,0,2,11:9 - 2:11 - 11:8 - 11:9 - 0:0
14029575,2023-09-14 17:30:00,Darbinyan Armen - Petrosyan Davit,3:0,11:7 - 12:10 - 11:9 - 0:0 - 0:0,3,0,Darbinyan Armen,Petrosyan Davit,fiurst,Darbinyan Armen - Petrosyan Davit,60,34,26,-8,8,18,22,20,0,0,-4,-2,-2,0,0,-8,11:7 - 12:10 - 11:9 - 0:0 - 0:0
14029516,2023-09-14 17:15:00,Gevorgyan Hayk - Avakimyan Davit,0:3,11:7 - 11:7 - 11:4 - 0:0 - 0:0,3,0,Gevorgyan Hayk,Avakimyan Davit,fiurst,Avakimyan Davit - Gevorgyan Hayk,51,18,33,15,-15,18,18,15,0,0,4,4,7,0,0,15,7:11 - 7:11 - 4:11 - 0:0 - 0:0
14029504,2023-09-14 17:00:00,Mkrtchyan Andranik - Darbinyan Armen,0:3,11:7 - 11:8 - 13:11 - 0:0 - 0:0,3,0,Mkrtchyan Andranik,Darbinyan Armen,fiurst,Darbinyan Armen - Mkrtchyan Andranik,61,26,35,9,-9,18,19,24,0,0,4,3,2,0,0,9,7:11 - 8:11 - 11:13 - 0:0 - 0:0
14029502,2023-09-14 16:45:00,Gevorgyan Hayk - Petrosyan Davit,3:2,11:8 - 11:13 - 12:14 - 11:7 - 12:10,3,2,Gevorgyan Hayk,Petrosyan Davit,fiurst,Gevorgyan Hayk - Petrosyan Davit,109,57,52,-5,5,19,24,26,18,22,-3,2,2,-4,-2,-5,11:8 - 11:13 - 12:14 - 11:7 - 12:10
14029499,2023-09-14 16:30:00,Avakimyan Davit - Mkrtchyan Andranik,2:3,11:8 - 12:10 - 6:11 - 6:11 - 11:13,2,3,Avakimyan Davit,Mkrtchyan Andranik,fiurst,Avakimyan Davit - Mkrtchyan Andranik,99,46,53,7,-7,19,22,17,17,24,-3,-2,5,5,2,7,11:8 - 12:10 - 6:11 - 6:11 - 11:13
14029496,2023-09-14 16:15:00,Darbinyan Armen - Gevorgyan Hayk,1:3,4:11 - 11:7 - 11:13 - 11:13 - 0:0,1,3,Darbinyan Armen,Gevorgyan Hayk,fiurst,Darbinyan Armen - Gevorgyan Hayk,81,37,44,7,-7,15,18,24,24,0,7,-4,2,2,0,7,4:11 - 11:7 - 11:13 - 11:13 - 0:0
14029493,2023-09-14 16:00:00,Petrosyan Davit - Mkrtchyan Andranik,3:0,7:11 - 2:11 - 2:11 - 0:0 - 0:0,0,3,Petrosyan Davit,Mkrtchyan Andranik,fiurst,Mkrtchyan Andranik - Petrosyan Davit,44,33,11,-22,22,18,13,13,0,0,-4,-9,-9,0,0,-22,11:7 - 11:2 - 11:2 - 0:0 - 0:0
14029474,2023-09-14 15:45:00,Avakimyan Davit - Darbinyan Armen,3:0,11:4 - 11:6 - 11:6 - 0:0 - 0:0,3,0,Avakimyan Davit,Darbinyan Armen,fiurst,Avakimyan Davit - Darbinyan Armen,49,33,16,-17,17,15,17,17,0,0,-7,-5,-5,0,0,-17,11:4 - 11:6 - 11:6 - 0:0 - 0:0
14029468,2023-09-14 15:40:00,Mkrtchyan Andranik - Gevorgyan Hayk,2:3,5:11 - 11:4 - 12:10 - 7:11 - 11:4,3,2,Mkrtchyan Andranik,Gevorgyan Hayk,fiurst,Gevorgyan Hayk - Mkrtchyan Andranik,86,40,46,6,-6,16,15,22,18,15,-6,7,2,-4,7,6,11:5 - 4:11 - 10:12 - 11:7 - 4:11
14029395,2023-09-14 15:15:00,Soghomonyan Hrayr - Rafayelyan Edgar,3:1,9:11 - 12:14 - 11:4 - 8:11 - 0:0,1,3,Soghomonyan Hrayr,Rafayelyan Edgar,fiurst,Rafayelyan Edgar - Soghomonyan Hrayr,80,40,40,0,0,20,26,15,19,0,-2,-2,7,-3,0,0,11:9 - 14:12 - 4:11 - 11:8 - 0:0
14029441,2023-09-14 15:15:00,Petrosyan Davit - Avakimyan Davit,3:1,11:4 - 7:11 - 6:11 - 7:11 - 0:0,1,3,Petrosyan Davit,Avakimyan Davit,fiurst,Avakimyan Davit - Petrosyan Davit,68,37,31,-6,6,15,18,17,18,0,7,-4,-5,-4,0,-6,4:11 - 11:7 - 11:6 - 11:7 - 0:0
14029389,2023-09-14 14:45:00,Nazaryan Mushegh - Antonyan Eduard,3:1,8:11 - 12:10 - 6:11 - 9:11 - 0:0,1,3,Nazaryan Mushegh,Antonyan Eduard,fiurst,Antonyan Eduard - Nazaryan Mushegh,78,43,35,-8,8,19,22,17,20,0,-3,2,-5,-2,0,-8,11:8 - 10:12 - 11:6 - 11:9 - 0:0
14029339,2023-09-14 14:40:00,Diaryan Aleksandr - Soghomonyan Hrayr,3:1,7:11 - 11:4 - 11:6 - 12:10 - 0:0,3,1,Diaryan Aleksandr,Soghomonyan Hrayr,fiurst,Diaryan Aleksandr - Soghomonyan Hrayr,72,41,31,-10,10,18,15,17,22,0,4,-7,-5,-2,0,-10,7:11 - 11:4 - 11:6 - 12:10 - 0:0
14029305,2023-09-14 14:30:00,Rafayelyan Edgar - Nazaryan Mushegh,2:0,4:11 - 5:11 - 6:11 - 0:0 - 0:0,0,2,Rafayelyan Edgar,Nazaryan Mushegh,fiurst,Nazaryan Mushegh - Rafayelyan Edgar,48,33,15,-18,18,15,16,17,0,0,-7,-6,-5,0,0,-18,11:4 - 11:5 - 11:6 - 0:0 - 0:0
14029219,2023-09-14 14:10:00,Diaryan Aleksandr - Antonyan Eduard,3:1,6:11 - 9:11 - 11:9 - 9:11 - 0:0,1,3,Diaryan Aleksandr,Antonyan Eduard,fiurst,Antonyan Eduard - Diaryan Aleksandr,77,42,35,-7,7,17,20,20,20,0,-5,-2,2,-2,0,-7,11:6 - 11:9 - 9:11 - 11:9 - 0:0
14029218,2023-09-14 14:05:00,Soghomonyan Hrayr - Nazaryan Mushegh,1:3,11:8 - 10:12 - 11:9 - 11:4 - 0:0,3,1,Soghomonyan Hrayr,Nazaryan Mushegh,fiurst,Nazaryan Mushegh - Soghomonyan Hrayr,76,33,43,10,-10,19,22,20,15,0,3,-2,2,7,0,10,8:11 - 12:10 - 9:11 - 4:11 - 0:0
14029213,2023-09-14 13:30:00,Rafayelyan Edgar - Diaryan Aleksandr,3:1,6:11 - 7:11 - 13:11 - 6:11 - 0:0,1,3,Rafayelyan Edgar,Diaryan Aleksandr,fiurst,Diaryan Aleksandr - Rafayelyan Edgar,76,44,32,-12,12,17,18,24,17,0,-5,-4,2,-5,0,-12,11:6 - 11:7 - 11:13 - 11:6 - 0:0
14029208,2023-09-14 13:15:00,Antonyan Eduard - Soghomonyan Hrayr,3:2,11:8 - 10:12 - 11:4 - 10:12 - 15:13,3,2,Antonyan Eduard,Soghomonyan Hrayr,fiurst,Antonyan Eduard - Soghomonyan Hrayr,106,57,49,-8,8,19,22,15,22,28,-3,2,-7,2,-2,-8,11:8 - 10:12 - 11:4 - 10:12 - 15:13
14029195,2023-09-14 13:00:00,Nazaryan Mushegh - Diaryan Aleksandr,3:2,4:11 - 11:6 - 17:15 - 8:11 - 5:11,2,3,Nazaryan Mushegh,Diaryan Aleksandr,fiurst,Diaryan Aleksandr - Nazaryan Mushegh,99,54,45,-9,9,15,17,32,19,16,-7,5,2,-3,-6,-9,11:4 - 6:11 - 15:17 - 11:8 - 11:5
14029193,2023-09-14 12:45:00,Antonyan Eduard - Rafayelyan Edgar,2:3,5:11 - 8:11 - 11:9 - 12:10 - 7:11,2,3,Antonyan Eduard,Rafayelyan Edgar,fiurst,Antonyan Eduard - Rafayelyan Edgar,95,43,52,9,-9,16,19,20,22,18,6,3,-2,-2,4,9,5:11 - 8:11 - 11:9 - 12:10 - 7:11
14029187,2023-09-14 12:15:00,Soghomonyan Hrayr - Diaryan Aleksandr,3:1,11:8 - 8:11 - 6:11 - 4:11 - 0:0,1,3,Soghomonyan Hrayr,Diaryan Aleksandr,fiurst,Diaryan Aleksandr - Soghomonyan Hrayr,70,41,29,-12,12,19,19,17,15,0,3,-3,-5,-7,0,-12,8:11 - 11:8 - 11:6 - 11:4 - 0:0
14029186,2023-09-14 12:05:00,Antonyan Eduard - Nazaryan Mushegh,3:1,5:11 - 11:6 - 11:7 - 11:8 - 0:0,3,1,Antonyan Eduard,Nazaryan Mushegh,fiurst,Antonyan Eduard - Nazaryan Mushegh,70,38,32,-6,6,16,17,18,19,0,6,-5,-4,-3,0,-6,5:11 - 11:6 - 11:7 - 11:8 - 0:0
14029184,2023-09-14 12:00:00,Rafayelyan Edgar - Soghomonyan Hrayr,3:0,11:7 - 11:8 - 11:4 - 0:0 - 0:0,3,0,Rafayelyan Edgar,Soghomonyan Hrayr,fiurst,Rafayelyan Edgar - Soghomonyan Hrayr,52,33,19,-14,14,18,19,15,0,0,-4,-3,-7,0,0,-14,11:7 - 11:8 - 11:4 - 0:0 - 0:0
14029173,2023-09-14 11:35:00,Antonyan Eduard - Diaryan Aleksandr,3:1,11:9 - 12:10 - 10:12 - 11:7 - 0:0,3,1,Antonyan Eduard,Diaryan Aleksandr,fiurst,Antonyan Eduard - Diaryan Aleksandr,82,44,38,-6,6,20,22,22,18,0,-2,-2,2,-4,0,-6,11:9 - 12:10 - 10:12 - 11:7 - 0:0
14029171,2023-09-14 11:30:00,Nazaryan Mushegh - Rafayelyan Edgar,1:3,11:6 - 7:11 - 12:14 - 9:11 - 0:0,1,3,Nazaryan Mushegh,Rafayelyan Edgar,fiurst,Nazaryan Mushegh - Rafayelyan Edgar,81,39,42,3,-3,17,18,26,20,0,-5,4,2,2,0,3,11:6 - 7:11 - 12:14 - 9:11 - 0:0
14029168,2023-09-14 11:00:00,Soghomonyan Hrayr - Antonyan Eduard,3:0,9:11 - 3:11 - 9:11 - 0:0 - 0:0,0,3,Soghomonyan Hrayr,Antonyan Eduard,fiurst,Antonyan Eduard - Soghomonyan Hrayr,54,33,21,-12,12,20,14,20,0,0,-2,-8,-2,0,0,-12,11:9 - 11:3 - 11:9 - 0:0 - 0:0
14029165,2023-09-14 10:55:00,Diaryan Aleksandr - Rafayelyan Edgar,3:2,4:11 - 11:7 - 9:11 - 11:8 - 11:4,3,2,Diaryan Aleksandr,Rafayelyan Edgar,fiurst,Diaryan Aleksandr - Rafayelyan Edgar,87,46,41,-5,5,15,18,20,19,15,7,-4,2,-3,-7,-5,4:11 - 11:7 - 9:11 - 11:8 - 11:4
14029163,2023-09-14 10:30:00,Nazaryan Mushegh - Soghomonyan Hrayr,3:1,11:6 - 11:7 - 7:11 - 11:6 - 0:0,3,1,Nazaryan Mushegh,Soghomonyan Hrayr,fiurst,Nazaryan Mushegh - Soghomonyan Hrayr,70,40,30,-10,10,17,18,18,17,0,-5,-4,4,-5,0,-10,11:6 - 11:7 - 7:11 - 11:6 - 0:0
14029159,2023-09-14 10:15:00,Rafayelyan Edgar - Antonyan Eduard,3:2,11:8 - 2:11 - 9:11 - 11:9 - 9:11,2,3,Rafayelyan Edgar,Antonyan Eduard,fiurst,Antonyan Eduard - Rafayelyan Edgar,92,50,42,-8,8,19,13,20,20,20,3,-9,-2,2,-2,-8,8:11 - 11:2 - 11:9 - 9:11 - 11:9
14029158,2023-09-14 10:00:00,Diaryan Aleksandr - Nazaryan Mushegh,3:1,9:11 - 11:5 - 11:3 - 11:6 - 0:0,3,1,Diaryan Aleksandr,Nazaryan Mushegh,fiurst,Diaryan Aleksandr - Nazaryan Mushegh,67,42,25,-17,17,20,16,14,17,0,2,-6,-8,-5,0,-17,9:11 - 11:5 - 11:3 - 11:6 - 0:0
14011391,2023-09-13 17:50:00,Petrosyan Davit - Gevorgyan Hayk,2:3,11:3 - 5:11 - 11:6 - 11:13 - 11:9,3,2,Petrosyan Davit,Gevorgyan Hayk,fiurst,Gevorgyan Hayk - Petrosyan Davit,91,42,49,7,-7,14,16,17,24,20,8,-6,5,-2,2,7,3:11 - 11:5 - 6:11 - 13:11 - 9:11
14011381,2023-09-13 17:30:00,Mkrtchyan Andranik - Petrosyan Davit,3:1,11:9 - 11:5 - 8:11 - 11:8 - 0:0,3,1,Mkrtchyan Andranik,Petrosyan Davit,fiurst,Mkrtchyan Andranik - Petrosyan Davit,74,41,33,-8,8,20,16,19,19,0,-2,-6,3,-3,0,-8,11:9 - 11:5 - 8:11 - 11:8 - 0:0
14011387,2023-09-13 17:25:00,Grigoryan Erik - Darbinyan Armen,0:3,11:4 - 11:7 - 11:3 - 0:0 - 0:0,3,0,Grigoryan Erik,Darbinyan Armen,fiurst,Darbinyan Armen - Grigoryan Erik,47,14,33,19,-19,15,18,14,0,0,7,4,8,0,0,19,4:11 - 7:11 - 3:11 - 0:0 - 0:0
14011379,2023-09-13 17:10:00,Grigoryan Erik - Gevorgyan Hayk,3:1,8:11 - 9:11 - 11:6 - 5:11 - 0:0,1,3,Grigoryan Erik,Gevorgyan Hayk,fiurst,Gevorgyan Hayk - Grigoryan Erik,72,39,33,-6,6,19,20,17,16,0,-3,-2,5,-6,0,-6,11:8 - 11:9 - 6:11 - 11:5 - 0:0
14011376,2023-09-13 17:00:00,Darbinyan Armen - Mkrtchyan Andranik,2:3,11:8 - 2:11 - 4:11 - 11:9 - 8:11,2,3,Darbinyan Armen,Mkrtchyan Andranik,fiurst,Darbinyan Armen - Mkrtchyan Andranik,86,36,50,14,-14,19,13,15,20,19,-3,9,7,-2,3,14,11:8 - 2:11 - 4:11 - 11:9 - 8:11
14011373,2023-09-13 16:30:00,Gevorgyan Hayk - Mkrtchyan Andranik,2:3,9:11 - 8:11 - 11:7 - 11:8 - 9:11,2,3,Gevorgyan Hayk,Mkrtchyan Andranik,fiurst,Gevorgyan Hayk - Mkrtchyan Andranik,96,48,48,0,0,20,19,18,19,20,2,3,-4,-3,2,0,9:11 - 8:11 - 11:7 - 11:8 - 9:11
14011375,2023-09-13 16:30:00,Petrosyan Davit - Grigoryan Erik,2:3,7:11 - 11:4 - 11:6 - 10:12 - 12:10,3,2,Petrosyan Davit,Grigoryan Erik,fiurst,Grigoryan Erik - Petrosyan Davit,94,43,51,8,-8,18,15,17,22,22,-4,7,5,-2,2,8,11:7 - 4:11 - 6:11 - 12:10 - 10:12
14011369,2023-09-13 16:05:00,Darbinyan Armen - Petrosyan Davit,0:3,7:11 - 8:11 - 5:11 - 0:0 - 0:0,0,3,Darbinyan Armen,Petrosyan Davit,fiurst,Darbinyan Armen - Petrosyan Davit,53,20,33,13,-13,18,19,16,0,0,4,3,6,0,0,13,7:11 - 8:11 - 5:11 - 0:0 - 0:0
14011333,2023-09-13 15:50:00,Gevorgyan Hayk - Darbinyan Armen,0:3,11:4 - 11:7 - 14:12 - 0:0 - 0:0,3,0,Gevorgyan Hayk,Darbinyan Armen,fiurst,Darbinyan Armen - Gevorgyan Hayk,59,23,36,13,-13,15,18,26,0,0,7,4,2,0,0,13,4:11 - 7:11 - 12:14 - 0:0 - 0:0
14011355,2023-09-13 15:50:00,Mkrtchyan Andranik - Grigoryan Erik,2:3,5:11 - 15:13 - 8:11 - 13:11 - 14:12,3,2,Mkrtchyan Andranik,Grigoryan Erik,fiurst,Grigoryan Erik - Mkrtchyan Andranik,113,58,55,-3,3,16,28,19,24,26,-6,2,-3,2,2,-3,11:5 - 13:15 - 11:8 - 11:13 - 12:14
14014608,2023-09-13 15:30:00,Nikoghosyan Narek - Papyan Karen,0:3,6:11 - 12:14 - 6:11 - 0:0 - 0:0,0,3,Nikoghosyan Narek,Papyan Karen,fiurst,Nikoghosyan Narek - Papyan Karen,60,24,36,12,-12,17,26,17,0,0,5,2,5,0,0,12,6:11 - 12:14 - 6:11 - 0:0 - 0:0
14011331,2023-09-13 15:20:00,Rafayelyan Edgar - Diaryan Aleksandr,3:1,15:13 - 8:11 - 3:11 - 15:17 - 0:0,1,3,Rafayelyan Edgar,Diaryan Aleksandr,fiurst,Diaryan Aleksandr - Rafayelyan Edgar,93,52,41,-11,11,28,19,14,32,0,2,-3,-8,-2,0,-11,13:15 - 11:8 - 11:3 - 17:15 - 0:0
14011325,2023-09-13 14:50:00,Antonyan Eduard - Nikoghosyan Narek,3:2,11:6 - 7:11 - 8:11 - 11:5 - 11:7,3,2,Antonyan Eduard,Nikoghosyan Narek,fiurst,Antonyan Eduard - Nikoghosyan Narek,88,48,40,-8,8,17,18,19,16,18,-5,4,3,-6,-4,-8,11:6 - 7:11 - 8:11 - 11:5 - 11:7
14011320,2023-09-13 14:45:00,Papyan Karen - Rafayelyan Edgar,3:2,11:9 - 8:11 - 9:11 - 11:9 - 11:5,3,2,Papyan Karen,Rafayelyan Edgar,fiurst,Papyan Karen - Rafayelyan Edgar,95,50,45,-5,5,20,19,20,20,16,-2,3,2,-2,-6,-5,11:9 - 8:11 - 9:11 - 11:9 - 11:5
14011318,2023-09-13 14:10:00,Nikoghosyan Narek - Rafayelyan Edgar,2:3,5:11 - 11:8 - 11:9 - 6:11 - 7:11,2,3,Nikoghosyan Narek,Rafayelyan Edgar,fiurst,Nikoghosyan Narek - Rafayelyan Edgar,90,40,50,10,-10,16,19,20,17,18,6,-3,-2,5,4,10,5:11 - 11:8 - 11:9 - 6:11 - 7:11
14011319,2023-09-13 14:10:00,Antonyan Eduard - Diaryan Aleksandr,3:2,12:10 - 11:7 - 7:11 - 8:11 - 12:10,3,2,Antonyan Eduard,Diaryan Aleksandr,fiurst,Antonyan Eduard - Diaryan Aleksandr,99,50,49,-1,1,22,18,18,19,22,-2,-4,4,3,-2,-1,12:10 - 11:7 - 7:11 - 8:11 - 12:10
14011305,2023-09-13 13:35:00,Papyan Karen - Antonyan Eduard,1:3,11:5 - 8:11 - 11:5 - 13:11 - 0:0,3,1,Papyan Karen,Antonyan Eduard,fiurst,Antonyan Eduard - Papyan Karen,75,32,43,11,-11,16,19,16,24,0,6,-3,6,2,0,11,5:11 - 11:8 - 5:11 - 11:13 - 0:0
14011302,2023-09-13 13:25:00,Diaryan Aleksandr - Nikoghosyan Narek,3:2,11:8 - 7:11 - 11:3 - 8:11 - 11:6,3,2,Diaryan Aleksandr,Nikoghosyan Narek,fiurst,Diaryan Aleksandr - Nikoghosyan Narek,87,48,39,-9,9,19,18,14,19,17,-3,4,-8,3,-5,-9,11:8 - 7:11 - 11:3 - 8:11 - 11:6
14011298,2023-09-13 13:10:00,Rafayelyan Edgar - Antonyan Eduard,3:0,9:11 - 7:11 - 4:11 - 0:0 - 0:0,0,3,Rafayelyan Edgar,Antonyan Eduard,fiurst,Antonyan Eduard - Rafayelyan Edgar,53,33,20,-13,13,20,18,15,0,0,-2,-4,-7,0,0,-13,11:9 - 11:7 - 11:4 - 0:0 - 0:0
14011295,2023-09-13 12:50:00,Diaryan Aleksandr - Papyan Karen,3:1,10:12 - 12:10 - 11:4 - 11:9 - 0:0,3,1,Diaryan Aleksandr,Papyan Karen,fiurst,Diaryan Aleksandr - Papyan Karen,79,44,35,-9,9,22,22,15,20,0,2,-2,-7,-2,0,-9,10:12 - 12:10 - 11:4 - 11:9 - 0:0
14011284,2023-09-13 12:20:00,Nikoghosyan Narek - Antonyan Eduard,1:3,11:7 - 16:14 - 7:11 - 11:8 - 0:0,3,1,Nikoghosyan Narek,Antonyan Eduard,fiurst,Antonyan Eduard - Nikoghosyan Narek,85,40,45,5,-5,18,30,18,19,0,4,2,-4,3,0,5,7:11 - 14:16 - 11:7 - 8:11 - 0:0
14011283,2023-09-13 12:10:00,Diaryan Aleksandr - Rafayelyan Edgar,3:0,13:11 - 11:3 - 12:10 - 0:0 - 0:0,3,0,Diaryan Aleksandr,Rafayelyan Edgar,fiurst,Diaryan Aleksandr - Rafayelyan Edgar,60,36,24,-12,12,24,14,22,0,0,-2,-8,-2,0,0,-12,13:11 - 11:3 - 12:10 - 0:0 - 0:0
14011278,2023-09-13 11:45:00,Papyan Karen - Nikoghosyan Narek,1:3,11:5 - 11:8 - 6:11 - 11:9 - 0:0,3,1,Papyan Karen,Nikoghosyan Narek,fiurst,Nikoghosyan Narek - Papyan Karen,72,33,39,6,-6,16,19,17,20,0,6,3,-5,2,0,6,5:11 - 8:11 - 11:6 - 9:11 - 0:0
14011277,2023-09-13 11:35:00,Diaryan Aleksandr - Antonyan Eduard,2:3,12:10 - 8:11 - 10:12 - 11:8 - 11:7,3,2,Diaryan Aleksandr,Antonyan Eduard,fiurst,Antonyan Eduard - Diaryan Aleksandr,100,48,52,4,-4,22,19,22,19,18,2,-3,-2,3,4,4,10:12 - 11:8 - 12:10 - 8:11 - 7:11
14011276,2023-09-13 11:20:00,Rafayelyan Edgar - Papyan Karen,3:1,7:11 - 11:8 - 8:11 - 9:11 - 0:0,1,3,Rafayelyan Edgar,Papyan Karen,fiurst,Papyan Karen - Rafayelyan Edgar,76,41,35,-6,6,18,19,19,20,0,-4,3,-3,-2,0,-6,11:7 - 8:11 - 11:8 - 11:9 - 0:0
14011275,2023-09-13 11:15:00,Nikoghosyan Narek - Diaryan Aleksandr,0:3,11:7 - 11:3 - 12:10 - 0:0 - 0:0,3,0,Nikoghosyan Narek,Diaryan Aleksandr,fiurst,Diaryan Aleksandr - Nikoghosyan Narek,54,20,34,14,-14,18,14,22,0,0,4,8,2,0,0,14,7:11 - 3:11 - 10:12 - 0:0 - 0:0
14011262,2023-09-13 10:45:00,Antonyan Eduard - Papyan Karen,0:3,12:14 - 4:11 - 4:11 - 0:0 - 0:0,0,3,Antonyan Eduard,Papyan Karen,fiurst,Antonyan Eduard - Papyan Karen,56,20,36,16,-16,26,15,15,0,0,2,7,7,0,0,16,12:14 - 4:11 - 4:11 - 0:0 - 0:0
14011259,2023-09-13 10:40:00,Rafayelyan Edgar - Nikoghosyan Narek,2:3,4:11 - 11:2 - 9:11 - 11:8 - 11:8,3,2,Rafayelyan Edgar,Nikoghosyan Narek,fiurst,Nikoghosyan Narek - Rafayelyan Edgar,86,40,46,6,-6,15,13,20,19,19,-7,9,-2,3,3,6,11:4 - 2:11 - 11:9 - 8:11 - 8:11
14011257,2023-09-13 10:15:00,Papyan Karen - Diaryan Aleksandr,1:3,12:10 - 12:14 - 11:8 - 11:7 - 0:0,3,1,Papyan Karen,Diaryan Aleksandr,fiurst,Diaryan Aleksandr - Papyan Karen,85,39,46,7,-7,22,26,19,18,0,2,-2,3,4,0,7,10:12 - 14:12 - 8:11 - 7:11 - 0:0
14011256,2023-09-13 10:00:00,Antonyan Eduard - Rafayelyan Edgar,2:3,12:10 - 8:11 - 8:11 - 11:8 - 8:11,2,3,Antonyan Eduard,Rafayelyan Edgar,fiurst,Antonyan Eduard - Rafayelyan Edgar,98,47,51,4,-4,22,19,19,19,19,-2,3,3,-3,3,4,12:10 - 8:11 - 8:11 - 11:8 - 8:11
13993288,2023-09-12 17:30:00,Petrosyan Davit - Avakimyan Davit,3:2,5:11 - 8:11 - 11:4 - 11:5 - 4:11,2,3,Petrosyan Davit,Avakimyan Davit,fiurst,Avakimyan Davit - Petrosyan Davit,81,42,39,-3,3,16,19,15,16,15,-6,-3,7,6,-7,-3,11:5 - 11:8 - 4:11 - 5:11 - 11:4
13993277,2023-09-12 17:15:00,Gevorgyan Hayk - Mkrtchyan Andranik,3:2,11:8 - 8:11 - 9:11 - 12:10 - 15:13,3,2,Gevorgyan Hayk,Mkrtchyan Andranik,fiurst,Gevorgyan Hayk - Mkrtchyan Andranik,108,55,53,-2,2,19,19,20,22,28,-3,3,2,-2,-2,-2,11:8 - 8:11 - 9:11 - 12:10 - 15:13
13993276,2023-09-12 17:00:00,Grigoryan Erik - Petrosyan Davit,1:3,11:9 - 10:12 - 4:11 - 6:11 - 0:0,1,3,Grigoryan Erik,Petrosyan Davit,fiurst,Grigoryan Erik - Petrosyan Davit,74,31,43,12,-12,20,22,15,17,0,-2,2,7,5,0,12,11:9 - 10:12 - 4:11 - 6:11 - 0:0
13993271,2023-09-12 16:45:00,Gevorgyan Hayk - Avakimyan Davit,3:1,6:11 - 7:11 - 11:5 - 8:11 - 0:0,1,3,Gevorgyan Hayk,Avakimyan Davit,fiurst,Avakimyan Davit - Gevorgyan Hayk,70,38,32,-6,6,17,18,16,19,0,-5,-4,6,-3,0,-6,11:6 - 11:7 - 5:11 - 11:8 - 0:0
13993266,2023-09-12 16:30:00,Mkrtchyan Andranik - Grigoryan Erik,1:3,9:11 - 12:10 - 11:9 - 13:11 - 0:0,3,1,Mkrtchyan Andranik,Grigoryan Erik,fiurst,Grigoryan Erik - Mkrtchyan Andranik,86,41,45,4,-4,20,22,20,24,0,-2,2,2,2,0,4,11:9 - 10:12 - 9:11 - 11:13 - 0:0
13993265,2023-09-12 16:15:00,Petrosyan Davit - Gevorgyan Hayk,3:1,12:10 - 10:12 - 3:11 - 5:11 - 0:0,1,3,Petrosyan Davit,Gevorgyan Hayk,fiurst,Gevorgyan Hayk - Petrosyan Davit,74,44,30,-14,14,22,22,14,16,0,2,-2,-8,-6,0,-14,10:12 - 12:10 - 11:3 - 11:5 - 0:0
13993254,2023-09-12 16:00:00,Avakimyan Davit - Grigoryan Erik,3:0,11:8 - 12:10 - 11:7 - 0:0 - 0:0,3,0,Avakimyan Davit,Grigoryan Erik,fiurst,Avakimyan Davit - Grigoryan Erik,59,34,25,-9,9,19,22,18,0,0,-3,-2,-4,0,0,-9,11:8 - 12:10 - 11:7 - 0:0 - 0:0
13993248,2023-09-12 15:50:00,Mkrtchyan Andranik - Petrosyan Davit,3:1,2:11 - 11:6 - 11:5 - 11:9 - 0:0,3,1,Mkrtchyan Andranik,Petrosyan Davit,fiurst,Mkrtchyan Andranik - Petrosyan Davit,66,35,31,-4,4,13,17,16,20,0,9,-5,-6,-2,0,-4,2:11 - 11:6 - 11:5 - 11:9 - 0:0
13993244,2023-09-12 15:30:00,Grigoryan Erik - Gevorgyan Hayk,3:1,8:11 - 11:9 - 7:11 - 7:11 - 0:0,1,3,Grigoryan Erik,Gevorgyan Hayk,fiurst,Gevorgyan Hayk - Grigoryan Erik,75,42,33,-9,9,19,20,18,18,0,-3,2,-4,-4,0,-9,11:8 - 9:11 - 11:7 - 11:7 - 0:0
13993204,2023-09-12 15:15:00,Avakimyan Davit - Mkrtchyan Andranik,0:3,7:11 - 9:11 - 6:11 - 0:0 - 0:0,0,3,Avakimyan Davit,Mkrtchyan Andranik,fiurst,Avakimyan Davit - Mkrtchyan Andranik,55,22,33,11,-11,18,20,17,0,0,4,2,5,0,0,11,7:11 - 9:11 - 6:11 - 0:0 - 0:0
13993203,2023-09-12 15:10:00,Antonyan Eduard - Nazaryan Mushegh,3:0,11:7 - 11:9 - 11:6 - 0:0 - 0:0,3,0,Antonyan Eduard,Nazaryan Mushegh,fiurst,Antonyan Eduard - Nazaryan Mushegh,55,33,22,-11,11,18,20,17,0,0,-4,-2,-5,0,0,-11,11:7 - 11:9 - 11:6 - 0:0 - 0:0
13991786,2023-09-12 14:50:00,Nikoghosyan Narek - Soghomonyan Hrayr,3:0,11:7 - 11:5 - 11:2 - 0:0 - 0:0,3,0,Nikoghosyan Narek,Soghomonyan Hrayr,fiurst,Nikoghosyan Narek - Soghomonyan Hrayr,47,33,14,-19,19,18,16,13,0,0,-4,-6,-9,0,0,-19,11:7 - 11:5 - 11:2 - 0:0 - 0:0
13991775,2023-09-12 14:40:00,Papyan Karen - Antonyan Eduard,2:3,5:11 - 11:9 - 11:13 - 11:4 - 11:7,3,2,Papyan Karen,Antonyan Eduard,fiurst,Antonyan Eduard - Papyan Karen,93,44,49,5,-5,16,20,24,15,18,-6,2,-2,7,4,5,11:5 - 9:11 - 13:11 - 4:11 - 7:11
13991728,2023-09-12 14:35:00,Nazaryan Mushegh - Nikoghosyan Narek,0:3,5:11 - 5:11 - 7:11 - 0:0 - 0:0,0,3,Nazaryan Mushegh,Nikoghosyan Narek,fiurst,Nazaryan Mushegh - Nikoghosyan Narek,50,17,33,16,-16,16,16,18,0,0,6,6,4,0,0,16,5:11 - 5:11 - 7:11 - 0:0 - 0:0
13989399,2023-09-12 14:05:00,Antonyan Eduard - Nikoghosyan Narek,3:1,11:8 - 11:9 - 7:11 - 11:5 - 0:0,3,1,Antonyan Eduard,Nikoghosyan Narek,fiurst,Antonyan Eduard - Nikoghosyan Narek,73,40,33,-7,7,19,20,18,16,0,-3,-2,4,-6,0,-7,11:8 - 11:9 - 7:11 - 11:5 - 0:0
13989407,2023-09-12 14:05:00,Papyan Karen - Soghomonyan Hrayr,3:2,11:13 - 11:7 - 9:11 - 11:3 - 11:1,3,2,Papyan Karen,Soghomonyan Hrayr,fiurst,Papyan Karen - Soghomonyan Hrayr,88,53,35,-18,18,24,18,20,14,12,2,-4,2,-8,-10,-18,11:13 - 11:7 - 9:11 - 11:3 - 11:1
13989383,2023-09-12 13:30:00,Soghomonyan Hrayr - Antonyan Eduard,3:1,9:11 - 6:11 - 11:9 - 6:11 - 0:0,1,3,Soghomonyan Hrayr,Antonyan Eduard,fiurst,Antonyan Eduard - Soghomonyan Hrayr,74,42,32,-10,10,20,17,20,17,0,-2,-5,2,-5,0,-10,11:9 - 11:6 - 9:11 - 11:6 - 0:0
13989395,2023-09-12 13:30:00,Nazaryan Mushegh - Papyan Karen,3:2,9:11 - 11:9 - 6:11 - 11:9 - 11:7,3,2,Nazaryan Mushegh,Papyan Karen,fiurst,Nazaryan Mushegh - Papyan Karen,95,48,47,-1,1,20,20,17,20,18,2,-2,5,-2,-4,-1,9:11 - 11:9 - 6:11 - 11:9 - 11:7
13989367,2023-09-12 13:00:00,Nikoghosyan Narek - Papyan Karen,1:3,9:11 - 11:7 - 11:13 - 9:11 - 0:0,1,3,Nikoghosyan Narek,Papyan Karen,fiurst,Nikoghosyan Narek - Papyan Karen,82,40,42,2,-2,20,18,24,20,0,2,-4,2,2,0,2,9:11 - 11:7 - 11:13 - 9:11 - 0:0
13989352,2023-09-12 12:55:00,Soghomonyan Hrayr - Nazaryan Mushegh,2:3,10:12 - 11:6 - 11:6 - 10:12 - 11:6,3,2,Soghomonyan Hrayr,Nazaryan Mushegh,fiurst,Nazaryan Mushegh - Soghomonyan Hrayr,95,42,53,11,-11,22,17,17,22,17,-2,5,5,-2,5,11,12:10 - 6:11 - 6:11 - 12:10 - 6:11
13989347,2023-09-12 12:20:00,Antonyan Eduard - Papyan Karen,2:3,9:11 - 11:9 - 9:11 - 11:8 - 10:12,2,3,Antonyan Eduard,Papyan Karen,fiurst,Antonyan Eduard - Papyan Karen,101,50,51,1,-1,20,20,20,19,22,2,-2,2,-3,2,1,9:11 - 11:9 - 9:11 - 11:8 - 10:12
13989333,2023-09-12 12:10:00,Soghomonyan Hrayr - Nikoghosyan Narek,3:0,9:11 - 6:11 - 8:11 - 0:0 - 0:0,0,3,Soghomonyan Hrayr,Nikoghosyan Narek,fiurst,Nikoghosyan Narek - Soghomonyan Hrayr,56,33,23,-10,10,20,17,19,0,0,-2,-5,-3,0,0,-10,11:9 - 11:6 - 11:8 - 0:0 - 0:0
13989315,2023-09-12 11:55:00,Nazaryan Mushegh - Antonyan Eduard,3:1,9:11 - 11:5 - 6:11 - 8:11 - 0:0,1,3,Nazaryan Mushegh,Antonyan Eduard,fiurst,Antonyan Eduard - Nazaryan Mushegh,72,38,34,-4,4,20,16,17,19,0,-2,6,-5,-3,0,-4,11:9 - 5:11 - 11:6 - 11:8 - 0:0
13989309,2023-09-12 11:50:00,Soghomonyan Hrayr - Papyan Karen,3:0,9:11 - 6:11 - 3:11 - 0:0 - 0:0,0,3,Soghomonyan Hrayr,Papyan Karen,fiurst,Papyan Karen - Soghomonyan Hrayr,51,33,18,-15,15,20,17,14,0,0,-2,-5,-8,0,0,-15,11:9 - 11:6 - 11:3 - 0:0 - 0:0
13989297,2023-09-12 11:25:00,Nikoghosyan Narek - Nazaryan Mushegh,1:3,12:10 - 9:11 - 11:9 - 11:6 - 0:0,3,1,Nikoghosyan Narek,Nazaryan Mushegh,fiurst,Nazaryan Mushegh - Nikoghosyan Narek,79,36,43,7,-7,22,20,20,17,0,2,-2,2,5,0,7,10:12 - 11:9 - 9:11 - 6:11 - 0:0
13989252,2023-09-12 11:20:00,Antonyan Eduard - Soghomonyan Hrayr,3:1,11:7 - 11:8 - 8:11 - 11:6 - 0:0,3,1,Antonyan Eduard,Soghomonyan Hrayr,fiurst,Antonyan Eduard - Soghomonyan Hrayr,73,41,32,-9,9,18,19,19,17,0,-4,-3,3,-5,0,-9,11:7 - 11:8 - 8:11 - 11:6 - 0:0
13989248,2023-09-12 10:45:00,Papyan Karen - Nazaryan Mushegh,0:3,11:4 - 11:8 - 12:10 - 0:0 - 0:0,3,0,Papyan Karen,Nazaryan Mushegh,fiurst,Nazaryan Mushegh - Papyan Karen,56,22,34,12,-12,15,19,22,0,0,7,3,2,0,0,12,4:11 - 8:11 - 10:12 - 0:0 - 0:0
13989233,2023-09-12 10:30:00,Nikoghosyan Narek - Antonyan Eduard,2:3,6:11 - 13:11 - 10:12 - 11:7 - 13:11,3,2,Nikoghosyan Narek,Antonyan Eduard,fiurst,Antonyan Eduard - Nikoghosyan Narek,105,52,53,1,-1,17,24,22,18,24,-5,2,-2,4,2,1,11:6 - 11:13 - 12:10 - 7:11 - 11:13
13989230,2023-09-12 10:15:00,Nazaryan Mushegh - Soghomonyan Hrayr,3:0,11:6 - 11:8 - 11:9 - 0:0 - 0:0,3,0,Nazaryan Mushegh,Soghomonyan Hrayr,fiurst,Nazaryan Mushegh - Soghomonyan Hrayr,56,33,23,-10,10,17,19,20,0,0,-5,-3,-2,0,0,-10,11:6 - 11:8 - 11:9 - 0:0 - 0:0
13989224,2023-09-12 10:10:00,Papyan Karen - Nikoghosyan Narek,3:1,2:11 - 3:11 - 11:6 - 8:11 - 0:0,1,3,Papyan Karen,Nikoghosyan Narek,fiurst,Nikoghosyan Narek - Papyan Karen,63,39,24,-15,15,13,14,17,19,0,-9,-8,5,-3,0,-15,11:2 - 11:3 - 6:11 - 11:8 - 0:0
13974100,2023-09-11 17:30:00,Petrosyan Davit - Darbinyan Armen,1:3,7:11 - 11:6 - 11:4 - 11:9 - 0:0,3,1,Petrosyan Davit,Darbinyan Armen,fiurst,Darbinyan Armen - Petrosyan Davit,70,30,40,10,-10,18,17,15,20,0,-4,5,7,2,0,10,11:7 - 6:11 - 4:11 - 9:11 - 0:0
13974095,2023-09-11 17:15:00,Grigoryan Erik - Avakimyan Davit,3:0,3:11 - 8:11 - 9:11 - 0:0 - 0:0,0,3,Grigoryan Erik,Avakimyan Davit,fiurst,Avakimyan Davit - Grigoryan Erik,53,33,20,-13,13,14,19,20,0,0,-8,-3,-2,0,0,-13,11:3 - 11:8 - 11:9 - 0:0 - 0:0
13974090,2023-09-11 17:05:00,Gevorgyan Hayk - Petrosyan Davit,3:1,13:11 - 8:11 - 11:6 - 11:4 - 0:0,3,1,Gevorgyan Hayk,Petrosyan Davit,fiurst,Gevorgyan Hayk - Petrosyan Davit,75,43,32,-11,11,24,19,17,15,0,-2,3,-5,-7,0,-11,13:11 - 8:11 - 11:6 - 11:4 - 0:0
13974087,2023-09-11 16:45:00,Grigoryan Erik - Darbinyan Armen,3:0,8:11 - 4:11 - 9:11 - 0:0 - 0:0,0,3,Grigoryan Erik,Darbinyan Armen,fiurst,Darbinyan Armen - Grigoryan Erik,54,33,21,-12,12,19,15,20,0,0,-3,-7,-2,0,0,-12,11:8 - 11:4 - 11:9 - 0:0 - 0:0
13974077,2023-09-11 16:30:00,Avakimyan Davit - Gevorgyan Hayk,2:3,11:5 - 11:13 - 10:12 - 11:8 - 9:11,2,3,Avakimyan Davit,Gevorgyan Hayk,fiurst,Avakimyan Davit - Gevorgyan Hayk,101,52,49,-3,3,16,24,22,19,20,-6,2,2,-3,2,-3,11:5 - 11:13 - 10:12 - 11:8 - 9:11
13974072,2023-09-11 16:15:00,Petrosyan Davit - Grigoryan Erik,2:3,11:7 - 11:3 - 6:11 - 9:11 - 11:7,3,2,Petrosyan Davit,Grigoryan Erik,fiurst,Grigoryan Erik - Petrosyan Davit,87,39,48,9,-9,18,14,17,20,18,4,8,-5,-2,4,9,7:11 - 3:11 - 11:6 - 11:9 - 7:11
13974070,2023-09-11 16:00:00,Darbinyan Armen - Gevorgyan Hayk,0:3,8:11 - 2:11 - 7:11 - 0:0 - 0:0,0,3,Darbinyan Armen,Gevorgyan Hayk,fiurst,Darbinyan Armen - Gevorgyan Hayk,50,17,33,16,-16,19,13,18,0,0,3,9,4,0,0,16,8:11 - 2:11 - 7:11 - 0:0 - 0:0
13974068,2023-09-11 15:45:00,Avakimyan Davit - Petrosyan Davit,3:1,11:9 - 10:12 - 11:9 - 16:14 - 0:0,3,1,Avakimyan Davit,Petrosyan Davit,fiurst,Avakimyan Davit - Petrosyan Davit,92,48,44,-4,4,20,22,20,30,0,-2,2,-2,-2,0,-4,11:9 - 10:12 - 11:9 - 16:14 - 0:0
13974055,2023-09-11 15:30:00,Gevorgyan Hayk - Grigoryan Erik,2:3,11:8 - 9:11 - 6:11 - 11:9 - 8:11,2,3,Gevorgyan Hayk,Grigoryan Erik,fiurst,Gevorgyan Hayk - Grigoryan Erik,95,45,50,5,-5,19,20,17,20,19,-3,2,5,-2,3,5,11:8 - 9:11 - 6:11 - 11:9 - 8:11
13974052,2023-09-11 15:15:00,Darbinyan Armen - Avakimyan Davit,3:1,7:11 - 11:13 - 11:9 - 7:11 - 0:0,1,3,Darbinyan Armen,Avakimyan Davit,fiurst,Avakimyan Davit - Darbinyan Armen,80,44,36,-8,8,18,24,20,18,0,-4,-2,2,-4,0,-8,11:7 - 13:11 - 9:11 - 11:7 - 0:0
13974048,2023-09-11 15:00:00,Soghomonyan Hrayr - Diaryan Aleksandr,0:3,11:8 - 11:5 - 11:9 - 0:0 - 0:0,3,0,Soghomonyan Hrayr,Diaryan Aleksandr,fiurst,Diaryan Aleksandr - Soghomonyan Hrayr,55,22,33,11,-11,19,16,20,0,0,3,6,2,0,0,11,8:11 - 5:11 - 9:11 - 0:0 - 0:0
13974047,2023-09-11 14:45:00,Papyan Karen - Nazaryan Mushegh,2:3,14:16 - 11:7 - 11:9 - 6:11 - 11:2,3,2,Papyan Karen,Nazaryan Mushegh,fiurst,Nazaryan Mushegh - Papyan Karen,98,45,53,8,-8,30,18,20,17,13,-2,4,2,-5,9,8,16:14 - 7:11 - 9:11 - 11:6 - 2:11
13974039,2023-09-11 14:30:00,Rafayelyan Edgar - Soghomonyan Hrayr,3:1,11:3 - 10:12 - 11:4 - 11:4 - 0:0,3,1,Rafayelyan Edgar,Soghomonyan Hrayr,fiurst,Rafayelyan Edgar - Soghomonyan Hrayr,66,43,23,-20,20,14,22,15,15,0,-8,2,-7,-7,0,-20,11:3 - 10:12 - 11:4 - 11:4 - 0:0
13974030,2023-09-11 14:15:00,Diaryan Aleksandr - Papyan Karen,1:3,11:8 - 7:11 - 11:13 - 12:14 - 0:0,1,3,Diaryan Aleksandr,Papyan Karen,fiurst,Diaryan Aleksandr - Papyan Karen,87,41,46,5,-5,19,18,24,26,0,-3,4,2,2,0,5,11:8 - 7:11 - 11:13 - 12:14 - 0:0
13974025,2023-09-11 14:00:00,Rafayelyan Edgar - Nazaryan Mushegh,2:3,11:9 - 5:11 - 9:11 - 11:7 - 11:8,3,2,Rafayelyan Edgar,Nazaryan Mushegh,fiurst,Nazaryan Mushegh - Rafayelyan Edgar,93,46,47,1,-1,20,16,20,18,19,2,-6,-2,4,3,1,9:11 - 11:5 - 11:9 - 7:11 - 8:11
13974021,2023-09-11 13:45:00,Soghomonyan Hrayr - Papyan Karen,0:3,11:5 - 11:9 - 11:8 - 0:0 - 0:0,3,0,Soghomonyan Hrayr,Papyan Karen,fiurst,Papyan Karen - Soghomonyan Hrayr,55,22,33,11,-11,16,20,19,0,0,6,2,3,0,0,11,5:11 - 9:11 - 8:11 - 0:0 - 0:0
13974018,2023-09-11 13:30:00,Diaryan Aleksandr - Rafayelyan Edgar,3:1,9:11 - 11:4 - 11:6 - 11:8 - 0:0,3,1,Diaryan Aleksandr,Rafayelyan Edgar,fiurst,Diaryan Aleksandr - Rafayelyan Edgar,71,42,29,-13,13,20,15,17,19,0,2,-7,-5,-3,0,-13,9:11 - 11:4 - 11:6 - 11:8 - 0:0
13974014,2023-09-11 13:15:00,Nazaryan Mushegh - Soghomonyan Hrayr,2:3,11:5 - 8:11 - 11:9 - 7:11 - 9:11,2,3,Nazaryan Mushegh,Soghomonyan Hrayr,fiurst,Nazaryan Mushegh - Soghomonyan Hrayr,93,46,47,1,-1,16,19,20,18,20,-6,3,-2,4,2,1,11:5 - 8:11 - 11:9 - 7:11 - 9:11
13974010,2023-09-11 13:00:00,Papyan Karen - Rafayelyan Edgar,3:2,7:11 - 9:11 - 12:10 - 12:10 - 11:8,3,2,Papyan Karen,Rafayelyan Edgar,fiurst,Papyan Karen - Rafayelyan Edgar,101,51,50,-1,1,18,20,22,22,19,4,2,-2,-2,-3,-1,7:11 - 9:11 - 12:10 - 12:10 - 11:8
13974009,2023-09-11 12:50:00,Nazaryan Mushegh - Diaryan Aleksandr,3:1,11:13 - 3:11 - 13:11 - 5:11 - 0:0,1,3,Nazaryan Mushegh,Diaryan Aleksandr,fiurst,Diaryan Aleksandr - Nazaryan Mushegh,78,46,32,-14,14,24,14,24,16,0,-2,-8,2,-6,0,-14,13:11 - 11:3 - 11:13 - 11:5 - 0:0
13974008,2023-09-11 12:25:00,Soghomonyan Hrayr - Rafayelyan Edgar,3:0,8:11 - 10:12 - 4:11 - 0:0 - 0:0,0,3,Soghomonyan Hrayr,Rafayelyan Edgar,fiurst,Rafayelyan Edgar - Soghomonyan Hrayr,56,34,22,-12,12,19,22,15,0,0,-3,-2,-7,0,0,-12,11:8 - 12:10 - 11:4 - 0:0 - 0:0
13974004,2023-09-11 12:00:00,Nazaryan Mushegh - Papyan Karen,3:0,11:5 - 11:8 - 11:7 - 0:0 - 0:0,3,0,Nazaryan Mushegh,Papyan Karen,fiurst,Nazaryan Mushegh - Papyan Karen,53,33,20,-13,13,16,19,18,0,0,-6,-3,-4,0,0,-13,11:5 - 11:8 - 11:7 - 0:0 - 0:0
13973996,2023-09-11 11:50:00,Diaryan Aleksandr - Soghomonyan Hrayr,3:0,11:5 - 11:5 - 14:12 - 0:0 - 0:0,3,0,Diaryan Aleksandr,Soghomonyan Hrayr,fiurst,Diaryan Aleksandr - Soghomonyan Hrayr,58,36,22,-14,14,16,16,26,0,0,-6,-6,-2,0,0,-14,11:5 - 11:5 - 14:12 - 0:0 - 0:0
13973985,2023-09-11 11:30:00,Nazaryan Mushegh - Rafayelyan Edgar,0:3,7:11 - 4:11 - 6:11 - 0:0 - 0:0,0,3,Nazaryan Mushegh,Rafayelyan Edgar,fiurst,Nazaryan Mushegh - Rafayelyan Edgar,50,17,33,16,-16,18,15,17,0,0,4,7,5,0,0,16,7:11 - 4:11 - 6:11 - 0:0 - 0:0
13973984,2023-09-11 11:15:00,Papyan Karen - Diaryan Aleksandr,3:1,12:10 - 6:11 - 10:12 - 10:12 - 0:0,1,3,Papyan Karen,Diaryan Aleksandr,fiurst,Diaryan Aleksandr - Papyan Karen,83,45,38,-7,7,22,17,22,22,0,2,-5,-2,-2,0,-7,10:12 - 11:6 - 12:10 - 12:10 - 0:0
13973980,2023-09-11 11:00:00,Soghomonyan Hrayr - Nazaryan Mushegh,3:2,9:11 - 11:8 - 8:11 - 11:6 - 4:11,2,3,Soghomonyan Hrayr,Nazaryan Mushegh,fiurst,Nazaryan Mushegh - Soghomonyan Hrayr,90,47,43,-4,4,20,19,19,17,15,-2,3,-3,5,-7,-4,11:9 - 8:11 - 11:8 - 6:11 - 11:4
13973976,2023-09-11 10:45:00,Rafayelyan Edgar - Diaryan Aleksandr,3:0,6:11 - 8:11 - 8:11 - 0:0 - 0:0,0,3,Rafayelyan Edgar,Diaryan Aleksandr,fiurst,Diaryan Aleksandr - Rafayelyan Edgar,55,33,22,-11,11,17,19,19,0,0,-5,-3,-3,0,0,-11,11:6 - 11:8 - 11:8 - 0:0 - 0:0
13973973,2023-09-11 10:30:00,Papyan Karen - Soghomonyan Hrayr,3:1,12:10 - 4:11 - 11:6 - 11:7 - 0:0,3,1,Papyan Karen,Soghomonyan Hrayr,fiurst,Papyan Karen - Soghomonyan Hrayr,72,38,34,-4,4,22,15,17,18,0,-2,7,-5,-4,0,-4,12:10 - 4:11 - 11:6 - 11:7 - 0:0
13973960,2023-09-11 10:15:00,Diaryan Aleksandr - Nazaryan Mushegh,0:0,0:0 - 0:0 - 0:0 - 0:0 - 0:0,0,0,Diaryan Aleksandr,Nazaryan Mushegh,fiurst,Diaryan Aleksandr - Nazaryan Mushegh,0,0,0,0,0,0,0,0,0,0,0,0,0,0,0,0,0:0 - 0:0 - 0:0 - 0:0 - 0:0
13973612,2023-09-11 10:00:00,Rafayelyan Edgar - Papyan Karen,0:0,0:0 - 0:0 - 0:0 - 0:0 - 0:0,0,0,Rafayelyan Edgar,Papyan Karen,fiurst,Papyan Karen - Rafayelyan Edgar,0,0,0,0,0,0,0,0,0,0,0,0,0,0,0,0,0:0 - 0:0 - 0:0 - 0:0 - 0:0
13954504,2023-09-10 17:30:00,Darbinyan Armen - Grigoryan Erik,3:1,11:7 - 6:11 - 11:9 - 11:8 - 0:0,3,1,Darbinyan Armen,Grigoryan Erik,fiurst,Darbinyan Armen - Grigoryan Erik,74,39,35,-4,4,18,17,20,19,0,-4,5,-2,-3,0,-4,11:7 - 6:11 - 11:9 - 11:8 - 0:0
13954503,2023-09-10 17:15:00,Mkrtchyan Andranik - Petrosyan Davit,1:3,13:11 - 9:11 - 9:11 - 9:11 - 0:0,1,3,Mkrtchyan Andranik,Petrosyan Davit,fiurst,Mkrtchyan Andranik - Petrosyan Davit,84,40,44,4,-4,24,20,20,20,0,-2,2,2,2,0,4,13:11 - 9:11 - 9:11 - 9:11 - 0:0
13954500,2023-09-10 17:00:00,Avakimyan Davit - Darbinyan Armen,3:1,11:7 - 9:11 - 12:10 - 11:9 - 0:0,3,1,Avakimyan Davit,Darbinyan Armen,fiurst,Avakimyan Davit - Darbinyan Armen,80,43,37,-6,6,18,20,22,20,0,-4,2,-2,-2,0,-6,11:7 - 9:11 - 12:10 - 11:9 - 0:0
13954472,2023-09-10 16:50:00,Mkrtchyan Andranik - Grigoryan Erik,0:3,13:11 - 11:4 - 11:6 - 0:0 - 0:0,3,0,Mkrtchyan Andranik,Grigoryan Erik,fiurst,Grigoryan Erik - Mkrtchyan Andranik,56,21,35,14,-14,24,15,17,0,0,2,7,5,0,0,14,11:13 - 4:11 - 6:11 - 0:0 - 0:0
13954423,2023-09-10 16:35:00,Petrosyan Davit - Avakimyan Davit,3:0,8:11 - 2:11 - 5:11 - 0:0 - 0:0,0,3,Petrosyan Davit,Avakimyan Davit,fiurst,Avakimyan Davit - Petrosyan Davit,48,33,15,-18,18,19,13,16,0,0,-3,-9,-6,0,0,-18,11:8 - 11:2 - 11:5 - 0:0 - 0:0
13954380,2023-09-10 16:15:00,Darbinyan Armen - Mkrtchyan Andranik,2:3,11:8 - 8:11 - 11:13 - 11:5 - 9:11,2,3,Darbinyan Armen,Mkrtchyan Andranik,fiurst,Darbinyan Armen - Mkrtchyan Andranik,98,50,48,-2,2,19,19,24,16,20,-3,3,2,-6,2,-2,11:8 - 8:11 - 11:13 - 11:5 - 9:11
13954347,2023-09-10 16:10:00,Grigoryan Erik - Avakimyan Davit,3:2,4:11 - 11:6 - 11:6 - 5:11 - 7:11,2,3,Grigoryan Erik,Avakimyan Davit,fiurst,Avakimyan Davit - Grigoryan Erik,83,45,38,-7,7,15,17,17,16,18,-7,5,5,-6,-4,-7,11:4 - 6:11 - 6:11 - 11:5 - 11:7
13954342,2023-09-10 15:50:00,Avakimyan Davit - Mkrtchyan Andranik,3:1,11:7 - 11:9 - 10:12 - 13:11 - 0:0,3,1,Avakimyan Davit,Mkrtchyan Andranik,fiurst,Avakimyan Davit - Mkrtchyan Andranik,84,45,39,-6,6,18,20,22,24,0,-4,-2,2,-2,0,-6,11:7 - 11:9 - 10:12 - 13:11 - 0:0
13954344,2023-09-10 15:45:00,Petrosyan Davit - Darbinyan Armen,0:3,11:6 - 11:7 - 11:7 - 0:0 - 0:0,3,0,Petrosyan Davit,Darbinyan Armen,fiurst,Darbinyan Armen - Petrosyan Davit,53,20,33,13,-13,17,18,18,0,0,5,4,4,0,0,13,6:11 - 7:11 - 7:11 - 0:0 - 0:0
13954314,2023-09-10 15:30:00,Rafayelyan Edgar - Nazaryan Mushegh,3:1,6:11 - 11:5 - 10:12 - 4:11 - 0:0,1,3,Rafayelyan Edgar,Nazaryan Mushegh,fiurst,Nazaryan Mushegh - Rafayelyan Edgar,70,39,31,-8,8,17,16,22,15,0,-5,6,-2,-7,0,-8,11:6 - 5:11 - 12:10 - 11:4 - 0:0
13954322,2023-09-10 15:30:00,Grigoryan Erik - Petrosyan Davit,0:3,5:11 - 9:11 - 6:11 - 0:0 - 0:0,0,3,Grigoryan Erik,Petrosyan Davit,fiurst,Grigoryan Erik - Petrosyan Davit,53,20,33,13,-13,16,20,17,0,0,6,2,5,0,0,13,5:11 - 9:11 - 6:11 - 0:0 - 0:0
13954309,2023-09-10 14:55:00,Diaryan Aleksandr - Antonyan Eduard,3:2,11:13 - 8:11 - 11:5 - 13:11 - 9:11,2,3,Diaryan Aleksandr,Antonyan Eduard,fiurst,Antonyan Eduard - Diaryan Aleksandr,103,51,52,1,-1,24,19,16,24,20,-2,-3,6,2,-2,1,13:11 - 11:8 - 5:11 - 11:13 - 11:9
13954307,2023-09-10 14:50:00,Nikoghosyan Narek - Rafayelyan Edgar,2:3,11:9 - 6:11 - 4:11 - 11:6 - 11:13,2,3,Nikoghosyan Narek,Rafayelyan Edgar,fiurst,Nikoghosyan Narek - Rafayelyan Edgar,93,43,50,7,-7,20,17,15,17,24,-2,5,7,-5,2,7,11:9 - 6:11 - 4:11 - 11:6 - 11:13
13954303,2023-09-10 14:35:00,Nazaryan Mushegh - Diaryan Aleksandr,3:0,6:11 - 7:11 - 5:11 - 0:0 - 0:0,0,3,Nazaryan Mushegh,Diaryan Aleksandr,fiurst,Diaryan Aleksandr - Nazaryan Mushegh,51,33,18,-15,15,17,18,16,0,0,-5,-4,-6,0,0,-15,11:6 - 11:7 - 11:5 - 0:0 - 0:0
13954299,2023-09-10 14:20:00,Nikoghosyan Narek - Antonyan Eduard,0:3,12:10 - 11:5 - 11:8 - 0:0 - 0:0,3,0,Nikoghosyan Narek,Antonyan Eduard,fiurst,Antonyan Eduard - Nikoghosyan Narek,57,23,34,11,-11,22,16,19,0,0,2,6,3,0,0,11,10:12 - 5:11 - 8:11 - 0:0 - 0:0
13954298,2023-09-10 14:15:00,Rafayelyan Edgar - Diaryan Aleksandr,3:0,7:11 - 8:11 - 6:11 - 0:0 - 0:0,0,3,Rafayelyan Edgar,Diaryan Aleksandr,fiurst,Diaryan Aleksandr - Rafayelyan Edgar,54,33,21,-12,12,18,19,17,0,0,-4,-3,-5,0,0,-12,11:7 - 11:8 - 11:6 - 0:0 - 0:0
13954297,2023-09-10 13:55:00,Nazaryan Mushegh - Nikoghosyan Narek,0:3,9:11 - 6:11 - 8:11 - 0:0 - 0:0,0,3,Nazaryan Mushegh,Nikoghosyan Narek,fiurst,Nazaryan Mushegh - Nikoghosyan Narek,56,23,33,10,-10,20,17,19,0,0,2,5,3,0,0,10,9:11 - 6:11 - 8:11 - 0:0 - 0:0
13954295,2023-09-10 13:40:00,Antonyan Eduard - Rafayelyan Edgar,2:3,11:13 - 11:2 - 10:12 - 11:7 - 5:11,2,3,Antonyan Eduard,Rafayelyan Edgar,fiurst,Antonyan Eduard - Rafayelyan Edgar,93,48,45,-3,3,24,13,22,18,16,2,-9,2,-4,6,-3,11:13 - 11:2 - 10:12 - 11:7 - 5:11
13954292,2023-09-10 13:10:00,Diaryan Aleksandr - Nikoghosyan Narek,3:2,12:10 - 6:11 - 5:11 - 11:8 - 11:9,3,2,Diaryan Aleksandr,Nikoghosyan Narek,fiurst,Diaryan Aleksandr - Nikoghosyan Narek,94,45,49,4,-4,22,17,16,19,20,-2,5,6,-3,-2,4,12:10 - 6:11 - 5:11 - 11:8 - 11:9
13954289,2023-09-10 13:05:00,Antonyan Eduard - Nazaryan Mushegh,3:1,10:12 - 11:8 - 11:6 - 15:13 - 0:0,3,1,Antonyan Eduard,Nazaryan Mushegh,fiurst,Antonyan Eduard - Nazaryan Mushegh,86,47,39,-8,8,22,19,17,28,0,2,-3,-5,-2,0,-8,10:12 - 11:8 - 11:6 - 15:13 - 0:0
13954281,2023-09-10 12:40:00,Rafayelyan Edgar - Nikoghosyan Narek,3:1,3:11 - 11:7 - 9:11 - 9:11 - 0:0,1,3,Rafayelyan Edgar,Nikoghosyan Narek,fiurst,Nikoghosyan Narek - Rafayelyan Edgar,72,40,32,-8,8,14,18,20,20,0,-8,4,-2,-2,0,-8,11:3 - 7:11 - 11:9 - 11:9 - 0:0
13953937,2023-09-10 12:30:00,Antonyan Eduard - Diaryan Aleksandr,0:3,10:12 - 9:11 - 7:11 - 0:0 - 0:0,0,3,Antonyan Eduard,Diaryan Aleksandr,fiurst,Antonyan Eduard - Diaryan Aleksandr,60,26,34,8,-8,22,20,18,0,0,2,2,4,0,0,8,10:12 - 9:11 - 7:11 - 0:0 - 0:0
13953920,2023-09-10 11:50:00,Antonyan Eduard - Nikoghosyan Narek,2:3,10:12 - 12:10 - 2:11 - 11:8 - 10:12,2,3,Antonyan Eduard,Nikoghosyan Narek,fiurst,Antonyan Eduard - Nikoghosyan Narek,98,45,53,8,-8,22,22,13,19,22,2,-2,9,-3,2,8,10:12 - 12:10 - 2:11 - 11:8 - 10:12
13953933,2023-09-10 11:50:00,Nazaryan Mushegh - Rafayelyan Edgar,0:3,4:11 - 5:11 - 6:11 - 0:0 - 0:0,0,3,Nazaryan Mushegh,Rafayelyan Edgar,fiurst,Nazaryan Mushegh - Rafayelyan Edgar,48,15,33,18,-18,15,16,17,0,0,7,6,5,0,0,18,4:11 - 5:11 - 6:11 - 0:0 - 0:0
13953914,2023-09-10 11:20:00,Diaryan Aleksandr - Nazaryan Mushegh,3:0,11:3 - 11:6 - 11:2 - 0:0 - 0:0,3,0,Diaryan Aleksandr,Nazaryan Mushegh,fiurst,Diaryan Aleksandr - Nazaryan Mushegh,44,33,11,-22,22,14,17,13,0,0,-8,-5,-9,0,0,-22,11:3 - 11:6 - 11:2 - 0:0 - 0:0
13953909,2023-09-10 11:15:00,Rafayelyan Edgar - Antonyan Eduard,2:3,9:11 - 6:11 - 11:7 - 13:11 - 12:10,3,2,Rafayelyan Edgar,Antonyan Eduard,fiurst,Antonyan Eduard - Rafayelyan Edgar,101,50,51,1,-1,20,17,18,24,22,-2,-5,4,2,2,1,11:9 - 11:6 - 7:11 - 11:13 - 10:12
13953906,2023-09-10 10:45:00,Nikoghosyan Narek - Nazaryan Mushegh,3:2,6:11 - 11:5 - 9:11 - 12:10 - 8:11,2,3,Nikoghosyan Narek,Nazaryan Mushegh,fiurst,Nazaryan Mushegh - Nikoghosyan Narek,94,48,46,-2,2,17,16,20,22,19,-5,6,-2,2,-3,-2,11:6 - 5:11 - 11:9 - 10:12 - 11:8
13953872,2023-09-10 10:40:00,Diaryan Aleksandr - Rafayelyan Edgar,3:1,12:14 - 12:10 - 11:8 - 11:9 - 0:0,3,1,Diaryan Aleksandr,Rafayelyan Edgar,fiurst,Diaryan Aleksandr - Rafayelyan Edgar,87,46,41,-5,5,26,22,19,20,0,2,-2,-3,-2,0,-5,12:14 - 12:10 - 11:8 - 11:9 - 0:0
13953856,2023-09-10 10:15:00,Nazaryan Mushegh - Antonyan Eduard,3:0,2:11 - 8:11 - 6:11 - 0:0 - 0:0,0,3,Nazaryan Mushegh,Antonyan Eduard,fiurst,Antonyan Eduard - Nazaryan Mushegh,49,33,16,-17,17,13,19,17,0,0,-9,-3,-5,0,0,-17,11:2 - 11:8 - 11:6 - 0:0 - 0:0
13953853,2023-09-10 10:05:00,Nikoghosyan Narek - Diaryan Aleksandr,2:3,11:4 - 11:5 - 11:13 - 7:11 - 11:7,3,2,Nikoghosyan Narek,Diaryan Aleksandr,fiurst,Diaryan Aleksandr - Nikoghosyan Narek,91,40,51,11,-11,15,16,24,18,18,7,6,-2,-4,4,11,4:11 - 5:11 - 13:11 - 11:7 - 7:11
13934043,2023-09-09 17:35:00,Mkrtchyan Andranik - Petrosyan Davit,3:0,11:8 - 11:4 - 12:10 - 0:0 - 0:0,3,0,Mkrtchyan Andranik,Petrosyan Davit,fiurst,Mkrtchyan Andranik - Petrosyan Davit,56,34,22,-12,12,19,15,22,0,0,-3,-7,-2,0,0,-12,11:8 - 11:4 - 12:10 - 0:0 - 0:0
13934042,2023-09-09 17:15:00,Gevorgyan Gegham - Avakimyan Davit,3:0,3:11 - 9:11 - 7:11 - 0:0 - 0:0,0,3,Gevorgyan Gegham,Avakimyan Davit,fiurst,Avakimyan Davit - Gevorgyan Gegham,52,33,19,-14,14,14,20,18,0,0,-8,-2,-4,0,0,-14,11:3 - 11:9 - 11:7 - 0:0 - 0:0
13934028,2023-09-09 17:00:00,Grigoryan Erik - Mkrtchyan Andranik,2:3,14:12 - 7:11 - 11:5 - 4:11 - 9:11,2,3,Grigoryan Erik,Mkrtchyan Andranik,fiurst,Grigoryan Erik - Mkrtchyan Andranik,95,45,50,5,-5,26,18,16,15,20,-2,4,-6,7,2,5,14:12 - 7:11 - 11:5 - 4:11 - 9:11
13934023,2023-09-09 16:45:00,Gevorgyan Gegham - Petrosyan Davit,3:0,11:3 - 14:12 - 11:7 - 0:0 - 0:0,3,0,Gevorgyan Gegham,Petrosyan Davit,fiurst,Gevorgyan Gegham - Petrosyan Davit,58,36,22,-14,14,14,26,18,0,0,-8,-2,-4,0,0,-14,11:3 - 14:12 - 11:7 - 0:0 - 0:0
13934018,2023-09-09 16:30:00,Avakimyan Davit - Grigoryan Erik,3:1,11:9 - 8:11 - 11:9 - 11:6 - 0:0,3,1,Avakimyan Davit,Grigoryan Erik,fiurst,Avakimyan Davit - Grigoryan Erik,76,41,35,-6,6,20,19,20,17,0,-2,3,-2,-5,0,-6,11:9 - 8:11 - 11:9 - 11:6 - 0:0
13934015,2023-09-09 16:15:00,Mkrtchyan Andranik - Gevorgyan Gegham,0:3,11:9 - 11:8 - 11:9 - 0:0 - 0:0,3,0,Mkrtchyan Andranik,Gevorgyan Gegham,fiurst,Gevorgyan Gegham - Mkrtchyan Andranik,59,26,33,7,-7,20,19,20,0,0,2,3,2,0,0,7,9:11 - 8:11 - 9:11 - 0:0 - 0:0
13933999,2023-09-09 16:00:00,Petrosyan Davit - Grigoryan Erik,3:0,9:11 - 5:11 - 7:11 - 0:0 - 0:0,0,3,Petrosyan Davit,Grigoryan Erik,fiurst,Grigoryan Erik - Petrosyan Davit,54,33,21,-12,12,20,16,18,0,0,-2,-6,-4,0,0,-12,11:9 - 11:5 - 11:7 - 0:0 - 0:0
13933991,2023-09-09 15:45:00,Avakimyan Davit - Mkrtchyan Andranik,3:1,7:11 - 11:6 - 14:12 - 11:7 - 0:0,3,1,Avakimyan Davit,Mkrtchyan Andranik,fiurst,Avakimyan Davit - Mkrtchyan Andranik,79,43,36,-7,7,18,17,26,18,0,4,-5,-2,-4,0,-7,7:11 - 11:6 - 14:12 - 11:7 - 0:0
13933985,2023-09-09 15:30:00,Grigoryan Erik - Gevorgyan Gegham,1:3,9:11 - 11:8 - 11:7 - 11:6 - 0:0,3,1,Grigoryan Erik,Gevorgyan Gegham,fiurst,Gevorgyan Gegham - Grigoryan Erik,74,32,42,10,-10,20,19,18,17,0,-2,3,4,5,0,10,11:9 - 8:11 - 7:11 - 6:11 - 0:0
13933978,2023-09-09 15:15:00,Petrosyan Davit - Avakimyan Davit,3:0,11:13 - 8:11 - 5:11 - 0:0 - 0:0,0,3,Petrosyan Davit,Avakimyan Davit,fiurst,Avakimyan Davit - Petrosyan Davit,59,35,24,-11,11,24,19,16,0,0,-2,-3,-6,0,0,-11,13:11 - 11:8 - 11:5 - 0:0 - 0:0
13933966,2023-09-09 15:05:00,Nikoghosyan Narek - Antonyan Eduard,0:3,11:9 - 11:7 - 15:13 - 0:0 - 0:0,3,0,Nikoghosyan Narek,Antonyan Eduard,fiurst,Antonyan Eduard - Nikoghosyan Narek,66,29,37,8,-8,20,18,28,0,0,2,4,2,0,0,8,9:11 - 7:11 - 13:15 - 0:0 - 0:0
13933964,2023-09-09 14:50:00,Rafayelyan Edgar - Papyan Karen,3:1,4:11 - 11:5 - 10:12 - 11:13 - 0:0,1,3,Rafayelyan Edgar,Papyan Karen,fiurst,Papyan Karen - Rafayelyan Edgar,77,41,36,-5,5,15,16,22,24,0,-7,6,-2,-2,0,-5,11:4 - 5:11 - 12:10 - 13:11 - 0:0
13933958,2023-09-09 14:30:00,Soghomonyan Hrayr - Nikoghosyan Narek,2:3,8:11 - 12:10 - 8:11 - 11:9 - 11:7,3,2,Soghomonyan Hrayr,Nikoghosyan Narek,fiurst,Nikoghosyan Narek - Soghomonyan Hrayr,98,48,50,2,-2,19,22,19,20,18,-3,2,-3,2,4,2,11:8 - 10:12 - 11:8 - 9:11 - 7:11
13933952,2023-09-09 14:25:00,Antonyan Eduard - Rafayelyan Edgar,0:3,8:11 - 6:11 - 4:11 - 0:0 - 0:0,0,3,Antonyan Eduard,Rafayelyan Edgar,fiurst,Antonyan Eduard - Rafayelyan Edgar,51,18,33,15,-15,19,17,15,0,0,3,5,7,0,0,15,8:11 - 6:11 - 4:11 - 0:0 - 0:0
13933949,2023-09-09 14:00:00,Soghomonyan Hrayr - Papyan Karen,3:1,3:11 - 3:11 - 11:6 - 5:11 - 0:0,1,3,Soghomonyan Hrayr,Papyan Karen,fiurst,Papyan Karen - Soghomonyan Hrayr,61,39,22,-17,17,14,14,17,16,0,-8,-8,5,-6,0,-17,11:3 - 11:3 - 6:11 - 11:5 - 0:0
13933088,2023-09-09 13:55:00,Nikoghosyan Narek - Rafayelyan Edgar,1:3,13:15 - 5:11 - 11:7 - 2:11 - 0:0,1,3,Nikoghosyan Narek,Rafayelyan Edgar,fiurst,Nikoghosyan Narek - Rafayelyan Edgar,75,31,44,13,-13,28,16,18,13,0,2,6,-4,9,0,13,13:15 - 5:11 - 11:7 - 2:11 - 0:0
13933087,2023-09-09 13:40:00,Antonyan Eduard - Soghomonyan Hrayr,3:1,6:11 - 11:4 - 11:5 - 11:5 - 0:0,3,1,Antonyan Eduard,Soghomonyan Hrayr,fiurst,Antonyan Eduard - Soghomonyan Hrayr,64,39,25,-14,14,17,15,16,16,0,5,-7,-6,-6,0,-14,6:11 - 11:4 - 11:5 - 11:5 - 0:0
13933086,2023-09-09 13:15:00,Papyan Karen - Nikoghosyan Narek,3:0,10:12 - 7:11 - 5:11 - 0:0 - 0:0,0,3,Papyan Karen,Nikoghosyan Narek,fiurst,Nikoghosyan Narek - Papyan Karen,56,34,22,-12,12,22,18,16,0,0,-2,-4,-6,0,0,-12,12:10 - 11:7 - 11:5 - 0:0 - 0:0
13933084,2023-09-09 13:00:00,Rafayelyan Edgar - Soghomonyan Hrayr,3:2,11:5 - 13:11 - 10:12 - 6:11 - 11:9,3,2,Rafayelyan Edgar,Soghomonyan Hrayr,fiurst,Rafayelyan Edgar - Soghomonyan Hrayr,99,51,48,-3,3,16,24,22,17,20,-6,-2,2,5,-2,-3,11:5 - 13:11 - 10:12 - 6:11 - 11:9
13933079,2023-09-09 12:55:00,Papyan Karen - Antonyan Eduard,1:3,3:11 - 11:4 - 11:7 - 13:11 - 0:0,3,1,Papyan Karen,Antonyan Eduard,fiurst,Antonyan Eduard - Papyan Karen,71,33,38,5,-5,14,15,18,24,0,-8,7,4,2,0,5,11:3 - 4:11 - 7:11 - 11:13 - 0:0
13933076,2023-09-09 12:30:00,Nikoghosyan Narek - Soghomonyan Hrayr,3:0,13:11 - 11:7 - 11:9 - 0:0 - 0:0,3,0,Nikoghosyan Narek,Soghomonyan Hrayr,fiurst,Nikoghosyan Narek - Soghomonyan Hrayr,62,35,27,-8,8,24,18,20,0,0,-2,-4,-2,0,0,-8,13:11 - 11:7 - 11:9 - 0:0 - 0:0
13933073,2023-09-09 12:20:00,Papyan Karen - Rafayelyan Edgar,1:3,6:11 - 11:9 - 8:11 - 7:11 - 0:0,1,3,Papyan Karen,Rafayelyan Edgar,fiurst,Papyan Karen - Rafayelyan Edgar,74,32,42,10,-10,17,20,19,18,0,5,-2,3,4,0,10,6:11 - 11:9 - 8:11 - 7:11 - 0:0
13933063,2023-09-09 12:00:00,Papyan Karen - Soghomonyan Hrayr,3:1,11:9 - 7:11 - 11:4 - 11:4 - 0:0,3,1,Papyan Karen,Soghomonyan Hrayr,fiurst,Papyan Karen - Soghomonyan Hrayr,68,40,28,-12,12,20,18,15,15,0,-2,4,-7,-7,0,-12,11:9 - 7:11 - 11:4 - 11:4 - 0:0
13933064,2023-09-09 12:00:00,Antonyan Eduard - Nikoghosyan Narek,3:0,11:6 - 11:6 - 11:8 - 0:0 - 0:0,3,0,Antonyan Eduard,Nikoghosyan Narek,fiurst,Antonyan Eduard - Nikoghosyan Narek,53,33,20,-13,13,17,17,19,0,0,-5,-5,-3,0,0,-13,11:6 - 11:6 - 11:8 - 0:0 - 0:0
13933060,2023-09-09 11:25:00,Rafayelyan Edgar - Antonyan Eduard,0:3,11:9 - 11:4 - 11:7 - 0:0 - 0:0,3,0,Rafayelyan Edgar,Antonyan Eduard,fiurst,Antonyan Eduard - Rafayelyan Edgar,53,20,33,13,-13,20,15,18,0,0,2,7,4,0,0,13,9:11 - 4:11 - 7:11 - 0:0 - 0:0
13933057,2023-09-09 11:10:00,Nikoghosyan Narek - Papyan Karen,3:2,14:16 - 20:18 - 9:11 - 11:5 - 12:10,3,2,Nikoghosyan Narek,Papyan Karen,fiurst,Nikoghosyan Narek - Papyan Karen,126,66,60,-6,6,30,38,20,16,22,2,-2,2,-6,-2,-6,14:16 - 20:18 - 9:11 - 11:5 - 12:10
13933054,2023-09-09 10:45:00,Soghomonyan Hrayr - Antonyan Eduard,3:2,7:11 - 7:11 - 11:8 - 11:7 - 5:11,2,3,Soghomonyan Hrayr,Antonyan Eduard,fiurst,Antonyan Eduard - Soghomonyan Hrayr,89,48,41,-7,7,18,18,19,18,16,-4,-4,3,4,-6,-7,11:7 - 11:7 - 8:11 - 7:11 - 11:5
13933050,2023-09-09 10:30:00,Rafayelyan Edgar - Nikoghosyan Narek,2:3,13:11 - 9:11 - 11:4 - 11:13 - 11:9,3,2,Rafayelyan Edgar,Nikoghosyan Narek,fiurst,Nikoghosyan Narek - Rafayelyan Edgar,103,48,55,7,-7,24,20,15,24,20,2,-2,7,-2,2,7,11:13 - 11:9 - 4:11 - 13:11 - 9:11
13933049,2023-09-09 10:15:00,Antonyan Eduard - Papyan Karen,1:3,8:11 - 11:6 - 8:11 - 7:11 - 0:0,1,3,Antonyan Eduard,Papyan Karen,fiurst,Antonyan Eduard - Papyan Karen,73,34,39,5,-5,19,17,19,18,0,3,-5,3,4,0,5,8:11 - 11:6 - 8:11 - 7:11 - 0:0
13933046,2023-09-09 10:00:00,Soghomonyan Hrayr - Rafayelyan Edgar,3:2,11:9 - 2:11 - 12:10 - 5:11 - 7:11,2,3,Soghomonyan Hrayr,Rafayelyan Edgar,fiurst,Rafayelyan Edgar - Soghomonyan Hrayr,89,52,37,-15,15,20,13,22,16,18,2,-9,2,-6,-4,-15,9:11 - 11:2 - 10:12 - 11:5 - 11:7
13914066,2023-09-08 17:15:00,Mkrtchyan Andranik - Darbinyan Armen,1:3,9:11 - 11:8 - 14:12 - 12:10 - 0:0,3,1,Mkrtchyan Andranik,Darbinyan Armen,fiurst,Darbinyan Armen - Mkrtchyan Andranik,87,41,46,5,-5,20,19,26,22,0,-2,3,2,2,0,5,11:9 - 8:11 - 12:14 - 10:12 - 0:0
13914054,2023-09-08 16:45:00,Mkrtchyan Andranik - Avakimyan Davit,3:2,7:11 - 11:3 - 5:11 - 11:8 - 8:11,2,3,Mkrtchyan Andranik,Avakimyan Davit,fiurst,Avakimyan Davit - Mkrtchyan Andranik,86,44,42,-2,2,18,14,16,19,19,-4,8,-6,3,-3,-2,11:7 - 3:11 - 11:5 - 8:11 - 11:8
13914039,2023-09-08 16:30:00,Darbinyan Armen - Gevorgyan Hayk,1:3,11:9 - 4:11 - 8:11 - 11:13 - 0:0,1,3,Darbinyan Armen,Gevorgyan Hayk,fiurst,Darbinyan Armen - Gevorgyan Hayk,78,34,44,10,-10,20,15,19,24,0,-2,7,3,2,0,10,11:9 - 4:11 - 8:11 - 11:13 - 0:0
13914037,2023-09-08 16:00:00,Avakimyan Davit - Gevorgyan Hayk,3:1,11:9 - 12:10 - 9:11 - 11:8 - 0:0,3,1,Avakimyan Davit,Gevorgyan Hayk,fiurst,Avakimyan Davit - Gevorgyan Hayk,81,43,38,-5,5,20,22,20,19,0,-2,-2,2,-3,0,-5,11:9 - 12:10 - 9:11 - 11:8 - 0:0
13914030,2023-09-08 15:30:00,Gevorgyan Hayk - Mkrtchyan Andranik,0:3,9:11 - 6:11 - 3:11 - 0:0 - 0:0,0,3,Gevorgyan Hayk,Mkrtchyan Andranik,fiurst,Gevorgyan Hayk - Mkrtchyan Andranik,51,18,33,15,-15,20,17,14,0,0,2,5,8,0,0,15,9:11 - 6:11 - 3:11 - 0:0 - 0:0
13914028,2023-09-08 15:15:00,Avakimyan Davit - Darbinyan Armen,3:0,11:5 - 11:8 - 11:6 - 0:0 - 0:0,3,0,Avakimyan Davit,Darbinyan Armen,fiurst,Avakimyan Davit - Darbinyan Armen,52,33,19,-14,14,16,19,17,0,0,-6,-3,-5,0,0,-14,11:5 - 11:8 - 11:6 - 0:0 - 0:0
13914024,2023-09-08 15:00:00,Papyan Karen - Diaryan Aleksandr,0:3,11:1 - 11:9 - 11:9 - 0:0 - 0:0,3,0,Papyan Karen,Diaryan Aleksandr,fiurst,Diaryan Aleksandr - Papyan Karen,52,19,33,14,-14,12,20,20,0,0,10,2,2,0,0,14,1:11 - 9:11 - 9:11 - 0:0 - 0:0
13914018,2023-09-08 14:45:00,Nikoghosyan Narek - Soghomonyan Hrayr,2:3,8:11 - 11:8 - 5:11 - 11:9 - 11:13,2,3,Nikoghosyan Narek,Soghomonyan Hrayr,fiurst,Nikoghosyan Narek - Soghomonyan Hrayr,98,46,52,6,-6,19,19,16,20,24,3,-3,6,-2,2,6,8:11 - 11:8 - 5:11 - 11:9 - 11:13
13914008,2023-09-08 14:30:00,Nazaryan Mushegh - Papyan Karen,1:3,13:15 - 11:4 - 9:11 - 7:11 - 0:0,1,3,Nazaryan Mushegh,Papyan Karen,fiurst,Nazaryan Mushegh - Papyan Karen,81,40,41,1,-1,28,15,20,18,0,2,-7,2,4,0,1,13:15 - 11:4 - 9:11 - 7:11 - 0:0
13914006,2023-09-08 14:20:00,Diaryan Aleksandr - Nikoghosyan Narek,3:0,11:8 - 11:7 - 11:9 - 0:0 - 0:0,3,0,Diaryan Aleksandr,Nikoghosyan Narek,fiurst,Diaryan Aleksandr - Nikoghosyan Narek,57,33,24,-9,9,19,18,20,0,0,-3,-4,-2,0,0,-9,11:8 - 11:7 - 11:9 - 0:0 - 0:0
13914005,2023-09-08 14:00:00,Nazaryan Mushegh - Soghomonyan Hrayr,3:0,11:5 - 11:7 - 11:7 - 0:0 - 0:0,3,0,Nazaryan Mushegh,Soghomonyan Hrayr,fiurst,Nazaryan Mushegh - Soghomonyan Hrayr,52,33,19,-14,14,16,18,18,0,0,-6,-4,-4,0,0,-14,11:5 - 11:7 - 11:7 - 0:0 - 0:0
13913979,2023-09-08 13:45:00,Papyan Karen - Nikoghosyan Narek,3:1,10:12 - 11:8 - 8:11 - 9:11 - 0:0,1,3,Papyan Karen,Nikoghosyan Narek,fiurst,Nikoghosyan Narek - Papyan Karen,80,42,38,-4,4,22,19,19,20,0,-2,3,-3,-2,0,-4,12:10 - 8:11 - 11:8 - 11:9 - 0:0
13913977,2023-09-08 13:30:00,Diaryan Aleksandr - Nazaryan Mushegh,3:0,11:7 - 11:5 - 11:4 - 0:0 - 0:0,3,0,Diaryan Aleksandr,Nazaryan Mushegh,fiurst,Diaryan Aleksandr - Nazaryan Mushegh,49,33,16,-17,17,18,16,15,0,0,-4,-6,-7,0,0,-17,11:7 - 11:5 - 11:4 - 0:0 - 0:0
13913976,2023-09-08 13:15:00,Soghomonyan Hrayr - Papyan Karen,3:0,8:11 - 11:13 - 5:11 - 0:0 - 0:0,0,3,Soghomonyan Hrayr,Papyan Karen,fiurst,Papyan Karen - Soghomonyan Hrayr,59,35,24,-11,11,19,24,16,0,0,-3,-2,-6,0,0,-11,11:8 - 13:11 - 11:5 - 0:0 - 0:0
13913965,2023-09-08 13:00:00,Nikoghosyan Narek - Nazaryan Mushegh,0:3,11:9 - 11:6 - 11:4 - 0:0 - 0:0,3,0,Nikoghosyan Narek,Nazaryan Mushegh,fiurst,Nazaryan Mushegh - Nikoghosyan Narek,52,19,33,14,-14,20,17,15,0,0,2,5,7,0,0,14,9:11 - 6:11 - 4:11 - 0:0 - 0:0
13913964,2023-09-08 12:45:00,Soghomonyan Hrayr - Diaryan Aleksandr,3:0,11:13 - 9:11 - 10:12 - 0:0 - 0:0,0,3,Soghomonyan Hrayr,Diaryan Aleksandr,fiurst,Diaryan Aleksandr - Soghomonyan Hrayr,66,36,30,-6,6,24,20,22,0,0,-2,-2,-2,0,0,-6,13:11 - 11:9 - 12:10 - 0:0 - 0:0
13913961,2023-09-08 12:15:00,Papyan Karen - Nazaryan Mushegh,3:2,8:11 - 11:9 - 6:11 - 11:8 - 8:11,2,3,Papyan Karen,Nazaryan Mushegh,fiurst,Nazaryan Mushegh - Papyan Karen,94,50,44,-6,6,19,20,17,19,19,-3,2,-5,3,-3,-6,11:8 - 9:11 - 11:6 - 8:11 - 11:8
13913960,2023-09-08 12:00:00,Soghomonyan Hrayr - Nikoghosyan Narek,3:2,11:6 - 12:10 - 8:11 - 7:11 - 2:11,2,3,Soghomonyan Hrayr,Nikoghosyan Narek,fiurst,Nikoghosyan Narek - Soghomonyan Hrayr,89,49,40,-9,9,17,22,19,18,13,5,2,-3,-4,-9,-9,6:11 - 10:12 - 11:8 - 11:7 - 11:2
13913959,2023-09-08 11:55:00,Diaryan Aleksandr - Papyan Karen,0:3,6:11 - 6:11 - 7:11 - 0:0 - 0:0,0,3,Diaryan Aleksandr,Papyan Karen,fiurst,Diaryan Aleksandr - Papyan Karen,52,19,33,14,-14,17,17,18,0,0,5,5,4,0,0,14,6:11 - 6:11 - 7:11 - 0:0 - 0:0
13913956,2023-09-08 11:30:00,Soghomonyan Hrayr - Nazaryan Mushegh,0:3,11:6 - 11:5 - 11:6 - 0:0 - 0:0,3,0,Soghomonyan Hrayr,Nazaryan Mushegh,fiurst,Nazaryan Mushegh - Soghomonyan Hrayr,50,17,33,16,-16,17,16,17,0,0,5,6,5,0,0,16,6:11 - 5:11 - 6:11 - 0:0 - 0:0
13913954,2023-09-08 11:15:00,Nikoghosyan Narek - Diaryan Aleksandr,2:3,11:7 - 11:7 - 9:11 - 11:13 - 11:7,3,2,Nikoghosyan Narek,Diaryan Aleksandr,fiurst,Diaryan Aleksandr - Nikoghosyan Narek,98,45,53,8,-8,18,18,20,24,18,4,4,-2,-2,4,8,7:11 - 7:11 - 11:9 - 13:11 - 7:11
13913953,2023-09-08 11:00:00,Papyan Karen - Soghomonyan Hrayr,3:0,11:8 - 11:9 - 11:4 - 0:0 - 0:0,3,0,Papyan Karen,Soghomonyan Hrayr,fiurst,Papyan Karen - Soghomonyan Hrayr,54,33,21,-12,12,19,20,15,0,0,-3,-2,-7,0,0,-12,11:8 - 11:9 - 11:4 - 0:0 - 0:0
13913952,2023-09-08 10:45:00,Nazaryan Mushegh - Diaryan Aleksandr,3:0,8:11 - 9:11 - 9:11 - 0:0 - 0:0,0,3,Nazaryan Mushegh,Diaryan Aleksandr,fiurst,Diaryan Aleksandr - Nazaryan Mushegh,59,33,26,-7,7,19,20,20,0,0,-3,-2,-2,0,0,-7,11:8 - 11:9 - 11:9 - 0:0 - 0:0
13913951,2023-09-08 10:30:00,Nikoghosyan Narek - Papyan Karen,1:3,8:11 - 10:12 - 11:5 - 8:11 - 0:0,1,3,Nikoghosyan Narek,Papyan Karen,fiurst,Nikoghosyan Narek - Papyan Karen,76,37,39,2,-2,19,22,16,19,0,3,2,-6,3,0,2,8:11 - 10:12 - 11:5 - 8:11 - 0:0
13913939,2023-09-08 10:15:00,Diaryan Aleksandr - Soghomonyan Hrayr,3:2,7:11 - 11:13 - 11:7 - 11:4 - 11:1,3,2,Diaryan Aleksandr,Soghomonyan Hrayr,fiurst,Diaryan Aleksandr - Soghomonyan Hrayr,87,51,36,-15,15,18,24,18,15,12,4,2,-4,-7,-10,-15,7:11 - 11:13 - 11:7 - 11:4 - 11:1
13913932,2023-09-08 10:10:00,Nazaryan Mushegh - Nikoghosyan Narek,0:3,5:11 - 7:11 - 6:11 - 0:0 - 0:0,0,3,Nazaryan Mushegh,Nikoghosyan Narek,fiurst,Nazaryan Mushegh - Nikoghosyan Narek,51,18,33,15,-15,16,18,17,0,0,6,4,5,0,0,15,5:11 - 7:11 - 6:11 - 0:0 - 0:0
13898030,2023-09-07 17:30:00,Darbinyan Armen - Gevorgyan Gegham,0:3,3:11 - 5:11 - 13:15 - 0:0 - 0:0,0,3,Darbinyan Armen,Gevorgyan Gegham,fiurst,Darbinyan Armen - Gevorgyan Gegham,58,21,37,16,-16,14,16,28,0,0,8,6,2,0,0,16,3:11 - 5:11 - 13:15 - 0:0 - 0:0
13898017,2023-09-07 17:15:00,Avakimyan Davit - Gevorgyan Hayk,3:1,6:11 - 11:9 - 11:8 - 11:9 - 0:0,3,1,Avakimyan Davit,Gevorgyan Hayk,fiurst,Avakimyan Davit - Gevorgyan Hayk,76,39,37,-2,2,17,20,19,20,0,5,-2,-3,-2,0,-2,6:11 - 11:9 - 11:8 - 11:9 - 0:0
13898006,2023-09-07 17:00:00,Petrosyan Davit - Darbinyan Armen,0:3,11:3 - 11:5 - 11:4 - 0:0 - 0:0,3,0,Petrosyan Davit,Darbinyan Armen,fiurst,Darbinyan Armen - Petrosyan Davit,45,12,33,21,-21,14,16,15,0,0,8,6,7,0,0,21,3:11 - 5:11 - 4:11 - 0:0 - 0:0
13898003,2023-09-07 16:45:00,Avakimyan Davit - Gevorgyan Gegham,3:0,11:9 - 11:9 - 11:5 - 0:0 - 0:0,3,0,Avakimyan Davit,Gevorgyan Gegham,fiurst,Avakimyan Davit - Gevorgyan Gegham,56,33,23,-10,10,20,20,16,0,0,-2,-2,-6,0,0,-10,11:9 - 11:9 - 11:5 - 0:0 - 0:0
13898002,2023-09-07 16:30:00,Gevorgyan Hayk - Petrosyan Davit,3:1,6:11 - 11:6 - 13:11 - 11:6 - 0:0,3,1,Gevorgyan Hayk,Petrosyan Davit,fiurst,Gevorgyan Hayk - Petrosyan Davit,75,41,34,-7,7,17,17,24,17,0,5,-5,-2,-5,0,-7,6:11 - 11:6 - 13:11 - 11:6 - 0:0
13897925,2023-09-07 16:15:00,Darbinyan Armen - Avakimyan Davit,3:2,7:11 - 6:11 - 11:9 - 13:11 - 12:14,2,3,Darbinyan Armen,Avakimyan Davit,fiurst,Avakimyan Davit - Darbinyan Armen,105,56,49,-7,7,18,17,20,24,26,-4,-5,2,2,-2,-7,11:7 - 11:6 - 9:11 - 11:13 - 14:12
13897923,2023-09-07 16:00:00,Gevorgyan Hayk - Darbinyan Armen,0:3,11:7 - 11:4 - 15:13 - 0:0 - 0:0,3,0,Gevorgyan Hayk,Darbinyan Armen,fiurst,Darbinyan Armen - Gevorgyan Hayk,61,24,37,13,-13,18,15,28,0,0,4,7,2,0,0,13,7:11 - 4:11 - 13:15 - 0:0 - 0:0
13897924,2023-09-07 16:00:00,Gevorgyan Gegham - Petrosyan Davit,3:2,11:7 - 11:7 - 11:13 - 11:13 - 11:8,3,2,Gevorgyan Gegham,Petrosyan Davit,fiurst,Gevorgyan Gegham - Petrosyan Davit,103,55,48,-7,7,18,18,24,24,19,-4,-4,2,2,-3,-7,11:7 - 11:7 - 11:13 - 11:13 - 11:8
13897916,2023-09-07 15:30:00,Gevorgyan Gegham - Gevorgyan Hayk,1:3,7:11 - 7:11 - 11:9 - 7:11 - 0:0,1,3,Gevorgyan Gegham,Gevorgyan Hayk,fiurst,Gevorgyan Gegham - Gevorgyan Hayk,74,32,42,10,-10,18,18,20,18,0,4,4,-2,4,0,10,7:11 - 7:11 - 11:9 - 7:11 - 0:0
13897918,2023-09-07 15:30:00,Petrosyan Davit - Avakimyan Davit,3:2,11:5 - 11:6 - 8:11 - 9:11 - 9:11,2,3,Petrosyan Davit,Avakimyan Davit,fiurst,Avakimyan Davit - Petrosyan Davit,92,44,48,4,-4,16,17,19,20,20,6,5,-3,-2,-2,4,5:11 - 6:11 - 11:8 - 11:9 - 11:9
13897914,2023-09-07 15:10:00,Nazaryan Mushegh - Rafayelyan Edgar,1:3,11:8 - 7:11 - 4:11 - 4:11 - 0:0,1,3,Nazaryan Mushegh,Rafayelyan Edgar,fiurst,Nazaryan Mushegh - Rafayelyan Edgar,67,26,41,15,-15,19,18,15,15,0,-3,4,7,7,0,15,11:8 - 7:11 - 4:11 - 4:11 - 0:0
13897912,2023-09-07 14:55:00,Antonyan Eduard - Nazaryan Mushegh,3:0,11:8 - 11:9 - 11:6 - 0:0 - 0:0,3,0,Antonyan Eduard,Nazaryan Mushegh,fiurst,Antonyan Eduard - Nazaryan Mushegh,56,33,23,-10,10,19,20,17,0,0,-3,-2,-5,0,0,-10,11:8 - 11:9 - 11:6 - 0:0 - 0:0
13897913,2023-09-07 14:55:00,Soghomonyan Hrayr - Diaryan Aleksandr,3:2,11:9 - 15:17 - 9:11 - 13:11 - 8:11,2,3,Soghomonyan Hrayr,Diaryan Aleksandr,fiurst,Diaryan Aleksandr - Soghomonyan Hrayr,115,59,56,-3,3,20,32,20,24,19,2,-2,-2,2,-3,-3,9:11 - 17:15 - 11:9 - 11:13 - 11:8
13897899,2023-09-07 14:25:00,Rafayelyan Edgar - Soghomonyan Hrayr,3:0,11:6 - 11:8 - 11:7 - 0:0 - 0:0,3,0,Rafayelyan Edgar,Soghomonyan Hrayr,fiurst,Rafayelyan Edgar - Soghomonyan Hrayr,54,33,21,-12,12,17,19,18,0,0,-5,-3,-4,0,0,-12,11:6 - 11:8 - 11:7 - 0:0 - 0:0
13897898,2023-09-07 14:20:00,Antonyan Eduard - Diaryan Aleksandr,3:2,9:11 - 11:9 - 7:11 - 11:8 - 12:10,3,2,Antonyan Eduard,Diaryan Aleksandr,fiurst,Antonyan Eduard - Diaryan Aleksandr,99,50,49,-1,1,20,20,18,19,22,2,-2,4,-3,-2,-1,9:11 - 11:9 - 7:11 - 11:8 - 12:10
13896548,2023-09-07 13:55:00,Nazaryan Mushegh - Soghomonyan Hrayr,3:0,11:6 - 11:5 - 11:7 - 0:0 - 0:0,3,0,Nazaryan Mushegh,Soghomonyan Hrayr,fiurst,Nazaryan Mushegh - Soghomonyan Hrayr,51,33,18,-15,15,17,16,18,0,0,-5,-6,-4,0,0,-15,11:6 - 11:5 - 11:7 - 0:0 - 0:0
13896545,2023-09-07 13:45:00,Rafayelyan Edgar - Antonyan Eduard,2:3,11:4 - 3:11 - 12:10 - 4:11 - 11:5,3,2,Rafayelyan Edgar,Antonyan Eduard,fiurst,Antonyan Eduard - Rafayelyan Edgar,82,41,41,0,0,15,14,22,15,16,7,-8,2,-7,6,0,4:11 - 11:3 - 10:12 - 11:4 - 5:11
13896543,2023-09-07 13:15:00,Diaryan Aleksandr - Nazaryan Mushegh,3:2,11:8 - 9:11 - 4:11 - 12:10 - 11:9,3,2,Diaryan Aleksandr,Nazaryan Mushegh,fiurst,Diaryan Aleksandr - Nazaryan Mushegh,96,47,49,2,-2,19,20,15,22,20,-3,2,7,-2,-2,2,11:8 - 9:11 - 4:11 - 12:10 - 11:9
13896542,2023-09-07 13:00:00,Soghomonyan Hrayr - Antonyan Eduard,3:2,11:7 - 18:16 - 10:12 - 9:11 - 8:11,2,3,Soghomonyan Hrayr,Antonyan Eduard,fiurst,Antonyan Eduard - Soghomonyan Hrayr,113,57,56,-1,1,18,34,22,20,19,4,2,-2,-2,-3,-1,7:11 - 16:18 - 12:10 - 11:9 - 11:8
13896536,2023-09-07 12:45:00,Diaryan Aleksandr - Rafayelyan Edgar,2:3,11:3 - 6:11 - 9:11 - 11:8 - 5:11,2,3,Diaryan Aleksandr,Rafayelyan Edgar,fiurst,Diaryan Aleksandr - Rafayelyan Edgar,86,42,44,2,-2,14,17,20,19,16,-8,5,2,-3,6,2,11:3 - 6:11 - 9:11 - 11:8 - 5:11
13896529,2023-09-07 12:15:00,Nazaryan Mushegh - Antonyan Eduard,3:1,7:11 - 6:11 - 12:10 - 7:11 - 0:0,1,3,Nazaryan Mushegh,Antonyan Eduard,fiurst,Antonyan Eduard - Nazaryan Mushegh,75,43,32,-11,11,18,17,22,18,0,-4,-5,2,-4,0,-11,11:7 - 11:6 - 10:12 - 11:7 - 0:0
13896521,2023-09-07 12:00:00,Diaryan Aleksandr - Soghomonyan Hrayr,3:1,8:11 - 11:6 - 11:9 - 11:5 - 0:0,3,1,Diaryan Aleksandr,Soghomonyan Hrayr,fiurst,Diaryan Aleksandr - Soghomonyan Hrayr,72,41,31,-10,10,19,17,20,16,0,3,-5,-2,-6,0,-10,8:11 - 11:6 - 11:9 - 11:5 - 0:0
13896454,2023-09-07 11:40:00,Rafayelyan Edgar - Nazaryan Mushegh,3:2,9:11 - 11:9 - 13:11 - 9:11 - 4:11,2,3,Rafayelyan Edgar,Nazaryan Mushegh,fiurst,Nazaryan Mushegh - Rafayelyan Edgar,99,53,46,-7,7,20,20,24,20,15,-2,2,2,-2,-7,-7,11:9 - 9:11 - 11:13 - 11:9 - 11:4
13896451,2023-09-07 11:30:00,Diaryan Aleksandr - Antonyan Eduard,3:0,7:11 - 7:11 - 6:11 - 0:0 - 0:0,0,3,Diaryan Aleksandr,Antonyan Eduard,fiurst,Antonyan Eduard - Diaryan Aleksandr,53,33,20,-13,13,18,18,17,0,0,-4,-4,-5,0,0,-13,11:7 - 11:7 - 11:6 - 0:0 - 0:0
13896448,2023-09-07 11:25:00,Soghomonyan Hrayr - Rafayelyan Edgar,3:0,7:11 - 3:11 - 5:11 - 0:0 - 0:0,0,3,Soghomonyan Hrayr,Rafayelyan Edgar,fiurst,Rafayelyan Edgar - Soghomonyan Hrayr,48,33,15,-18,18,18,14,16,0,0,-4,-8,-6,0,0,-18,11:7 - 11:3 - 11:5 - 0:0 - 0:0
13896436,2023-09-07 11:05:00,Nazaryan Mushegh - Diaryan Aleksandr,3:1,9:11 - 8:11 - 11:5 - 3:11 - 0:0,1,3,Nazaryan Mushegh,Diaryan Aleksandr,fiurst,Diaryan Aleksandr - Nazaryan Mushegh,69,38,31,-7,7,20,19,16,14,0,-2,-3,6,-8,0,-7,11:9 - 11:8 - 5:11 - 11:3 - 0:0
13896423,2023-09-07 10:55:00,Antonyan Eduard - Rafayelyan Edgar,3:0,11:6 - 11:8 - 16:14 - 0:0 - 0:0,3,0,Antonyan Eduard,Rafayelyan Edgar,fiurst,Antonyan Eduard - Rafayelyan Edgar,66,38,28,-10,10,17,19,30,0,0,-5,-3,-2,0,0,-10,11:6 - 11:8 - 16:14 - 0:0 - 0:0
13896403,2023-09-07 10:30:00,Soghomonyan Hrayr - Nazaryan Mushegh,3:2,11:7 - 3:11 - 11:9 - 6:11 - 12:14,2,3,Soghomonyan Hrayr,Nazaryan Mushegh,fiurst,Nazaryan Mushegh - Soghomonyan Hrayr,95,52,43,-9,9,18,14,20,17,26,4,-8,2,-5,-2,-9,7:11 - 11:3 - 9:11 - 11:6 - 14:12
13896390,2023-09-07 10:15:00,Rafayelyan Edgar - Diaryan Aleksandr,3:2,13:11 - 11:9 - 6:11 - 9:11 - 7:11,2,3,Rafayelyan Edgar,Diaryan Aleksandr,fiurst,Diaryan Aleksandr - Rafayelyan Edgar,99,53,46,-7,7,24,20,17,20,18,2,2,-5,-2,-4,-7,11:13 - 9:11 - 11:6 - 11:9 - 11:7
13896388,2023-09-07 10:00:00,Antonyan Eduard - Soghomonyan Hrayr,3:0,14:12 - 11:7 - 14:12 - 0:0 - 0:0,3,0,Antonyan Eduard,Soghomonyan Hrayr,fiurst,Antonyan Eduard - Soghomonyan Hrayr,70,39,31,-8,8,26,18,26,0,0,-2,-4,-2,0,0,-8,14:12 - 11:7 - 14:12 - 0:0 - 0:0
13880185,2023-09-06 17:30:00,Gevorgyan Hayk - Mkrtchyan Andranik,0:3,10:12 - 9:11 - 5:11 - 0:0 - 0:0,0,3,Gevorgyan Hayk,Mkrtchyan Andranik,fiurst,Gevorgyan Hayk - Mkrtchyan Andranik,58,24,34,10,-10,22,20,16,0,0,2,2,6,0,0,10,10:12 - 9:11 - 5:11 - 0:0 - 0:0
13880182,2023-09-06 17:15:00,Petrosyan Davit - Gevorgyan Gegham,2:3,9:11 - 11:9 - 11:1 - 9:11 - 11:5,3,2,Petrosyan Davit,Gevorgyan Gegham,fiurst,Gevorgyan Gegham - Petrosyan Davit,88,37,51,14,-14,20,20,12,20,16,-2,2,10,-2,6,14,11:9 - 9:11 - 1:11 - 11:9 - 5:11
13880173,2023-09-06 17:00:00,Avakimyan Davit - Gevorgyan Hayk,1:3,4:11 - 9:11 - 11:9 - 9:11 - 0:0,1,3,Avakimyan Davit,Gevorgyan Hayk,fiurst,Avakimyan Davit - Gevorgyan Hayk,75,33,42,9,-9,15,20,20,20,0,7,2,-2,2,0,9,4:11 - 9:11 - 11:9 - 9:11 - 0:0
13880172,2023-09-06 16:45:00,Petrosyan Davit - Mkrtchyan Andranik,2:3,11:7 - 11:9 - 8:11 - 9:11 - 11:6,3,2,Petrosyan Davit,Mkrtchyan Andranik,fiurst,Mkrtchyan Andranik - Petrosyan Davit,94,44,50,6,-6,18,20,19,20,17,4,2,-3,-2,5,6,7:11 - 9:11 - 11:8 - 11:9 - 6:11
13880171,2023-09-06 16:30:00,Gevorgyan Gegham - Avakimyan Davit,2:3,11:7 - 11:9 - 4:11 - 9:11 - 11:4,3,2,Gevorgyan Gegham,Avakimyan Davit,fiurst,Avakimyan Davit - Gevorgyan Gegham,88,42,46,4,-4,18,20,15,20,15,4,2,-7,-2,7,4,7:11 - 9:11 - 11:4 - 11:9 - 4:11
13880163,2023-09-06 16:15:00,Gevorgyan Hayk - Petrosyan Davit,3:0,11:7 - 11:5 - 11:4 - 0:0 - 0:0,3,0,Gevorgyan Hayk,Petrosyan Davit,fiurst,Gevorgyan Hayk - Petrosyan Davit,49,33,16,-17,17,18,16,15,0,0,-4,-6,-7,0,0,-17,11:7 - 11:5 - 11:4 - 0:0 - 0:0
13880150,2023-09-06 16:00:00,Mkrtchyan Andranik - Avakimyan Davit,0:3,13:11 - 11:4 - 11:9 - 0:0 - 0:0,3,0,Mkrtchyan Andranik,Avakimyan Davit,fiurst,Avakimyan Davit - Mkrtchyan Andranik,59,24,35,11,-11,24,15,20,0,0,2,7,2,0,0,11,11:13 - 4:11 - 9:11 - 0:0 - 0:0
13880149,2023-09-06 15:45:00,Gevorgyan Gegham - Gevorgyan Hayk,0:3,4:11 - 8:11 - 4:11 - 0:0 - 0:0,0,3,Gevorgyan Gegham,Gevorgyan Hayk,fiurst,Gevorgyan Gegham - Gevorgyan Hayk,49,16,33,17,-17,15,19,15,0,0,7,3,7,0,0,17,4:11 - 8:11 - 4:11 - 0:0 - 0:0
13880147,2023-09-06 15:40:00,Avakimyan Davit - Petrosyan Davit,3:1,11:9 - 11:8 - 4:11 - 11:8 - 0:0,3,1,Avakimyan Davit,Petrosyan Davit,fiurst,Avakimyan Davit - Petrosyan Davit,73,37,36,-1,1,20,19,15,19,0,-2,-3,7,-3,0,-1,11:9 - 11:8 - 4:11 - 11:8 - 0:0
13880142,2023-09-06 15:15:00,Nikoghosyan Narek - Papyan Karen,1:3,5:11 - 11:2 - 10:12 - 11:13 - 0:0,1,3,Nikoghosyan Narek,Papyan Karen,fiurst,Nikoghosyan Narek - Papyan Karen,75,37,38,1,-1,16,13,22,24,0,6,-9,2,2,0,1,5:11 - 11:2 - 10:12 - 11:13 - 0:0
13880143,2023-09-06 15:15:00,Mkrtchyan Andranik - Gevorgyan Gegham,0:3,11:5 - 11:7 - 18:16 - 0:0 - 0:0,3,0,Mkrtchyan Andranik,Gevorgyan Gegham,fiurst,Gevorgyan Gegham - Mkrtchyan Andranik,68,28,40,12,-12,16,18,34,0,0,6,4,2,0,0,12,5:11 - 7:11 - 16:18 - 0:0 - 0:0
13880140,2023-09-06 14:45:00,Antonyan Eduard - Rafayelyan Edgar,0:3,4:11 - 8:11 - 7:11 - 0:0 - 0:0,0,3,Antonyan Eduard,Rafayelyan Edgar,fiurst,Antonyan Eduard - Rafayelyan Edgar,52,19,33,14,-14,15,19,18,0,0,7,3,4,0,0,14,4:11 - 8:11 - 7:11 - 0:0 - 0:0
13880129,2023-09-06 14:30:00,Diaryan Aleksandr - Nikoghosyan Narek,3:0,11:9 - 12:10 - 11:8 - 0:0 - 0:0,3,0,Diaryan Aleksandr,Nikoghosyan Narek,fiurst,Diaryan Aleksandr - Nikoghosyan Narek,61,34,27,-7,7,20,22,19,0,0,-2,-2,-3,0,0,-7,11:9 - 12:10 - 11:8 - 0:0 - 0:0
13880126,2023-09-06 14:15:00,Papyan Karen - Antonyan Eduard,0:3,11:7 - 11:4 - 11:6 - 0:0 - 0:0,3,0,Papyan Karen,Antonyan Eduard,fiurst,Antonyan Eduard - Papyan Karen,50,17,33,16,-16,18,15,17,0,0,4,7,5,0,0,16,7:11 - 4:11 - 6:11 - 0:0 - 0:0
13880122,2023-09-06 14:00:00,Diaryan Aleksandr - Rafayelyan Edgar,0:3,8:11 - 9:11 - 8:11 - 0:0 - 0:0,0,3,Diaryan Aleksandr,Rafayelyan Edgar,fiurst,Diaryan Aleksandr - Rafayelyan Edgar,58,25,33,8,-8,19,20,19,0,0,3,2,3,0,0,8,8:11 - 9:11 - 8:11 - 0:0 - 0:0
13880121,2023-09-06 13:45:00,Nikoghosyan Narek - Antonyan Eduard,0:3,11:7 - 11:4 - 11:3 - 0:0 - 0:0,3,0,Nikoghosyan Narek,Antonyan Eduard,fiurst,Antonyan Eduard - Nikoghosyan Narek,47,14,33,19,-19,18,15,14,0,0,4,7,8,0,0,19,7:11 - 4:11 - 3:11 - 0:0 - 0:0
13880117,2023-09-06 13:35:00,Papyan Karen - Diaryan Aleksandr,3:0,2:11 - 3:11 - 6:11 - 0:0 - 0:0,0,3,Papyan Karen,Diaryan Aleksandr,fiurst,Diaryan Aleksandr - Papyan Karen,44,33,11,-22,22,13,14,17,0,0,-9,-8,-5,0,0,-22,11:2 - 11:3 - 11:6 - 0:0 - 0:0
13880110,2023-09-06 13:15:00,Rafayelyan Edgar - Nikoghosyan Narek,0:3,11:7 - 11:7 - 11:7 - 0:0 - 0:0,3,0,Rafayelyan Edgar,Nikoghosyan Narek,fiurst,Nikoghosyan Narek - Rafayelyan Edgar,54,21,33,12,-12,18,18,18,0,0,4,4,4,0,0,12,7:11 - 7:11 - 7:11 - 0:0 - 0:0
13880108,2023-09-06 13:00:00,Antonyan Eduard - Diaryan Aleksandr,2:3,3:11 - 11:9 - 11:9 - 9:11 - 6:11,2,3,Antonyan Eduard,Diaryan Aleksandr,fiurst,Antonyan Eduard - Diaryan Aleksandr,91,40,51,11,-11,14,20,20,20,17,8,-2,-2,2,5,11,3:11 - 11:9 - 11:9 - 9:11 - 6:11
13880106,2023-09-06 12:45:00,Rafayelyan Edgar - Papyan Karen,3:1,15:17 - 11:8 - 7:11 - 4:11 - 0:0,1,3,Rafayelyan Edgar,Papyan Karen,fiurst,Papyan Karen - Rafayelyan Edgar,84,47,37,-10,10,32,19,18,15,0,-2,3,-4,-7,0,-10,17:15 - 8:11 - 11:7 - 11:4 - 0:0
13880092,2023-09-06 12:15:00,Nikoghosyan Narek - Diaryan Aleksandr,2:3,6:11 - 11:6 - 11:5 - 9:11 - 11:9,3,2,Nikoghosyan Narek,Diaryan Aleksandr,fiurst,Diaryan Aleksandr - Nikoghosyan Narek,90,42,48,6,-6,17,17,16,20,20,-5,5,6,-2,2,6,11:6 - 6:11 - 5:11 - 11:9 - 9:11
13880091,2023-09-06 12:05:00,Rafayelyan Edgar - Antonyan Eduard,2:3,11:6 - 11:8 - 9:11 - 8:11 - 11:6,3,2,Rafayelyan Edgar,Antonyan Eduard,fiurst,Antonyan Eduard - Rafayelyan Edgar,92,42,50,8,-8,17,19,20,19,17,5,3,-2,-3,5,8,6:11 - 8:11 - 11:9 - 11:8 - 6:11
13880089,2023-09-06 11:55:00,Papyan Karen - Nikoghosyan Narek,0:3,11:5 - 11:6 - 11:7 - 0:0 - 0:0,3,0,Papyan Karen,Nikoghosyan Narek,fiurst,Nikoghosyan Narek - Papyan Karen,51,18,33,15,-15,16,17,18,0,0,6,5,4,0,0,15,5:11 - 6:11 - 7:11 - 0:0 - 0:0
13880087,2023-09-06 11:30:00,Rafayelyan Edgar - Diaryan Aleksandr,1:3,11:9 - 9:11 - 11:9 - 13:11 - 0:0,3,1,Rafayelyan Edgar,Diaryan Aleksandr,fiurst,Diaryan Aleksandr - Rafayelyan Edgar,84,40,44,4,-4,20,20,20,24,0,2,-2,2,2,0,4,9:11 - 11:9 - 9:11 - 11:13 - 0:0
13880082,2023-09-06 11:20:00,Antonyan Eduard - Papyan Karen,1:3,11:13 - 8:11 - 11:7 - 9:11 - 0:0,1,3,Antonyan Eduard,Papyan Karen,fiurst,Antonyan Eduard - Papyan Karen,81,39,42,3,-3,24,19,18,20,0,2,3,-4,2,0,3,11:13 - 8:11 - 11:7 - 9:11 - 0:0
13880057,2023-09-06 11:10:00,Nikoghosyan Narek - Rafayelyan Edgar,3:0,11:8 - 11:7 - 11:6 - 0:0 - 0:0,3,0,Nikoghosyan Narek,Rafayelyan Edgar,fiurst,Nikoghosyan Narek - Rafayelyan Edgar,54,33,21,-12,12,19,18,17,0,0,-3,-4,-5,0,0,-12,11:8 - 11:7 - 11:6 - 0:0 - 0:0
13880043,2023-09-06 10:45:00,Diaryan Aleksandr - Papyan Karen,3:1,13:11 - 11:9 - 9:11 - 11:8 - 0:0,3,1,Diaryan Aleksandr,Papyan Karen,fiurst,Diaryan Aleksandr - Papyan Karen,83,44,39,-5,5,24,20,20,19,0,-2,-2,2,-3,0,-5,13:11 - 11:9 - 9:11 - 11:8 - 0:0
13880041,2023-09-06 10:30:00,Antonyan Eduard - Nikoghosyan Narek,2:3,11:2 - 3:11 - 11:9 - 8:11 - 8:11,2,3,Antonyan Eduard,Nikoghosyan Narek,fiurst,Antonyan Eduard - Nikoghosyan Narek,85,41,44,3,-3,13,14,20,19,19,-9,8,-2,3,3,3,11:2 - 3:11 - 11:9 - 8:11 - 8:11
13880029,2023-09-06 10:15:00,Papyan Karen - Rafayelyan Edgar,1:3,6:11 - 7:11 - 11:8 - 9:11 - 0:0,1,3,Papyan Karen,Rafayelyan Edgar,fiurst,Papyan Karen - Rafayelyan Edgar,74,33,41,8,-8,17,18,19,20,0,5,4,-3,2,0,8,6:11 - 7:11 - 11:8 - 9:11 - 0:0
13880027,2023-09-06 10:00:00,Diaryan Aleksandr - Antonyan Eduard,1:3,11:6 - 11:1 - 11:13 - 11:3 - 0:0,3,1,Diaryan Aleksandr,Antonyan Eduard,fiurst,Antonyan Eduard - Diaryan Aleksandr,67,23,44,21,-21,17,12,24,14,0,5,10,-2,8,0,21,6:11 - 1:11 - 13:11 - 3:11 - 0:0
13861549,2023-09-05 17:30:00,Darbinyan Armen - Gevorgyan Hayk,0:3,9:11 - 3:11 - 5:11 - 0:0 - 0:0,0,3,Darbinyan Armen,Gevorgyan Hayk,fiurst,Darbinyan Armen - Gevorgyan Hayk,50,17,33,16,-16,20,14,16,0,0,2,8,6,0,0,16,9:11 - 3:11 - 5:11 - 0:0 - 0:0
13861547,2023-09-05 17:15:00,Grigoryan Erik - Mkrtchyan Andranik,0:3,8:11 - 7:11 - 7:11 - 0:0 - 0:0,0,3,Grigoryan Erik,Mkrtchyan Andranik,fiurst,Grigoryan Erik - Mkrtchyan Andranik,55,22,33,11,-11,19,18,18,0,0,3,4,4,0,0,11,8:11 - 7:11 - 7:11 - 0:0 - 0:0
13861545,2023-09-05 17:00:00,Gevorgyan Gegham - Darbinyan Armen,0:3,11:8 - 11:3 - 11:6 - 0:0 - 0:0,3,0,Gevorgyan Gegham,Darbinyan Armen,fiurst,Darbinyan Armen - Gevorgyan Gegham,50,17,33,16,-16,19,14,17,0,0,3,8,5,0,0,16,8:11 - 3:11 - 6:11 - 0:0 - 0:0
13861542,2023-09-05 16:45:00,Grigoryan Erik - Gevorgyan Hayk,3:0,7:11 - 7:11 - 11:13 - 0:0 - 0:0,0,3,Grigoryan Erik,Gevorgyan Hayk,fiurst,Gevorgyan Hayk - Grigoryan Erik,60,35,25,-10,10,18,18,24,0,0,-4,-4,-2,0,0,-10,11:7 - 11:7 - 13:11 - 0:0 - 0:0
13861540,2023-09-05 16:40:00,Mkrtchyan Andranik - Gevorgyan Gegham,0:3,11:8 - 11:8 - 11:9 - 0:0 - 0:0,3,0,Mkrtchyan Andranik,Gevorgyan Gegham,fiurst,Gevorgyan Gegham - Mkrtchyan Andranik,58,25,33,8,-8,19,19,20,0,0,3,3,2,0,0,8,8:11 - 8:11 - 9:11 - 0:0 - 0:0
13861538,2023-09-05 16:15:00,Darbinyan Armen - Grigoryan Erik,3:1,11:4 - 13:15 - 11:3 - 11:9 - 0:0,3,1,Darbinyan Armen,Grigoryan Erik,fiurst,Darbinyan Armen - Grigoryan Erik,77,46,31,-15,15,15,28,14,20,0,-7,2,-8,-2,0,-15,11:4 - 13:15 - 11:3 - 11:9 - 0:0
13861525,2023-09-05 16:00:00,Gevorgyan Hayk - Gevorgyan Gegham,2:3,6:11 - 11:6 - 15:17 - 12:10 - 11:3,3,2,Gevorgyan Hayk,Gevorgyan Gegham,fiurst,Gevorgyan Gegham - Gevorgyan Hayk,102,47,55,8,-8,17,17,32,22,14,-5,5,-2,2,8,8,11:6 - 6:11 - 17:15 - 10:12 - 3:11
13861522,2023-09-05 15:45:00,Mkrtchyan Andranik - Darbinyan Armen,0:3,11:6 - 11:5 - 11:5 - 0:0 - 0:0,3,0,Mkrtchyan Andranik,Darbinyan Armen,fiurst,Darbinyan Armen - Mkrtchyan Andranik,49,16,33,17,-17,17,16,16,0,0,5,6,6,0,0,17,6:11 - 5:11 - 5:11 - 0:0 - 0:0
13860998,2023-09-05 15:30:00,Gevorgyan Gegham - Grigoryan Erik,3:2,5:11 - 11:8 - 8:11 - 12:10 - 11:6,3,2,Gevorgyan Gegham,Grigoryan Erik,fiurst,Gevorgyan Gegham - Grigoryan Erik,93,47,46,-1,1,16,19,19,22,17,6,-3,3,-2,-5,-1,5:11 - 11:8 - 8:11 - 12:10 - 11:6
13860997,2023-09-05 15:15:00,Gevorgyan Hayk - Mkrtchyan Andranik,1:3,9:11 - 6:11 - 11:8 - 7:11 - 0:0,1,3,Gevorgyan Hayk,Mkrtchyan Andranik,fiurst,Gevorgyan Hayk - Mkrtchyan Andranik,74,33,41,8,-8,20,17,19,18,0,2,5,-3,4,0,8,9:11 - 6:11 - 11:8 - 7:11 - 0:0
13860993,2023-09-05 15:00:00,Soghomonyan Hrayr - Antonyan Eduard,3:2,11:3 - 6:11 - 5:11 - 11:7 - 6:11,2,3,Soghomonyan Hrayr,Antonyan Eduard,fiurst,Antonyan Eduard - Soghomonyan Hrayr,82,43,39,-4,4,14,17,16,18,17,8,-5,-6,4,-5,-4,3:11 - 11:6 - 11:5 - 7:11 - 11:6
13860989,2023-09-05 14:45:00,Nazaryan Mushegh - Nikoghosyan Narek,0:3,4:11 - 4:11 - 5:11 - 0:0 - 0:0,0,3,Nazaryan Mushegh,Nikoghosyan Narek,fiurst,Nazaryan Mushegh - Nikoghosyan Narek,46,13,33,20,-20,15,15,16,0,0,7,7,6,0,0,20,4:11 - 4:11 - 5:11 - 0:0 - 0:0
13860987,2023-09-05 14:35:00,Papyan Karen - Soghomonyan Hrayr,3:0,11:5 - 11:4 - 11:4 - 0:0 - 0:0,3,0,Papyan Karen,Soghomonyan Hrayr,fiurst,Papyan Karen - Soghomonyan Hrayr,46,33,13,-20,20,16,15,15,0,0,-6,-7,-7,0,0,-20,11:5 - 11:4 - 11:4 - 0:0 - 0:0
13860986,2023-09-05 14:20:00,Antonyan Eduard - Nazaryan Mushegh,3:0,11:5 - 12:10 - 11:8 - 0:0 - 0:0,3,0,Antonyan Eduard,Nazaryan Mushegh,fiurst,Antonyan Eduard - Nazaryan Mushegh,57,34,23,-11,11,16,22,19,0,0,-6,-2,-3,0,0,-11,11:5 - 12:10 - 11:8 - 0:0 - 0:0
13860985,2023-09-05 14:05:00,Papyan Karen - Nikoghosyan Narek,1:3,8:11 - 11:9 - 11:7 - 11:9 - 0:0,3,1,Papyan Karen,Nikoghosyan Narek,fiurst,Nikoghosyan Narek - Papyan Karen,77,36,41,5,-5,19,20,18,20,0,-3,2,4,2,0,5,11:8 - 9:11 - 7:11 - 9:11 - 0:0
13860974,2023-09-05 14:00:00,Soghomonyan Hrayr - Nazaryan Mushegh,0:3,11:4 - 11:9 - 11:4 - 0:0 - 0:0,3,0,Soghomonyan Hrayr,Nazaryan Mushegh,fiurst,Nazaryan Mushegh - Soghomonyan Hrayr,50,17,33,16,-16,15,20,15,0,0,7,2,7,0,0,16,4:11 - 9:11 - 4:11 - 0:0 - 0:0
13860973,2023-09-05 13:30:00,Antonyan Eduard - Papyan Karen,1:3,8:11 - 11:8 - 7:11 - 10:12 - 0:0,1,3,Antonyan Eduard,Papyan Karen,fiurst,Antonyan Eduard - Papyan Karen,78,36,42,6,-6,19,19,18,22,0,3,-3,4,2,0,6,8:11 - 11:8 - 7:11 - 10:12 - 0:0
13860972,2023-09-05 13:20:00,Nikoghosyan Narek - Soghomonyan Hrayr,3:2,8:11 - 11:5 - 12:10 - 8:11 - 11:7,3,2,Nikoghosyan Narek,Soghomonyan Hrayr,fiurst,Nikoghosyan Narek - Soghomonyan Hrayr,94,50,44,-6,6,19,16,22,19,18,3,-6,-2,3,-4,-6,8:11 - 11:5 - 12:10 - 8:11 - 11:7
13860969,2023-09-05 13:00:00,Nazaryan Mushegh - Papyan Karen,0:3,9:11 - 9:11 - 1:11 - 0:0 - 0:0,0,3,Nazaryan Mushegh,Papyan Karen,fiurst,Nazaryan Mushegh - Papyan Karen,52,19,33,14,-14,20,20,12,0,0,2,2,10,0,0,14,9:11 - 9:11 - 1:11 - 0:0 - 0:0
13860966,2023-09-05 12:50:00,Nikoghosyan Narek - Antonyan Eduard,0:3,11:5 - 11:3 - 12:10 - 0:0 - 0:0,3,0,Nikoghosyan Narek,Antonyan Eduard,fiurst,Antonyan Eduard - Nikoghosyan Narek,52,18,34,16,-16,16,14,22,0,0,6,8,2,0,0,16,5:11 - 3:11 - 10:12 - 0:0 - 0:0
13860963,2023-09-05 12:40:00,Soghomonyan Hrayr - Papyan Karen,3:0,6:11 - 3:11 - 5:11 - 0:0 - 0:0,0,3,Soghomonyan Hrayr,Papyan Karen,fiurst,Papyan Karen - Soghomonyan Hrayr,47,33,14,-19,19,17,14,16,0,0,-5,-8,-6,0,0,-19,11:6 - 11:3 - 11:5 - 0:0 - 0:0
13860948,2023-09-05 12:10:00,Antonyan Eduard - Soghomonyan Hrayr,3:1,11:8 - 11:9 - 8:11 - 11:8 - 0:0,3,1,Antonyan Eduard,Soghomonyan Hrayr,fiurst,Antonyan Eduard - Soghomonyan Hrayr,77,41,36,-5,5,19,20,19,19,0,-3,-2,3,-3,0,-5,11:8 - 11:9 - 8:11 - 11:8 - 0:0
13860959,2023-09-05 12:10:00,Nikoghosyan Narek - Nazaryan Mushegh,1:3,11:9 - 11:9 - 6:11 - 11:8 - 0:0,3,1,Nikoghosyan Narek,Nazaryan Mushegh,fiurst,Nazaryan Mushegh - Nikoghosyan Narek,76,37,39,2,-2,20,20,17,19,0,2,2,-5,3,0,2,9:11 - 9:11 - 11:6 - 8:11 - 0:0
13860943,2023-09-05 11:40:00,Nikoghosyan Narek - Papyan Karen,1:3,11:5 - 10:12 - 6:11 - 9:11 - 0:0,1,3,Nikoghosyan Narek,Papyan Karen,fiurst,Nikoghosyan Narek - Papyan Karen,75,36,39,3,-3,16,22,17,20,0,-6,2,5,2,0,3,11:5 - 10:12 - 6:11 - 9:11 - 0:0
13860942,2023-09-05 11:35:00,Nazaryan Mushegh - Antonyan Eduard,3:1,8:11 - 12:10 - 10:12 - 9:11 - 0:0,1,3,Nazaryan Mushegh,Antonyan Eduard,fiurst,Antonyan Eduard - Nazaryan Mushegh,83,44,39,-5,5,19,22,22,20,0,-3,2,-2,-2,0,-5,11:8 - 10:12 - 12:10 - 11:9 - 0:0
13860941,2023-09-05 11:05:00,Soghomonyan Hrayr - Nikoghosyan Narek,3:1,8:11 - 2:11 - 11:9 - 6:11 - 0:0,1,3,Soghomonyan Hrayr,Nikoghosyan Narek,fiurst,Nikoghosyan Narek - Soghomonyan Hrayr,69,42,27,-15,15,19,13,20,17,0,-3,-9,2,-5,0,-15,11:8 - 11:2 - 9:11 - 11:6 - 0:0
13860938,2023-09-05 10:55:00,Papyan Karen - Antonyan Eduard,2:3,13:11 - 11:8 - 8:11 - 8:11 - 11:9,3,2,Papyan Karen,Antonyan Eduard,fiurst,Antonyan Eduard - Papyan Karen,101,50,51,1,-1,24,19,19,19,20,2,3,-3,-3,2,1,11:13 - 8:11 - 11:8 - 11:8 - 9:11
13860936,2023-09-05 10:35:00,Nazaryan Mushegh - Soghomonyan Hrayr,3:2,7:11 - 11:5 - 12:10 - 4:11 - 11:6,3,2,Nazaryan Mushegh,Soghomonyan Hrayr,fiurst,Nazaryan Mushegh - Soghomonyan Hrayr,88,45,43,-2,2,18,16,22,15,17,4,-6,-2,7,-5,-2,7:11 - 11:5 - 12:10 - 4:11 - 11:6
13860933,2023-09-05 10:15:00,Antonyan Eduard - Nikoghosyan Narek,3:2,6:11 - 8:11 - 11:6 - 11:9 - 11:4,3,2,Antonyan Eduard,Nikoghosyan Narek,fiurst,Antonyan Eduard - Nikoghosyan Narek,88,47,41,-6,6,17,19,17,20,15,5,3,-5,-2,-7,-6,6:11 - 8:11 - 11:6 - 11:9 - 11:4
13860921,2023-09-05 10:00:00,Papyan Karen - Nazaryan Mushegh,1:3,13:11 - 7:11 - 12:10 - 15:13 - 0:0,3,1,Papyan Karen,Nazaryan Mushegh,fiurst,Nazaryan Mushegh - Papyan Karen,92,45,47,2,-2,24,18,22,28,0,2,-4,2,2,0,2,11:13 - 11:7 - 10:12 - 13:15 - 0:0
13840376,2023-09-04 17:30:00,Petrosyan Davit - Grigoryan Erik,0:3,11:6 - 11:7 - 11:4 - 0:0 - 0:0,3,0,Petrosyan Davit,Grigoryan Erik,fiurst,Grigoryan Erik - Petrosyan Davit,50,17,33,16,-16,17,18,15,0,0,5,4,7,0,0,16,6:11 - 7:11 - 4:11 - 0:0 - 0:0
13840371,2023-09-04 17:15:00,Gevorgyan Hayk - Darbinyan Armen,0:3,11:6 - 11:9 - 11:9 - 0:0 - 0:0,3,0,Gevorgyan Hayk,Darbinyan Armen,fiurst,Darbinyan Armen - Gevorgyan Hayk,57,24,33,9,-9,17,20,20,0,0,5,2,2,0,0,9,6:11 - 9:11 - 9:11 - 0:0 - 0:0
13840365,2023-09-04 17:00:00,Mkrtchyan Andranik - Petrosyan Davit,1:3,11:3 - 5:11 - 6:11 - 9:11 - 0:0,1,3,Mkrtchyan Andranik,Petrosyan Davit,fiurst,Mkrtchyan Andranik - Petrosyan Davit,67,31,36,5,-5,14,16,17,20,0,-8,6,5,2,0,5,11:3 - 5:11 - 6:11 - 9:11 - 0:0
13840358,2023-09-04 16:45:00,Gevorgyan Hayk - Grigoryan Erik,3:1,7:11 - 11:4 - 11:8 - 12:10 - 0:0,3,1,Gevorgyan Hayk,Grigoryan Erik,fiurst,Gevorgyan Hayk - Grigoryan Erik,74,41,33,-8,8,18,15,19,22,0,4,-7,-3,-2,0,-8,7:11 - 11:4 - 11:8 - 12:10 - 0:0
13840345,2023-09-04 16:30:00,Darbinyan Armen - Mkrtchyan Andranik,2:3,11:6 - 11:9 - 9:11 - 10:12 - 6:11,2,3,Darbinyan Armen,Mkrtchyan Andranik,fiurst,Darbinyan Armen - Mkrtchyan Andranik,96,47,49,2,-2,17,20,20,22,17,-5,-2,2,2,5,2,11:6 - 11:9 - 9:11 - 10:12 - 6:11
13840342,2023-09-04 16:15:00,Petrosyan Davit - Gevorgyan Hayk,0:3,11:9 - 11:6 - 13:11 - 0:0 - 0:0,3,0,Petrosyan Davit,Gevorgyan Hayk,fiurst,Gevorgyan Hayk - Petrosyan Davit,61,26,35,9,-9,20,17,24,0,0,2,5,2,0,0,9,9:11 - 6:11 - 11:13 - 0:0 - 0:0
13840321,2023-09-04 16:00:00,Grigoryan Erik - Mkrtchyan Andranik,0:3,8:11 - 6:11 - 7:11 - 0:0 - 0:0,0,3,Grigoryan Erik,Mkrtchyan Andranik,fiurst,Grigoryan Erik - Mkrtchyan Andranik,54,21,33,12,-12,19,17,18,0,0,3,5,4,0,0,12,8:11 - 6:11 - 7:11 - 0:0 - 0:0
13840295,2023-09-04 15:45:00,Darbinyan Armen - Petrosyan Davit,1:3,7:11 - 7:11 - 11:9 - 6:11 - 0:0,1,3,Darbinyan Armen,Petrosyan Davit,fiurst,Darbinyan Armen - Petrosyan Davit,73,31,42,11,-11,18,18,20,17,0,4,4,-2,5,0,11,7:11 - 7:11 - 11:9 - 6:11 - 0:0
13840292,2023-09-04 15:30:00,Mkrtchyan Andranik - Gevorgyan Hayk,1:3,11:7 - 10:12 - 11:3 - 11:9 - 0:0,3,1,Mkrtchyan Andranik,Gevorgyan Hayk,fiurst,Gevorgyan Hayk - Mkrtchyan Andranik,74,31,43,12,-12,18,22,14,20,0,4,-2,8,2,0,12,7:11 - 12:10 - 3:11 - 9:11 - 0:0
13840289,2023-09-04 15:15:00,Grigoryan Erik - Darbinyan Armen,3:1,9:11 - 7:11 - 11:4 - 12:14 - 0:0,1,3,Grigoryan Erik,Darbinyan Armen,fiurst,Darbinyan Armen - Grigoryan Erik,79,40,39,-1,1,20,18,15,26,0,-2,-4,7,-2,0,-1,11:9 - 11:7 - 4:11 - 14:12 - 0:0
13840288,2023-09-04 15:00:00,Papyan Karen - Diaryan Aleksandr,1:3,11:6 - 14:12 - 5:11 - 11:8 - 0:0,3,1,Papyan Karen,Diaryan Aleksandr,fiurst,Diaryan Aleksandr - Papyan Karen,78,37,41,4,-4,17,26,16,19,0,5,2,-6,3,0,4,6:11 - 12:14 - 11:5 - 8:11 - 0:0
13840281,2023-09-04 14:45:00,Nazaryan Mushegh - Soghomonyan Hrayr,1:3,4:11 - 11:8 - 8:11 - 6:11 - 0:0,1,3,Nazaryan Mushegh,Soghomonyan Hrayr,fiurst,Nazaryan Mushegh - Soghomonyan Hrayr,70,29,41,12,-12,15,19,19,17,0,7,-3,3,5,0,12,4:11 - 11:8 - 8:11 - 6:11 - 0:0
13840271,2023-09-04 14:30:00,Rafayelyan Edgar - Papyan Karen,3:1,8:11 - 5:11 - 14:12 - 8:11 - 0:0,1,3,Rafayelyan Edgar,Papyan Karen,fiurst,Papyan Karen - Rafayelyan Edgar,80,45,35,-10,10,19,16,26,19,0,-3,-6,2,-3,0,-10,11:8 - 11:5 - 12:14 - 11:8 - 0:0
13840269,2023-09-04 14:15:00,Diaryan Aleksandr - Nazaryan Mushegh,3:2,9:11 - 6:11 - 14:12 - 11:9 - 11:6,3,2,Diaryan Aleksandr,Nazaryan Mushegh,fiurst,Diaryan Aleksandr - Nazaryan Mushegh,100,51,49,-2,2,20,17,26,20,17,2,5,-2,-2,-5,-2,9:11 - 6:11 - 14:12 - 11:9 - 11:6
13840268,2023-09-04 14:00:00,Rafayelyan Edgar - Soghomonyan Hrayr,3:0,12:10 - 11:8 - 11:4 - 0:0 - 0:0,3,0,Rafayelyan Edgar,Soghomonyan Hrayr,fiurst,Rafayelyan Edgar - Soghomonyan Hrayr,56,34,22,-12,12,22,19,15,0,0,-2,-3,-7,0,0,-12,12:10 - 11:8 - 11:4 - 0:0 - 0:0
13840264,2023-09-04 13:45:00,Papyan Karen - Nazaryan Mushegh,0:3,11:7 - 11:8 - 11:4 - 0:0 - 0:0,3,0,Papyan Karen,Nazaryan Mushegh,fiurst,Nazaryan Mushegh - Papyan Karen,52,19,33,14,-14,18,19,15,0,0,4,3,7,0,0,14,7:11 - 8:11 - 4:11 - 0:0 - 0:0
13840260,2023-09-04 13:30:00,Diaryan Aleksandr - Rafayelyan Edgar,1:3,11:8 - 8:11 - 9:11 - 8:11 - 0:0,1,3,Diaryan Aleksandr,Rafayelyan Edgar,fiurst,Diaryan Aleksandr - Rafayelyan Edgar,77,36,41,5,-5,19,19,20,19,0,-3,3,2,3,0,5,11:8 - 8:11 - 9:11 - 8:11 - 0:0
13840259,2023-09-04 13:15:00,Soghomonyan Hrayr - Papyan Karen,3:1,8:11 - 11:9 - 7:11 - 5:11 - 0:0,1,3,Soghomonyan Hrayr,Papyan Karen,fiurst,Papyan Karen - Soghomonyan Hrayr,73,42,31,-11,11,19,20,18,16,0,-3,2,-4,-6,0,-11,11:8 - 9:11 - 11:7 - 11:5 - 0:0
13840257,2023-09-04 13:00:00,Nazaryan Mushegh - Rafayelyan Edgar,0:3,9:11 - 7:11 - 6:11 - 0:0 - 0:0,0,3,Nazaryan Mushegh,Rafayelyan Edgar,fiurst,Nazaryan Mushegh - Rafayelyan Edgar,55,22,33,11,-11,20,18,17,0,0,2,4,5,0,0,11,9:11 - 7:11 - 6:11 - 0:0 - 0:0
13839710,2023-09-04 12:45:00,Soghomonyan Hrayr - Diaryan Aleksandr,3:0,6:11 - 14:16 - 8:11 - 0:0 - 0:0,0,3,Soghomonyan Hrayr,Diaryan Aleksandr,fiurst,Diaryan Aleksandr - Soghomonyan Hrayr,66,38,28,-10,10,17,30,19,0,0,-5,-2,-3,0,0,-10,11:6 - 16:14 - 11:8 - 0:0 - 0:0
13839697,2023-09-04 12:20:00,Papyan Karen - Rafayelyan Edgar,3:1,11:6 - 11:6 - 7:11 - 11:9 - 0:0,3,1,Papyan Karen,Rafayelyan Edgar,fiurst,Papyan Karen - Rafayelyan Edgar,72,40,32,-8,8,17,17,18,20,0,-5,-5,4,-2,0,-8,11:6 - 11:6 - 7:11 - 11:9 - 0:0
13839686,2023-09-04 12:00:00,Soghomonyan Hrayr - Nazaryan Mushegh,0:3,11:8 - 11:8 - 13:11 - 0:0 - 0:0,3,0,Soghomonyan Hrayr,Nazaryan Mushegh,fiurst,Nazaryan Mushegh - Soghomonyan Hrayr,62,27,35,8,-8,19,19,24,0,0,3,3,2,0,0,8,8:11 - 8:11 - 11:13 - 0:0 - 0:0
13839684,2023-09-04 11:45:00,Diaryan Aleksandr - Papyan Karen,3:2,11:13 - 11:9 - 11:2 - 6:11 - 11:5,3,2,Diaryan Aleksandr,Papyan Karen,fiurst,Diaryan Aleksandr - Papyan Karen,90,50,40,-10,10,24,20,13,17,16,2,-2,-9,5,-6,-10,11:13 - 11:9 - 11:2 - 6:11 - 11:5
13839681,2023-09-04 11:30:00,Soghomonyan Hrayr - Rafayelyan Edgar,3:0,3:11 - 6:11 - 5:11 - 0:0 - 0:0,0,3,Soghomonyan Hrayr,Rafayelyan Edgar,fiurst,Rafayelyan Edgar - Soghomonyan Hrayr,47,33,14,-19,19,14,17,16,0,0,-8,-5,-6,0,0,-19,11:3 - 11:6 - 11:5 - 0:0 - 0:0
13839676,2023-09-04 11:15:00,Nazaryan Mushegh - Diaryan Aleksandr,3:0,11:13 - 2:11 - 8:11 - 0:0 - 0:0,0,3,Nazaryan Mushegh,Diaryan Aleksandr,fiurst,Diaryan Aleksandr - Nazaryan Mushegh,56,35,21,-14,14,24,13,19,0,0,-2,-9,-3,0,0,-14,13:11 - 11:2 - 11:8 - 0:0 - 0:0
13839673,2023-09-04 11:00:00,Papyan Karen - Soghomonyan Hrayr,3:1,9:11 - 11:6 - 13:11 - 11:8 - 0:0,3,1,Papyan Karen,Soghomonyan Hrayr,fiurst,Papyan Karen - Soghomonyan Hrayr,80,44,36,-8,8,20,17,24,19,0,2,-5,-2,-3,0,-8,9:11 - 11:6 - 13:11 - 11:8 - 0:0
13839660,2023-09-04 10:45:00,Rafayelyan Edgar - Diaryan Aleksandr,2:3,11:9 - 6:11 - 11:6 - 7:11 - 11:9,3,2,Rafayelyan Edgar,Diaryan Aleksandr,fiurst,Diaryan Aleksandr - Rafayelyan Edgar,92,46,46,0,0,20,17,17,18,20,2,-5,5,-4,2,0,9:11 - 11:6 - 6:11 - 11:7 - 9:11
13839657,2023-09-04 10:30:00,Nazaryan Mushegh - Papyan Karen,1:3,5:11 - 13:15 - 11:9 - 9:11 - 0:0,1,3,Nazaryan Mushegh,Papyan Karen,fiurst,Nazaryan Mushegh - Papyan Karen,84,38,46,8,-8,16,28,20,20,0,6,2,-2,2,0,8,5:11 - 13:15 - 11:9 - 9:11 - 0:0
13839652,2023-09-04 10:15:00,Diaryan Aleksandr - Soghomonyan Hrayr,3:1,11:4 - 11:2 - 11:13 - 11:6 - 0:0,3,1,Diaryan Aleksandr,Soghomonyan Hrayr,fiurst,Diaryan Aleksandr - Soghomonyan Hrayr,69,44,25,-19,19,15,13,24,17,0,-7,-9,2,-5,0,-19,11:4 - 11:2 - 11:13 - 11:6 - 0:0
13839647,2023-09-04 10:00:00,Rafayelyan Edgar - Nazaryan Mushegh,3:2,5:11 - 11:8 - 11:5 - 7:11 - 8:11,2,3,Rafayelyan Edgar,Nazaryan Mushegh,fiurst,Nazaryan Mushegh - Rafayelyan Edgar,88,46,42,-4,4,16,19,16,18,19,-6,3,6,-4,-3,-4,11:5 - 8:11 - 5:11 - 11:7 - 11:8
13822583,2023-09-03 17:30:00,Gevorgyan Gegham - Darbinyan Armen,0:3,11:5 - 11:5 - 11:5 - 0:0 - 0:0,3,0,Gevorgyan Gegham,Darbinyan Armen,fiurst,Darbinyan Armen - Gevorgyan Gegham,48,15,33,18,-18,16,16,16,0,0,6,6,6,0,0,18,5:11 - 5:11 - 5:11 - 0:0 - 0:0
13822578,2023-09-03 17:15:00,Gevorgyan Hayk - Petrosyan Davit,3:1,7:11 - 11:4 - 13:11 - 14:12 - 0:0,3,1,Gevorgyan Hayk,Petrosyan Davit,fiurst,Gevorgyan Hayk - Petrosyan Davit,83,45,38,-7,7,18,15,24,26,0,4,-7,-2,-2,0,-7,7:11 - 11:4 - 13:11 - 14:12 - 0:0
13822658,2023-09-03 17:00:00,Grigoryan Erik - Gevorgyan Gegham,3:0,4:11 - 7:11 - 9:11 - 0:0 - 0:0,0,3,Grigoryan Erik,Gevorgyan Gegham,fiurst,Gevorgyan Gegham - Grigoryan Erik,53,33,20,-13,13,15,18,20,0,0,-7,-4,-2,0,0,-13,11:4 - 11:7 - 11:9 - 0:0 - 0:0
13822656,2023-09-03 16:50:00,Gevorgyan Hayk - Darbinyan Armen,0:3,11:2 - 11:7 - 11:3 - 0:0 - 0:0,3,0,Gevorgyan Hayk,Darbinyan Armen,fiurst,Darbinyan Armen - Gevorgyan Hayk,45,12,33,21,-21,13,18,14,0,0,9,4,8,0,0,21,2:11 - 7:11 - 3:11 - 0:0 - 0:0
13822654,2023-09-03 16:30:00,Petrosyan Davit - Grigoryan Erik,0:3,11:4 - 11:3 - 11:5 - 0:0 - 0:0,3,0,Petrosyan Davit,Grigoryan Erik,fiurst,Grigoryan Erik - Petrosyan Davit,45,12,33,21,-21,15,14,16,0,0,7,8,6,0,0,21,4:11 - 3:11 - 5:11 - 0:0 - 0:0
13822652,2023-09-03 16:15:00,Gevorgyan Gegham - Gevorgyan Hayk,2:3,11:8 - 6:11 - 6:11 - 13:11 - 4:11,2,3,Gevorgyan Gegham,Gevorgyan Hayk,fiurst,Gevorgyan Gegham - Gevorgyan Hayk,92,40,52,12,-12,19,17,17,24,15,-3,5,5,-2,7,12,11:8 - 6:11 - 6:11 - 13:11 - 4:11
13822649,2023-09-03 16:00:00,Darbinyan Armen - Grigoryan Erik,3:0,11:9 - 12:10 - 11:9 - 0:0 - 0:0,3,0,Darbinyan Armen,Grigoryan Erik,fiurst,Darbinyan Armen - Grigoryan Erik,62,34,28,-6,6,20,22,20,0,0,-2,-2,-2,0,0,-6,11:9 - 12:10 - 11:9 - 0:0 - 0:0
13822648,2023-09-03 15:45:00,Petrosyan Davit - Gevorgyan Gegham,0:3,11:7 - 11:7 - 11:1 - 0:0 - 0:0,3,0,Petrosyan Davit,Gevorgyan Gegham,fiurst,Gevorgyan Gegham - Petrosyan Davit,48,15,33,18,-18,18,18,12,0,0,4,4,10,0,0,18,7:11 - 7:11 - 1:11 - 0:0 - 0:0
13822644,2023-09-03 15:30:00,Grigoryan Erik - Gevorgyan Hayk,3:0,6:11 - 6:11 - 6:11 - 0:0 - 0:0,0,3,Grigoryan Erik,Gevorgyan Hayk,fiurst,Gevorgyan Hayk - Grigoryan Erik,51,33,18,-15,15,17,17,17,0,0,-5,-5,-5,0,0,-15,11:6 - 11:6 - 11:6 - 0:0 - 0:0
13822643,2023-09-03 15:15:00,Darbinyan Armen - Petrosyan Davit,3:2,11:7 - 6:11 - 9:11 - 11:8 - 12:10,3,2,Darbinyan Armen,Petrosyan Davit,fiurst,Darbinyan Armen - Petrosyan Davit,96,49,47,-2,2,18,17,20,19,22,-4,5,2,-3,-2,-2,11:7 - 6:11 - 9:11 - 11:8 - 12:10
13822632,2023-09-03 15:00:00,Nazaryan Mushegh - Rafayelyan Edgar,0:3,8:11 - 8:11 - 4:11 - 0:0 - 0:0,0,3,Nazaryan Mushegh,Rafayelyan Edgar,fiurst,Nazaryan Mushegh - Rafayelyan Edgar,53,20,33,13,-13,19,19,15,0,0,3,3,7,0,0,13,8:11 - 8:11 - 4:11 - 0:0 - 0:0
13822628,2023-09-03 14:45:00,Diaryan Aleksandr - Antonyan Eduard,0:3,11:8 - 11:3 - 11:2 - 0:0 - 0:0,3,0,Diaryan Aleksandr,Antonyan Eduard,fiurst,Antonyan Eduard - Diaryan Aleksandr,46,13,33,20,-20,19,14,13,0,0,3,8,9,0,0,20,8:11 - 3:11 - 2:11 - 0:0 - 0:0
13822624,2023-09-03 14:35:00,Nikoghosyan Narek - Nazaryan Mushegh,0:3,11:3 - 11:9 - 11:5 - 0:0 - 0:0,3,0,Nikoghosyan Narek,Nazaryan Mushegh,fiurst,Nazaryan Mushegh - Nikoghosyan Narek,50,17,33,16,-16,14,20,16,0,0,8,2,6,0,0,16,3:11 - 9:11 - 5:11 - 0:0 - 0:0
13822622,2023-09-03 14:15:00,Rafayelyan Edgar - Diaryan Aleksandr,3:1,11:8 - 6:11 - 10:12 - 5:11 - 0:0,1,3,Rafayelyan Edgar,Diaryan Aleksandr,fiurst,Diaryan Aleksandr - Rafayelyan Edgar,74,42,32,-10,10,19,17,22,16,0,3,-5,-2,-6,0,-10,8:11 - 11:6 - 12:10 - 11:5 - 0:0
13822621,2023-09-03 14:00:00,Nikoghosyan Narek - Antonyan Eduard,1:3,11:6 - 11:9 - 6:11 - 11:3 - 0:0,3,1,Nikoghosyan Narek,Antonyan Eduard,fiurst,Antonyan Eduard - Nikoghosyan Narek,68,29,39,10,-10,17,20,17,14,0,5,2,-5,8,0,10,6:11 - 9:11 - 11:6 - 3:11 - 0:0
13822610,2023-09-03 13:45:00,Nazaryan Mushegh - Diaryan Aleksandr,3:2,11:8 - 11:9 - 9:11 - 7:11 - 7:11,2,3,Nazaryan Mushegh,Diaryan Aleksandr,fiurst,Diaryan Aleksandr - Nazaryan Mushegh,95,50,45,-5,5,19,20,20,18,18,3,2,-2,-4,-4,-5,8:11 - 9:11 - 11:9 - 11:7 - 11:7
13822609,2023-09-03 13:30:00,Rafayelyan Edgar - Nikoghosyan Narek,3:0,9:11 - 10:12 - 6:11 - 0:0 - 0:0,0,3,Rafayelyan Edgar,Nikoghosyan Narek,fiurst,Nikoghosyan Narek - Rafayelyan Edgar,59,34,25,-9,9,20,22,17,0,0,-2,-2,-5,0,0,-9,11:9 - 12:10 - 11:6 - 0:0 - 0:0
13822604,2023-09-03 13:15:00,Antonyan Eduard - Nazaryan Mushegh,3:0,11:9 - 11:7 - 12:10 - 0:0 - 0:0,3,0,Antonyan Eduard,Nazaryan Mushegh,fiurst,Antonyan Eduard - Nazaryan Mushegh,60,34,26,-8,8,20,18,22,0,0,-2,-4,-2,0,0,-8,11:9 - 11:7 - 12:10 - 0:0 - 0:0
13822585,2023-09-03 13:00:00,Diaryan Aleksandr - Nikoghosyan Narek,1:3,7:11 - 8:11 - 11:6 - 8:11 - 0:0,1,3,Diaryan Aleksandr,Nikoghosyan Narek,fiurst,Diaryan Aleksandr - Nikoghosyan Narek,73,34,39,5,-5,18,19,17,19,0,4,3,-5,3,0,5,7:11 - 8:11 - 11:6 - 8:11 - 0:0
13822581,2023-09-03 12:45:00,Antonyan Eduard - Rafayelyan Edgar,3:0,14:12 - 11:8 - 11:7 - 0:0 - 0:0,3,0,Antonyan Eduard,Rafayelyan Edgar,fiurst,Antonyan Eduard - Rafayelyan Edgar,63,36,27,-9,9,26,19,18,0,0,-2,-3,-4,0,0,-9,14:12 - 11:8 - 11:7 - 0:0 - 0:0
13822575,2023-09-03 12:15:00,Nazaryan Mushegh - Nikoghosyan Narek,0:3,9:11 - 9:11 - 5:11 - 0:0 - 0:0,0,3,Nazaryan Mushegh,Nikoghosyan Narek,fiurst,Nazaryan Mushegh - Nikoghosyan Narek,56,23,33,10,-10,20,20,16,0,0,2,2,6,0,0,10,9:11 - 9:11 - 5:11 - 0:0 - 0:0
13822493,2023-09-03 12:10:00,Antonyan Eduard - Diaryan Aleksandr,3:1,11:9 - 10:12 - 11:6 - 11:8 - 0:0,3,1,Antonyan Eduard,Diaryan Aleksandr,fiurst,Antonyan Eduard - Diaryan Aleksandr,78,43,35,-8,8,20,22,17,19,0,-2,2,-5,-3,0,-8,11:9 - 10:12 - 11:6 - 11:8 - 0:0
13822492,2023-09-03 11:55:00,Rafayelyan Edgar - Nazaryan Mushegh,0:3,11:9 - 11:7 - 11:5 - 0:0 - 0:0,3,0,Rafayelyan Edgar,Nazaryan Mushegh,fiurst,Nazaryan Mushegh - Rafayelyan Edgar,54,21,33,12,-12,20,18,16,0,0,2,4,6,0,0,12,9:11 - 7:11 - 5:11 - 0:0 - 0:0
13822488,2023-09-03 11:30:00,Antonyan Eduard - Nikoghosyan Narek,3:2,11:9 - 7:11 - 9:11 - 11:7 - 11:9,3,2,Antonyan Eduard,Nikoghosyan Narek,fiurst,Antonyan Eduard - Nikoghosyan Narek,96,49,47,-2,2,20,18,20,18,20,-2,4,2,-4,-2,-2,11:9 - 7:11 - 9:11 - 11:7 - 11:9
13822484,2023-09-03 11:15:00,Diaryan Aleksandr - Rafayelyan Edgar,3:1,11:6 - 7:11 - 11:8 - 11:7 - 0:0,3,1,Diaryan Aleksandr,Rafayelyan Edgar,fiurst,Diaryan Aleksandr - Rafayelyan Edgar,72,40,32,-8,8,17,18,19,18,0,-5,4,-3,-4,0,-8,11:6 - 7:11 - 11:8 - 11:7 - 0:0
13822483,2023-09-03 11:00:00,Nazaryan Mushegh - Antonyan Eduard,3:0,6:11 - 5:11 - 5:11 - 0:0 - 0:0,0,3,Nazaryan Mushegh,Antonyan Eduard,fiurst,Antonyan Eduard - Nazaryan Mushegh,49,33,16,-17,17,17,16,16,0,0,-5,-6,-6,0,0,-17,11:6 - 11:5 - 11:5 - 0:0 - 0:0
13822480,2023-09-03 10:45:00,Nikoghosyan Narek - Rafayelyan Edgar,2:3,4:11 - 12:10 - 7:11 - 11:7 - 8:11,2,3,Nikoghosyan Narek,Rafayelyan Edgar,fiurst,Nikoghosyan Narek - Rafayelyan Edgar,92,42,50,8,-8,15,22,18,18,19,7,-2,4,-4,3,8,4:11 - 12:10 - 7:11 - 11:7 - 8:11
13822479,2023-09-03 10:35:00,Diaryan Aleksandr - Nazaryan Mushegh,3:0,11:8 - 11:4 - 11:5 - 0:0 - 0:0,3,0,Diaryan Aleksandr,Nazaryan Mushegh,fiurst,Diaryan Aleksandr - Nazaryan Mushegh,50,33,17,-16,16,19,15,16,0,0,-3,-7,-6,0,0,-16,11:8 - 11:4 - 11:5 - 0:0 - 0:0
13822478,2023-09-03 10:15:00,Rafayelyan Edgar - Antonyan Eduard,2:3,11:0 - 7:11 - 7:11 - 11:8 - 11:5,3,2,Rafayelyan Edgar,Antonyan Eduard,fiurst,Antonyan Eduard - Rafayelyan Edgar,82,35,47,12,-12,11,18,18,19,16,11,-4,-4,3,6,12,0:11 - 11:7 - 11:7 - 8:11 - 5:11
13822465,2023-09-03 10:05:00,Nikoghosyan Narek - Diaryan Aleksandr,2:3,11:6 - 9:11 - 8:11 - 11:9 - 11:6,3,2,Nikoghosyan Narek,Diaryan Aleksandr,fiurst,Diaryan Aleksandr - Nikoghosyan Narek,93,43,50,7,-7,17,20,19,20,17,5,-2,-3,2,5,7,6:11 - 11:9 - 11:8 - 9:11 - 6:11
13804756,2023-09-02 17:35:00,Gevorgyan Hayk - Petrosyan Davit,2:3,7:11 - 11:8 - 11:8 - 3:11 - 10:12,2,3,Gevorgyan Hayk,Petrosyan Davit,fiurst,Gevorgyan Hayk - Petrosyan Davit,92,42,50,8,-8,18,19,19,14,22,4,-3,-3,8,2,8,7:11 - 11:8 - 11:8 - 3:11 - 10:12
13804743,2023-09-02 17:15:00,Darbinyan Armen - Gevorgyan Gegham,0:3,6:11 - 6:11 - 5:11 - 0:0 - 0:0,0,3,Darbinyan Armen,Gevorgyan Gegham,fiurst,Darbinyan Armen - Gevorgyan Gegham,50,17,33,16,-16,17,17,16,0,0,5,5,6,0,0,16,6:11 - 6:11 - 5:11 - 0:0 - 0:0
13804742,2023-09-02 17:00:00,Mkrtchyan Andranik - Gevorgyan Hayk,0:3,11:9 - 11:9 - 12:10 - 0:0 - 0:0,3,0,Mkrtchyan Andranik,Gevorgyan Hayk,fiurst,Gevorgyan Hayk - Mkrtchyan Andranik,62,28,34,6,-6,20,20,22,0,0,2,2,2,0,0,6,9:11 - 9:11 - 10:12 - 0:0 - 0:0
13804741,2023-09-02 16:45:00,Darbinyan Armen - Petrosyan Davit,1:3,9:11 - 12:10 - 8:11 - 6:11 - 0:0,1,3,Darbinyan Armen,Petrosyan Davit,fiurst,Darbinyan Armen - Petrosyan Davit,78,35,43,8,-8,20,22,19,17,0,2,-2,3,5,0,8,9:11 - 12:10 - 8:11 - 6:11 - 0:0
13804738,2023-09-02 16:30:00,Gevorgyan Gegham - Mkrtchyan Andranik,3:1,11:8 - 13:11 - 4:11 - 11:8 - 0:0,3,1,Gevorgyan Gegham,Mkrtchyan Andranik,fiurst,Gevorgyan Gegham - Mkrtchyan Andranik,77,39,38,-1,1,19,24,15,19,0,-3,-2,7,-3,0,-1,11:8 - 13:11 - 4:11 - 11:8 - 0:0
13804737,2023-09-02 16:15:00,Gevorgyan Hayk - Darbinyan Armen,3:0,11:13 - 8:11 - 9:11 - 0:0 - 0:0,0,3,Gevorgyan Hayk,Darbinyan Armen,fiurst,Darbinyan Armen - Gevorgyan Hayk,63,35,28,-7,7,24,19,20,0,0,-2,-3,-2,0,0,-7,13:11 - 11:8 - 11:9 - 0:0 - 0:0
13804734,2023-09-02 16:00:00,Petrosyan Davit - Mkrtchyan Andranik,3:1,11:7 - 8:11 - 8:11 - 9:11 - 0:0,1,3,Petrosyan Davit,Mkrtchyan Andranik,fiurst,Mkrtchyan Andranik - Petrosyan Davit,76,40,36,-4,4,18,19,19,20,0,4,-3,-3,-2,0,-4,7:11 - 11:8 - 11:8 - 11:9 - 0:0
13804720,2023-09-02 15:50:00,Gevorgyan Gegham - Gevorgyan Hayk,3:0,12:10 - 11:8 - 11:8 - 0:0 - 0:0,3,0,Gevorgyan Gegham,Gevorgyan Hayk,fiurst,Gevorgyan Gegham - Gevorgyan Hayk,60,34,26,-8,8,22,19,19,0,0,-2,-3,-3,0,0,-8,12:10 - 11:8 - 11:8 - 0:0 - 0:0
13804717,2023-09-02 15:45:00,Mkrtchyan Andranik - Darbinyan Armen,0:3,11:5 - 11:9 - 11:6 - 0:0 - 0:0,3,0,Mkrtchyan Andranik,Darbinyan Armen,fiurst,Darbinyan Armen - Mkrtchyan Andranik,53,20,33,13,-13,16,20,17,0,0,6,2,5,0,0,13,5:11 - 9:11 - 6:11 - 0:0 - 0:0
13804667,2023-09-02 15:20:00,Petrosyan Davit - Gevorgyan Gegham,3:1,11:7 - 14:16 - 9:11 - 3:11 - 0:0,1,3,Petrosyan Davit,Gevorgyan Gegham,fiurst,Gevorgyan Gegham - Petrosyan Davit,82,45,37,-8,8,18,30,20,14,0,4,-2,-2,-8,0,-8,7:11 - 16:14 - 11:9 - 11:3 - 0:0
13804659,2023-09-02 15:15:00,Antonyan Eduard - Papyan Karen,3:2,7:11 - 11:8 - 11:7 - 5:11 - 11:8,3,2,Antonyan Eduard,Papyan Karen,fiurst,Antonyan Eduard - Papyan Karen,90,45,45,0,0,18,19,18,16,19,4,-3,-4,6,-3,0,7:11 - 11:8 - 11:7 - 5:11 - 11:8
13804656,2023-09-02 14:55:00,Nikoghosyan Narek - Rafayelyan Edgar,1:3,11:2 - 7:11 - 9:11 - 8:11 - 0:0,1,3,Nikoghosyan Narek,Rafayelyan Edgar,fiurst,Nikoghosyan Narek - Rafayelyan Edgar,70,35,35,0,0,13,18,20,19,0,-9,4,2,3,0,0,11:2 - 7:11 - 9:11 - 8:11 - 0:0
13804645,2023-09-02 14:40:00,Soghomonyan Hrayr - Antonyan Eduard,3:1,11:8 - 8:11 - 11:13 - 10:12 - 0:0,1,3,Soghomonyan Hrayr,Antonyan Eduard,fiurst,Antonyan Eduard - Soghomonyan Hrayr,84,44,40,-4,4,19,19,24,22,0,3,-3,-2,-2,0,-4,8:11 - 11:8 - 13:11 - 12:10 - 0:0
13804643,2023-09-02 14:25:00,Papyan Karen - Nikoghosyan Narek,0:3,13:11 - 12:10 - 11:8 - 0:0 - 0:0,3,0,Papyan Karen,Nikoghosyan Narek,fiurst,Nikoghosyan Narek - Papyan Karen,65,29,36,7,-7,24,22,19,0,0,2,2,3,0,0,7,11:13 - 10:12 - 8:11 - 0:0 - 0:0
13804640,2023-09-02 14:05:00,Soghomonyan Hrayr - Rafayelyan Edgar,3:2,13:11 - 13:11 - 7:11 - 8:11 - 8:11,2,3,Soghomonyan Hrayr,Rafayelyan Edgar,fiurst,Rafayelyan Edgar - Soghomonyan Hrayr,104,55,49,-6,6,24,24,18,19,19,2,2,-4,-3,-3,-6,11:13 - 11:13 - 11:7 - 11:8 - 11:8
13804637,2023-09-02 13:50:00,Antonyan Eduard - Nikoghosyan Narek,3:2,8:11 - 12:10 - 3:11 - 11:9 - 11:5,3,2,Antonyan Eduard,Nikoghosyan Narek,fiurst,Antonyan Eduard - Nikoghosyan Narek,91,45,46,1,-1,19,22,14,20,16,3,-2,8,-2,-6,1,8:11 - 12:10 - 3:11 - 11:9 - 11:5
13804634,2023-09-02 13:40:00,Papyan Karen - Soghomonyan Hrayr,3:0,11:3 - 11:6 - 11:6 - 0:0 - 0:0,3,0,Papyan Karen,Soghomonyan Hrayr,fiurst,Papyan Karen - Soghomonyan Hrayr,48,33,15,-18,18,14,17,17,0,0,-8,-5,-5,0,0,-18,11:3 - 11:6 - 11:6 - 0:0 - 0:0
13804632,2023-09-02 13:25:00,Rafayelyan Edgar - Antonyan Eduard,3:0,6:11 - 3:11 - 9:11 - 0:0 - 0:0,0,3,Rafayelyan Edgar,Antonyan Eduard,fiurst,Antonyan Eduard - Rafayelyan Edgar,51,33,18,-15,15,17,14,20,0,0,-5,-8,-2,0,0,-15,11:6 - 11:3 - 11:9 - 0:0 - 0:0
13804627,2023-09-02 13:00:00,Nikoghosyan Narek - Soghomonyan Hrayr,3:2,9:11 - 10:12 - 12:10 - 12:10 - 11:7,3,2,Nikoghosyan Narek,Soghomonyan Hrayr,fiurst,Nikoghosyan Narek - Soghomonyan Hrayr,104,54,50,-4,4,20,22,22,22,18,2,2,-2,-2,-4,-4,9:11 - 10:12 - 12:10 - 12:10 - 11:7
13804622,2023-09-02 12:55:00,Rafayelyan Edgar - Papyan Karen,3:1,11:1 - 9:11 - 9:11 - 9:11 - 0:0,1,3,Rafayelyan Edgar,Papyan Karen,fiurst,Papyan Karen - Rafayelyan Edgar,72,34,38,4,-4,12,20,20,20,0,10,-2,-2,-2,0,4,1:11 - 11:9 - 11:9 - 11:9 - 0:0
13804339,2023-09-02 12:20:00,Rafayelyan Edgar - Nikoghosyan Narek,2:3,10:12 - 11:6 - 11:7 - 7:11 - 11:6,3,2,Rafayelyan Edgar,Nikoghosyan Narek,fiurst,Nikoghosyan Narek - Rafayelyan Edgar,92,42,50,8,-8,22,17,18,18,17,-2,5,4,-4,5,8,12:10 - 6:11 - 7:11 - 11:7 - 6:11
13804343,2023-09-02 12:20:00,Antonyan Eduard - Soghomonyan Hrayr,3:1,6:11 - 11:8 - 12:10 - 11:9 - 0:0,3,1,Antonyan Eduard,Soghomonyan Hrayr,fiurst,Antonyan Eduard - Soghomonyan Hrayr,78,40,38,-2,2,17,19,22,20,0,5,-3,-2,-2,0,-2,6:11 - 11:8 - 12:10 - 11:9 - 0:0
13804336,2023-09-02 11:55:00,Papyan Karen - Antonyan Eduard,3:0,2:11 - 4:11 - 9:11 - 0:0 - 0:0,0,3,Papyan Karen,Antonyan Eduard,fiurst,Antonyan Eduard - Papyan Karen,48,33,15,-18,18,13,15,20,0,0,-9,-7,-2,0,0,-18,11:2 - 11:4 - 11:9 - 0:0 - 0:0
13804332,2023-09-02 11:50:00,Rafayelyan Edgar - Soghomonyan Hrayr,3:1,3:11 - 11:5 - 13:11 - 11:9 - 0:0,3,1,Rafayelyan Edgar,Soghomonyan Hrayr,fiurst,Rafayelyan Edgar - Soghomonyan Hrayr,74,38,36,-2,2,14,16,24,20,0,8,-6,-2,-2,0,-2,3:11 - 11:5 - 13:11 - 11:9 - 0:0
13804331,2023-09-02 11:25:00,Nikoghosyan Narek - Papyan Karen,3:0,11:2 - 11:7 - 11:4 - 0:0 - 0:0,3,0,Nikoghosyan Narek,Papyan Karen,fiurst,Nikoghosyan Narek - Papyan Karen,46,33,13,-20,20,13,18,15,0,0,-9,-4,-7,0,0,-20,11:2 - 11:7 - 11:4 - 0:0 - 0:0
13804329,2023-09-02 11:20:00,Antonyan Eduard - Rafayelyan Edgar,2:3,11:5 - 11:9 - 7:11 - 4:11 - 9:11,2,3,Antonyan Eduard,Rafayelyan Edgar,fiurst,Antonyan Eduard - Rafayelyan Edgar,89,42,47,5,-5,16,20,18,15,20,-6,-2,4,7,2,5,11:5 - 11:9 - 7:11 - 4:11 - 9:11
13804319,2023-09-02 10:45:00,Nikoghosyan Narek - Antonyan Eduard,3:1,9:11 - 11:13 - 17:15 - 6:11 - 0:0,1,3,Nikoghosyan Narek,Antonyan Eduard,fiurst,Antonyan Eduard - Nikoghosyan Narek,93,50,43,-7,7,20,24,32,17,0,-2,-2,2,-5,0,-7,11:9 - 13:11 - 15:17 - 11:6 - 0:0
13804322,2023-09-02 10:45:00,Soghomonyan Hrayr - Papyan Karen,3:0,8:11 - 5:11 - 7:11 - 0:0 - 0:0,0,3,Soghomonyan Hrayr,Papyan Karen,fiurst,Papyan Karen - Soghomonyan Hrayr,53,33,20,-13,13,19,16,18,0,0,-3,-6,-4,0,0,-13,11:8 - 11:5 - 11:7 - 0:0 - 0:0
13804307,2023-09-02 10:15:00,Papyan Karen - Rafayelyan Edgar,3:2,11:5 - 18:20 - 9:11 - 14:12 - 11:3,3,2,Papyan Karen,Rafayelyan Edgar,fiurst,Papyan Karen - Rafayelyan Edgar,114,63,51,-12,12,16,38,20,26,14,-6,2,2,-2,-8,-12,11:5 - 18:20 - 9:11 - 14:12 - 11:3
13804305,2023-09-02 10:00:00,Soghomonyan Hrayr - Nikoghosyan Narek,2:3,5:11 - 11:7 - 11:9 - 4:11 - 16:14,3,2,Soghomonyan Hrayr,Nikoghosyan Narek,fiurst,Nikoghosyan Narek - Soghomonyan Hrayr,99,52,47,-5,5,16,18,20,15,30,-6,4,2,-7,2,-5,11:5 - 7:11 - 9:11 - 11:4 - 14:16
13784211,2023-09-01 17:30:00,Darbinyan Armen - Gevorgyan Gegham,2:3,15:13 - 11:9 - 6:11 - 8:11 - 6:11,2,3,Darbinyan Armen,Gevorgyan Gegham,fiurst,Darbinyan Armen - Gevorgyan Gegham,101,46,55,9,-9,28,20,17,19,17,-2,-2,5,3,5,9,15:13 - 11:9 - 6:11 - 8:11 - 6:11
13784207,2023-09-01 17:15:00,Grigoryan Erik - Mkrtchyan Andranik,0:3,7:11 - 11:13 - 7:11 - 0:0 - 0:0,0,3,Grigoryan Erik,Mkrtchyan Andranik,fiurst,Grigoryan Erik - Mkrtchyan Andranik,60,25,35,10,-10,18,24,18,0,0,4,2,4,0,0,10,7:11 - 11:13 - 7:11 - 0:0 - 0:0
13784206,2023-09-01 17:00:00,Petrosyan Davit - Darbinyan Armen,1:3,11:9 - 11:8 - 9:11 - 11:4 - 0:0,3,1,Petrosyan Davit,Darbinyan Armen,fiurst,Darbinyan Armen - Petrosyan Davit,74,32,42,10,-10,20,19,20,15,0,2,3,-2,7,0,10,9:11 - 8:11 - 11:9 - 4:11 - 0:0
13784202,2023-09-01 16:45:00,Grigoryan Erik - Gevorgyan Gegham,3:1,6:11 - 11:5 - 6:11 - 5:11 - 0:0,1,3,Grigoryan Erik,Gevorgyan Gegham,fiurst,Gevorgyan Gegham - Grigoryan Erik,66,38,28,-10,10,17,16,17,16,0,-5,6,-5,-6,0,-10,11:6 - 5:11 - 11:6 - 11:5 - 0:0
13784191,2023-09-01 16:30:00,Mkrtchyan Andranik - Petrosyan Davit,3:2,11:3 - 11:7 - 8:11 - 9:11 - 11:8,3,2,Mkrtchyan Andranik,Petrosyan Davit,fiurst,Mkrtchyan Andranik - Petrosyan Davit,90,50,40,-10,10,14,18,19,20,19,-8,-4,3,2,-3,-10,11:3 - 11:7 - 8:11 - 9:11 - 11:8
13784179,2023-09-01 16:15:00,Darbinyan Armen - Grigoryan Erik,1:3,6:11 - 11:4 - 6:11 - 9:11 - 0:0,1,3,Darbinyan Armen,Grigoryan Erik,fiurst,Darbinyan Armen - Grigoryan Erik,69,32,37,5,-5,17,15,17,20,0,5,-7,5,2,0,5,6:11 - 11:4 - 6:11 - 9:11 - 0:0
13784173,2023-09-01 16:00:00,Gevorgyan Gegham - Petrosyan Davit,0:3,7:11 - 7:11 - 8:11 - 0:0 - 0:0,0,3,Gevorgyan Gegham,Petrosyan Davit,fiurst,Gevorgyan Gegham - Petrosyan Davit,55,22,33,11,-11,18,18,19,0,0,4,4,3,0,0,11,7:11 - 7:11 - 8:11 - 0:0 - 0:0
13784154,2023-09-01 15:55:00,Mkrtchyan Andranik - Darbinyan Armen,0:3,11:9 - 11:9 - 11:7 - 0:0 - 0:0,3,0,Mkrtchyan Andranik,Darbinyan Armen,fiurst,Darbinyan Armen - Mkrtchyan Andranik,58,25,33,8,-8,20,20,18,0,0,2,2,4,0,0,8,9:11 - 9:11 - 7:11 - 0:0 - 0:0
13784142,2023-09-01 15:30:00,Petrosyan Davit - Grigoryan Erik,1:3,11:7 - 11:4 - 9:11 - 11:4 - 0:0,3,1,Petrosyan Davit,Grigoryan Erik,fiurst,Grigoryan Erik - Petrosyan Davit,68,26,42,16,-16,18,15,20,15,0,4,7,-2,7,0,16,7:11 - 4:11 - 11:9 - 4:11 - 0:0
13784141,2023-09-01 15:15:00,Gevorgyan Gegham - Mkrtchyan Andranik,2:3,11:4 - 7:11 - 14:12 - 8:11 - 12:14,2,3,Gevorgyan Gegham,Mkrtchyan Andranik,fiurst,Gevorgyan Gegham - Mkrtchyan Andranik,104,52,52,0,0,15,18,26,19,26,-7,4,-2,3,2,0,11:4 - 7:11 - 14:12 - 8:11 - 12:14
13784132,2023-09-01 15:05:00,Nikoghosyan Narek - Nazaryan Mushegh,0:3,11:6 - 11:3 - 11:6 - 0:0 - 0:0,3,0,Nikoghosyan Narek,Nazaryan Mushegh,fiurst,Nazaryan Mushegh - Nikoghosyan Narek,48,15,33,18,-18,17,14,17,0,0,5,8,5,0,0,18,6:11 - 3:11 - 6:11 - 0:0 - 0:0
13784126,2023-09-01 14:40:00,Diaryan Aleksandr - Nikoghosyan Narek,1:3,9:11 - 11:2 - 9:11 - 6:11 - 0:0,1,3,Diaryan Aleksandr,Nikoghosyan Narek,fiurst,Diaryan Aleksandr - Nikoghosyan Narek,70,35,35,0,0,20,13,20,17,0,2,-9,2,5,0,0,9:11 - 11:2 - 9:11 - 6:11 - 0:0
13784114,2023-09-01 14:05:00,Diaryan Aleksandr - Soghomonyan Hrayr,3:1,12:10 - 11:6 - 10:12 - 11:6 - 0:0,3,1,Diaryan Aleksandr,Soghomonyan Hrayr,fiurst,Diaryan Aleksandr - Soghomonyan Hrayr,78,44,34,-10,10,22,17,22,17,0,-2,-5,2,-5,0,-10,12:10 - 11:6 - 10:12 - 11:6 - 0:0
13784097,2023-09-01 13:30:00,Nazaryan Mushegh - Diaryan Aleksandr,3:2,11:7 - 13:15 - 10:12 - 11:7 - 5:11,2,3,Nazaryan Mushegh,Diaryan Aleksandr,fiurst,Diaryan Aleksandr - Nazaryan Mushegh,102,52,50,-2,2,18,28,22,18,16,4,-2,-2,4,-6,-2,7:11 - 15:13 - 12:10 - 7:11 - 11:5
13784086,2023-09-01 13:15:00,Soghomonyan Hrayr - Nikoghosyan Narek,3:1,12:14 - 11:8 - 7:11 - 8:11 - 0:0,1,3,Soghomonyan Hrayr,Nikoghosyan Narek,fiurst,Nikoghosyan Narek - Soghomonyan Hrayr,82,44,38,-6,6,26,19,18,19,0,-2,3,-4,-3,0,-6,14:12 - 8:11 - 11:7 - 11:8 - 0:0
13784083,2023-09-01 13:00:00,Papyan Karen - Diaryan Aleksandr,3:0,1:11 - 2:11 - 1:11 - 0:0 - 0:0,0,3,Papyan Karen,Diaryan Aleksandr,fiurst,Diaryan Aleksandr - Papyan Karen,37,33,4,-29,29,12,13,12,0,0,-10,-9,-10,0,0,-29,11:1 - 11:2 - 11:1 - 0:0 - 0:0
13784076,2023-09-01 12:45:00,Soghomonyan Hrayr - Nazaryan Mushegh,3:0,6:11 - 10:12 - 5:11 - 0:0 - 0:0,0,3,Soghomonyan Hrayr,Nazaryan Mushegh,fiurst,Nazaryan Mushegh - Soghomonyan Hrayr,55,34,21,-13,13,17,22,16,0,0,-5,-2,-6,0,0,-13,11:6 - 12:10 - 11:5 - 0:0 - 0:0
13784069,2023-09-01 12:20:00,Soghomonyan Hrayr - Papyan Karen,0:3,11:8 - 11:4 - 11:6 - 0:0 - 0:0,3,0,Soghomonyan Hrayr,Papyan Karen,fiurst,Papyan Karen - Soghomonyan Hrayr,51,18,33,15,-15,19,15,17,0,0,3,7,5,0,0,15,8:11 - 4:11 - 6:11 - 0:0 - 0:0
13784073,2023-09-01 12:20:00,Nikoghosyan Narek - Diaryan Aleksandr,0:3,11:6 - 11:3 - 11:6 - 0:0 - 0:0,3,0,Nikoghosyan Narek,Diaryan Aleksandr,fiurst,Diaryan Aleksandr - Nikoghosyan Narek,48,15,33,18,-18,17,14,17,0,0,5,8,5,0,0,18,6:11 - 3:11 - 6:11 - 0:0 - 0:0
13784056,2023-09-01 11:45:00,Nazaryan Mushegh - Nikoghosyan Narek,0:3,8:11 - 6:11 - 5:11 - 0:0 - 0:0,0,3,Nazaryan Mushegh,Nikoghosyan Narek,fiurst,Nazaryan Mushegh - Nikoghosyan Narek,52,19,33,14,-14,19,17,16,0,0,3,5,6,0,0,14,8:11 - 6:11 - 5:11 - 0:0 - 0:0
13784054,2023-09-01 11:35:00,Soghomonyan Hrayr - Diaryan Aleksandr,3:2,11:13 - 9:11 - 11:8 - 13:11 - 10:12,2,3,Soghomonyan Hrayr,Diaryan Aleksandr,fiurst,Diaryan Aleksandr - Soghomonyan Hrayr,109,55,54,-1,1,24,20,19,24,22,-2,-2,3,2,-2,-1,13:11 - 11:9 - 8:11 - 11:13 - 12:10
13784050,2023-09-01 11:15:00,Papyan Karen - Nazaryan Mushegh,3:1,7:11 - 11:9 - 9:11 - 5:11 - 0:0,1,3,Papyan Karen,Nazaryan Mushegh,fiurst,Nazaryan Mushegh - Papyan Karen,74,42,32,-10,10,18,20,20,16,0,-4,2,-2,-6,0,-10,11:7 - 9:11 - 11:9 - 11:5 - 0:0
13784048,2023-09-01 11:00:00,Nikoghosyan Narek - Soghomonyan Hrayr,3:1,12:10 - 6:11 - 11:2 - 11:7 - 0:0,3,1,Nikoghosyan Narek,Soghomonyan Hrayr,fiurst,Nikoghosyan Narek - Soghomonyan Hrayr,70,40,30,-10,10,22,17,13,18,0,-2,5,-9,-4,0,-10,12:10 - 6:11 - 11:2 - 11:7 - 0:0
13784035,2023-09-01 10:50:00,Diaryan Aleksandr - Nazaryan Mushegh,3:0,11:9 - 11:5 - 11:5 - 0:0 - 0:0,3,0,Diaryan Aleksandr,Nazaryan Mushegh,fiurst,Diaryan Aleksandr - Nazaryan Mushegh,52,33,19,-14,14,20,16,16,0,0,-2,-6,-6,0,0,-14,11:9 - 11:5 - 11:5 - 0:0 - 0:0
13784033,2023-09-01 10:30:00,Papyan Karen - Nikoghosyan Narek,3:1,12:10 - 3:11 - 9:11 - 3:11 - 0:0,1,3,Papyan Karen,Nikoghosyan Narek,fiurst,Nikoghosyan Narek - Papyan Karen,70,43,27,-16,16,22,14,20,14,0,2,-8,-2,-8,0,-16,10:12 - 11:3 - 11:9 - 11:3 - 0:0
13784031,2023-09-01 10:15:00,Nazaryan Mushegh - Soghomonyan Hrayr,3:2,11:7 - 11:9 - 2:11 - 9:11 - 11:7,3,2,Nazaryan Mushegh,Soghomonyan Hrayr,fiurst,Nazaryan Mushegh - Soghomonyan Hrayr,89,44,45,1,-1,18,20,13,20,18,-4,-2,9,2,-4,1,11:7 - 11:9 - 2:11 - 9:11 - 11:7
13784028,2023-09-01 10:00:00,Diaryan Aleksandr - Papyan Karen,3:0,11:2 - 11:3 - 11:2 - 0:0 - 0:0,3,0,Diaryan Aleksandr,Papyan Karen,fiurst,Diaryan Aleksandr - Papyan Karen,40,33,7,-26,26,13,14,13,0,0,-9,-8,-9,0,0,-26,11:2 - 11:3 - 11:2 - 0:0 - 0:0
13769251,2023-08-31 17:30:00,Gevorgyan Gegham - Mkrtchyan Andranik,1:3,11:9 - 9:11 - 12:14 - 7:11 - 0:0,1,3,Gevorgyan Gegham,Mkrtchyan Andranik,fiurst,Gevorgyan Gegham - Mkrtchyan Andranik,84,39,45,6,-6,20,20,26,18,0,-2,2,2,4,0,6,11:9 - 9:11 - 12:14 - 7:11 - 0:0
13769249,2023-08-31 17:15:00,Petrosyan Davit - Gevorgyan Hayk,3:1,12:10 - 6:11 - 7:11 - 5:11 - 0:0,1,3,Petrosyan Davit,Gevorgyan Hayk,fiurst,Gevorgyan Hayk - Petrosyan Davit,73,43,30,-13,13,22,17,18,16,0,2,-5,-4,-6,0,-13,10:12 - 11:6 - 11:7 - 11:5 - 0:0
13769246,2023-08-31 17:00:00,Grigoryan Erik - Gevorgyan Gegham,3:0,5:11 - 6:11 - 7:11 - 0:0 - 0:0,0,3,Grigoryan Erik,Gevorgyan Gegham,fiurst,Gevorgyan Gegham - Grigoryan Erik,51,33,18,-15,15,16,17,18,0,0,-6,-5,-4,0,0,-15,11:5 - 11:6 - 11:7 - 0:0 - 0:0
13769242,2023-08-31 16:45:00,Petrosyan Davit - Mkrtchyan Andranik,3:1,11:6 - 12:14 - 9:11 - 9:11 - 0:0,1,3,Petrosyan Davit,Mkrtchyan Andranik,fiurst,Mkrtchyan Andranik - Petrosyan Davit,83,42,41,-1,1,17,26,20,20,0,5,-2,-2,-2,0,-1,6:11 - 14:12 - 11:9 - 11:9 - 0:0
13769227,2023-08-31 16:30:00,Gevorgyan Hayk - Grigoryan Erik,3:0,11:4 - 11:6 - 11:9 - 0:0 - 0:0,3,0,Gevorgyan Hayk,Grigoryan Erik,fiurst,Gevorgyan Hayk - Grigoryan Erik,52,33,19,-14,14,15,17,20,0,0,-7,-5,-2,0,0,-14,11:4 - 11:6 - 11:9 - 0:0 - 0:0
13769225,2023-08-31 16:15:00,Gevorgyan Gegham - Petrosyan Davit,3:1,11:7 - 11:5 - 7:11 - 12:10 - 0:0,3,1,Gevorgyan Gegham,Petrosyan Davit,fiurst,Gevorgyan Gegham - Petrosyan Davit,74,41,33,-8,8,18,16,18,22,0,-4,-6,4,-2,0,-8,11:7 - 11:5 - 7:11 - 12:10 - 0:0
13769190,2023-08-31 16:00:00,Mkrtchyan Andranik - Grigoryan Erik,0:3,11:6 - 13:11 - 11:6 - 0:0 - 0:0,3,0,Mkrtchyan Andranik,Grigoryan Erik,fiurst,Grigoryan Erik - Mkrtchyan Andranik,58,23,35,12,-12,17,24,17,0,0,5,2,5,0,0,12,6:11 - 11:13 - 6:11 - 0:0 - 0:0
13769184,2023-08-31 15:50:00,Gevorgyan Hayk - Gevorgyan Gegham,0:3,11:6 - 11:7 - 11:2 - 0:0 - 0:0,3,0,Gevorgyan Hayk,Gevorgyan Gegham,fiurst,Gevorgyan Gegham - Gevorgyan Hayk,48,15,33,18,-18,17,18,13,0,0,5,4,9,0,0,18,6:11 - 7:11 - 2:11 - 0:0 - 0:0
13769180,2023-08-31 15:30:00,Grigoryan Erik - Petrosyan Davit,0:3,5:11 - 3:11 - 6:11 - 0:0 - 0:0,0,3,Grigoryan Erik,Petrosyan Davit,fiurst,Grigoryan Erik - Petrosyan Davit,47,14,33,19,-19,16,14,17,0,0,6,8,5,0,0,19,5:11 - 3:11 - 6:11 - 0:0 - 0:0
13769168,2023-08-31 15:25:00,Mkrtchyan Andranik - Gevorgyan Hayk,3:1,10:12 - 5:11 - 11:8 - 9:11 - 0:0,1,3,Mkrtchyan Andranik,Gevorgyan Hayk,fiurst,Gevorgyan Hayk - Mkrtchyan Andranik,77,42,35,-7,7,22,16,19,20,0,-2,-6,3,-2,0,-7,12:10 - 11:5 - 8:11 - 11:9 - 0:0
13769148,2023-08-31 15:05:00,Antonyan Eduard - Rafayelyan Edgar,3:0,12:10 - 11:9 - 11:9 - 0:0 - 0:0,3,0,Antonyan Eduard,Rafayelyan Edgar,fiurst,Antonyan Eduard - Rafayelyan Edgar,62,34,28,-6,6,22,20,20,0,0,-2,-2,-2,0,0,-6,12:10 - 11:9 - 11:9 - 0:0 - 0:0
13769150,2023-08-31 15:05:00,Diaryan Aleksandr - Soghomonyan Hrayr,3:1,11:7 - 8:11 - 11:7 - 12:10 - 0:0,3,1,Diaryan Aleksandr,Soghomonyan Hrayr,fiurst,Diaryan Aleksandr - Soghomonyan Hrayr,77,42,35,-7,7,18,19,18,22,0,-4,3,-4,-2,0,-7,11:7 - 8:11 - 11:7 - 12:10 - 0:0
13769142,2023-08-31 14:35:00,Nazaryan Mushegh - Diaryan Aleksandr,3:0,7:11 - 10:12 - 4:11 - 0:0 - 0:0,0,3,Nazaryan Mushegh,Diaryan Aleksandr,fiurst,Diaryan Aleksandr - Nazaryan Mushegh,55,34,21,-13,13,18,22,15,0,0,-4,-2,-7,0,0,-13,11:7 - 12:10 - 11:4 - 0:0 - 0:0
13769137,2023-08-31 14:30:00,Soghomonyan Hrayr - Antonyan Eduard,1:3,9:11 - 11:7 - 12:10 - 11:8 - 0:0,3,1,Soghomonyan Hrayr,Antonyan Eduard,fiurst,Antonyan Eduard - Soghomonyan Hrayr,79,36,43,7,-7,20,18,22,19,0,-2,4,2,3,0,7,11:9 - 7:11 - 10:12 - 8:11 - 0:0
13769126,2023-08-31 14:05:00,Nazaryan Mushegh - Rafayelyan Edgar,3:1,12:10 - 11:8 - 8:11 - 12:10 - 0:0,3,1,Nazaryan Mushegh,Rafayelyan Edgar,fiurst,Nazaryan Mushegh - Rafayelyan Edgar,82,43,39,-4,4,22,19,19,22,0,-2,-3,3,-2,0,-4,12:10 - 11:8 - 8:11 - 12:10 - 0:0
13769054,2023-08-31 13:45:00,Diaryan Aleksandr - Antonyan Eduard,2:3,5:11 - 11:9 - 5:11 - 14:12 - 11:6,3,2,Diaryan Aleksandr,Antonyan Eduard,fiurst,Antonyan Eduard - Diaryan Aleksandr,95,49,46,-3,3,16,20,16,26,17,-6,2,-6,2,5,-3,11:5 - 9:11 - 11:5 - 12:14 - 6:11
13769051,2023-08-31 13:30:00,Soghomonyan Hrayr - Nazaryan Mushegh,3:2,9:11 - 11:5 - 6:11 - 11:7 - 10:12,2,3,Soghomonyan Hrayr,Nazaryan Mushegh,fiurst,Nazaryan Mushegh - Soghomonyan Hrayr,93,46,47,1,-1,20,16,17,18,22,-2,6,-5,4,-2,1,11:9 - 5:11 - 11:6 - 7:11 - 12:10
13769047,2023-08-31 13:15:00,Rafayelyan Edgar - Diaryan Aleksandr,3:0,3:11 - 7:11 - 6:11 - 0:0 - 0:0,0,3,Rafayelyan Edgar,Diaryan Aleksandr,fiurst,Diaryan Aleksandr - Rafayelyan Edgar,49,33,16,-17,17,14,18,17,0,0,-8,-4,-5,0,0,-17,11:3 - 11:7 - 11:6 - 0:0 - 0:0
13769044,2023-08-31 13:00:00,Antonyan Eduard - Nazaryan Mushegh,3:0,11:6 - 11:4 - 11:6 - 0:0 - 0:0,3,0,Antonyan Eduard,Nazaryan Mushegh,fiurst,Antonyan Eduard - Nazaryan Mushegh,49,33,16,-17,17,17,15,17,0,0,-5,-7,-5,0,0,-17,11:6 - 11:4 - 11:6 - 0:0 - 0:0
13769040,2023-08-31 12:45:00,Rafayelyan Edgar - Soghomonyan Hrayr,3:2,11:7 - 9:11 - 11:8 - 6:11 - 11:6,3,2,Rafayelyan Edgar,Soghomonyan Hrayr,fiurst,Rafayelyan Edgar - Soghomonyan Hrayr,91,48,43,-5,5,18,20,19,17,17,-4,2,-3,5,-5,-5,11:7 - 9:11 - 11:8 - 6:11 - 11:6
13769038,2023-08-31 12:15:00,Diaryan Aleksandr - Nazaryan Mushegh,0:3,11:13 - 4:11 - 5:11 - 0:0 - 0:0,0,3,Diaryan Aleksandr,Nazaryan Mushegh,fiurst,Diaryan Aleksandr - Nazaryan Mushegh,55,20,35,15,-15,24,15,16,0,0,2,7,6,0,0,15,11:13 - 4:11 - 5:11 - 0:0 - 0:0
13769026,2023-08-31 12:10:00,Rafayelyan Edgar - Antonyan Eduard,2:3,11:5 - 3:11 - 5:11 - 12:10 - 11:4,3,2,Rafayelyan Edgar,Antonyan Eduard,fiurst,Antonyan Eduard - Rafayelyan Edgar,83,41,42,1,-1,16,14,16,22,15,6,-8,-6,2,7,1,5:11 - 11:3 - 11:5 - 10:12 - 4:11
13769025,2023-08-31 11:45:00,Soghomonyan Hrayr - Diaryan Aleksandr,3:0,1:11 - 3:11 - 2:11 - 0:0 - 0:0,0,3,Soghomonyan Hrayr,Diaryan Aleksandr,fiurst,Diaryan Aleksandr - Soghomonyan Hrayr,39,33,6,-27,27,12,14,13,0,0,-10,-8,-9,0,0,-27,11:1 - 11:3 - 11:2 - 0:0 - 0:0
13769022,2023-08-31 11:35:00,Rafayelyan Edgar - Nazaryan Mushegh,3:2,11:13 - 11:6 - 10:12 - 11:7 - 7:11,2,3,Rafayelyan Edgar,Nazaryan Mushegh,fiurst,Nazaryan Mushegh - Rafayelyan Edgar,99,49,50,1,-1,24,17,22,18,18,-2,5,-2,4,-4,1,13:11 - 6:11 - 12:10 - 7:11 - 11:7
13769007,2023-08-31 11:15:00,Antonyan Eduard - Soghomonyan Hrayr,3:1,9:11 - 11:6 - 11:8 - 11:9 - 0:0,3,1,Antonyan Eduard,Soghomonyan Hrayr,fiurst,Antonyan Eduard - Soghomonyan Hrayr,76,42,34,-8,8,20,17,19,20,0,2,-5,-3,-2,0,-8,9:11 - 11:6 - 11:8 - 11:9 - 0:0
13768988,2023-08-31 11:00:00,Diaryan Aleksandr - Rafayelyan Edgar,3:2,7:11 - 11:2 - 8:11 - 11:9 - 11:2,3,2,Diaryan Aleksandr,Rafayelyan Edgar,fiurst,Diaryan Aleksandr - Rafayelyan Edgar,83,48,35,-13,13,18,13,19,20,13,4,-9,3,-2,-9,-13,7:11 - 11:2 - 8:11 - 11:9 - 11:2
13768977,2023-08-31 10:45:00,Nazaryan Mushegh - Soghomonyan Hrayr,1:3,6:11 - 12:10 - 9:11 - 10:12 - 0:0,1,3,Nazaryan Mushegh,Soghomonyan Hrayr,fiurst,Nazaryan Mushegh - Soghomonyan Hrayr,81,37,44,7,-7,17,22,20,22,0,5,-2,2,2,0,7,6:11 - 12:10 - 9:11 - 10:12 - 0:0
13768973,2023-08-31 10:30:00,Antonyan Eduard - Diaryan Aleksandr,1:3,7:11 - 11:2 - 9:11 - 5:11 - 0:0,1,3,Antonyan Eduard,Diaryan Aleksandr,fiurst,Antonyan Eduard - Diaryan Aleksandr,67,32,35,3,-3,18,13,20,16,0,4,-9,2,6,0,3,7:11 - 11:2 - 9:11 - 5:11 - 0:0
13768972,2023-08-31 10:15:00,Soghomonyan Hrayr - Rafayelyan Edgar,3:0,6:11 - 8:11 - 7:11 - 0:0 - 0:0,0,3,Soghomonyan Hrayr,Rafayelyan Edgar,fiurst,Rafayelyan Edgar - Soghomonyan Hrayr,54,33,21,-12,12,17,19,18,0,0,-5,-3,-4,0,0,-12,11:6 - 11:8 - 11:7 - 0:0 - 0:0
13768970,2023-08-31 10:00:00,Nazaryan Mushegh - Antonyan Eduard,3:0,7:11 - 8:11 - 7:11 - 0:0 - 0:0,0,3,Nazaryan Mushegh,Antonyan Eduard,fiurst,Antonyan Eduard - Nazaryan Mushegh,55,33,22,-11,11,18,19,18,0,0,-4,-3,-4,0,0,-11,11:7 - 11:8 - 11:7 - 0:0 - 0:0
13748538,2023-08-30 17:30:00,Gevorgyan Hayk - Grigoryan Erik,3:1,11:1 - 11:5 - 11:13 - 12:10 - 0:0,3,1,Gevorgyan Hayk,Grigoryan Erik,fiurst,Gevorgyan Hayk - Grigoryan Erik,74,45,29,-16,16,12,16,24,22,0,-10,-6,2,-2,0,-16,11:1 - 11:5 - 11:13 - 12:10 - 0:0
13748535,2023-08-30 17:15:00,Darbinyan Armen - Gevorgyan Gegham,1:3,11:5 - 7:11 - 5:11 - 6:11 - 0:0,1,3,Darbinyan Armen,Gevorgyan Gegham,fiurst,Darbinyan Armen - Gevorgyan Gegham,67,29,38,9,-9,16,18,16,17,0,-6,4,6,5,0,9,11:5 - 7:11 - 5:11 - 6:11 - 0:0
13748531,2023-08-30 17:00:00,Mkrtchyan Andranik - Gevorgyan Hayk,0:3,11:5 - 11:5 - 13:11 - 0:0 - 0:0,3,0,Mkrtchyan Andranik,Gevorgyan Hayk,fiurst,Gevorgyan Hayk - Mkrtchyan Andranik,56,21,35,14,-14,16,16,24,0,0,6,6,2,0,0,14,5:11 - 5:11 - 11:13 - 0:0 - 0:0
13748519,2023-08-30 16:45:00,Darbinyan Armen - Grigoryan Erik,1:3,6:11 - 11:3 - 6:11 - 9:11 - 0:0,1,3,Darbinyan Armen,Grigoryan Erik,fiurst,Darbinyan Armen - Grigoryan Erik,68,32,36,4,-4,17,14,17,20,0,5,-8,5,2,0,4,6:11 - 11:3 - 6:11 - 9:11 - 0:0
13748517,2023-08-30 16:30:00,Gevorgyan Gegham - Mkrtchyan Andranik,1:3,10:12 - 11:5 - 4:11 - 10:12 - 0:0,1,3,Gevorgyan Gegham,Mkrtchyan Andranik,fiurst,Gevorgyan Gegham - Mkrtchyan Andranik,75,35,40,5,-5,22,16,15,22,0,2,-6,7,2,0,5,10:12 - 11:5 - 4:11 - 10:12 - 0:0
13748475,2023-08-30 16:15:00,Gevorgyan Hayk - Darbinyan Armen,0:3,11:4 - 11:6 - 11:6 - 0:0 - 0:0,3,0,Gevorgyan Hayk,Darbinyan Armen,fiurst,Darbinyan Armen - Gevorgyan Hayk,49,16,33,17,-17,15,17,17,0,0,7,5,5,0,0,17,4:11 - 6:11 - 6:11 - 0:0 - 0:0
13748470,2023-08-30 16:00:00,Grigoryan Erik - Mkrtchyan Andranik,3:1,11:9 - 11:7 - 8:11 - 11:7 - 0:0,3,1,Grigoryan Erik,Mkrtchyan Andranik,fiurst,Grigoryan Erik - Mkrtchyan Andranik,75,41,34,-7,7,20,18,19,18,0,-2,-4,3,-4,0,-7,11:9 - 11:7 - 8:11 - 11:7 - 0:0
13748467,2023-08-30 15:50:00,Gevorgyan Gegham - Gevorgyan Hayk,2:3,11:4 - 4:11 - 4:11 - 11:1 - 9:11,2,3,Gevorgyan Gegham,Gevorgyan Hayk,fiurst,Gevorgyan Gegham - Gevorgyan Hayk,77,39,38,-1,1,15,15,15,12,20,-7,7,7,-10,2,-1,11:4 - 4:11 - 4:11 - 11:1 - 9:11
13748452,2023-08-30 15:40:00,Mkrtchyan Andranik - Darbinyan Armen,0:3,11:8 - 11:9 - 11:9 - 0:0 - 0:0,3,0,Mkrtchyan Andranik,Darbinyan Armen,fiurst,Darbinyan Armen - Mkrtchyan Andranik,59,26,33,7,-7,19,20,20,0,0,3,2,2,0,0,7,8:11 - 9:11 - 9:11 - 0:0 - 0:0
13748443,2023-08-30 15:20:00,Grigoryan Erik - Gevorgyan Gegham,1:3,7:11 - 11:7 - 11:2 - 11:8 - 0:0,3,1,Grigoryan Erik,Gevorgyan Gegham,fiurst,Gevorgyan Gegham - Grigoryan Erik,68,28,40,12,-12,18,18,13,19,0,-4,4,9,3,0,12,11:7 - 7:11 - 2:11 - 8:11 - 0:0
13747800,2023-08-30 15:15:00,Rafayelyan Edgar - Papyan Karen,2:3,11:8 - 11:7 - 7:11 - 4:11 - 11:8,3,2,Rafayelyan Edgar,Papyan Karen,fiurst,Papyan Karen - Rafayelyan Edgar,89,45,44,-1,1,19,18,18,15,19,3,4,-4,-7,3,-1,8:11 - 7:11 - 11:7 - 11:4 - 8:11
13747792,2023-08-30 15:05:00,Nikoghosyan Narek - Diaryan Aleksandr,3:0,7:11 - 5:11 - 5:11 - 0:0 - 0:0,0,3,Nikoghosyan Narek,Diaryan Aleksandr,fiurst,Diaryan Aleksandr - Nikoghosyan Narek,50,33,17,-16,16,18,16,16,0,0,-4,-6,-6,0,0,-16,11:7 - 11:5 - 11:5 - 0:0 - 0:0
13747775,2023-08-30 14:40:00,Antonyan Eduard - Rafayelyan Edgar,3:2,9:11 - 8:11 - 11:9 - 11:6 - 11:9,3,2,Antonyan Eduard,Rafayelyan Edgar,fiurst,Antonyan Eduard - Rafayelyan Edgar,96,50,46,-4,4,20,19,20,17,20,2,3,-2,-5,-2,-4,9:11 - 8:11 - 11:9 - 11:6 - 11:9
13747770,2023-08-30 14:35:00,Papyan Karen - Nikoghosyan Narek,3:0,6:11 - 9:11 - 13:15 - 0:0 - 0:0,0,3,Papyan Karen,Nikoghosyan Narek,fiurst,Nikoghosyan Narek - Papyan Karen,65,37,28,-9,9,17,20,28,0,0,-5,-2,-2,0,0,-9,11:6 - 11:9 - 15:13 - 0:0 - 0:0
13747759,2023-08-30 14:10:00,Antonyan Eduard - Diaryan Aleksandr,0:3,6:11 - 6:11 - 17:19 - 0:0 - 0:0,0,3,Antonyan Eduard,Diaryan Aleksandr,fiurst,Antonyan Eduard - Diaryan Aleksandr,70,29,41,12,-12,17,17,36,0,0,5,5,2,0,0,12,6:11 - 6:11 - 17:19 - 0:0 - 0:0
13747757,2023-08-30 14:00:00,Rafayelyan Edgar - Nikoghosyan Narek,3:2,11:9 - 11:8 - 7:11 - 4:11 - 6:11,2,3,Rafayelyan Edgar,Nikoghosyan Narek,fiurst,Nikoghosyan Narek - Rafayelyan Edgar,89,50,39,-11,11,20,19,18,15,17,2,3,-4,-7,-5,-11,9:11 - 8:11 - 11:7 - 11:4 - 11:6
13747750,2023-08-30 13:40:00,Papyan Karen - Antonyan Eduard,0:3,11:6 - 11:3 - 11:9 - 0:0 - 0:0,3,0,Papyan Karen,Antonyan Eduard,fiurst,Antonyan Eduard - Papyan Karen,51,18,33,15,-15,17,14,20,0,0,5,8,2,0,0,15,6:11 - 3:11 - 9:11 - 0:0 - 0:0
13747738,2023-08-30 13:30:00,Diaryan Aleksandr - Rafayelyan Edgar,3:1,16:14 - 11:8 - 9:11 - 11:8 - 0:0,3,1,Diaryan Aleksandr,Rafayelyan Edgar,fiurst,Diaryan Aleksandr - Rafayelyan Edgar,88,47,41,-6,6,30,19,20,19,0,-2,-3,2,-3,0,-6,16:14 - 11:8 - 9:11 - 11:8 - 0:0
13747732,2023-08-30 13:10:00,Nikoghosyan Narek - Antonyan Eduard,3:0,7:11 - 7:11 - 11:13 - 0:0 - 0:0,0,3,Nikoghosyan Narek,Antonyan Eduard,fiurst,Antonyan Eduard - Nikoghosyan Narek,60,35,25,-10,10,18,18,24,0,0,-4,-4,-2,0,0,-10,11:7 - 11:7 - 13:11 - 0:0 - 0:0
13747724,2023-08-30 13:00:00,Diaryan Aleksandr - Papyan Karen,2:3,11:7 - 8:11 - 11:7 - 6:11 - 9:11,2,3,Diaryan Aleksandr,Papyan Karen,fiurst,Diaryan Aleksandr - Papyan Karen,92,45,47,2,-2,18,19,18,17,20,-4,3,-4,5,2,2,11:7 - 8:11 - 11:7 - 6:11 - 9:11
13747705,2023-08-30 12:35:00,Rafayelyan Edgar - Antonyan Eduard,3:2,11:7 - 11:13 - 5:11 - 11:5 - 6:11,2,3,Rafayelyan Edgar,Antonyan Eduard,fiurst,Antonyan Eduard - Rafayelyan Edgar,91,47,44,-3,3,18,24,16,16,17,4,-2,-6,6,-5,-3,7:11 - 13:11 - 11:5 - 5:11 - 11:6
13747690,2023-08-30 12:05:00,Papyan Karen - Rafayelyan Edgar,3:0,11:6 - 11:8 - 13:11 - 0:0 - 0:0,3,0,Papyan Karen,Rafayelyan Edgar,fiurst,Papyan Karen - Rafayelyan Edgar,60,35,25,-10,10,17,19,24,0,0,-5,-3,-2,0,0,-10,11:6 - 11:8 - 13:11 - 0:0 - 0:0
13747694,2023-08-30 12:05:00,Diaryan Aleksandr - Nikoghosyan Narek,3:1,11:2 - 6:11 - 18:16 - 11:9 - 0:0,3,1,Diaryan Aleksandr,Nikoghosyan Narek,fiurst,Diaryan Aleksandr - Nikoghosyan Narek,84,46,38,-8,8,13,17,34,20,0,-9,5,-2,-2,0,-8,11:2 - 6:11 - 18:16 - 11:9 - 0:0
13747676,2023-08-30 11:30:00,Diaryan Aleksandr - Antonyan Eduard,0:3,11:4 - 11:2 - 11:3 - 0:0 - 0:0,3,0,Diaryan Aleksandr,Antonyan Eduard,fiurst,Antonyan Eduard - Diaryan Aleksandr,42,9,33,24,-24,15,13,14,0,0,7,9,8,0,0,24,4:11 - 2:11 - 3:11 - 0:0 - 0:0
13747673,2023-08-30 11:25:00,Nikoghosyan Narek - Papyan Karen,2:3,11:4 - 11:5 - 12:14 - 11:13 - 5:11,2,3,Nikoghosyan Narek,Papyan Karen,fiurst,Nikoghosyan Narek - Papyan Karen,97,50,47,-3,3,15,16,26,24,16,-7,-6,2,2,6,-3,11:4 - 11:5 - 12:14 - 11:13 - 5:11
13747669,2023-08-30 11:00:00,Rafayelyan Edgar - Diaryan Aleksandr,3:1,6:11 - 7:11 - 12:10 - 6:11 - 0:0,1,3,Rafayelyan Edgar,Diaryan Aleksandr,fiurst,Diaryan Aleksandr - Rafayelyan Edgar,74,43,31,-12,12,17,18,22,17,0,-5,-4,2,-5,0,-12,11:6 - 11:7 - 10:12 - 11:6 - 0:0
13747665,2023-08-30 10:55:00,Antonyan Eduard - Papyan Karen,1:3,7:11 - 11:3 - 9:11 - 8:11 - 0:0,1,3,Antonyan Eduard,Papyan Karen,fiurst,Antonyan Eduard - Papyan Karen,71,35,36,1,-1,18,14,20,19,0,4,-8,2,3,0,1,7:11 - 11:3 - 9:11 - 8:11 - 0:0
13747661,2023-08-30 10:35:00,Nikoghosyan Narek - Rafayelyan Edgar,3:0,11:7 - 11:4 - 11:6 - 0:0 - 0:0,3,0,Nikoghosyan Narek,Rafayelyan Edgar,fiurst,Nikoghosyan Narek - Rafayelyan Edgar,50,33,17,-16,16,18,15,17,0,0,-4,-7,-5,0,0,-16,11:7 - 11:4 - 11:6 - 0:0 - 0:0
13747659,2023-08-30 10:15:00,Papyan Karen - Diaryan Aleksandr,2:3,12:10 - 12:10 - 19:21 - 9:11 - 11:9,3,2,Papyan Karen,Diaryan Aleksandr,fiurst,Diaryan Aleksandr - Papyan Karen,124,61,63,2,-2,22,22,40,20,20,2,2,-2,-2,2,2,10:12 - 10:12 - 21:19 - 11:9 - 9:11
13747647,2023-08-30 10:00:00,Antonyan Eduard - Nikoghosyan Narek,2:3,9:11 - 6:11 - 11:7 - 11:9 - 4:11,2,3,Antonyan Eduard,Nikoghosyan Narek,fiurst,Antonyan Eduard - Nikoghosyan Narek,90,41,49,8,-8,20,17,18,20,15,2,5,-4,-2,7,8,9:11 - 6:11 - 11:7 - 11:9 - 4:11
13732486,2023-08-29 17:30:00,Grigoryan Erik - Gevorgyan Hayk,1:3,3:11 - 11:4 - 11:8 - 11:8 - 0:0,3,1,Grigoryan Erik,Gevorgyan Hayk,fiurst,Gevorgyan Hayk - Grigoryan Erik,67,31,36,5,-5,14,15,19,19,0,-8,7,3,3,0,5,11:3 - 4:11 - 8:11 - 8:11 - 0:0
13732485,2023-08-29 17:15:00,Mkrtchyan Andranik - Petrosyan Davit,1:3,12:14 - 9:11 - 11:9 - 9:11 - 0:0,1,3,Mkrtchyan Andranik,Petrosyan Davit,fiurst,Mkrtchyan Andranik - Petrosyan Davit,86,41,45,4,-4,26,20,20,20,0,2,2,-2,2,0,4,12:14 - 9:11 - 11:9 - 9:11 - 0:0
13732484,2023-08-29 17:00:00,Darbinyan Armen - Grigoryan Erik,0:3,8:11 - 6:11 - 14:16 - 0:0 - 0:0,0,3,Darbinyan Armen,Grigoryan Erik,fiurst,Darbinyan Armen - Grigoryan Erik,66,28,38,10,-10,19,17,30,0,0,3,5,2,0,0,10,8:11 - 6:11 - 14:16 - 0:0 - 0:0
13732483,2023-08-29 16:45:00,Mkrtchyan Andranik - Gevorgyan Hayk,1:3,11:6 - 7:11 - 13:11 - 11:9 - 0:0,3,1,Mkrtchyan Andranik,Gevorgyan Hayk,fiurst,Gevorgyan Hayk - Mkrtchyan Andranik,79,37,42,5,-5,17,18,24,20,0,5,-4,2,2,0,5,6:11 - 11:7 - 11:13 - 9:11 - 0:0
13732477,2023-08-29 16:30:00,Petrosyan Davit - Darbinyan Armen,2:3,11:4 - 11:9 - 5:11 - 9:11 - 11:4,3,2,Petrosyan Davit,Darbinyan Armen,fiurst,Darbinyan Armen - Petrosyan Davit,86,39,47,8,-8,15,20,16,20,15,7,2,-6,-2,7,8,4:11 - 9:11 - 11:5 - 11:9 - 4:11
13732091,2023-08-29 16:15:00,Grigoryan Erik - Mkrtchyan Andranik,0:3,11:13 - 8:11 - 7:11 - 0:0 - 0:0,0,3,Grigoryan Erik,Mkrtchyan Andranik,fiurst,Grigoryan Erik - Mkrtchyan Andranik,61,26,35,9,-9,24,19,18,0,0,2,3,4,0,0,9,11:13 - 8:11 - 7:11 - 0:0 - 0:0
13732090,2023-08-29 16:00:00,Gevorgyan Hayk - Darbinyan Armen,3:2,5:11 - 7:11 - 12:10 - 11:6 - 7:11,2,3,Gevorgyan Hayk,Darbinyan Armen,fiurst,Darbinyan Armen - Gevorgyan Hayk,91,49,42,-7,7,16,18,22,17,18,-6,-4,2,5,-4,-7,11:5 - 11:7 - 10:12 - 6:11 - 11:7
13732088,2023-08-29 15:45:00,Petrosyan Davit - Grigoryan Erik,1:3,11:2 - 11:5 - 8:11 - 11:5 - 0:0,3,1,Petrosyan Davit,Grigoryan Erik,fiurst,Grigoryan Erik - Petrosyan Davit,64,23,41,18,-18,13,16,19,16,0,9,6,-3,6,0,18,2:11 - 5:11 - 11:8 - 5:11 - 0:0
13732078,2023-08-29 15:35:00,Gevorgyan Hayk - Petrosyan Davit,3:0,11:4 - 11:1 - 11:2 - 0:0 - 0:0,3,0,Gevorgyan Hayk,Petrosyan Davit,fiurst,Gevorgyan Hayk - Petrosyan Davit,40,33,7,-26,26,15,12,13,0,0,-7,-10,-9,0,0,-26,11:4 - 11:1 - 11:2 - 0:0 - 0:0
13732082,2023-08-29 15:30:00,Darbinyan Armen - Mkrtchyan Andranik,0:3,1:11 - 4:11 - 9:11 - 0:0 - 0:0,0,3,Darbinyan Armen,Mkrtchyan Andranik,fiurst,Darbinyan Armen - Mkrtchyan Andranik,47,14,33,19,-19,12,15,20,0,0,10,7,2,0,0,19,1:11 - 4:11 - 9:11 - 0:0 - 0:0
13732060,2023-08-29 15:15:00,Papyan Karen - Nikoghosyan Narek,0:3,14:12 - 11:8 - 11:8 - 0:0 - 0:0,3,0,Papyan Karen,Nikoghosyan Narek,fiurst,Nikoghosyan Narek - Papyan Karen,64,28,36,8,-8,26,19,19,0,0,2,3,3,0,0,8,12:14 - 8:11 - 8:11 - 0:0 - 0:0
13732069,2023-08-29 15:10:00,Nazaryan Mushegh - Antonyan Eduard,3:0,7:11 - 8:11 - 9:11 - 0:0 - 0:0,0,3,Nazaryan Mushegh,Antonyan Eduard,fiurst,Antonyan Eduard - Nazaryan Mushegh,57,33,24,-9,9,18,19,20,0,0,-4,-3,-2,0,0,-9,11:7 - 11:8 - 11:9 - 0:0 - 0:0
13732048,2023-08-29 14:35:00,Antonyan Eduard - Papyan Karen,3:2,13:15 - 11:8 - 10:12 - 11:8 - 11:4,3,2,Antonyan Eduard,Papyan Karen,fiurst,Antonyan Eduard - Papyan Karen,103,56,47,-9,9,28,19,22,19,15,2,-3,2,-3,-7,-9,13:15 - 11:8 - 10:12 - 11:8 - 11:4
13732055,2023-08-29 14:35:00,Soghomonyan Hrayr - Nazaryan Mushegh,2:3,11:5 - 9:11 - 11:5 - 9:11 - 11:6,3,2,Soghomonyan Hrayr,Nazaryan Mushegh,fiurst,Nazaryan Mushegh - Soghomonyan Hrayr,89,38,51,13,-13,16,20,16,20,17,6,-2,6,-2,5,13,5:11 - 11:9 - 5:11 - 11:9 - 6:11
13732044,2023-08-29 14:10:00,Soghomonyan Hrayr - Nikoghosyan Narek,3:0,6:11 - 5:11 - 3:11 - 0:0 - 0:0,0,3,Soghomonyan Hrayr,Nikoghosyan Narek,fiurst,Nikoghosyan Narek - Soghomonyan Hrayr,47,33,14,-19,19,17,16,14,0,0,-5,-6,-8,0,0,-19,11:6 - 11:5 - 11:3 - 0:0 - 0:0
13731566,2023-08-29 14:00:00,Nazaryan Mushegh - Papyan Karen,3:2,11:9 - 10:12 - 11:9 - 4:11 - 11:9,3,2,Nazaryan Mushegh,Papyan Karen,fiurst,Nazaryan Mushegh - Papyan Karen,97,47,50,3,-3,20,22,20,15,20,-2,2,-2,7,-2,3,11:9 - 10:12 - 11:9 - 4:11 - 11:9
13731562,2023-08-29 13:40:00,Nikoghosyan Narek - Nazaryan Mushegh,1:3,11:6 - 9:11 - 11:6 - 11:4 - 0:0,3,1,Nikoghosyan Narek,Nazaryan Mushegh,fiurst,Nazaryan Mushegh - Nikoghosyan Narek,69,27,42,15,-15,17,20,17,15,0,5,-2,5,7,0,15,6:11 - 11:9 - 6:11 - 4:11 - 0:0
13731564,2023-08-29 13:40:00,Antonyan Eduard - Soghomonyan Hrayr,3:0,11:9 - 16:14 - 11:6 - 0:0 - 0:0,3,0,Antonyan Eduard,Soghomonyan Hrayr,fiurst,Antonyan Eduard - Soghomonyan Hrayr,67,38,29,-9,9,20,30,17,0,0,-2,-2,-5,0,0,-9,11:9 - 16:14 - 11:6 - 0:0 - 0:0
13731560,2023-08-29 13:00:00,Papyan Karen - Soghomonyan Hrayr,3:0,11:4 - 12:10 - 11:6 - 0:0 - 0:0,3,0,Papyan Karen,Soghomonyan Hrayr,fiurst,Papyan Karen - Soghomonyan Hrayr,54,34,20,-14,14,15,22,17,0,0,-7,-2,-5,0,0,-14,11:4 - 12:10 - 11:6 - 0:0 - 0:0
13731556,2023-08-29 12:50:00,Nikoghosyan Narek - Antonyan Eduard,2:3,4:11 - 18:20 - 13:11 - 11:9 - 11:9,3,2,Nikoghosyan Narek,Antonyan Eduard,fiurst,Antonyan Eduard - Nikoghosyan Narek,117,60,57,-3,3,15,38,24,20,20,-7,-2,2,2,2,-3,11:4 - 20:18 - 11:13 - 9:11 - 9:11
13731548,2023-08-29 12:15:00,Nazaryan Mushegh - Soghomonyan Hrayr,3:1,6:11 - 11:9 - 11:6 - 11:7 - 0:0,3,1,Nazaryan Mushegh,Soghomonyan Hrayr,fiurst,Nazaryan Mushegh - Soghomonyan Hrayr,72,39,33,-6,6,17,20,17,18,0,5,-2,-5,-4,0,-6,6:11 - 11:9 - 11:6 - 11:7 - 0:0
13731543,2023-08-29 12:05:00,Nikoghosyan Narek - Papyan Karen,1:3,9:11 - 5:11 - 11:5 - 7:11 - 0:0,1,3,Nikoghosyan Narek,Papyan Karen,fiurst,Nikoghosyan Narek - Papyan Karen,70,32,38,6,-6,20,16,16,18,0,2,6,-6,4,0,6,9:11 - 5:11 - 11:5 - 7:11 - 0:0
13731539,2023-08-29 11:45:00,Antonyan Eduard - Nazaryan Mushegh,3:0,11:3 - 11:6 - 11:5 - 0:0 - 0:0,3,0,Antonyan Eduard,Nazaryan Mushegh,fiurst,Antonyan Eduard - Nazaryan Mushegh,47,33,14,-19,19,14,17,16,0,0,-8,-5,-6,0,0,-19,11:3 - 11:6 - 11:5 - 0:0 - 0:0
13731535,2023-08-29 11:30:00,Nikoghosyan Narek - Soghomonyan Hrayr,3:1,8:11 - 11:6 - 11:7 - 11:9 - 0:0,3,1,Nikoghosyan Narek,Soghomonyan Hrayr,fiurst,Nikoghosyan Narek - Soghomonyan Hrayr,74,41,33,-8,8,19,17,18,20,0,3,-5,-4,-2,0,-8,8:11 - 11:6 - 11:7 - 11:9 - 0:0
13731533,2023-08-29 11:20:00,Papyan Karen - Antonyan Eduard,3:2,13:15 - 11:8 - 14:16 - 11:3 - 4:11,2,3,Papyan Karen,Antonyan Eduard,fiurst,Antonyan Eduard - Papyan Karen,106,53,53,0,0,28,19,30,14,15,-2,3,-2,8,-7,0,15:13 - 8:11 - 16:14 - 3:11 - 11:4
13731529,2023-08-29 11:00:00,Nazaryan Mushegh - Nikoghosyan Narek,0:3,5:11 - 9:11 - 8:11 - 0:0 - 0:0,0,3,Nazaryan Mushegh,Nikoghosyan Narek,fiurst,Nazaryan Mushegh - Nikoghosyan Narek,55,22,33,11,-11,16,20,19,0,0,6,2,3,0,0,11,5:11 - 9:11 - 8:11 - 0:0 - 0:0
13731517,2023-08-29 10:55:00,Soghomonyan Hrayr - Antonyan Eduard,3:0,7:11 - 8:11 - 5:11 - 0:0 - 0:0,0,3,Soghomonyan Hrayr,Antonyan Eduard,fiurst,Antonyan Eduard - Soghomonyan Hrayr,53,33,20,-13,13,18,19,16,0,0,-4,-3,-6,0,0,-13,11:7 - 11:8 - 11:5 - 0:0 - 0:0
13731514,2023-08-29 10:30:00,Papyan Karen - Nazaryan Mushegh,0:3,11:9 - 11:6 - 11:4 - 0:0 - 0:0,3,0,Papyan Karen,Nazaryan Mushegh,fiurst,Nazaryan Mushegh - Papyan Karen,52,19,33,14,-14,20,17,15,0,0,2,5,7,0,0,14,9:11 - 6:11 - 4:11 - 0:0 - 0:0
13731511,2023-08-29 10:15:00,Antonyan Eduard - Nikoghosyan Narek,3:2,8:11 - 3:11 - 11:5 - 11:7 - 15:13,3,2,Antonyan Eduard,Nikoghosyan Narek,fiurst,Antonyan Eduard - Nikoghosyan Narek,95,48,47,-1,1,19,14,16,18,28,3,8,-6,-4,-2,-1,8:11 - 3:11 - 11:5 - 11:7 - 15:13
13731504,2023-08-29 10:00:00,Soghomonyan Hrayr - Papyan Karen,3:0,1:11 - 9:11 - 5:11 - 0:0 - 0:0,0,3,Soghomonyan Hrayr,Papyan Karen,fiurst,Papyan Karen - Soghomonyan Hrayr,48,33,15,-18,18,12,20,16,0,0,-10,-2,-6,0,0,-18,11:1 - 11:9 - 11:5 - 0:0 - 0:0
13705209,2023-08-28 17:30:00,Petrosyan Davit - Darbinyan Armen,0:3,11:9 - 11:4 - 11:7 - 0:0 - 0:0,3,0,Petrosyan Davit,Darbinyan Armen,fiurst,Darbinyan Armen - Petrosyan Davit,53,20,33,13,-13,20,15,18,0,0,2,7,4,0,0,13,9:11 - 4:11 - 7:11 - 0:0 - 0:0
13705207,2023-08-28 17:15:00,Grigoryan Erik - Gevorgyan Gegham,3:1,8:11 - 11:9 - 5:11 - 5:11 - 0:0,1,3,Grigoryan Erik,Gevorgyan Gegham,fiurst,Gevorgyan Gegham - Grigoryan Erik,71,42,29,-13,13,19,20,16,16,0,-3,2,-6,-6,0,-13,11:8 - 9:11 - 11:5 - 11:5 - 0:0
13705202,2023-08-28 17:05:00,Gevorgyan Hayk - Petrosyan Davit,3:1,11:13 - 11:8 - 11:6 - 11:7 - 0:0,3,1,Gevorgyan Hayk,Petrosyan Davit,fiurst,Gevorgyan Hayk - Petrosyan Davit,78,44,34,-10,10,24,19,17,18,0,2,-3,-5,-4,0,-10,11:13 - 11:8 - 11:6 - 11:7 - 0:0
13705186,2023-08-28 16:50:00,Grigoryan Erik - Darbinyan Armen,3:2,9:11 - 11:8 - 8:11 - 11:5 - 9:11,2,3,Grigoryan Erik,Darbinyan Armen,fiurst,Darbinyan Armen - Grigoryan Erik,94,46,48,2,-2,20,19,19,16,20,-2,3,-3,6,-2,2,11:9 - 8:11 - 11:8 - 5:11 - 11:9
13705183,2023-08-28 16:30:00,Gevorgyan Gegham - Gevorgyan Hayk,2:3,11:4 - 3:11 - 12:10 - 3:11 - 7:11,2,3,Gevorgyan Gegham,Gevorgyan Hayk,fiurst,Gevorgyan Gegham - Gevorgyan Hayk,83,36,47,11,-11,15,14,22,14,18,-7,8,-2,8,4,11,11:4 - 3:11 - 12:10 - 3:11 - 7:11
13705182,2023-08-28 16:15:00,Petrosyan Davit - Grigoryan Erik,3:2,12:14 - 8:11 - 11:2 - 11:8 - 5:11,2,3,Petrosyan Davit,Grigoryan Erik,fiurst,Grigoryan Erik - Petrosyan Davit,93,46,47,1,-1,26,19,13,19,16,-2,-3,9,3,-6,1,14:12 - 11:8 - 2:11 - 8:11 - 11:5
13705180,2023-08-28 16:00:00,Darbinyan Armen - Gevorgyan Hayk,0:3,5:11 - 12:14 - 2:11 - 0:0 - 0:0,0,3,Darbinyan Armen,Gevorgyan Hayk,fiurst,Darbinyan Armen - Gevorgyan Hayk,55,19,36,17,-17,16,26,13,0,0,6,2,9,0,0,17,5:11 - 12:14 - 2:11 - 0:0 - 0:0
13705178,2023-08-28 15:45:00,Gevorgyan Gegham - Petrosyan Davit,3:0,11:8 - 11:7 - 11:8 - 0:0 - 0:0,3,0,Gevorgyan Gegham,Petrosyan Davit,fiurst,Gevorgyan Gegham - Petrosyan Davit,56,33,23,-10,10,19,18,19,0,0,-3,-4,-3,0,0,-10,11:8 - 11:7 - 11:8 - 0:0 - 0:0
13705174,2023-08-28 15:30:00,Gevorgyan Hayk - Grigoryan Erik,3:1,11:6 - 9:11 - 11:6 - 11:1 - 0:0,3,1,Gevorgyan Hayk,Grigoryan Erik,fiurst,Gevorgyan Hayk - Grigoryan Erik,66,42,24,-18,18,17,20,17,12,0,-5,2,-5,-10,0,-18,11:6 - 9:11 - 11:6 - 11:1 - 0:0
13705170,2023-08-28 15:15:00,Darbinyan Armen - Gevorgyan Gegham,2:3,11:8 - 8:11 - 15:13 - 7:11 - 6:11,2,3,Darbinyan Armen,Gevorgyan Gegham,fiurst,Darbinyan Armen - Gevorgyan Gegham,101,47,54,7,-7,19,19,28,18,17,-3,3,-2,4,5,7,11:8 - 8:11 - 15:13 - 7:11 - 6:11
13705168,2023-08-28 15:00:00,Diaryan Aleksandr - Papyan Karen,2:3,11:7 - 12:10 - 11:13 - 10:12 - 4:11,2,3,Diaryan Aleksandr,Papyan Karen,fiurst,Diaryan Aleksandr - Papyan Karen,101,48,53,5,-5,18,22,24,22,15,-4,-2,2,2,7,5,11:7 - 12:10 - 11:13 - 10:12 - 4:11
13705149,2023-08-28 14:45:00,Soghomonyan Hrayr - Nazaryan Mushegh,3:2,8:11 - 9:11 - 11:6 - 11:9 - 8:11,2,3,Soghomonyan Hrayr,Nazaryan Mushegh,fiurst,Nazaryan Mushegh - Soghomonyan Hrayr,95,48,47,-1,1,19,20,17,20,19,-3,-2,5,2,-3,-1,11:8 - 11:9 - 6:11 - 9:11 - 11:8
13705117,2023-08-28 14:30:00,Rafayelyan Edgar - Diaryan Aleksandr,3:0,8:11 - 8:11 - 10:12 - 0:0 - 0:0,0,3,Rafayelyan Edgar,Diaryan Aleksandr,fiurst,Diaryan Aleksandr - Rafayelyan Edgar,60,34,26,-8,8,19,19,22,0,0,-3,-3,-2,0,0,-8,11:8 - 11:8 - 12:10 - 0:0 - 0:0
13705089,2023-08-28 14:15:00,Papyan Karen - Soghomonyan Hrayr,3:1,10:12 - 11:6 - 11:5 - 11:8 - 0:0,3,1,Papyan Karen,Soghomonyan Hrayr,fiurst,Papyan Karen - Soghomonyan Hrayr,74,43,31,-12,12,22,17,16,19,0,2,-5,-6,-3,0,-12,10:12 - 11:6 - 11:5 - 11:8 - 0:0
13705077,2023-08-28 14:00:00,Rafayelyan Edgar - Nazaryan Mushegh,0:3,13:11 - 11:5 - 11:7 - 0:0 - 0:0,3,0,Rafayelyan Edgar,Nazaryan Mushegh,fiurst,Nazaryan Mushegh - Rafayelyan Edgar,58,23,35,12,-12,24,16,18,0,0,2,6,4,0,0,12,11:13 - 5:11 - 7:11 - 0:0 - 0:0
13705073,2023-08-28 13:45:00,Diaryan Aleksandr - Soghomonyan Hrayr,3:1,11:4 - 11:7 - 8:11 - 11:4 - 0:0,3,1,Diaryan Aleksandr,Soghomonyan Hrayr,fiurst,Diaryan Aleksandr - Soghomonyan Hrayr,67,41,26,-15,15,15,18,19,15,0,-7,-4,3,-7,0,-15,11:4 - 11:7 - 8:11 - 11:4 - 0:0
13705071,2023-08-28 13:30:00,Papyan Karen - Rafayelyan Edgar,3:0,11:7 - 11:5 - 11:9 - 0:0 - 0:0,3,0,Papyan Karen,Rafayelyan Edgar,fiurst,Papyan Karen - Rafayelyan Edgar,54,33,21,-12,12,18,16,20,0,0,-4,-6,-2,0,0,-12,11:7 - 11:5 - 11:9 - 0:0 - 0:0
13705067,2023-08-28 13:15:00,Nazaryan Mushegh - Diaryan Aleksandr,3:1,7:11 - 6:11 - 11:4 - 6:11 - 0:0,1,3,Nazaryan Mushegh,Diaryan Aleksandr,fiurst,Diaryan Aleksandr - Nazaryan Mushegh,67,37,30,-7,7,18,17,15,17,0,-4,-5,7,-5,0,-7,11:7 - 11:6 - 4:11 - 11:6 - 0:0
13705065,2023-08-28 13:00:00,Soghomonyan Hrayr - Rafayelyan Edgar,1:3,13:11 - 11:6 - 9:11 - 12:10 - 0:0,3,1,Soghomonyan Hrayr,Rafayelyan Edgar,fiurst,Rafayelyan Edgar - Soghomonyan Hrayr,83,38,45,7,-7,24,17,20,22,0,2,5,-2,2,0,7,11:13 - 6:11 - 11:9 - 10:12 - 0:0
13705063,2023-08-28 12:45:00,Nazaryan Mushegh - Papyan Karen,1:3,9:11 - 6:11 - 11:7 - 4:11 - 0:0,1,3,Nazaryan Mushegh,Papyan Karen,fiurst,Nazaryan Mushegh - Papyan Karen,70,30,40,10,-10,20,17,18,15,0,2,5,-4,7,0,10,9:11 - 6:11 - 11:7 - 4:11 - 0:0
13705061,2023-08-28 12:20:00,Diaryan Aleksandr - Rafayelyan Edgar,2:3,11:7 - 5:11 - 11:4 - 9:11 - 4:11,2,3,Diaryan Aleksandr,Rafayelyan Edgar,fiurst,Diaryan Aleksandr - Rafayelyan Edgar,84,40,44,4,-4,18,16,15,20,15,-4,6,-7,2,7,4,11:7 - 5:11 - 11:4 - 9:11 - 4:11
13705039,2023-08-28 12:00:00,Nazaryan Mushegh - Soghomonyan Hrayr,3:1,6:11 - 11:9 - 11:6 - 11:5 - 0:0,3,1,Nazaryan Mushegh,Soghomonyan Hrayr,fiurst,Nazaryan Mushegh - Soghomonyan Hrayr,70,39,31,-8,8,17,20,17,16,0,5,-2,-5,-6,0,-8,6:11 - 11:9 - 11:6 - 11:5 - 0:0
13705038,2023-08-28 11:45:00,Papyan Karen - Diaryan Aleksandr,3:1,11:9 - 10:12 - 7:11 - 8:11 - 0:0,1,3,Papyan Karen,Diaryan Aleksandr,fiurst,Diaryan Aleksandr - Papyan Karen,79,43,36,-7,7,20,22,18,19,0,2,-2,-4,-3,0,-7,9:11 - 12:10 - 11:7 - 11:8 - 0:0
13705036,2023-08-28 11:40:00,Nazaryan Mushegh - Rafayelyan Edgar,3:1,11:8 - 11:3 - 5:11 - 11:7 - 0:0,3,1,Nazaryan Mushegh,Rafayelyan Edgar,fiurst,Nazaryan Mushegh - Rafayelyan Edgar,67,38,29,-9,9,19,14,16,18,0,-3,-8,6,-4,0,-9,11:8 - 11:3 - 5:11 - 11:7 - 0:0
13705031,2023-08-28 11:20:00,Diaryan Aleksandr - Nazaryan Mushegh,3:0,11:9 - 11:5 - 11:9 - 0:0 - 0:0,3,0,Diaryan Aleksandr,Nazaryan Mushegh,fiurst,Diaryan Aleksandr - Nazaryan Mushegh,56,33,23,-10,10,20,16,20,0,0,-2,-6,-2,0,0,-10,11:9 - 11:5 - 11:9 - 0:0 - 0:0
13705034,2023-08-28 11:20:00,Soghomonyan Hrayr - Papyan Karen,3:0,9:11 - 10:12 - 3:11 - 0:0 - 0:0,0,3,Soghomonyan Hrayr,Papyan Karen,fiurst,Papyan Karen - Soghomonyan Hrayr,56,34,22,-12,12,20,22,14,0,0,-2,-2,-8,0,0,-12,11:9 - 12:10 - 11:3 - 0:0 - 0:0
13705027,2023-08-28 10:45:00,Rafayelyan Edgar - Papyan Karen,2:3,8:11 - 9:11 - 11:9 - 11:8 - 11:5,3,2,Rafayelyan Edgar,Papyan Karen,fiurst,Papyan Karen - Rafayelyan Edgar,94,44,50,6,-6,19,20,20,19,16,-3,-2,2,3,6,6,11:8 - 11:9 - 9:11 - 8:11 - 5:11
13705026,2023-08-28 10:35:00,Soghomonyan Hrayr - Diaryan Aleksandr,2:3,11:7 - 13:11 - 4:11 - 8:11 - 15:13,3,2,Soghomonyan Hrayr,Diaryan Aleksandr,fiurst,Diaryan Aleksandr - Soghomonyan Hrayr,104,53,51,-2,2,18,24,15,19,28,4,2,-7,-3,2,-2,7:11 - 11:13 - 11:4 - 11:8 - 13:15
13705023,2023-08-28 10:15:00,Papyan Karen - Nazaryan Mushegh,3:0,6:11 - 10:12 - 5:11 - 0:0 - 0:0,0,3,Papyan Karen,Nazaryan Mushegh,fiurst,Nazaryan Mushegh - Papyan Karen,55,34,21,-13,13,17,22,16,0,0,-5,-2,-6,0,0,-13,11:6 - 12:10 - 11:5 - 0:0 - 0:0
13705022,2023-08-28 10:00:00,Rafayelyan Edgar - Soghomonyan Hrayr,3:2,4:11 - 11:9 - 11:13 - 11:8 - 11:5,3,2,Rafayelyan Edgar,Soghomonyan Hrayr,fiurst,Rafayelyan Edgar - Soghomonyan Hrayr,94,48,46,-2,2,15,20,24,19,16,7,-2,2,-3,-6,-2,4:11 - 11:9 - 11:13 - 11:8 - 11:5
13686866,2023-08-27 17:40:00,Gevorgyan Gegham - Petrosyan Davit,0:3,7:11 - 3:11 - 9:11 - 0:0 - 0:0,0,3,Gevorgyan Gegham,Petrosyan Davit,fiurst,Gevorgyan Gegham - Petrosyan Davit,52,19,33,14,-14,18,14,20,0,0,4,8,2,0,0,14,7:11 - 3:11 - 9:11 - 0:0 - 0:0
13686861,2023-08-27 17:15:00,Darbinyan Armen - Gevorgyan Hayk,0:3,7:11 - 13:15 - 5:11 - 0:0 - 0:0,0,3,Darbinyan Armen,Gevorgyan Hayk,fiurst,Darbinyan Armen - Gevorgyan Hayk,62,25,37,12,-12,18,28,16,0,0,4,2,6,0,0,12,7:11 - 13:15 - 5:11 - 0:0 - 0:0
13686860,2023-08-27 17:00:00,Mkrtchyan Andranik - Gevorgyan Gegham,2:3,7:11 - 13:11 - 8:11 - 11:8 - 11:9,3,2,Mkrtchyan Andranik,Gevorgyan Gegham,fiurst,Gevorgyan Gegham - Mkrtchyan Andranik,100,50,50,0,0,18,24,19,19,20,-4,2,-3,3,2,0,11:7 - 11:13 - 11:8 - 8:11 - 9:11
13686856,2023-08-27 16:45:00,Darbinyan Armen - Petrosyan Davit,3:0,11:8 - 11:9 - 12:10 - 0:0 - 0:0,3,0,Darbinyan Armen,Petrosyan Davit,fiurst,Darbinyan Armen - Petrosyan Davit,61,34,27,-7,7,19,20,22,0,0,-3,-2,-2,0,0,-7,11:8 - 11:9 - 12:10 - 0:0 - 0:0
13686854,2023-08-27 16:30:00,Gevorgyan Hayk - Mkrtchyan Andranik,1:3,8:11 - 4:11 - 11:8 - 9:11 - 0:0,1,3,Gevorgyan Hayk,Mkrtchyan Andranik,fiurst,Gevorgyan Hayk - Mkrtchyan Andranik,73,32,41,9,-9,19,15,19,20,0,3,7,-3,2,0,9,8:11 - 4:11 - 11:8 - 9:11 - 0:0
13686834,2023-08-27 16:15:00,Gevorgyan Gegham - Darbinyan Armen,3:2,9:11 - 11:5 - 11:9 - 11:13 - 7:11,2,3,Gevorgyan Gegham,Darbinyan Armen,fiurst,Darbinyan Armen - Gevorgyan Gegham,98,49,49,0,0,20,16,20,24,18,-2,6,2,-2,-4,0,11:9 - 5:11 - 9:11 - 13:11 - 11:7
13686823,2023-08-27 16:00:00,Petrosyan Davit - Mkrtchyan Andranik,3:0,11:13 - 2:11 - 7:11 - 0:0 - 0:0,0,3,Petrosyan Davit,Mkrtchyan Andranik,fiurst,Mkrtchyan Andranik - Petrosyan Davit,55,35,20,-15,15,24,13,18,0,0,-2,-9,-4,0,0,-15,13:11 - 11:2 - 11:7 - 0:0 - 0:0
13686821,2023-08-27 15:45:00,Gevorgyan Hayk - Gevorgyan Gegham,0:3,11:7 - 11:7 - 11:9 - 0:0 - 0:0,3,0,Gevorgyan Hayk,Gevorgyan Gegham,fiurst,Gevorgyan Gegham - Gevorgyan Hayk,56,23,33,10,-10,18,18,20,0,0,4,4,2,0,0,10,7:11 - 7:11 - 9:11 - 0:0 - 0:0
13686819,2023-08-27 15:30:00,Mkrtchyan Andranik - Darbinyan Armen,0:3,11:6 - 11:6 - 11:8 - 0:0 - 0:0,3,0,Mkrtchyan Andranik,Darbinyan Armen,fiurst,Darbinyan Armen - Mkrtchyan Andranik,53,20,33,13,-13,17,17,19,0,0,5,5,3,0,0,13,6:11 - 6:11 - 8:11 - 0:0 - 0:0
13686816,2023-08-27 15:15:00,Petrosyan Davit - Gevorgyan Hayk,3:0,5:11 - 11:13 - 4:11 - 0:0 - 0:0,0,3,Petrosyan Davit,Gevorgyan Hayk,fiurst,Gevorgyan Hayk - Petrosyan Davit,55,35,20,-15,15,16,24,15,0,0,-6,-2,-7,0,0,-15,11:5 - 13:11 - 11:4 - 0:0 - 0:0
13685134,2023-08-27 15:00:00,Rafayelyan Edgar - Nazaryan Mushegh,3:2,10:12 - 11:7 - 9:11 - 11:9 - 4:11,2,3,Rafayelyan Edgar,Nazaryan Mushegh,fiurst,Nazaryan Mushegh - Rafayelyan Edgar,95,50,45,-5,5,22,18,20,20,15,-2,4,-2,2,-7,-5,12:10 - 7:11 - 11:9 - 9:11 - 11:4
13685130,2023-08-27 14:50:00,Diaryan Aleksandr - Antonyan Eduard,1:3,11:8 - 11:7 - 9:11 - 11:3 - 0:0,3,1,Diaryan Aleksandr,Antonyan Eduard,fiurst,Antonyan Eduard - Diaryan Aleksandr,71,29,42,13,-13,19,18,20,14,0,3,4,-2,8,0,13,8:11 - 7:11 - 11:9 - 3:11 - 0:0
13685118,2023-08-27 14:30:00,Nikoghosyan Narek - Rafayelyan Edgar,3:1,11:4 - 9:11 - 11:8 - 11:5 - 0:0,3,1,Nikoghosyan Narek,Rafayelyan Edgar,fiurst,Nikoghosyan Narek - Rafayelyan Edgar,70,42,28,-14,14,15,20,19,16,0,-7,2,-3,-6,0,-14,11:4 - 9:11 - 11:8 - 11:5 - 0:0
13685115,2023-08-27 14:15:00,Nazaryan Mushegh - Diaryan Aleksandr,3:2,5:11 - 11:6 - 10:12 - 11:5 - 9:11,2,3,Nazaryan Mushegh,Diaryan Aleksandr,fiurst,Diaryan Aleksandr - Nazaryan Mushegh,91,45,46,1,-1,16,17,22,16,20,-6,5,-2,6,-2,1,11:5 - 6:11 - 12:10 - 5:11 - 11:9
13685112,2023-08-27 14:00:00,Nikoghosyan Narek - Antonyan Eduard,0:3,11:7 - 11:8 - 11:7 - 0:0 - 0:0,3,0,Nikoghosyan Narek,Antonyan Eduard,fiurst,Antonyan Eduard - Nikoghosyan Narek,55,22,33,11,-11,18,19,18,0,0,4,3,4,0,0,11,7:11 - 8:11 - 7:11 - 0:0 - 0:0
13685107,2023-08-27 13:55:00,Rafayelyan Edgar - Diaryan Aleksandr,3:0,6:11 - 9:11 - 8:11 - 0:0 - 0:0,0,3,Rafayelyan Edgar,Diaryan Aleksandr,fiurst,Diaryan Aleksandr - Rafayelyan Edgar,56,33,23,-10,10,17,20,19,0,0,-5,-2,-3,0,0,-10,11:6 - 11:9 - 11:8 - 0:0 - 0:0
13685106,2023-08-27 13:30:00,Nazaryan Mushegh - Nikoghosyan Narek,1:3,4:11 - 9:11 - 11:9 - 6:11 - 0:0,1,3,Nazaryan Mushegh,Nikoghosyan Narek,fiurst,Nazaryan Mushegh - Nikoghosyan Narek,72,30,42,12,-12,15,20,20,17,0,7,2,-2,5,0,12,4:11 - 9:11 - 11:9 - 6:11 - 0:0
13685103,2023-08-27 13:15:00,Antonyan Eduard - Rafayelyan Edgar,3:2,12:10 - 7:11 - 11:7 - 8:11 - 11:9,3,2,Antonyan Eduard,Rafayelyan Edgar,fiurst,Antonyan Eduard - Rafayelyan Edgar,97,49,48,-1,1,22,18,18,19,20,-2,4,-4,3,-2,-1,12:10 - 7:11 - 11:7 - 8:11 - 11:9
13685074,2023-08-27 13:00:00,Diaryan Aleksandr - Nikoghosyan Narek,3:1,6:11 - 11:5 - 11:9 - 12:10 - 0:0,3,1,Diaryan Aleksandr,Nikoghosyan Narek,fiurst,Diaryan Aleksandr - Nikoghosyan Narek,75,40,35,-5,5,17,16,20,22,0,5,-6,-2,-2,0,-5,6:11 - 11:5 - 11:9 - 12:10 - 0:0
13685063,2023-08-27 12:45:00,Antonyan Eduard - Nazaryan Mushegh,3:1,11:8 - 8:11 - 11:5 - 11:5 - 0:0,3,1,Antonyan Eduard,Nazaryan Mushegh,fiurst,Antonyan Eduard - Nazaryan Mushegh,70,41,29,-12,12,19,19,16,16,0,-3,3,-6,-6,0,-12,11:8 - 8:11 - 11:5 - 11:5 - 0:0
13685060,2023-08-27 12:15:00,Rafayelyan Edgar - Nikoghosyan Narek,2:3,11:6 - 7:11 - 12:10 - 12:14 - 11:5,3,2,Rafayelyan Edgar,Nikoghosyan Narek,fiurst,Nikoghosyan Narek - Rafayelyan Edgar,99,46,53,7,-7,17,18,22,26,16,5,-4,2,-2,6,7,6:11 - 11:7 - 10:12 - 14:12 - 5:11
13685057,2023-08-27 12:00:00,Antonyan Eduard - Diaryan Aleksandr,0:3,6:11 - 2:11 - 9:11 - 0:0 - 0:0,0,3,Antonyan Eduard,Diaryan Aleksandr,fiurst,Antonyan Eduard - Diaryan Aleksandr,50,17,33,16,-16,17,13,20,0,0,5,9,2,0,0,16,6:11 - 2:11 - 9:11 - 0:0 - 0:0
13685052,2023-08-27 11:50:00,Nazaryan Mushegh - Rafayelyan Edgar,3:0,11:5 - 11:6 - 11:6 - 0:0 - 0:0,3,0,Nazaryan Mushegh,Rafayelyan Edgar,fiurst,Nazaryan Mushegh - Rafayelyan Edgar,50,33,17,-16,16,16,17,17,0,0,-6,-5,-5,0,0,-16,11:5 - 11:6 - 11:6 - 0:0 - 0:0
13685051,2023-08-27 11:30:00,Antonyan Eduard - Nikoghosyan Narek,3:0,11:8 - 11:9 - 11:1 - 0:0 - 0:0,3,0,Antonyan Eduard,Nikoghosyan Narek,fiurst,Antonyan Eduard - Nikoghosyan Narek,51,33,18,-15,15,19,20,12,0,0,-3,-2,-10,0,0,-15,11:8 - 11:9 - 11:1 - 0:0 - 0:0
13685040,2023-08-27 11:15:00,Diaryan Aleksandr - Nazaryan Mushegh,3:2,11:5 - 11:13 - 12:10 - 8:11 - 11:3,3,2,Diaryan Aleksandr,Nazaryan Mushegh,fiurst,Diaryan Aleksandr - Nazaryan Mushegh,95,53,42,-11,11,16,24,22,19,14,-6,2,-2,3,-8,-11,11:5 - 11:13 - 12:10 - 8:11 - 11:3
13685039,2023-08-27 11:05:00,Rafayelyan Edgar - Antonyan Eduard,1:3,11:6 - 12:10 - 8:11 - 12:10 - 0:0,3,1,Rafayelyan Edgar,Antonyan Eduard,fiurst,Antonyan Eduard - Rafayelyan Edgar,80,37,43,6,-6,17,22,19,22,0,5,2,-3,2,0,6,6:11 - 10:12 - 11:8 - 10:12 - 0:0
13685038,2023-08-27 10:45:00,Nikoghosyan Narek - Nazaryan Mushegh,1:3,6:11 - 11:5 - 11:2 - 14:12 - 0:0,3,1,Nikoghosyan Narek,Nazaryan Mushegh,fiurst,Nazaryan Mushegh - Nikoghosyan Narek,72,30,42,12,-12,17,16,13,26,0,-5,6,9,2,0,12,11:6 - 5:11 - 2:11 - 12:14 - 0:0
13685036,2023-08-27 10:40:00,Diaryan Aleksandr - Rafayelyan Edgar,3:1,9:11 - 11:3 - 11:8 - 11:4 - 0:0,3,1,Diaryan Aleksandr,Rafayelyan Edgar,fiurst,Diaryan Aleksandr - Rafayelyan Edgar,68,42,26,-16,16,20,14,19,15,0,2,-8,-3,-7,0,-16,9:11 - 11:3 - 11:8 - 11:4 - 0:0
13685011,2023-08-27 10:15:00,Nazaryan Mushegh - Antonyan Eduard,1:3,11:6 - 5:11 - 11:8 - 15:13 - 0:0,3,1,Nazaryan Mushegh,Antonyan Eduard,fiurst,Antonyan Eduard - Nazaryan Mushegh,80,38,42,4,-4,17,16,19,28,0,5,-6,3,2,0,4,6:11 - 11:5 - 8:11 - 13:15 - 0:0
13685004,2023-08-27 10:00:00,Nikoghosyan Narek - Diaryan Aleksandr,2:3,14:12 - 11:5 - 9:11 - 8:11 - 16:14,3,2,Nikoghosyan Narek,Diaryan Aleksandr,fiurst,Diaryan Aleksandr - Nikoghosyan Narek,111,53,58,5,-5,26,16,20,19,30,2,6,-2,-3,2,5,12:14 - 5:11 - 11:9 - 11:8 - 14:16
13669463,2023-08-26 17:30:00,Darbinyan Armen - Gevorgyan Gegham,0:3,10:12 - 8:11 - 7:11 - 0:0 - 0:0,0,3,Darbinyan Armen,Gevorgyan Gegham,fiurst,Darbinyan Armen - Gevorgyan Gegham,59,25,34,9,-9,22,19,18,0,0,2,3,4,0,0,9,10:12 - 8:11 - 7:11 - 0:0 - 0:0
13669450,2023-08-26 17:20:00,Grigoryan Erik - Mkrtchyan Andranik,1:3,11:9 - 11:13 - 9:11 - 9:11 - 0:0,1,3,Grigoryan Erik,Mkrtchyan Andranik,fiurst,Grigoryan Erik - Mkrtchyan Andranik,84,40,44,4,-4,20,24,20,20,0,-2,2,2,2,0,4,11:9 - 11:13 - 9:11 - 9:11 - 0:0
13669425,2023-08-26 17:00:00,Petrosyan Davit - Darbinyan Armen,1:3,11:9 - 14:16 - 11:5 - 11:7 - 0:0,3,1,Petrosyan Davit,Darbinyan Armen,fiurst,Darbinyan Armen - Petrosyan Davit,84,37,47,10,-10,20,30,16,18,0,2,-2,6,4,0,10,9:11 - 16:14 - 5:11 - 7:11 - 0:0
13669424,2023-08-26 16:45:00,Grigoryan Erik - Gevorgyan Gegham,2:3,11:8 - 6:11 - 7:11 - 12:10 - 11:8,3,2,Grigoryan Erik,Gevorgyan Gegham,fiurst,Gevorgyan Gegham - Grigoryan Erik,95,48,47,-1,1,19,17,18,22,19,3,-5,-4,2,3,-1,8:11 - 11:6 - 11:7 - 10:12 - 8:11
13669423,2023-08-26 16:30:00,Mkrtchyan Andranik - Petrosyan Davit,3:2,11:8 - 10:12 - 10:12 - 11:7 - 11:8,3,2,Mkrtchyan Andranik,Petrosyan Davit,fiurst,Mkrtchyan Andranik - Petrosyan Davit,100,53,47,-6,6,19,22,22,18,19,-3,2,2,-4,-3,-6,11:8 - 10:12 - 10:12 - 11:7 - 11:8
13669419,2023-08-26 16:15:00,Darbinyan Armen - Grigoryan Erik,1:3,7:11 - 11:8 - 9:11 - 10:12 - 0:0,1,3,Darbinyan Armen,Grigoryan Erik,fiurst,Darbinyan Armen - Grigoryan Erik,79,37,42,5,-5,18,19,20,22,0,4,-3,2,2,0,5,7:11 - 11:8 - 9:11 - 10:12 - 0:0
13669412,2023-08-26 16:00:00,Gevorgyan Gegham - Petrosyan Davit,0:3,6:11 - 4:11 - 2:11 - 0:0 - 0:0,0,3,Gevorgyan Gegham,Petrosyan Davit,fiurst,Gevorgyan Gegham - Petrosyan Davit,45,12,33,21,-21,17,15,13,0,0,5,7,9,0,0,21,6:11 - 4:11 - 2:11 - 0:0 - 0:0
13669355,2023-08-26 15:45:00,Mkrtchyan Andranik - Darbinyan Armen,0:3,11:7 - 11:3 - 11:7 - 0:0 - 0:0,3,0,Mkrtchyan Andranik,Darbinyan Armen,fiurst,Darbinyan Armen - Mkrtchyan Andranik,50,17,33,16,-16,18,14,18,0,0,4,8,4,0,0,16,7:11 - 3:11 - 7:11 - 0:0 - 0:0
13669336,2023-08-26 15:30:00,Petrosyan Davit - Grigoryan Erik,1:3,7:11 - 11:7 - 11:8 - 11:8 - 0:0,3,1,Petrosyan Davit,Grigoryan Erik,fiurst,Grigoryan Erik - Petrosyan Davit,74,34,40,6,-6,18,18,19,19,0,-4,4,3,3,0,6,11:7 - 7:11 - 8:11 - 8:11 - 0:0
13669329,2023-08-26 15:15:00,Gevorgyan Gegham - Mkrtchyan Andranik,0:3,5:11 - 9:11 - 6:11 - 0:0 - 0:0,0,3,Gevorgyan Gegham,Mkrtchyan Andranik,fiurst,Gevorgyan Gegham - Mkrtchyan Andranik,53,20,33,13,-13,16,20,17,0,0,6,2,5,0,0,13,5:11 - 9:11 - 6:11 - 0:0 - 0:0
13669309,2023-08-26 15:05:00,Antonyan Eduard - Soghomonyan Hrayr,3:0,11:8 - 11:6 - 11:4 - 0:0 - 0:0,3,0,Antonyan Eduard,Soghomonyan Hrayr,fiurst,Antonyan Eduard - Soghomonyan Hrayr,51,33,18,-15,15,19,17,15,0,0,-3,-5,-7,0,0,-15,11:8 - 11:6 - 11:4 - 0:0 - 0:0
13669308,2023-08-26 14:45:00,Rafayelyan Edgar - Nikoghosyan Narek,0:3,13:11 - 11:6 - 11:9 - 0:0 - 0:0,3,0,Rafayelyan Edgar,Nikoghosyan Narek,fiurst,Nikoghosyan Narek - Rafayelyan Edgar,61,26,35,9,-9,24,17,20,0,0,2,5,2,0,0,9,11:13 - 6:11 - 9:11 - 0:0 - 0:0
13669276,2023-08-26 14:35:00,Papyan Karen - Antonyan Eduard,1:3,11:6 - 6:11 - 11:6 - 11:8 - 0:0,3,1,Papyan Karen,Antonyan Eduard,fiurst,Antonyan Eduard - Papyan Karen,70,31,39,8,-8,17,17,17,19,0,5,-5,5,3,0,8,6:11 - 11:6 - 6:11 - 8:11 - 0:0
13669274,2023-08-26 14:15:00,Soghomonyan Hrayr - Rafayelyan Edgar,2:0,2:11 - 11:13 - 0:0 - 0:0 - 0:0,0,2,Soghomonyan Hrayr,Rafayelyan Edgar,fiurst,Rafayelyan Edgar - Soghomonyan Hrayr,37,24,13,-11,11,13,24,0,0,0,-9,-2,0,0,0,-11,11:2 - 13:11 - 0:0 - 0:0 - 0:0
13669273,2023-08-26 14:05:00,Papyan Karen - Nikoghosyan Narek,1:3,11:8 - 5:11 - 11:3 - 11:6 - 0:0,3,1,Papyan Karen,Nikoghosyan Narek,fiurst,Nikoghosyan Narek - Papyan Karen,66,28,38,10,-10,19,16,14,17,0,3,-6,8,5,0,10,8:11 - 11:5 - 3:11 - 6:11 - 0:0
13668585,2023-08-26 13:45:00,Antonyan Eduard - Rafayelyan Edgar,1:3,11:5 - 9:11 - 3:11 - 7:11 - 0:0,1,3,Antonyan Eduard,Rafayelyan Edgar,fiurst,Antonyan Eduard - Rafayelyan Edgar,68,30,38,8,-8,16,20,14,18,0,-6,2,8,4,0,8,11:5 - 9:11 - 3:11 - 7:11 - 0:0
13668578,2023-08-26 13:30:00,Soghomonyan Hrayr - Papyan Karen,3:0,9:11 - 4:11 - 9:11 - 0:0 - 0:0,0,3,Soghomonyan Hrayr,Papyan Karen,fiurst,Papyan Karen - Soghomonyan Hrayr,55,33,22,-11,11,20,15,20,0,0,-2,-7,-2,0,0,-11,11:9 - 11:4 - 11:9 - 0:0 - 0:0
13668577,2023-08-26 13:25:00,Nikoghosyan Narek - Antonyan Eduard,0:3,13:11 - 11:7 - 11:7 - 0:0 - 0:0,3,0,Nikoghosyan Narek,Antonyan Eduard,fiurst,Antonyan Eduard - Nikoghosyan Narek,60,25,35,10,-10,24,18,18,0,0,2,4,4,0,0,10,11:13 - 7:11 - 7:11 - 0:0 - 0:0
13668576,2023-08-26 13:00:00,Rafayelyan Edgar - Papyan Karen,3:2,11:9 - 11:7 - 12:14 - 6:11 - 7:11,2,3,Rafayelyan Edgar,Papyan Karen,fiurst,Papyan Karen - Rafayelyan Edgar,99,52,47,-5,5,20,18,26,17,18,2,4,-2,-5,-4,-5,9:11 - 7:11 - 14:12 - 11:6 - 11:7
13668574,2023-08-26 12:55:00,Nikoghosyan Narek - Soghomonyan Hrayr,3:1,11:9 - 11:8 - 1:11 - 11:9 - 0:0,3,1,Nikoghosyan Narek,Soghomonyan Hrayr,fiurst,Nikoghosyan Narek - Soghomonyan Hrayr,71,34,37,3,-3,20,19,12,20,0,-2,-3,10,-2,0,3,11:9 - 11:8 - 1:11 - 11:9 - 0:0
13668565,2023-08-26 12:20:00,Antonyan Eduard - Papyan Karen,3:1,9:11 - 11:4 - 11:6 - 11:9 - 0:0,3,1,Antonyan Eduard,Papyan Karen,fiurst,Antonyan Eduard - Papyan Karen,72,42,30,-12,12,20,15,17,20,0,2,-7,-5,-2,0,-12,9:11 - 11:4 - 11:6 - 11:9 - 0:0
13668534,2023-08-26 12:00:00,Nikoghosyan Narek - Rafayelyan Edgar,2:3,11:8 - 9:11 - 8:11 - 13:11 - 5:11,2,3,Nikoghosyan Narek,Rafayelyan Edgar,fiurst,Nikoghosyan Narek - Rafayelyan Edgar,98,46,52,6,-6,19,20,19,24,16,-3,2,3,-2,6,6,11:8 - 9:11 - 8:11 - 13:11 - 5:11
13668533,2023-08-26 11:45:00,Soghomonyan Hrayr - Antonyan Eduard,3:1,9:11 - 11:9 - 11:13 - 5:11 - 0:0,1,3,Soghomonyan Hrayr,Antonyan Eduard,fiurst,Antonyan Eduard - Soghomonyan Hrayr,80,44,36,-8,8,20,20,24,16,0,-2,2,-2,-6,0,-8,11:9 - 9:11 - 13:11 - 11:5 - 0:0
13668531,2023-08-26 11:30:00,Nikoghosyan Narek - Papyan Karen,2:3,9:11 - 11:9 - 6:11 - 11:5 - 13:15,2,3,Nikoghosyan Narek,Papyan Karen,fiurst,Nikoghosyan Narek - Papyan Karen,101,50,51,1,-1,20,20,17,16,28,2,-2,5,-6,2,1,9:11 - 11:9 - 6:11 - 11:5 - 13:15
13668526,2023-08-26 11:15:00,Rafayelyan Edgar - Soghomonyan Hrayr,3:0,11:9 - 11:8 - 11:9 - 0:0 - 0:0,3,0,Rafayelyan Edgar,Soghomonyan Hrayr,fiurst,Rafayelyan Edgar - Soghomonyan Hrayr,59,33,26,-7,7,20,19,20,0,0,-2,-3,-2,0,0,-7,11:9 - 11:8 - 11:9 - 0:0 - 0:0
13668523,2023-08-26 11:05:00,Antonyan Eduard - Nikoghosyan Narek,0:3,11:13 - 7:11 - 4:11 - 0:0 - 0:0,0,3,Antonyan Eduard,Nikoghosyan Narek,fiurst,Antonyan Eduard - Nikoghosyan Narek,57,22,35,13,-13,24,18,15,0,0,2,4,7,0,0,13,11:13 - 7:11 - 4:11 - 0:0 - 0:0
13668522,2023-08-26 10:45:00,Papyan Karen - Soghomonyan Hrayr,3:0,11:5 - 11:6 - 11:8 - 0:0 - 0:0,3,0,Papyan Karen,Soghomonyan Hrayr,fiurst,Papyan Karen - Soghomonyan Hrayr,52,33,19,-14,14,16,17,19,0,0,-6,-5,-3,0,0,-14,11:5 - 11:6 - 11:8 - 0:0 - 0:0
13668521,2023-08-26 10:30:00,Rafayelyan Edgar - Antonyan Eduard,3:2,11:7 - 6:11 - 11:6 - 12:14 - 14:16,2,3,Rafayelyan Edgar,Antonyan Eduard,fiurst,Antonyan Eduard - Rafayelyan Edgar,108,54,54,0,0,18,17,17,26,30,4,-5,5,-2,-2,0,7:11 - 11:6 - 6:11 - 14:12 - 16:14
13668518,2023-08-26 10:15:00,Soghomonyan Hrayr - Nikoghosyan Narek,3:0,8:11 - 5:11 - 4:11 - 0:0 - 0:0,0,3,Soghomonyan Hrayr,Nikoghosyan Narek,fiurst,Nikoghosyan Narek - Soghomonyan Hrayr,50,33,17,-16,16,19,16,15,0,0,-3,-6,-7,0,0,-16,11:8 - 11:5 - 11:4 - 0:0 - 0:0
13668480,2023-08-26 10:00:00,Papyan Karen - Rafayelyan Edgar,3:2,7:11 - 11:5 - 11:5 - 9:11 - 11:8,3,2,Papyan Karen,Rafayelyan Edgar,fiurst,Papyan Karen - Rafayelyan Edgar,89,49,40,-9,9,18,16,16,20,19,4,-6,-6,2,-3,-9,7:11 - 11:5 - 11:5 - 9:11 - 11:8
13647493,2023-08-25 17:45:00,Papyan Karen - Nazaryan Mushegh,1:3,12:14 - 11:4 - 13:11 - 11:5 - 0:0,3,1,Papyan Karen,Nazaryan Mushegh,fiurst,Nazaryan Mushegh - Papyan Karen,81,34,47,13,-13,26,15,24,16,0,-2,7,2,6,0,13,14:12 - 4:11 - 11:13 - 5:11 - 0:0
13647492,2023-08-25 17:30:00,Nikoghosyan Narek - Mkrtchyan Andranik,0:3,11:2 - 11:4 - 11:7 - 0:0 - 0:0,3,0,Nikoghosyan Narek,Mkrtchyan Andranik,fiurst,Mkrtchyan Andranik - Nikoghosyan Narek,46,13,33,20,-20,13,15,18,0,0,9,7,4,0,0,20,2:11 - 4:11 - 7:11 - 0:0 - 0:0
13647479,2023-08-25 17:15:00,Petrosyan Davit - Soghomonyan Hrayr,2:3,7:11 - 11:6 - 12:10 - 8:11 - 8:11,2,3,Petrosyan Davit,Soghomonyan Hrayr,fiurst,Petrosyan Davit - Soghomonyan Hrayr,95,46,49,3,-3,18,17,22,19,19,4,-5,-2,3,3,3,7:11 - 11:6 - 12:10 - 8:11 - 8:11
13647478,2023-08-25 17:00:00,Nikoghosyan Narek - Nazaryan Mushegh,0:3,13:11 - 11:8 - 11:5 - 0:0 - 0:0,3,0,Nikoghosyan Narek,Nazaryan Mushegh,fiurst,Nazaryan Mushegh - Nikoghosyan Narek,59,24,35,11,-11,24,19,16,0,0,2,3,6,0,0,11,11:13 - 8:11 - 5:11 - 0:0 - 0:0
13647449,2023-08-25 16:45:00,Diaryan Aleksandr - Papyan Karen,2:3,11:4 - 9:11 - 13:11 - 8:11 - 7:11,2,3,Diaryan Aleksandr,Papyan Karen,fiurst,Diaryan Aleksandr - Papyan Karen,96,48,48,0,0,15,20,24,19,18,-7,2,-2,3,4,0,11:4 - 9:11 - 13:11 - 8:11 - 7:11
13647443,2023-08-25 16:30:00,Soghomonyan Hrayr - Mkrtchyan Andranik,2:3,10:12 - 11:4 - 11:5 - 7:11 - 11:1,3,2,Soghomonyan Hrayr,Mkrtchyan Andranik,fiurst,Mkrtchyan Andranik - Soghomonyan Hrayr,83,33,50,17,-17,22,15,16,18,12,-2,7,6,-4,10,17,12:10 - 4:11 - 5:11 - 11:7 - 1:11
13647196,2023-08-25 16:15:00,Nazaryan Mushegh - Petrosyan Davit,3:0,11:5 - 11:6 - 11:8 - 0:0 - 0:0,3,0,Nazaryan Mushegh,Petrosyan Davit,fiurst,Nazaryan Mushegh - Petrosyan Davit,52,33,19,-14,14,16,17,19,0,0,-6,-5,-3,0,0,-14,11:5 - 11:6 - 11:8 - 0:0 - 0:0
13647181,2023-08-25 16:00:00,Mkrtchyan Andranik - Diaryan Aleksandr,3:0,3:11 - 4:11 - 6:11 - 0:0 - 0:0,0,3,Mkrtchyan Andranik,Diaryan Aleksandr,fiurst,Diaryan Aleksandr - Mkrtchyan Andranik,46,33,13,-20,20,14,15,17,0,0,-8,-7,-5,0,0,-20,11:3 - 11:4 - 11:6 - 0:0 - 0:0
13647180,2023-08-25 15:45:00,Papyan Karen - Nikoghosyan Narek,0:3,12:10 - 11:9 - 12:10 - 0:0 - 0:0,3,0,Papyan Karen,Nikoghosyan Narek,fiurst,Nikoghosyan Narek - Papyan Karen,64,29,35,6,-6,22,20,22,0,0,2,2,2,0,0,6,10:12 - 9:11 - 10:12 - 0:0 - 0:0
13647175,2023-08-25 15:30:00,Nazaryan Mushegh - Diaryan Aleksandr,3:0,4:11 - 5:11 - 3:11 - 0:0 - 0:0,0,3,Nazaryan Mushegh,Diaryan Aleksandr,fiurst,Diaryan Aleksandr - Nazaryan Mushegh,45,33,12,-21,21,15,16,14,0,0,-7,-6,-8,0,0,-21,11:4 - 11:5 - 11:3 - 0:0 - 0:0
13647171,2023-08-25 15:15:00,Petrosyan Davit - Nikoghosyan Narek,3:0,8:11 - 9:11 - 6:11 - 0:0 - 0:0,0,3,Petrosyan Davit,Nikoghosyan Narek,fiurst,Nikoghosyan Narek - Petrosyan Davit,56,33,23,-10,10,19,20,17,0,0,-3,-2,-5,0,0,-10,11:8 - 11:9 - 11:6 - 0:0 - 0:0
13647168,2023-08-25 15:05:00,Soghomonyan Hrayr - Papyan Karen,3:0,6:11 - 5:11 - 3:11 - 0:0 - 0:0,0,3,Soghomonyan Hrayr,Papyan Karen,fiurst,Papyan Karen - Soghomonyan Hrayr,47,33,14,-19,19,17,16,14,0,0,-5,-6,-8,0,0,-19,11:6 - 11:5 - 11:3 - 0:0 - 0:0
13647164,2023-08-25 14:45:00,Mkrtchyan Andranik - Nazaryan Mushegh,0:3,4:11 - 6:11 - 7:11 - 0:0 - 0:0,0,3,Mkrtchyan Andranik,Nazaryan Mushegh,fiurst,Mkrtchyan Andranik - Nazaryan Mushegh,50,17,33,16,-16,15,17,18,0,0,7,5,4,0,0,16,4:11 - 6:11 - 7:11 - 0:0 - 0:0
13647162,2023-08-25 14:30:00,Soghomonyan Hrayr - Petrosyan Davit,1:3,11:6 - 15:13 - 7:11 - 12:10 - 0:0,3,1,Soghomonyan Hrayr,Petrosyan Davit,fiurst,Petrosyan Davit - Soghomonyan Hrayr,85,40,45,5,-5,17,28,18,22,0,5,2,-4,2,0,5,6:11 - 13:15 - 11:7 - 10:12 - 0:0
13647067,2023-08-25 13:45:00,Diaryan Aleksandr - Nikoghosyan Narek,3:1,11:7 - 11:1 - 3:11 - 11:6 - 0:0,3,1,Diaryan Aleksandr,Nikoghosyan Narek,fiurst,Diaryan Aleksandr - Nikoghosyan Narek,61,36,25,-11,11,18,12,14,17,0,-4,-10,8,-5,0,-11,11:7 - 11:1 - 3:11 - 11:6 - 0:0
13647064,2023-08-25 13:30:00,Papyan Karen - Mkrtchyan Andranik,0:3,11:4 - 11:4 - 11:7 - 0:0 - 0:0,3,0,Papyan Karen,Mkrtchyan Andranik,fiurst,Mkrtchyan Andranik - Papyan Karen,48,15,33,18,-18,15,15,18,0,0,7,7,4,0,0,18,4:11 - 4:11 - 7:11 - 0:0 - 0:0
13647063,2023-08-25 13:15:00,Petrosyan Davit - Diaryan Aleksandr,3:0,5:11 - 2:11 - 2:11 - 0:0 - 0:0,0,3,Petrosyan Davit,Diaryan Aleksandr,fiurst,Diaryan Aleksandr - Petrosyan Davit,42,33,9,-24,24,16,13,13,0,0,-6,-9,-9,0,0,-24,11:5 - 11:2 - 11:2 - 0:0 - 0:0
13647049,2023-08-25 13:00:00,Nazaryan Mushegh - Soghomonyan Hrayr,3:2,6:11 - 11:8 - 5:11 - 11:5 - 11:7,3,2,Nazaryan Mushegh,Soghomonyan Hrayr,fiurst,Nazaryan Mushegh - Soghomonyan Hrayr,86,44,42,-2,2,17,19,16,16,18,5,-3,6,-6,-4,-2,6:11 - 11:8 - 5:11 - 11:5 - 11:7
13647031,2023-08-25 12:45:00,Papyan Karen - Petrosyan Davit,3:1,7:11 - 12:10 - 11:9 - 11:7 - 0:0,3,1,Papyan Karen,Petrosyan Davit,fiurst,Papyan Karen - Petrosyan Davit,78,41,37,-4,4,18,22,20,18,0,4,-2,-2,-4,0,-4,7:11 - 12:10 - 11:9 - 11:7 - 0:0
13647027,2023-08-25 12:30:00,Mkrtchyan Andranik - Nikoghosyan Narek,0:3,7:11 - 7:11 - 13:15 - 0:0 - 0:0,0,3,Mkrtchyan Andranik,Nikoghosyan Narek,fiurst,Mkrtchyan Andranik - Nikoghosyan Narek,64,27,37,10,-10,18,18,28,0,0,4,4,2,0,0,10,7:11 - 7:11 - 13:15 - 0:0 - 0:0
13647024,2023-08-25 12:20:00,Soghomonyan Hrayr - Diaryan Aleksandr,3:0,5:11 - 5:11 - 5:11 - 0:0 - 0:0,0,3,Soghomonyan Hrayr,Diaryan Aleksandr,fiurst,Diaryan Aleksandr - Soghomonyan Hrayr,48,33,15,-18,18,16,16,16,0,0,-6,-6,-6,0,0,-18,11:5 - 11:5 - 11:5 - 0:0 - 0:0
13647022,2023-08-25 12:00:00,Nazaryan Mushegh - Papyan Karen,3:2,11:7 - 8:11 - 11:9 - 4:11 - 11:6,3,2,Nazaryan Mushegh,Papyan Karen,fiurst,Nazaryan Mushegh - Papyan Karen,89,45,44,-1,1,18,19,20,15,17,-4,3,-2,7,-5,-1,11:7 - 8:11 - 11:9 - 4:11 - 11:6
13647020,2023-08-25 11:45:00,Nikoghosyan Narek - Soghomonyan Hrayr,2:3,9:11 - 13:11 - 11:6 - 7:11 - 8:11,2,3,Nikoghosyan Narek,Soghomonyan Hrayr,fiurst,Nikoghosyan Narek - Soghomonyan Hrayr,98,48,50,2,-2,20,24,17,18,19,2,-2,-5,4,3,2,9:11 - 13:11 - 11:6 - 7:11 - 8:11
13647016,2023-08-25 11:30:00,Petrosyan Davit - Mkrtchyan Andranik,3:0,9:11 - 11:13 - 14:16 - 0:0 - 0:0,0,3,Petrosyan Davit,Mkrtchyan Andranik,fiurst,Mkrtchyan Andranik - Petrosyan Davit,74,40,34,-6,6,20,24,30,0,0,-2,-2,-2,0,0,-6,11:9 - 13:11 - 16:14 - 0:0 - 0:0
13647014,2023-08-25 11:15:00,Nazaryan Mushegh - Nikoghosyan Narek,1:3,4:11 - 4:11 - 11:7 - 6:11 - 0:0,1,3,Nazaryan Mushegh,Nikoghosyan Narek,fiurst,Nazaryan Mushegh - Nikoghosyan Narek,65,25,40,15,-15,15,15,18,17,0,7,7,-4,5,0,15,4:11 - 4:11 - 11:7 - 6:11 - 0:0
13646997,2023-08-25 11:00:00,Papyan Karen - Diaryan Aleksandr,3:0,10:12 - 4:11 - 7:11 - 0:0 - 0:0,0,3,Papyan Karen,Diaryan Aleksandr,fiurst,Diaryan Aleksandr - Papyan Karen,55,34,21,-13,13,22,15,18,0,0,-2,-7,-4,0,0,-13,12:10 - 11:4 - 11:7 - 0:0 - 0:0
13646996,2023-08-25 10:45:00,Mkrtchyan Andranik - Soghomonyan Hrayr,1:3,7:11 - 11:9 - 6:11 - 8:11 - 0:0,1,3,Mkrtchyan Andranik,Soghomonyan Hrayr,fiurst,Mkrtchyan Andranik - Soghomonyan Hrayr,74,32,42,10,-10,18,20,17,19,0,4,-2,5,3,0,10,7:11 - 11:9 - 6:11 - 8:11 - 0:0
13646985,2023-08-25 10:30:00,Petrosyan Davit - Nazaryan Mushegh,3:1,11:8 - 9:11 - 9:11 - 10:12 - 0:0,1,3,Petrosyan Davit,Nazaryan Mushegh,fiurst,Nazaryan Mushegh - Petrosyan Davit,81,42,39,-3,3,19,20,20,22,0,3,-2,-2,-2,0,-3,8:11 - 11:9 - 11:9 - 12:10 - 0:0
13646977,2023-08-25 10:15:00,Nikoghosyan Narek - Papyan Karen,1:3,10:12 - 11:2 - 9:11 - 11:13 - 0:0,1,3,Nikoghosyan Narek,Papyan Karen,fiurst,Nikoghosyan Narek - Papyan Karen,79,41,38,-3,3,22,13,20,24,0,2,-9,2,2,0,-3,10:12 - 11:2 - 9:11 - 11:13 - 0:0
13646974,2023-08-25 10:00:00,Diaryan Aleksandr - Mkrtchyan Andranik,3:1,11:7 - 11:8 - 8:11 - 11:4 - 0:0,3,1,Diaryan Aleksandr,Mkrtchyan Andranik,fiurst,Diaryan Aleksandr - Mkrtchyan Andranik,71,41,30,-11,11,18,19,19,15,0,-4,-3,3,-7,0,-11,11:7 - 11:8 - 8:11 - 11:4 - 0:0
13633118,2023-08-24 17:45:00,Petrosyan Davit - Diaryan Aleksandr,3:0,4:11 - 7:11 - 4:11 - 0:0 - 0:0,0,3,Petrosyan Davit,Diaryan Aleksandr,fiurst,Diaryan Aleksandr - Petrosyan Davit,48,33,15,-18,18,15,18,15,0,0,-7,-4,-7,0,0,-18,11:4 - 11:7 - 11:4 - 0:0 - 0:0
13633117,2023-08-24 17:30:00,Soghomonyan Hrayr - Nikoghosyan Narek,3:1,5:11 - 12:10 - 9:11 - 8:11 - 0:0,1,3,Soghomonyan Hrayr,Nikoghosyan Narek,fiurst,Nikoghosyan Narek - Soghomonyan Hrayr,77,43,34,-9,9,16,22,20,19,0,-6,2,-2,-3,0,-9,11:5 - 10:12 - 11:9 - 11:8 - 0:0
13633114,2023-08-24 17:00:00,Petrosyan Davit - Soghomonyan Hrayr,0:3,7:11 - 5:11 - 2:11 - 0:0 - 0:0,0,3,Petrosyan Davit,Soghomonyan Hrayr,fiurst,Petrosyan Davit - Soghomonyan Hrayr,47,14,33,19,-19,18,16,13,0,0,4,6,9,0,0,19,7:11 - 5:11 - 2:11 - 0:0 - 0:0
13633100,2023-08-24 16:30:00,Antonyan Eduard - Nikoghosyan Narek,2:3,9:11 - 11:9 - 7:11 - 11:6 - 8:11,2,3,Antonyan Eduard,Nikoghosyan Narek,fiurst,Antonyan Eduard - Nikoghosyan Narek,94,46,48,2,-2,20,20,18,17,19,2,-2,4,-5,3,2,9:11 - 11:9 - 7:11 - 11:6 - 8:11
13633094,2023-08-24 16:00:00,Nikoghosyan Narek - Petrosyan Davit,3:0,11:8 - 11:9 - 11:4 - 0:0 - 0:0,3,0,Nikoghosyan Narek,Petrosyan Davit,fiurst,Nikoghosyan Narek - Petrosyan Davit,54,33,21,-12,12,19,20,15,0,0,-3,-2,-7,0,0,-12,11:8 - 11:9 - 11:4 - 0:0 - 0:0
13633091,2023-08-24 15:45:00,Diaryan Aleksandr - Antonyan Eduard,3:0,1:11 - 12:14 - 9:11 - 0:0 - 0:0,0,3,Diaryan Aleksandr,Antonyan Eduard,fiurst,Antonyan Eduard - Diaryan Aleksandr,58,36,22,-14,14,12,26,20,0,0,-10,-2,-2,0,0,-14,11:1 - 14:12 - 11:9 - 0:0 - 0:0
13633085,2023-08-24 15:15:00,Soghomonyan Hrayr - Diaryan Aleksandr,3:1,11:7 - 8:11 - 8:11 - 4:11 - 0:0,1,3,Soghomonyan Hrayr,Diaryan Aleksandr,fiurst,Diaryan Aleksandr - Soghomonyan Hrayr,71,40,31,-9,9,18,19,19,15,0,4,-3,-3,-7,0,-9,7:11 - 11:8 - 11:8 - 11:4 - 0:0
13633084,2023-08-24 15:00:00,Antonyan Eduard - Petrosyan Davit,3:0,11:7 - 11:6 - 11:9 - 0:0 - 0:0,3,0,Antonyan Eduard,Petrosyan Davit,fiurst,Antonyan Eduard - Petrosyan Davit,55,33,22,-11,11,18,17,20,0,0,-4,-5,-2,0,0,-11,11:7 - 11:6 - 11:9 - 0:0 - 0:0
13633071,2023-08-24 14:45:00,Diaryan Aleksandr - Nikoghosyan Narek,1:3,8:11 - 11:9 - 11:13 - 7:11 - 0:0,1,3,Diaryan Aleksandr,Nikoghosyan Narek,fiurst,Diaryan Aleksandr - Nikoghosyan Narek,81,37,44,7,-7,19,20,24,18,0,3,-2,2,4,0,7,8:11 - 11:9 - 11:13 - 7:11 - 0:0
13633069,2023-08-24 13:45:00,Soghomonyan Hrayr - Antonyan Eduard,3:0,6:11 - 9:11 - 4:11 - 0:0 - 0:0,0,3,Soghomonyan Hrayr,Antonyan Eduard,fiurst,Antonyan Eduard - Soghomonyan Hrayr,52,33,19,-14,14,17,20,15,0,0,-5,-2,-7,0,0,-14,11:6 - 11:9 - 11:4 - 0:0 - 0:0
13612839,2023-08-24 13:30:00,Diaryan Aleksandr - Petrosyan Davit,3:0,11:4 - 11:6 - 11:5 - 0:0 - 0:0,3,0,Diaryan Aleksandr,Petrosyan Davit,fiurst,Diaryan Aleksandr - Petrosyan Davit,48,33,15,-18,18,15,17,16,0,0,-7,-5,-6,0,0,-18,11:4 - 11:6 - 11:5 - 0:0 - 0:0
13612835,2023-08-24 13:15:00,Nikoghosyan Narek - Soghomonyan Hrayr,3:0,11:7 - 11:8 - 11:6 - 0:0 - 0:0,3,0,Nikoghosyan Narek,Soghomonyan Hrayr,fiurst,Nikoghosyan Narek - Soghomonyan Hrayr,54,33,21,-12,12,18,19,17,0,0,-4,-3,-5,0,0,-12,11:7 - 11:8 - 11:6 - 0:0 - 0:0
13612819,2023-08-24 12:45:00,Soghomonyan Hrayr - Petrosyan Davit,0:3,11:7 - 11:7 - 11:6 - 0:0 - 0:0,3,0,Soghomonyan Hrayr,Petrosyan Davit,fiurst,Petrosyan Davit - Soghomonyan Hrayr,53,20,33,13,-13,18,18,17,0,0,4,4,5,0,0,13,7:11 - 7:11 - 6:11 - 0:0 - 0:0
13612814,2023-08-24 12:15:00,Nikoghosyan Narek - Antonyan Eduard,3:2,10:12 - 11:7 - 9:11 - 11:8 - 10:12,2,3,Nikoghosyan Narek,Antonyan Eduard,fiurst,Antonyan Eduard - Nikoghosyan Narek,101,50,51,1,-1,22,18,20,19,22,-2,4,-2,3,-2,1,12:10 - 7:11 - 11:9 - 8:11 - 12:10
13612809,2023-08-24 11:45:00,Petrosyan Davit - Nikoghosyan Narek,3:0,4:11 - 5:11 - 3:11 - 0:0 - 0:0,0,3,Petrosyan Davit,Nikoghosyan Narek,fiurst,Nikoghosyan Narek - Petrosyan Davit,45,33,12,-21,21,15,16,14,0,0,-7,-6,-8,0,0,-21,11:4 - 11:5 - 11:3 - 0:0 - 0:0
13612807,2023-08-24 11:30:00,Antonyan Eduard - Diaryan Aleksandr,0:3,7:11 - 4:11 - 2:11 - 0:0 - 0:0,0,3,Antonyan Eduard,Diaryan Aleksandr,fiurst,Antonyan Eduard - Diaryan Aleksandr,46,13,33,20,-20,18,15,13,0,0,4,7,9,0,0,20,7:11 - 4:11 - 2:11 - 0:0 - 0:0
13612805,2023-08-24 11:00:00,Diaryan Aleksandr - Soghomonyan Hrayr,3:0,12:10 - 11:4 - 11:5 - 0:0 - 0:0,3,0,Diaryan Aleksandr,Soghomonyan Hrayr,fiurst,Diaryan Aleksandr - Soghomonyan Hrayr,53,34,19,-15,15,22,15,16,0,0,-2,-7,-6,0,0,-15,12:10 - 11:4 - 11:5 - 0:0 - 0:0
13612803,2023-08-24 10:45:00,Petrosyan Davit - Antonyan Eduard,3:0,12:14 - 6:11 - 8:11 - 0:0 - 0:0,0,3,Petrosyan Davit,Antonyan Eduard,fiurst,Antonyan Eduard - Petrosyan Davit,62,36,26,-10,10,26,17,19,0,0,-2,-5,-3,0,0,-10,14:12 - 11:6 - 11:8 - 0:0 - 0:0
13612802,2023-08-24 10:30:00,Nikoghosyan Narek - Diaryan Aleksandr,3:0,7:11 - 9:11 - 4:11 - 0:0 - 0:0,0,3,Nikoghosyan Narek,Diaryan Aleksandr,fiurst,Diaryan Aleksandr - Nikoghosyan Narek,53,33,20,-13,13,18,20,15,0,0,-4,-2,-7,0,0,-13,11:7 - 11:9 - 11:4 - 0:0 - 0:0
13612801,2023-08-24 10:15:00,Petrosyan Davit - Darbinyan Armen,0:3,11:8 - 11:7 - 11:6 - 0:0 - 0:0,3,0,Petrosyan Davit,Darbinyan Armen,fiurst,Darbinyan Armen - Petrosyan Davit,54,21,33,12,-12,19,18,17,0,0,3,4,5,0,0,12,8:11 - 7:11 - 6:11 - 0:0 - 0:0
13612790,2023-08-24 10:00:00,Antonyan Eduard - Soghomonyan Hrayr,3:1,10:12 - 11:6 - 11:4 - 11:7 - 0:0,3,1,Antonyan Eduard,Soghomonyan Hrayr,fiurst,Antonyan Eduard - Soghomonyan Hrayr,72,43,29,-14,14,22,17,15,18,0,2,-5,-7,-4,0,-14,10:12 - 11:6 - 11:4 - 11:7 - 0:0
13611637,2023-08-23 17:45:00,Darbinyan Armen - Soghomonyan Hrayr,0:3,6:11 - 8:11 - 5:11 - 0:0 - 0:0,0,3,Darbinyan Armen,Soghomonyan Hrayr,fiurst,Darbinyan Armen - Soghomonyan Hrayr,52,19,33,14,-14,17,19,16,0,0,5,3,6,0,0,14,6:11 - 8:11 - 5:11 - 0:0 - 0:0
13611636,2023-08-23 17:35:00,Papyan Karen - Petrosyan Davit,3:0,11:9 - 11:9 - 11:9 - 0:0 - 0:0,3,0,Papyan Karen,Petrosyan Davit,fiurst,Papyan Karen - Petrosyan Davit,60,33,27,-6,6,20,20,20,0,0,-2,-2,-2,0,0,-6,11:9 - 11:9 - 11:9 - 0:0 - 0:0
13611635,2023-08-23 17:15:00,Antonyan Eduard - Diaryan Aleksandr,2:3,11:6 - 11:9 - 5:11 - 8:11 - 2:11,2,3,Antonyan Eduard,Diaryan Aleksandr,fiurst,Antonyan Eduard - Diaryan Aleksandr,85,37,48,11,-11,17,20,16,19,13,-5,-2,6,3,9,11,11:6 - 11:9 - 5:11 - 8:11 - 2:11
13611634,2023-08-23 17:00:00,Papyan Karen - Soghomonyan Hrayr,3:2,11:9 - 8:11 - 11:8 - 10:12 - 11:6,3,2,Papyan Karen,Soghomonyan Hrayr,fiurst,Papyan Karen - Soghomonyan Hrayr,97,51,46,-5,5,20,19,19,22,17,-2,3,-3,2,-5,-5,11:9 - 8:11 - 11:8 - 10:12 - 11:6
13611622,2023-08-23 16:45:00,Avakimyan Davit - Darbinyan Armen,3:0,11:9 - 11:5 - 15:13 - 0:0 - 0:0,3,0,Avakimyan Davit,Darbinyan Armen,fiurst,Avakimyan Davit - Darbinyan Armen,64,37,27,-10,10,20,16,28,0,0,-2,-6,-2,0,0,-10,11:9 - 11:5 - 15:13 - 0:0 - 0:0
13611620,2023-08-23 16:30:00,Diaryan Aleksandr - Petrosyan Davit,3:0,11:9 - 11:6 - 11:9 - 0:0 - 0:0,3,0,Diaryan Aleksandr,Petrosyan Davit,fiurst,Diaryan Aleksandr - Petrosyan Davit,57,33,24,-9,9,20,17,20,0,0,-2,-5,-2,0,0,-9,11:9 - 11:6 - 11:9 - 0:0 - 0:0
13611418,2023-08-23 16:15:00,Soghomonyan Hrayr - Antonyan Eduard,3:2,11:5 - 4:11 - 11:8 - 8:11 - 7:11,2,3,Soghomonyan Hrayr,Antonyan Eduard,fiurst,Antonyan Eduard - Soghomonyan Hrayr,87,46,41,-5,5,16,15,19,19,18,6,-7,3,-3,-4,-5,5:11 - 11:4 - 8:11 - 11:8 - 11:7
13611417,2023-08-23 16:00:00,Petrosyan Davit - Avakimyan Davit,3:1,5:11 - 5:11 - 11:9 - 1:11 - 0:0,1,3,Petrosyan Davit,Avakimyan Davit,fiurst,Avakimyan Davit - Petrosyan Davit,64,42,22,-20,20,16,16,20,12,0,-6,-6,2,-10,0,-20,11:5 - 11:5 - 9:11 - 11:1 - 0:0
13611404,2023-08-23 15:45:00,Darbinyan Armen - Papyan Karen,0:3,7:11 - 10:12 - 8:11 - 0:0 - 0:0,0,3,Darbinyan Armen,Papyan Karen,fiurst,Darbinyan Armen - Papyan Karen,59,25,34,9,-9,18,22,19,0,0,4,2,3,0,0,9,7:11 - 10:12 - 8:11 - 0:0 - 0:0
13611372,2023-08-23 15:30:00,Soghomonyan Hrayr - Avakimyan Davit,0:3,11:7 - 11:4 - 11:2 - 0:0 - 0:0,3,0,Soghomonyan Hrayr,Avakimyan Davit,fiurst,Avakimyan Davit - Soghomonyan Hrayr,46,13,33,20,-20,18,15,13,0,0,4,7,9,0,0,20,7:11 - 4:11 - 2:11 - 0:0 - 0:0
13611370,2023-08-23 15:15:00,Antonyan Eduard - Papyan Karen,1:3,12:10 - 7:11 - 4:11 - 3:11 - 0:0,1,3,Antonyan Eduard,Papyan Karen,fiurst,Antonyan Eduard - Papyan Karen,69,26,43,17,-17,22,18,15,14,0,-2,4,7,8,0,17,12:10 - 7:11 - 4:11 - 3:11 - 0:0
13611364,2023-08-23 15:05:00,Diaryan Aleksandr - Darbinyan Armen,0:3,11:8 - 11:6 - 11:5 - 0:0 - 0:0,3,0,Diaryan Aleksandr,Darbinyan Armen,fiurst,Darbinyan Armen - Diaryan Aleksandr,52,19,33,14,-14,19,17,16,0,0,3,5,6,0,0,14,8:11 - 6:11 - 5:11 - 0:0 - 0:0
13611348,2023-08-23 14:45:00,Petrosyan Davit - Soghomonyan Hrayr,1:3,2:11 - 9:11 - 12:10 - 9:11 - 0:0,1,3,Petrosyan Davit,Soghomonyan Hrayr,fiurst,Petrosyan Davit - Soghomonyan Hrayr,75,32,43,11,-11,13,20,22,20,0,9,2,-2,2,0,11,2:11 - 9:11 - 12:10 - 9:11 - 0:0
13611347,2023-08-23 14:35:00,Diaryan Aleksandr - Antonyan Eduard,2:3,11:4 - 9:11 - 12:10 - 3:11 - 11:4,3,2,Diaryan Aleksandr,Antonyan Eduard,fiurst,Antonyan Eduard - Diaryan Aleksandr,86,40,46,6,-6,15,20,22,14,15,7,-2,2,-8,7,6,4:11 - 11:9 - 10:12 - 11:3 - 4:11
13611346,2023-08-23 13:45:00,Avakimyan Davit - Papyan Karen,2:3,11:13 - 10:12 - 11:4 - 11:6 - 6:11,2,3,Avakimyan Davit,Papyan Karen,fiurst,Avakimyan Davit - Papyan Karen,95,49,46,-3,3,24,22,15,17,17,2,2,-7,-5,5,-3,11:13 - 10:12 - 11:4 - 11:6 - 6:11
13611345,2023-08-23 13:30:00,Darbinyan Armen - Petrosyan Davit,0:3,7:11 - 8:11 - 2:11 - 0:0 - 0:0,0,3,Darbinyan Armen,Petrosyan Davit,fiurst,Darbinyan Armen - Petrosyan Davit,50,17,33,16,-16,18,19,13,0,0,4,3,9,0,0,16,7:11 - 8:11 - 2:11 - 0:0 - 0:0
13611337,2023-08-23 13:15:00,Antonyan Eduard - Avakimyan Davit,3:2,11:4 - 10:12 - 11:6 - 11:13 - 11:9,3,2,Antonyan Eduard,Avakimyan Davit,fiurst,Antonyan Eduard - Avakimyan Davit,98,54,44,-10,10,15,22,17,24,20,-7,2,-5,2,-2,-10,11:4 - 10:12 - 11:6 - 11:13 - 11:9
13611314,2023-08-23 13:00:00,Soghomonyan Hrayr - Diaryan Aleksandr,3:0,5:11 - 7:11 - 3:11 - 0:0 - 0:0,0,3,Soghomonyan Hrayr,Diaryan Aleksandr,fiurst,Diaryan Aleksandr - Soghomonyan Hrayr,48,33,15,-18,18,16,18,14,0,0,-6,-4,-8,0,0,-18,11:5 - 11:7 - 11:3 - 0:0 - 0:0
13611318,2023-08-23 12:45:00,Soghomonyan Hrayr - Diaryan Aleksandr,0:0,0:0 - 0:0 - 0:0 - 0:0 - 0:0,0,0,Soghomonyan Hrayr,Diaryan Aleksandr,fiurst,Diaryan Aleksandr - Soghomonyan Hrayr,0,0,0,0,0,0,0,0,0,0,0,0,0,0,0,0,0:0 - 0:0 - 0:0 - 0:0 - 0:0
13629321,2023-08-23 12:45:00,Darbinyan Armen - Antonyan Eduard,3:0,3:11 - 7:11 - 5:11 - 0:0 - 0:0,0,3,Darbinyan Armen,Antonyan Eduard,fiurst,Antonyan Eduard - Darbinyan Armen,48,33,15,-18,18,14,18,16,0,0,-8,-4,-6,0,0,-18,11:3 - 11:7 - 11:5 - 0:0 - 0:0
13611313,2023-08-23 12:30:00,Petrosyan Davit - Papyan Karen,3:1,11:8 - 2:11 - 9:11 - 9:11 - 0:0,1,3,Petrosyan Davit,Papyan Karen,fiurst,Papyan Karen - Petrosyan Davit,72,41,31,-10,10,19,13,20,20,0,3,-9,-2,-2,0,-10,8:11 - 11:2 - 11:9 - 11:9 - 0:0
13611306,2023-08-23 12:15:00,Diaryan Aleksandr - Avakimyan Davit,0:3,11:4 - 11:5 - 11:6 - 0:0 - 0:0,3,0,Diaryan Aleksandr,Avakimyan Davit,fiurst,Avakimyan Davit - Diaryan Aleksandr,48,15,33,18,-18,15,16,17,0,0,7,6,5,0,0,18,4:11 - 5:11 - 6:11 - 0:0 - 0:0
13611301,2023-08-23 12:00:00,Soghomonyan Hrayr - Darbinyan Armen,0:3,11:8 - 11:7 - 11:7 - 0:0 - 0:0,3,0,Soghomonyan Hrayr,Darbinyan Armen,fiurst,Darbinyan Armen - Soghomonyan Hrayr,55,22,33,11,-11,19,18,18,0,0,3,4,4,0,0,11,8:11 - 7:11 - 7:11 - 0:0 - 0:0
13611299,2023-08-23 11:45:00,Papyan Karen - Diaryan Aleksandr,3:1,6:11 - 11:9 - 5:11 - 5:11 - 0:0,1,3,Papyan Karen,Diaryan Aleksandr,fiurst,Diaryan Aleksandr - Papyan Karen,69,42,27,-15,15,17,20,16,16,0,-5,2,-6,-6,0,-15,11:6 - 9:11 - 11:5 - 11:5 - 0:0
13611298,2023-08-23 11:30:00,Antonyan Eduard - Petrosyan Davit,3:0,11:8 - 11:7 - 11:8 - 0:0 - 0:0,3,0,Antonyan Eduard,Petrosyan Davit,fiurst,Antonyan Eduard - Petrosyan Davit,56,33,23,-10,10,19,18,19,0,0,-3,-4,-3,0,0,-10,11:8 - 11:7 - 11:8 - 0:0 - 0:0
13611294,2023-08-23 11:15:00,Soghomonyan Hrayr - Papyan Karen,3:2,7:11 - 11:3 - 11:7 - 10:12 - 6:11,2,3,Soghomonyan Hrayr,Papyan Karen,fiurst,Papyan Karen - Soghomonyan Hrayr,89,44,45,1,-1,18,14,18,22,17,-4,8,4,-2,-5,1,11:7 - 3:11 - 7:11 - 12:10 - 11:6
13611291,2023-08-23 11:00:00,Darbinyan Armen - Avakimyan Davit,3:0,6:11 - 6:11 - 8:11 - 0:0 - 0:0,0,3,Darbinyan Armen,Avakimyan Davit,fiurst,Avakimyan Davit - Darbinyan Armen,53,33,20,-13,13,17,17,19,0,0,-5,-5,-3,0,0,-13,11:6 - 11:6 - 11:8 - 0:0 - 0:0
13611280,2023-08-23 10:45:00,Petrosyan Davit - Diaryan Aleksandr,3:0,4:11 - 1:11 - 6:11 - 0:0 - 0:0,0,3,Petrosyan Davit,Diaryan Aleksandr,fiurst,Diaryan Aleksandr - Petrosyan Davit,44,33,11,-22,22,15,12,17,0,0,-7,-10,-5,0,0,-22,11:4 - 11:1 - 11:6 - 0:0 - 0:0
13611279,2023-08-23 10:30:00,Antonyan Eduard - Soghomonyan Hrayr,1:3,11:8 - 5:11 - 8:11 - 17:19 - 0:0,1,3,Antonyan Eduard,Soghomonyan Hrayr,fiurst,Antonyan Eduard - Soghomonyan Hrayr,90,41,49,8,-8,19,16,19,36,0,-3,6,3,2,0,8,11:8 - 5:11 - 8:11 - 17:19 - 0:0
13611278,2023-08-23 10:15:00,Papyan Karen - Darbinyan Armen,1:3,11:9 - 11:5 - 9:11 - 11:8 - 0:0,3,1,Papyan Karen,Darbinyan Armen,fiurst,Darbinyan Armen - Papyan Karen,75,33,42,9,-9,20,16,20,19,0,2,6,-2,3,0,9,9:11 - 5:11 - 11:9 - 8:11 - 0:0
13611276,2023-08-23 10:00:00,Avakimyan Davit - Petrosyan Davit,2:3,11:8 - 8:11 - 6:11 - 11:8 - 9:11,2,3,Avakimyan Davit,Petrosyan Davit,fiurst,Avakimyan Davit - Petrosyan Davit,94,45,49,4,-4,19,19,17,19,20,-3,3,5,-3,2,4,11:8 - 8:11 - 6:11 - 11:8 - 9:11
13594303,2023-08-22 17:45:00,Soghomonyan Hrayr - Antonyan Eduard,3:0,6:11 - 5:11 - 9:11 - 0:0 - 0:0,0,3,Soghomonyan Hrayr,Antonyan Eduard,fiurst,Antonyan Eduard - Soghomonyan Hrayr,53,33,20,-13,13,17,16,20,0,0,-5,-6,-2,0,0,-13,11:6 - 11:5 - 11:9 - 0:0 - 0:0
13594299,2023-08-22 17:30:00,Mkrtchyan Andranik - Papyan Karen,0:3,5:11 - 5:11 - 4:11 - 0:0 - 0:0,0,3,Mkrtchyan Andranik,Papyan Karen,fiurst,Mkrtchyan Andranik - Papyan Karen,47,14,33,19,-19,16,16,15,0,0,6,6,7,0,0,19,5:11 - 5:11 - 4:11 - 0:0 - 0:0
13594298,2023-08-22 17:20:00,Avakimyan Davit - Darbinyan Armen,2:3,11:8 - 6:11 - 11:9 - 11:13 - 9:11,2,3,Avakimyan Davit,Darbinyan Armen,fiurst,Avakimyan Davit - Darbinyan Armen,100,48,52,4,-4,19,17,20,24,20,-3,5,-2,2,2,4,11:8 - 6:11 - 11:9 - 11:13 - 9:11
13594297,2023-08-22 17:00:00,Mkrtchyan Andranik - Antonyan Eduard,3:0,6:11 - 8:11 - 8:11 - 0:0 - 0:0,0,3,Mkrtchyan Andranik,Antonyan Eduard,fiurst,Antonyan Eduard - Mkrtchyan Andranik,55,33,22,-11,11,17,19,19,0,0,-5,-3,-3,0,0,-11,11:6 - 11:8 - 11:8 - 0:0 - 0:0
13594286,2023-08-22 16:45:00,Diaryan Aleksandr - Soghomonyan Hrayr,3:2,11:2 - 11:4 - 12:14 - 10:12 - 16:14,3,2,Diaryan Aleksandr,Soghomonyan Hrayr,fiurst,Diaryan Aleksandr - Soghomonyan Hrayr,106,60,46,-14,14,13,15,26,22,30,-9,-7,2,2,-2,-14,11:2 - 11:4 - 12:14 - 10:12 - 16:14
13594284,2023-08-22 16:30:00,Darbinyan Armen - Papyan Karen,0:3,9:11 - 14:16 - 9:11 - 0:0 - 0:0,0,3,Darbinyan Armen,Papyan Karen,fiurst,Darbinyan Armen - Papyan Karen,70,32,38,6,-6,20,30,20,0,0,2,2,2,0,0,6,9:11 - 14:16 - 9:11 - 0:0 - 0:0
13594283,2023-08-22 16:15:00,Antonyan Eduard - Avakimyan Davit,3:0,11:4 - 11:4 - 11:9 - 0:0 - 0:0,3,0,Antonyan Eduard,Avakimyan Davit,fiurst,Antonyan Eduard - Avakimyan Davit,50,33,17,-16,16,15,15,20,0,0,-7,-7,-2,0,0,-16,11:4 - 11:4 - 11:9 - 0:0 - 0:0
13594280,2023-08-22 16:00:00,Papyan Karen - Diaryan Aleksandr,3:0,9:11 - 7:11 - 3:11 - 0:0 - 0:0,0,3,Papyan Karen,Diaryan Aleksandr,fiurst,Diaryan Aleksandr - Papyan Karen,52,33,19,-14,14,20,18,14,0,0,-2,-4,-8,0,0,-14,11:9 - 11:7 - 11:3 - 0:0 - 0:0
13594279,2023-08-22 15:45:00,Soghomonyan Hrayr - Mkrtchyan Andranik,1:3,11:9 - 15:13 - 9:11 - 11:6 - 0:0,3,1,Soghomonyan Hrayr,Mkrtchyan Andranik,fiurst,Mkrtchyan Andranik - Soghomonyan Hrayr,85,39,46,7,-7,20,28,20,17,0,2,2,-2,5,0,7,9:11 - 13:15 - 11:9 - 6:11 - 0:0
13594276,2023-08-22 15:30:00,Antonyan Eduard - Diaryan Aleksandr,3:2,12:10 - 6:11 - 3:11 - 11:9 - 12:10,3,2,Antonyan Eduard,Diaryan Aleksandr,fiurst,Antonyan Eduard - Diaryan Aleksandr,95,44,51,7,-7,22,17,14,20,22,-2,5,8,-2,-2,7,12:10 - 6:11 - 3:11 - 11:9 - 12:10
13594275,2023-08-22 15:15:00,Avakimyan Davit - Mkrtchyan Andranik,3:1,7:11 - 16:14 - 13:11 - 11:8 - 0:0,3,1,Avakimyan Davit,Mkrtchyan Andranik,fiurst,Avakimyan Davit - Mkrtchyan Andranik,91,47,44,-3,3,18,30,24,19,0,4,-2,-2,-3,0,-3,7:11 - 16:14 - 13:11 - 11:8 - 0:0
13594266,2023-08-22 15:00:00,Darbinyan Armen - Soghomonyan Hrayr,0:3,9:11 - 4:11 - 9:11 - 0:0 - 0:0,0,3,Darbinyan Armen,Soghomonyan Hrayr,fiurst,Darbinyan Armen - Soghomonyan Hrayr,55,22,33,11,-11,20,15,20,0,0,2,7,2,0,0,11,9:11 - 4:11 - 9:11 - 0:0 - 0:0
13594256,2023-08-22 14:45:00,Papyan Karen - Antonyan Eduard,1:3,14:12 - 11:13 - 11:4 - 11:4 - 0:0,3,1,Papyan Karen,Antonyan Eduard,fiurst,Antonyan Eduard - Papyan Karen,80,33,47,14,-14,26,24,15,15,0,2,-2,7,7,0,14,12:14 - 13:11 - 4:11 - 4:11 - 0:0
13594253,2023-08-22 14:30:00,Darbinyan Armen - Avakimyan Davit,3:2,11:1 - 7:11 - 13:11 - 10:12 - 5:11,2,3,Darbinyan Armen,Avakimyan Davit,fiurst,Avakimyan Davit - Darbinyan Armen,92,46,46,0,0,12,18,24,22,16,10,-4,2,-2,-6,0,1:11 - 11:7 - 11:13 - 12:10 - 11:5
13594250,2023-08-22 13:45:00,Diaryan Aleksandr - Mkrtchyan Andranik,3:0,11:4 - 11:5 - 11:7 - 0:0 - 0:0,3,0,Diaryan Aleksandr,Mkrtchyan Andranik,fiurst,Diaryan Aleksandr - Mkrtchyan Andranik,49,33,16,-17,17,15,16,18,0,0,-7,-6,-4,0,0,-17,11:4 - 11:5 - 11:7 - 0:0 - 0:0
13594572,2023-08-22 13:30:00,Soghomonyan Hrayr - Papyan Karen,3:2,8:11 - 12:10 - 11:9 - 8:11 - 6:11,2,3,Soghomonyan Hrayr,Papyan Karen,fiurst,Papyan Karen - Soghomonyan Hrayr,97,52,45,-7,7,19,22,20,19,17,-3,2,2,-3,-5,-7,11:8 - 10:12 - 9:11 - 11:8 - 11:6
13594561,2023-08-22 13:25:00,Avakimyan Davit - Diaryan Aleksandr,0:3,9:11 - 4:11 - 2:11 - 0:0 - 0:0,0,3,Avakimyan Davit,Diaryan Aleksandr,fiurst,Avakimyan Davit - Diaryan Aleksandr,48,15,33,18,-18,20,15,13,0,0,2,7,9,0,0,18,9:11 - 4:11 - 2:11 - 0:0 - 0:0
13594559,2023-08-22 13:00:00,Antonyan Eduard - Darbinyan Armen,3:0,11:6 - 11:6 - 11:7 - 0:0 - 0:0,3,0,Antonyan Eduard,Darbinyan Armen,fiurst,Antonyan Eduard - Darbinyan Armen,52,33,19,-14,14,17,17,18,0,0,-5,-5,-4,0,0,-14,11:6 - 11:6 - 11:7 - 0:0 - 0:0
13594554,2023-08-22 12:45:00,Soghomonyan Hrayr - Avakimyan Davit,2:3,11:8 - 19:17 - 9:11 - 10:12 - 11:9,3,2,Soghomonyan Hrayr,Avakimyan Davit,fiurst,Avakimyan Davit - Soghomonyan Hrayr,117,57,60,3,-3,19,36,20,22,20,3,2,-2,-2,2,3,8:11 - 17:19 - 11:9 - 12:10 - 9:11
13594552,2023-08-22 12:30:00,Papyan Karen - Mkrtchyan Andranik,0:3,11:4 - 12:10 - 11:9 - 0:0 - 0:0,3,0,Papyan Karen,Mkrtchyan Andranik,fiurst,Mkrtchyan Andranik - Papyan Karen,57,23,34,11,-11,15,22,20,0,0,7,2,2,0,0,11,4:11 - 10:12 - 9:11 - 0:0 - 0:0
13594549,2023-08-22 12:15:00,Darbinyan Armen - Diaryan Aleksandr,0:3,4:11 - 8:11 - 8:11 - 0:0 - 0:0,0,3,Darbinyan Armen,Diaryan Aleksandr,fiurst,Darbinyan Armen - Diaryan Aleksandr,53,20,33,13,-13,15,19,19,0,0,7,3,3,0,0,13,4:11 - 8:11 - 8:11 - 0:0 - 0:0
13594548,2023-08-22 12:00:00,Antonyan Eduard - Soghomonyan Hrayr,3:1,11:8 - 11:7 - 5:11 - 11:6 - 0:0,3,1,Antonyan Eduard,Soghomonyan Hrayr,fiurst,Antonyan Eduard - Soghomonyan Hrayr,70,38,32,-6,6,19,18,16,17,0,-3,-4,6,-5,0,-6,11:8 - 11:7 - 5:11 - 11:6 - 0:0
13594546,2023-08-22 11:45:00,Mkrtchyan Andranik - Darbinyan Armen,0:3,11:3 - 11:2 - 11:7 - 0:0 - 0:0,3,0,Mkrtchyan Andranik,Darbinyan Armen,fiurst,Darbinyan Armen - Mkrtchyan Andranik,45,12,33,21,-21,14,13,18,0,0,8,9,4,0,0,21,3:11 - 2:11 - 7:11 - 0:0 - 0:0
13594544,2023-08-22 11:35:00,Avakimyan Davit - Papyan Karen,0:3,7:11 - 9:11 - 5:11 - 0:0 - 0:0,0,3,Avakimyan Davit,Papyan Karen,fiurst,Avakimyan Davit - Papyan Karen,54,21,33,12,-12,18,20,16,0,0,4,2,6,0,0,12,7:11 - 9:11 - 5:11 - 0:0 - 0:0
13594138,2023-08-22 11:15:00,Antonyan Eduard - Mkrtchyan Andranik,3:0,11:6 - 11:5 - 11:6 - 0:0 - 0:0,3,0,Antonyan Eduard,Mkrtchyan Andranik,fiurst,Antonyan Eduard - Mkrtchyan Andranik,50,33,17,-16,16,17,16,17,0,0,-5,-6,-5,0,0,-16,11:6 - 11:5 - 11:6 - 0:0 - 0:0
13594137,2023-08-22 11:00:00,Soghomonyan Hrayr - Diaryan Aleksandr,3:2,6:11 - 9:11 - 13:11 - 11:8 - 13:15,2,3,Soghomonyan Hrayr,Diaryan Aleksandr,fiurst,Diaryan Aleksandr - Soghomonyan Hrayr,108,56,52,-4,4,17,20,24,19,28,-5,-2,2,3,-2,-4,11:6 - 11:9 - 11:13 - 8:11 - 15:13
13594135,2023-08-22 10:45:00,Papyan Karen - Darbinyan Armen,0:3,11:7 - 11:6 - 11:6 - 0:0 - 0:0,3,0,Papyan Karen,Darbinyan Armen,fiurst,Darbinyan Armen - Papyan Karen,52,19,33,14,-14,18,17,17,0,0,4,5,5,0,0,14,7:11 - 6:11 - 6:11 - 0:0 - 0:0
13594133,2023-08-22 10:30:00,Avakimyan Davit - Antonyan Eduard,3:2,8:11 - 5:11 - 11:8 - 11:6 - 4:11,2,3,Avakimyan Davit,Antonyan Eduard,fiurst,Antonyan Eduard - Avakimyan Davit,86,47,39,-8,8,19,16,19,17,15,-3,-6,3,5,-7,-8,11:8 - 11:5 - 8:11 - 6:11 - 11:4
13594130,2023-08-22 10:15:00,Mkrtchyan Andranik - Soghomonyan Hrayr,2:3,11:9 - 2:11 - 7:11 - 11:7 - 8:11,2,3,Mkrtchyan Andranik,Soghomonyan Hrayr,fiurst,Mkrtchyan Andranik - Soghomonyan Hrayr,88,39,49,10,-10,20,13,18,18,19,-2,9,4,-4,3,10,11:9 - 2:11 - 7:11 - 11:7 - 8:11
13594115,2023-08-22 10:00:00,Diaryan Aleksandr - Papyan Karen,0:0,0:0 - 0:0 - 0:0 - 0:0 - 0:0,0,0,Diaryan Aleksandr,Papyan Karen,fiurst,Diaryan Aleksandr - Papyan Karen,0,0,0,0,0,0,0,0,0,0,0,0,0,0,0,0,0:0 - 0:0 - 0:0 - 0:0 - 0:0
13606624,2023-08-22 10:00:00,Diaryan Aleksandr - Papyan Karen,3:2,9:11 - 11:2 - 9:11 - 11:9 - 11:7,3,2,Diaryan Aleksandr,Papyan Karen,fiurst,Diaryan Aleksandr - Papyan Karen,91,51,40,-11,11,20,13,20,20,18,2,-9,2,-2,-4,-11,9:11 - 11:2 - 9:11 - 11:9 - 11:7
13573262,2023-08-21 17:45:00,Nikoghosyan Narek - Darbinyan Armen,0:3,11:8 - 11:6 - 11:7 - 0:0 - 0:0,3,0,Nikoghosyan Narek,Darbinyan Armen,fiurst,Darbinyan Armen - Nikoghosyan Narek,54,21,33,12,-12,19,17,18,0,0,3,5,4,0,0,12,8:11 - 6:11 - 7:11 - 0:0 - 0:0
13573260,2023-08-21 17:30:00,Nazaryan Mushegh - Antonyan Eduard,3:0,7:11 - 6:11 - 6:11 - 0:0 - 0:0,0,3,Nazaryan Mushegh,Antonyan Eduard,fiurst,Antonyan Eduard - Nazaryan Mushegh,52,33,19,-14,14,18,17,17,0,0,-4,-5,-5,0,0,-14,11:7 - 11:6 - 11:6 - 0:0 - 0:0
13573259,2023-08-21 17:15:00,Soghomonyan Hrayr - Avakimyan Davit,0:3,11:9 - 11:7 - 11:7 - 0:0 - 0:0,3,0,Soghomonyan Hrayr,Avakimyan Davit,fiurst,Avakimyan Davit - Soghomonyan Hrayr,56,23,33,10,-10,20,18,18,0,0,2,4,4,0,0,10,9:11 - 7:11 - 7:11 - 0:0 - 0:0
13573255,2023-08-21 17:00:00,Nazaryan Mushegh - Darbinyan Armen,0:3,11:7 - 11:8 - 11:3 - 0:0 - 0:0,3,0,Nazaryan Mushegh,Darbinyan Armen,fiurst,Darbinyan Armen - Nazaryan Mushegh,51,18,33,15,-15,18,19,14,0,0,4,3,8,0,0,15,7:11 - 8:11 - 3:11 - 0:0 - 0:0
13573248,2023-08-21 16:45:00,Mkrtchyan Andranik - Nikoghosyan Narek,0:3,6:11 - 7:11 - 7:11 - 0:0 - 0:0,0,3,Mkrtchyan Andranik,Nikoghosyan Narek,fiurst,Mkrtchyan Andranik - Nikoghosyan Narek,53,20,33,13,-13,17,18,18,0,0,5,4,4,0,0,13,6:11 - 7:11 - 7:11 - 0:0 - 0:0
13573247,2023-08-21 16:30:00,Avakimyan Davit - Antonyan Eduard,3:0,6:11 - 8:11 - 7:11 - 0:0 - 0:0,0,3,Avakimyan Davit,Antonyan Eduard,fiurst,Antonyan Eduard - Avakimyan Davit,54,33,21,-12,12,17,19,18,0,0,-5,-3,-4,0,0,-12,11:6 - 11:8 - 11:7 - 0:0 - 0:0
13573232,2023-08-21 16:20:00,Darbinyan Armen - Soghomonyan Hrayr,0:3,9:11 - 6:11 - 9:11 - 0:0 - 0:0,0,3,Darbinyan Armen,Soghomonyan Hrayr,fiurst,Darbinyan Armen - Soghomonyan Hrayr,57,24,33,9,-9,20,17,20,0,0,2,5,2,0,0,9,9:11 - 6:11 - 9:11 - 0:0 - 0:0
13576410,2023-08-21 16:00:00,Antonyan Eduard - Mkrtchyan Andranik,3:0,11:4 - 11:8 - 11:8 - 0:0 - 0:0,3,0,Antonyan Eduard,Mkrtchyan Andranik,fiurst,Antonyan Eduard - Mkrtchyan Andranik,53,33,20,-13,13,15,19,19,0,0,-7,-3,-3,0,0,-13,11:4 - 11:8 - 11:8 - 0:0 - 0:0
13573036,2023-08-21 15:50:00,Nikoghosyan Narek - Nazaryan Mushegh,3:2,5:11 - 8:11 - 11:9 - 12:10 - 7:11,2,3,Nikoghosyan Narek,Nazaryan Mushegh,fiurst,Nazaryan Mushegh - Nikoghosyan Narek,95,52,43,-9,9,16,19,20,22,18,-6,-3,2,2,-4,-9,11:5 - 11:8 - 9:11 - 10:12 - 11:7
13573030,2023-08-21 15:30:00,Darbinyan Armen - Mkrtchyan Andranik,1:3,5:11 - 11:9 - 8:11 - 1:11 - 0:0,1,3,Darbinyan Armen,Mkrtchyan Andranik,fiurst,Darbinyan Armen - Mkrtchyan Andranik,67,25,42,17,-17,16,20,19,12,0,6,-2,3,10,0,17,5:11 - 11:9 - 8:11 - 1:11 - 0:0
13573029,2023-08-21 15:15:00,Soghomonyan Hrayr - Nazaryan Mushegh,3:2,5:11 - 9:11 - 16:14 - 11:9 - 12:14,2,3,Soghomonyan Hrayr,Nazaryan Mushegh,fiurst,Nazaryan Mushegh - Soghomonyan Hrayr,112,59,53,-6,6,16,20,30,20,26,-6,-2,2,2,-2,-6,11:5 - 11:9 - 14:16 - 9:11 - 14:12
13573028,2023-08-21 15:00:00,Avakimyan Davit - Nikoghosyan Narek,0:3,4:11 - 7:11 - 4:11 - 0:0 - 0:0,0,3,Avakimyan Davit,Nikoghosyan Narek,fiurst,Avakimyan Davit - Nikoghosyan Narek,48,15,33,18,-18,15,18,15,0,0,7,4,7,0,0,18,4:11 - 7:11 - 4:11 - 0:0 - 0:0
13573022,2023-08-21 14:45:00,Antonyan Eduard - Darbinyan Armen,3:0,11:6 - 11:6 - 11:9 - 0:0 - 0:0,3,0,Antonyan Eduard,Darbinyan Armen,fiurst,Antonyan Eduard - Darbinyan Armen,54,33,21,-12,12,17,17,20,0,0,-5,-5,-2,0,0,-12,11:6 - 11:6 - 11:9 - 0:0 - 0:0
13573019,2023-08-21 14:30:00,Avakimyan Davit - Soghomonyan Hrayr,0:3,11:13 - 4:11 - 8:11 - 0:0 - 0:0,0,3,Avakimyan Davit,Soghomonyan Hrayr,fiurst,Avakimyan Davit - Soghomonyan Hrayr,58,23,35,12,-12,24,15,19,0,0,2,7,3,0,0,12,11:13 - 4:11 - 8:11 - 0:0 - 0:0
13573008,2023-08-21 13:45:00,Mkrtchyan Andranik - Nazaryan Mushegh,1:3,11:13 - 11:8 - 5:11 - 6:11 - 0:0,1,3,Mkrtchyan Andranik,Nazaryan Mushegh,fiurst,Mkrtchyan Andranik - Nazaryan Mushegh,76,33,43,10,-10,24,19,16,17,0,2,-3,6,5,0,10,11:13 - 11:8 - 5:11 - 6:11 - 0:0
13572616,2023-08-21 13:30:00,Nikoghosyan Narek - Antonyan Eduard,3:1,8:11 - 9:11 - 11:2 - 9:11 - 0:0,1,3,Nikoghosyan Narek,Antonyan Eduard,fiurst,Antonyan Eduard - Nikoghosyan Narek,72,35,37,2,-2,19,20,13,20,0,-3,-2,9,-2,0,2,11:8 - 11:9 - 2:11 - 11:9 - 0:0
13572615,2023-08-21 13:15:00,Soghomonyan Hrayr - Mkrtchyan Andranik,1:3,9:11 - 11:5 - 11:9 - 11:5 - 0:0,3,1,Soghomonyan Hrayr,Mkrtchyan Andranik,fiurst,Mkrtchyan Andranik - Soghomonyan Hrayr,72,30,42,12,-12,20,16,20,16,0,-2,6,2,6,0,12,11:9 - 5:11 - 9:11 - 5:11 - 0:0
13572614,2023-08-21 13:00:00,Darbinyan Armen - Avakimyan Davit,3:0,9:11 - 8:11 - 7:11 - 0:0 - 0:0,0,3,Darbinyan Armen,Avakimyan Davit,fiurst,Avakimyan Davit - Darbinyan Armen,57,33,24,-9,9,20,19,18,0,0,-2,-3,-4,0,0,-9,11:9 - 11:8 - 11:7 - 0:0 - 0:0
13572603,2023-08-21 12:45:00,Nikoghosyan Narek - Soghomonyan Hrayr,3:1,11:9 - 11:8 - 5:11 - 11:3 - 0:0,3,1,Nikoghosyan Narek,Soghomonyan Hrayr,fiurst,Nikoghosyan Narek - Soghomonyan Hrayr,69,38,31,-7,7,20,19,16,14,0,-2,-3,6,-8,0,-7,11:9 - 11:8 - 5:11 - 11:3 - 0:0
13572600,2023-08-21 12:30:00,Antonyan Eduard - Nazaryan Mushegh,3:0,11:6 - 11:5 - 11:7 - 0:0 - 0:0,3,0,Antonyan Eduard,Nazaryan Mushegh,fiurst,Antonyan Eduard - Nazaryan Mushegh,51,33,18,-15,15,17,16,18,0,0,-5,-6,-4,0,0,-15,11:6 - 11:5 - 11:7 - 0:0 - 0:0
13572598,2023-08-21 12:15:00,Avakimyan Davit - Mkrtchyan Andranik,3:2,11:9 - 10:12 - 11:7 - 4:11 - 12:10,3,2,Avakimyan Davit,Mkrtchyan Andranik,fiurst,Avakimyan Davit - Mkrtchyan Andranik,97,48,49,1,-1,20,22,18,15,22,-2,2,-4,7,-2,1,11:9 - 10:12 - 11:7 - 4:11 - 12:10
13572595,2023-08-21 12:00:00,Darbinyan Armen - Nikoghosyan Narek,0:3,8:11 - 6:11 - 3:11 - 0:0 - 0:0,0,3,Darbinyan Armen,Nikoghosyan Narek,fiurst,Darbinyan Armen - Nikoghosyan Narek,50,17,33,16,-16,19,17,14,0,0,3,5,8,0,0,16,8:11 - 6:11 - 3:11 - 0:0 - 0:0
13572592,2023-08-21 11:45:00,Nazaryan Mushegh - Avakimyan Davit,3:0,9:11 - 2:11 - 7:11 - 0:0 - 0:0,0,3,Nazaryan Mushegh,Avakimyan Davit,fiurst,Avakimyan Davit - Nazaryan Mushegh,51,33,18,-15,15,20,13,18,0,0,-2,-9,-4,0,0,-15,11:9 - 11:2 - 11:7 - 0:0 - 0:0
13572591,2023-08-21 11:30:00,Soghomonyan Hrayr - Antonyan Eduard,1:3,11:7 - 7:11 - 11:4 - 11:5 - 0:0,3,1,Soghomonyan Hrayr,Antonyan Eduard,fiurst,Antonyan Eduard - Soghomonyan Hrayr,67,27,40,13,-13,18,18,15,16,0,4,-4,7,6,0,13,7:11 - 11:7 - 4:11 - 5:11 - 0:0
13572590,2023-08-21 11:15:00,Darbinyan Armen - Nazaryan Mushegh,0:3,8:11 - 4:11 - 5:11 - 0:0 - 0:0,0,3,Darbinyan Armen,Nazaryan Mushegh,fiurst,Darbinyan Armen - Nazaryan Mushegh,50,17,33,16,-16,19,15,16,0,0,3,7,6,0,0,16,8:11 - 4:11 - 5:11 - 0:0 - 0:0
13572579,2023-08-21 11:00:00,Nikoghosyan Narek - Mkrtchyan Andranik,0:3,11:7 - 11:5 - 11:4 - 0:0 - 0:0,3,0,Nikoghosyan Narek,Mkrtchyan Andranik,fiurst,Mkrtchyan Andranik - Nikoghosyan Narek,49,16,33,17,-17,18,16,15,0,0,4,6,7,0,0,17,7:11 - 5:11 - 4:11 - 0:0 - 0:0
13572569,2023-08-21 10:45:00,Antonyan Eduard - Avakimyan Davit,3:1,11:13 - 12:10 - 11:8 - 11:4 - 0:0,3,1,Antonyan Eduard,Avakimyan Davit,fiurst,Antonyan Eduard - Avakimyan Davit,80,45,35,-10,10,24,22,19,15,0,2,-2,-3,-7,0,-10,11:13 - 12:10 - 11:8 - 11:4 - 0:0
13572568,2023-08-21 10:30:00,Soghomonyan Hrayr - Darbinyan Armen,0:3,11:7 - 11:9 - 11:6 - 0:0 - 0:0,3,0,Soghomonyan Hrayr,Darbinyan Armen,fiurst,Darbinyan Armen - Soghomonyan Hrayr,55,22,33,11,-11,18,20,17,0,0,4,2,5,0,0,11,7:11 - 9:11 - 6:11 - 0:0 - 0:0
13572564,2023-08-21 10:20:00,Nazaryan Mushegh - Nikoghosyan Narek,0:3,8:11 - 6:11 - 4:11 - 0:0 - 0:0,0,3,Nazaryan Mushegh,Nikoghosyan Narek,fiurst,Nazaryan Mushegh - Nikoghosyan Narek,51,18,33,15,-15,19,17,15,0,0,3,5,7,0,0,15,8:11 - 6:11 - 4:11 - 0:0 - 0:0
13576396,2023-08-21 10:00:00,Mkrtchyan Andranik - Antonyan Eduard,1:3,11:8 - 11:7 - 6:11 - 11:7 - 0:0,3,1,Mkrtchyan Andranik,Antonyan Eduard,fiurst,Antonyan Eduard - Mkrtchyan Andranik,72,33,39,6,-6,19,18,17,18,0,3,4,-5,4,0,6,8:11 - 7:11 - 11:6 - 7:11 - 0:0
13552946,2023-08-20 17:45:00,Avakimyan Davit - Petrosyan Davit,3:0,11:7 - 11:7 - 11:6 - 0:0 - 0:0,3,0,Avakimyan Davit,Petrosyan Davit,fiurst,Avakimyan Davit - Petrosyan Davit,53,33,20,-13,13,18,18,17,0,0,-4,-4,-5,0,0,-13,11:7 - 11:7 - 11:6 - 0:0 - 0:0
13552945,2023-08-20 17:30:00,Diaryan Aleksandr - Nazaryan Mushegh,3:0,11:5 - 11:9 - 11:7 - 0:0 - 0:0,3,0,Diaryan Aleksandr,Nazaryan Mushegh,fiurst,Diaryan Aleksandr - Nazaryan Mushegh,54,33,21,-12,12,16,20,18,0,0,-6,-2,-4,0,0,-12,11:5 - 11:9 - 11:7 - 0:0 - 0:0
13552943,2023-08-20 17:15:00,Papyan Karen - Nikoghosyan Narek,2:3,9:11 - 11:9 - 6:11 - 11:8 - 13:11,3,2,Papyan Karen,Nikoghosyan Narek,fiurst,Nikoghosyan Narek - Papyan Karen,100,50,50,0,0,20,20,17,19,24,-2,2,-5,3,2,0,11:9 - 9:11 - 11:6 - 8:11 - 11:13
13552941,2023-08-20 17:00:00,Diaryan Aleksandr - Petrosyan Davit,3:1,11:9 - 11:6 - 10:12 - 11:7 - 0:0,3,1,Diaryan Aleksandr,Petrosyan Davit,fiurst,Diaryan Aleksandr - Petrosyan Davit,77,43,34,-9,9,20,17,22,18,0,-2,-5,2,-4,0,-9,11:9 - 11:6 - 10:12 - 11:7 - 0:0
13552936,2023-08-20 16:45:00,Darbinyan Armen - Avakimyan Davit,3:0,9:11 - 9:11 - 11:13 - 0:0 - 0:0,0,3,Darbinyan Armen,Avakimyan Davit,fiurst,Avakimyan Davit - Darbinyan Armen,64,35,29,-6,6,20,20,24,0,0,-2,-2,-2,0,0,-6,11:9 - 11:9 - 13:11 - 0:0 - 0:0
13552934,2023-08-20 16:30:00,Nikoghosyan Narek - Nazaryan Mushegh,1:3,11:9 - 11:5 - 11:13 - 11:4 - 0:0,3,1,Nikoghosyan Narek,Nazaryan Mushegh,fiurst,Nazaryan Mushegh - Nikoghosyan Narek,75,31,44,13,-13,20,16,24,15,0,2,6,-2,7,0,13,9:11 - 5:11 - 13:11 - 4:11 - 0:0
13552933,2023-08-20 16:15:00,Petrosyan Davit - Papyan Karen,3:0,3:11 - 5:11 - 8:11 - 0:0 - 0:0,0,3,Petrosyan Davit,Papyan Karen,fiurst,Papyan Karen - Petrosyan Davit,49,33,16,-17,17,14,16,19,0,0,-8,-6,-3,0,0,-17,11:3 - 11:5 - 11:8 - 0:0 - 0:0
13552903,2023-08-20 16:00:00,Nazaryan Mushegh - Darbinyan Armen,0:3,11:6 - 11:6 - 11:6 - 0:0 - 0:0,3,0,Nazaryan Mushegh,Darbinyan Armen,fiurst,Darbinyan Armen - Nazaryan Mushegh,51,18,33,15,-15,17,17,17,0,0,5,5,5,0,0,15,6:11 - 6:11 - 6:11 - 0:0 - 0:0
13552896,2023-08-20 15:45:00,Avakimyan Davit - Diaryan Aleksandr,0:3,5:11 - 4:11 - 7:11 - 0:0 - 0:0,0,3,Avakimyan Davit,Diaryan Aleksandr,fiurst,Avakimyan Davit - Diaryan Aleksandr,49,16,33,17,-17,16,15,18,0,0,6,7,4,0,0,17,5:11 - 4:11 - 7:11 - 0:0 - 0:0
13552895,2023-08-20 15:30:00,Petrosyan Davit - Darbinyan Armen,0:3,11:4 - 11:9 - 11:6 - 0:0 - 0:0,3,0,Petrosyan Davit,Darbinyan Armen,fiurst,Darbinyan Armen - Petrosyan Davit,52,19,33,14,-14,15,20,17,0,0,7,2,5,0,0,14,4:11 - 9:11 - 6:11 - 0:0 - 0:0
13552886,2023-08-20 15:15:00,Papyan Karen - Diaryan Aleksandr,1:3,11:8 - 12:10 - 9:11 - 11:8 - 0:0,3,1,Papyan Karen,Diaryan Aleksandr,fiurst,Diaryan Aleksandr - Papyan Karen,80,37,43,6,-6,19,22,20,19,0,3,2,-2,3,0,6,8:11 - 10:12 - 11:9 - 8:11 - 0:0
13552880,2023-08-20 15:00:00,Nikoghosyan Narek - Avakimyan Davit,0:3,11:7 - 11:7 - 11:5 - 0:0 - 0:0,3,0,Nikoghosyan Narek,Avakimyan Davit,fiurst,Avakimyan Davit - Nikoghosyan Narek,52,19,33,14,-14,18,18,16,0,0,4,4,6,0,0,14,7:11 - 7:11 - 5:11 - 0:0 - 0:0
13552874,2023-08-20 14:45:00,Nazaryan Mushegh - Petrosyan Davit,3:0,11:9 - 11:2 - 16:14 - 0:0 - 0:0,3,0,Nazaryan Mushegh,Petrosyan Davit,fiurst,Nazaryan Mushegh - Petrosyan Davit,63,38,25,-13,13,20,13,30,0,0,-2,-9,-2,0,0,-13,11:9 - 11:2 - 16:14 - 0:0 - 0:0
13552860,2023-08-20 14:30:00,Nikoghosyan Narek - Papyan Karen,3:2,9:11 - 11:4 - 11:3 - 3:11 - 11:7,3,2,Nikoghosyan Narek,Papyan Karen,fiurst,Nikoghosyan Narek - Papyan Karen,81,45,36,-9,9,20,15,14,14,18,2,-7,-8,8,-4,-9,9:11 - 11:4 - 11:3 - 3:11 - 11:7
13571342,2023-08-20 13:45:00,Darbinyan Armen - Diaryan Aleksandr,0:3,5:11 - 7:11 - 9:11 - 0:0 - 0:0,0,3,Darbinyan Armen,Diaryan Aleksandr,fiurst,Darbinyan Armen - Diaryan Aleksandr,54,21,33,12,-12,16,18,20,0,0,6,4,2,0,0,12,5:11 - 7:11 - 9:11 - 0:0 - 0:0
13552851,2023-08-20 13:30:00,Avakimyan Davit - Nazaryan Mushegh,0:3,9:11 - 4:11 - 11:13 - 0:0 - 0:0,0,3,Avakimyan Davit,Nazaryan Mushegh,fiurst,Avakimyan Davit - Nazaryan Mushegh,59,24,35,11,-11,20,15,24,0,0,2,7,2,0,0,11,9:11 - 4:11 - 11:13 - 0:0 - 0:0
13552853,2023-08-20 13:30:00,Darbinyan Armen - Diaryan Aleksandr,0:0,0:0 - 0:0 - 0:0 - 0:0 - 0:0,0,0,Darbinyan Armen,Diaryan Aleksandr,fiurst,Darbinyan Armen - Diaryan Aleksandr,0,0,0,0,0,0,0,0,0,0,0,0,0,0,0,0,0:0 - 0:0 - 0:0 - 0:0 - 0:0
13552848,2023-08-20 13:15:00,Papyan Karen - Darbinyan Armen,0:3,11:8 - 11:7 - 11:5 - 0:0 - 0:0,3,0,Papyan Karen,Darbinyan Armen,fiurst,Darbinyan Armen - Papyan Karen,53,20,33,13,-13,19,18,16,0,0,3,4,6,0,0,13,8:11 - 7:11 - 5:11 - 0:0 - 0:0
13552821,2023-08-20 13:00:00,Petrosyan Davit - Nikoghosyan Narek,3:0,7:11 - 9:11 - 7:11 - 0:0 - 0:0,0,3,Petrosyan Davit,Nikoghosyan Narek,fiurst,Nikoghosyan Narek - Petrosyan Davit,56,33,23,-10,10,18,20,18,0,0,-4,-2,-4,0,0,-10,11:7 - 11:9 - 11:7 - 0:0 - 0:0
13552820,2023-08-20 12:45:00,Avakimyan Davit - Papyan Karen,2:3,5:11 - 11:4 - 4:11 - 11:8 - 10:12,2,3,Avakimyan Davit,Papyan Karen,fiurst,Avakimyan Davit - Papyan Karen,87,41,46,5,-5,16,15,15,19,22,6,-7,7,-3,2,5,5:11 - 11:4 - 4:11 - 11:8 - 10:12
13552819,2023-08-20 12:30:00,Nazaryan Mushegh - Diaryan Aleksandr,3:0,4:11 - 2:11 - 5:11 - 0:0 - 0:0,0,3,Nazaryan Mushegh,Diaryan Aleksandr,fiurst,Diaryan Aleksandr - Nazaryan Mushegh,44,33,11,-22,22,15,13,16,0,0,-7,-9,-6,0,0,-22,11:4 - 11:2 - 11:5 - 0:0 - 0:0
13552812,2023-08-20 12:25:00,Nikoghosyan Narek - Darbinyan Armen,1:3,11:9 - 9:11 - 13:11 - 11:9 - 0:0,3,1,Nikoghosyan Narek,Darbinyan Armen,fiurst,Darbinyan Armen - Nikoghosyan Narek,84,40,44,4,-4,20,20,24,20,0,2,-2,2,2,0,4,9:11 - 11:9 - 11:13 - 9:11 - 0:0
13552801,2023-08-20 12:00:00,Petrosyan Davit - Avakimyan Davit,3:0,9:11 - 8:11 - 9:11 - 0:0 - 0:0,0,3,Petrosyan Davit,Avakimyan Davit,fiurst,Avakimyan Davit - Petrosyan Davit,59,33,26,-7,7,20,19,20,0,0,-2,-3,-2,0,0,-7,11:9 - 11:8 - 11:9 - 0:0 - 0:0
13552793,2023-08-20 11:45:00,Diaryan Aleksandr - Nikoghosyan Narek,2:3,11:6 - 6:11 - 7:11 - 13:11 - 6:11,2,3,Diaryan Aleksandr,Nikoghosyan Narek,fiurst,Diaryan Aleksandr - Nikoghosyan Narek,93,43,50,7,-7,17,17,18,24,17,-5,5,4,-2,5,7,11:6 - 6:11 - 7:11 - 13:11 - 6:11
13552785,2023-08-20 11:30:00,Papyan Karen - Nazaryan Mushegh,3:0,8:11 - 4:11 - 9:11 - 0:0 - 0:0,0,3,Papyan Karen,Nazaryan Mushegh,fiurst,Nazaryan Mushegh - Papyan Karen,54,33,21,-12,12,19,15,20,0,0,-3,-7,-2,0,0,-12,11:8 - 11:4 - 11:9 - 0:0 - 0:0
13552784,2023-08-20 11:15:00,Petrosyan Davit - Diaryan Aleksandr,3:0,9:11 - 8:11 - 5:11 - 0:0 - 0:0,0,3,Petrosyan Davit,Diaryan Aleksandr,fiurst,Diaryan Aleksandr - Petrosyan Davit,55,33,22,-11,11,20,19,16,0,0,-2,-3,-6,0,0,-11,11:9 - 11:8 - 11:5 - 0:0 - 0:0
13552783,2023-08-20 11:00:00,Avakimyan Davit - Darbinyan Armen,3:0,11:7 - 11:9 - 16:14 - 0:0 - 0:0,3,0,Avakimyan Davit,Darbinyan Armen,fiurst,Avakimyan Davit - Darbinyan Armen,68,38,30,-8,8,18,20,30,0,0,-4,-2,-2,0,0,-8,11:7 - 11:9 - 16:14 - 0:0 - 0:0
13552782,2023-08-20 10:45:00,Nazaryan Mushegh - Nikoghosyan Narek,0:3,6:11 - 3:11 - 4:11 - 0:0 - 0:0,0,3,Nazaryan Mushegh,Nikoghosyan Narek,fiurst,Nazaryan Mushegh - Nikoghosyan Narek,46,13,33,20,-20,17,14,15,0,0,5,8,7,0,0,20,6:11 - 3:11 - 4:11 - 0:0 - 0:0
13552771,2023-08-20 10:30:00,Papyan Karen - Petrosyan Davit,2:3,9:11 - 12:10 - 7:11 - 11:4 - 8:11,2,3,Papyan Karen,Petrosyan Davit,fiurst,Papyan Karen - Petrosyan Davit,94,47,47,0,0,20,22,18,15,19,2,-2,4,-7,3,0,9:11 - 12:10 - 7:11 - 11:4 - 8:11
13552770,2023-08-20 10:15:00,Diaryan Aleksandr - Avakimyan Davit,0:3,11:2 - 11:6 - 11:3 - 0:0 - 0:0,3,0,Diaryan Aleksandr,Avakimyan Davit,fiurst,Avakimyan Davit - Diaryan Aleksandr,44,11,33,22,-22,13,17,14,0,0,9,5,8,0,0,22,2:11 - 6:11 - 3:11 - 0:0 - 0:0
13552763,2023-08-20 10:00:00,Darbinyan Armen - Nazaryan Mushegh,0:3,7:11 - 6:11 - 10:12 - 0:0 - 0:0,0,3,Darbinyan Armen,Nazaryan Mushegh,fiurst,Darbinyan Armen - Nazaryan Mushegh,57,23,34,11,-11,18,17,22,0,0,4,5,2,0,0,11,7:11 - 6:11 - 10:12 - 0:0 - 0:0
13515261,2023-08-19 17:45:00,Papyan Karen - Mkrtchyan Andranik,1:3,11:7 - 4:11 - 13:11 - 11:6 - 0:0,3,1,Papyan Karen,Mkrtchyan Andranik,fiurst,Mkrtchyan Andranik - Papyan Karen,74,35,39,4,-4,18,15,24,17,0,4,-7,2,5,0,4,7:11 - 11:4 - 11:13 - 6:11 - 0:0
13515260,2023-08-19 17:30:00,Nikoghosyan Narek - Diaryan Aleksandr,3:2,12:14 - 11:9 - 16:14 - 8:11 - 8:11,2,3,Nikoghosyan Narek,Diaryan Aleksandr,fiurst,Diaryan Aleksandr - Nikoghosyan Narek,114,59,55,-4,4,26,20,30,19,19,-2,2,2,-3,-3,-4,14:12 - 9:11 - 14:16 - 11:8 - 11:8
13515249,2023-08-19 17:15:00,Nazaryan Mushegh - Avakimyan Davit,0:3,11:7 - 11:4 - 12:10 - 0:0 - 0:0,3,0,Nazaryan Mushegh,Avakimyan Davit,fiurst,Avakimyan Davit - Nazaryan Mushegh,55,21,34,13,-13,18,15,22,0,0,4,7,2,0,0,13,7:11 - 4:11 - 10:12 - 0:0 - 0:0
13515242,2023-08-19 17:00:00,Nikoghosyan Narek - Mkrtchyan Andranik,1:3,11:9 - 6:11 - 12:10 - 16:14 - 0:0,3,1,Nikoghosyan Narek,Mkrtchyan Andranik,fiurst,Mkrtchyan Andranik - Nikoghosyan Narek,89,44,45,1,-1,20,17,22,30,0,2,-5,2,2,0,1,9:11 - 11:6 - 10:12 - 14:16 - 0:0
13515241,2023-08-19 16:45:00,Petrosyan Davit - Papyan Karen,3:0,4:11 - 9:11 - 9:11 - 0:0 - 0:0,0,3,Petrosyan Davit,Papyan Karen,fiurst,Papyan Karen - Petrosyan Davit,55,33,22,-11,11,15,20,20,0,0,-7,-2,-2,0,0,-11,11:4 - 11:9 - 11:9 - 0:0 - 0:0
13515240,2023-08-19 16:30:00,Avakimyan Davit - Diaryan Aleksandr,0:3,8:11 - 2:11 - 5:11 - 0:0 - 0:0,0,3,Avakimyan Davit,Diaryan Aleksandr,fiurst,Avakimyan Davit - Diaryan Aleksandr,48,15,33,18,-18,19,13,16,0,0,3,9,6,0,0,18,8:11 - 2:11 - 5:11 - 0:0 - 0:0
13515235,2023-08-19 16:15:00,Mkrtchyan Andranik - Nazaryan Mushegh,1:3,5:11 - 5:11 - 16:14 - 11:13 - 0:0,1,3,Mkrtchyan Andranik,Nazaryan Mushegh,fiurst,Mkrtchyan Andranik - Nazaryan Mushegh,86,37,49,12,-12,16,16,30,24,0,6,6,-2,2,0,12,5:11 - 5:11 - 16:14 - 11:13 - 0:0
13515232,2023-08-19 16:05:00,Diaryan Aleksandr - Petrosyan Davit,3:0,11:9 - 11:5 - 11:8 - 0:0 - 0:0,3,0,Diaryan Aleksandr,Petrosyan Davit,fiurst,Diaryan Aleksandr - Petrosyan Davit,55,33,22,-11,11,20,16,19,0,0,-2,-6,-3,0,0,-11,11:9 - 11:5 - 11:8 - 0:0 - 0:0
13515230,2023-08-19 15:45:00,Papyan Karen - Nikoghosyan Narek,2:3,11:8 - 8:11 - 11:8 - 7:11 - 11:9,3,2,Papyan Karen,Nikoghosyan Narek,fiurst,Nikoghosyan Narek - Papyan Karen,95,47,48,1,-1,19,19,19,18,20,3,-3,3,-4,2,1,8:11 - 11:8 - 8:11 - 11:7 - 9:11
13515227,2023-08-19 15:30:00,Mkrtchyan Andranik - Petrosyan Davit,2:3,11:13 - 11:4 - 3:11 - 11:6 - 8:11,2,3,Mkrtchyan Andranik,Petrosyan Davit,fiurst,Mkrtchyan Andranik - Petrosyan Davit,89,44,45,1,-1,24,15,14,17,19,2,-7,8,-5,3,1,11:13 - 11:4 - 3:11 - 11:6 - 8:11
13515225,2023-08-19 15:15:00,Nazaryan Mushegh - Nikoghosyan Narek,0:3,7:11 - 6:11 - 5:11 - 0:0 - 0:0,0,3,Nazaryan Mushegh,Nikoghosyan Narek,fiurst,Nazaryan Mushegh - Nikoghosyan Narek,51,18,33,15,-15,18,17,16,0,0,4,5,6,0,0,15,7:11 - 6:11 - 5:11 - 0:0 - 0:0
13515224,2023-08-19 15:00:00,Avakimyan Davit - Papyan Karen,1:3,7:11 - 12:10 - 1:11 - 9:11 - 0:0,1,3,Avakimyan Davit,Papyan Karen,fiurst,Avakimyan Davit - Papyan Karen,72,29,43,14,-14,18,22,12,20,0,4,-2,10,2,0,14,7:11 - 12:10 - 1:11 - 9:11 - 0:0
13515223,2023-08-19 14:45:00,Diaryan Aleksandr - Mkrtchyan Andranik,3:1,11:13 - 11:9 - 11:2 - 11:3 - 0:0,3,1,Diaryan Aleksandr,Mkrtchyan Andranik,fiurst,Diaryan Aleksandr - Mkrtchyan Andranik,71,44,27,-17,17,24,20,13,14,0,2,-2,-9,-8,0,-17,11:13 - 11:9 - 11:2 - 11:3 - 0:0
13515202,2023-08-19 14:30:00,Avakimyan Davit - Nazaryan Mushegh,3:2,11:8 - 11:7 - 9:11 - 7:11 - 11:9,3,2,Avakimyan Davit,Nazaryan Mushegh,fiurst,Avakimyan Davit - Nazaryan Mushegh,95,49,46,-3,3,19,18,20,18,20,-3,-4,2,4,-2,-3,11:8 - 11:7 - 9:11 - 7:11 - 11:9
13515201,2023-08-19 13:45:00,Petrosyan Davit - Nikoghosyan Narek,3:0,7:11 - 7:11 - 6:11 - 0:0 - 0:0,0,3,Petrosyan Davit,Nikoghosyan Narek,fiurst,Nikoghosyan Narek - Petrosyan Davit,53,33,20,-13,13,18,18,17,0,0,-4,-4,-5,0,0,-13,11:7 - 11:7 - 11:6 - 0:0 - 0:0
13515200,2023-08-19 13:30:00,Papyan Karen - Diaryan Aleksandr,3:0,3:11 - 5:11 - 14:16 - 0:0 - 0:0,0,3,Papyan Karen,Diaryan Aleksandr,fiurst,Diaryan Aleksandr - Papyan Karen,60,38,22,-16,16,14,16,30,0,0,-8,-6,-2,0,0,-16,11:3 - 11:5 - 16:14 - 0:0 - 0:0
13515187,2023-08-19 13:15:00,Nazaryan Mushegh - Petrosyan Davit,3:0,11:7 - 11:7 - 11:6 - 0:0 - 0:0,3,0,Nazaryan Mushegh,Petrosyan Davit,fiurst,Nazaryan Mushegh - Petrosyan Davit,53,33,20,-13,13,18,18,17,0,0,-4,-4,-5,0,0,-13,11:7 - 11:7 - 11:6 - 0:0 - 0:0
13515211,2023-08-19 13:00:00,Mkrtchyan Andranik - Avakimyan Davit,3:0,8:11 - 4:11 - 4:11 - 0:0 - 0:0,0,3,Mkrtchyan Andranik,Avakimyan Davit,fiurst,Avakimyan Davit - Mkrtchyan Andranik,49,33,16,-17,17,19,15,15,0,0,-3,-7,-7,0,0,-17,11:8 - 11:4 - 11:4 - 0:0 - 0:0
13515186,2023-08-19 12:45:00,Papyan Karen - Nazaryan Mushegh,2:3,11:7 - 3:11 - 9:11 - 11:9 - 12:10,3,2,Papyan Karen,Nazaryan Mushegh,fiurst,Nazaryan Mushegh - Papyan Karen,94,48,46,-2,2,18,14,20,20,22,4,-8,-2,2,2,-2,7:11 - 11:3 - 11:9 - 9:11 - 10:12
13515185,2023-08-19 12:30:00,Diaryan Aleksandr - Nikoghosyan Narek,0:3,7:11 - 9:11 - 7:11 - 0:0 - 0:0,0,3,Diaryan Aleksandr,Nikoghosyan Narek,fiurst,Diaryan Aleksandr - Nikoghosyan Narek,56,23,33,10,-10,18,20,18,0,0,4,2,4,0,0,10,7:11 - 9:11 - 7:11 - 0:0 - 0:0
13515180,2023-08-19 12:15:00,Avakimyan Davit - Petrosyan Davit,3:1,13:11 - 11:3 - 6:11 - 11:9 - 0:0,3,1,Avakimyan Davit,Petrosyan Davit,fiurst,Avakimyan Davit - Petrosyan Davit,75,41,34,-7,7,24,14,17,20,0,-2,-8,5,-2,0,-7,13:11 - 11:3 - 6:11 - 11:9 - 0:0
13515178,2023-08-19 12:00:00,Mkrtchyan Andranik - Papyan Karen,3:0,11:7 - 11:8 - 11:1 - 0:0 - 0:0,3,0,Mkrtchyan Andranik,Papyan Karen,fiurst,Mkrtchyan Andranik - Papyan Karen,49,33,16,-17,17,18,19,12,0,0,-4,-3,-10,0,0,-17,11:7 - 11:8 - 11:1 - 0:0 - 0:0
13515169,2023-08-19 11:45:00,Nikoghosyan Narek - Avakimyan Davit,0:3,11:6 - 14:12 - 11:7 - 0:0 - 0:0,3,0,Nikoghosyan Narek,Avakimyan Davit,fiurst,Avakimyan Davit - Nikoghosyan Narek,61,25,36,11,-11,17,26,18,0,0,5,2,4,0,0,11,6:11 - 12:14 - 7:11 - 0:0 - 0:0
13515163,2023-08-19 11:30:00,Nazaryan Mushegh - Diaryan Aleksandr,0:3,11:5 - 11:8 - 11:9 - 0:0 - 0:0,3,0,Nazaryan Mushegh,Diaryan Aleksandr,fiurst,Diaryan Aleksandr - Nazaryan Mushegh,55,22,33,11,-11,16,19,20,0,0,6,3,2,0,0,11,5:11 - 8:11 - 9:11 - 0:0 - 0:0
13515162,2023-08-19 11:15:00,Mkrtchyan Andranik - Nikoghosyan Narek,1:3,5:11 - 11:9 - 7:11 - 7:11 - 0:0,1,3,Mkrtchyan Andranik,Nikoghosyan Narek,fiurst,Mkrtchyan Andranik - Nikoghosyan Narek,72,30,42,12,-12,16,20,18,18,0,6,-2,4,4,0,12,5:11 - 11:9 - 7:11 - 7:11 - 0:0
13515159,2023-08-19 11:00:00,Papyan Karen - Petrosyan Davit,3:1,11:9 - 9:11 - 11:9 - 14:12 - 0:0,3,1,Papyan Karen,Petrosyan Davit,fiurst,Papyan Karen - Petrosyan Davit,86,45,41,-4,4,20,20,20,26,0,-2,2,-2,-2,0,-4,11:9 - 9:11 - 11:9 - 14:12 - 0:0
13515156,2023-08-19 10:45:00,Diaryan Aleksandr - Avakimyan Davit,0:3,11:3 - 11:5 - 11:3 - 0:0 - 0:0,3,0,Diaryan Aleksandr,Avakimyan Davit,fiurst,Avakimyan Davit - Diaryan Aleksandr,44,11,33,22,-22,14,16,14,0,0,8,6,8,0,0,22,3:11 - 5:11 - 3:11 - 0:0 - 0:0
13515155,2023-08-19 10:30:00,Nazaryan Mushegh - Mkrtchyan Andranik,3:1,7:11 - 12:14 - 11:6 - 8:11 - 0:0,1,3,Nazaryan Mushegh,Mkrtchyan Andranik,fiurst,Mkrtchyan Andranik - Nazaryan Mushegh,80,42,38,-4,4,18,26,17,19,0,-4,-2,5,-3,0,-4,11:7 - 14:12 - 6:11 - 11:8 - 0:0
13515152,2023-08-19 10:15:00,Nikoghosyan Narek - Papyan Karen,3:0,11:6 - 11:6 - 11:2 - 0:0 - 0:0,3,0,Nikoghosyan Narek,Papyan Karen,fiurst,Nikoghosyan Narek - Papyan Karen,47,33,14,-19,19,17,17,13,0,0,-5,-5,-9,0,0,-19,11:6 - 11:6 - 11:2 - 0:0 - 0:0
13515147,2023-08-19 10:00:00,Petrosyan Davit - Diaryan Aleksandr,1:3,12:14 - 11:5 - 11:5 - 11:9 - 0:0,3,1,Petrosyan Davit,Diaryan Aleksandr,fiurst,Diaryan Aleksandr - Petrosyan Davit,78,33,45,12,-12,26,16,16,20,0,-2,6,6,2,0,12,14:12 - 5:11 - 5:11 - 9:11 - 0:0
13512485,2023-08-18 17:45:00,Petrosyan Davit - Soghomonyan Hrayr,3:2,14:12 - 12:10 - 6:11 - 5:11 - 11:9,3,2,Petrosyan Davit,Soghomonyan Hrayr,fiurst,Petrosyan Davit - Soghomonyan Hrayr,101,48,53,5,-5,26,22,17,16,20,-2,-2,5,6,-2,5,14:12 - 12:10 - 6:11 - 5:11 - 11:9
13512481,2023-08-18 17:30:00,Darbinyan Armen - Papyan Karen,0:3,1:11 - 2:11 - 6:11 - 0:0 - 0:0,0,3,Darbinyan Armen,Papyan Karen,fiurst,Darbinyan Armen - Papyan Karen,42,9,33,24,-24,12,13,17,0,0,10,9,5,0,0,24,1:11 - 2:11 - 6:11 - 0:0 - 0:0
13512478,2023-08-18 17:15:00,Nikoghosyan Narek - Antonyan Eduard,2:3,11:7 - 11:8 - 5:11 - 12:14 - 11:3,3,2,Nikoghosyan Narek,Antonyan Eduard,fiurst,Antonyan Eduard - Nikoghosyan Narek,93,43,50,7,-7,18,19,16,26,14,4,3,-6,-2,8,7,7:11 - 8:11 - 11:5 - 14:12 - 3:11
13512475,2023-08-18 17:00:00,Petrosyan Davit - Darbinyan Armen,0:3,13:11 - 11:7 - 11:5 - 0:0 - 0:0,3,0,Petrosyan Davit,Darbinyan Armen,fiurst,Darbinyan Armen - Petrosyan Davit,58,23,35,12,-12,24,18,16,0,0,2,4,6,0,0,12,11:13 - 7:11 - 5:11 - 0:0 - 0:0
13512473,2023-08-18 16:45:00,Soghomonyan Hrayr - Nikoghosyan Narek,3:1,11:8 - 5:11 - 4:11 - 7:11 - 0:0,1,3,Soghomonyan Hrayr,Nikoghosyan Narek,fiurst,Nikoghosyan Narek - Soghomonyan Hrayr,68,41,27,-14,14,19,16,15,18,0,3,-6,-7,-4,0,-14,8:11 - 11:5 - 11:4 - 11:7 - 0:0
13512467,2023-08-18 16:30:00,Antonyan Eduard - Papyan Karen,0:3,6:11 - 5:11 - 2:11 - 0:0 - 0:0,0,3,Antonyan Eduard,Papyan Karen,fiurst,Antonyan Eduard - Papyan Karen,46,13,33,20,-20,17,16,13,0,0,5,6,9,0,0,20,6:11 - 5:11 - 2:11 - 0:0 - 0:0
13512457,2023-08-18 16:15:00,Nikoghosyan Narek - Darbinyan Armen,0:3,11:3 - 11:5 - 11:8 - 0:0 - 0:0,3,0,Nikoghosyan Narek,Darbinyan Armen,fiurst,Darbinyan Armen - Nikoghosyan Narek,49,16,33,17,-17,14,16,19,0,0,8,6,3,0,0,17,3:11 - 5:11 - 8:11 - 0:0 - 0:0
13512454,2023-08-18 16:00:00,Papyan Karen - Petrosyan Davit,3:0,11:7 - 11:7 - 11:9 - 0:0 - 0:0,3,0,Papyan Karen,Petrosyan Davit,fiurst,Papyan Karen - Petrosyan Davit,56,33,23,-10,10,18,18,20,0,0,-4,-4,-2,0,0,-10,11:7 - 11:7 - 11:9 - 0:0 - 0:0
13512448,2023-08-18 15:45:00,Soghomonyan Hrayr - Antonyan Eduard,3:2,11:4 - 11:9 - 5:11 - 8:11 - 9:11,2,3,Soghomonyan Hrayr,Antonyan Eduard,fiurst,Antonyan Eduard - Soghomonyan Hrayr,90,46,44,-2,2,15,20,16,19,20,7,2,-6,-3,-2,-2,4:11 - 9:11 - 11:5 - 11:8 - 11:9
13512446,2023-08-18 15:30:00,Papyan Karen - Nikoghosyan Narek,2:3,11:8 - 10:12 - 11:7 - 9:11 - 11:9,3,2,Papyan Karen,Nikoghosyan Narek,fiurst,Nikoghosyan Narek - Papyan Karen,99,47,52,5,-5,19,22,18,20,20,3,-2,4,-2,2,5,8:11 - 12:10 - 7:11 - 11:9 - 9:11
13512441,2023-08-18 15:15:00,Darbinyan Armen - Soghomonyan Hrayr,0:3,10:12 - 4:11 - 9:11 - 0:0 - 0:0,0,3,Darbinyan Armen,Soghomonyan Hrayr,fiurst,Darbinyan Armen - Soghomonyan Hrayr,57,23,34,11,-11,22,15,20,0,0,2,7,2,0,0,11,10:12 - 4:11 - 9:11 - 0:0 - 0:0
13512438,2023-08-18 15:00:00,Antonyan Eduard - Petrosyan Davit,3:2,11:9 - 5:11 - 11:6 - 8:11 - 11:5,3,2,Antonyan Eduard,Petrosyan Davit,fiurst,Antonyan Eduard - Petrosyan Davit,88,46,42,-4,4,20,16,17,19,16,-2,6,-5,3,-6,-4,11:9 - 5:11 - 11:6 - 8:11 - 11:5
13512421,2023-08-18 14:45:00,Soghomonyan Hrayr - Papyan Karen,3:1,11:7 - 4:11 - 13:15 - 7:11 - 0:0,1,3,Soghomonyan Hrayr,Papyan Karen,fiurst,Papyan Karen - Soghomonyan Hrayr,79,44,35,-9,9,18,15,28,18,0,4,-7,-2,-4,0,-9,7:11 - 11:4 - 15:13 - 11:7 - 0:0
13512418,2023-08-18 14:30:00,Nikoghosyan Narek - Petrosyan Davit,3:0,11:8 - 11:4 - 11:7 - 0:0 - 0:0,3,0,Nikoghosyan Narek,Petrosyan Davit,fiurst,Nikoghosyan Narek - Petrosyan Davit,52,33,19,-14,14,19,15,18,0,0,-3,-7,-4,0,0,-14,11:8 - 11:4 - 11:7 - 0:0 - 0:0
13512416,2023-08-18 13:45:00,Darbinyan Armen - Antonyan Eduard,3:0,5:11 - 4:11 - 3:11 - 0:0 - 0:0,0,3,Darbinyan Armen,Antonyan Eduard,fiurst,Antonyan Eduard - Darbinyan Armen,45,33,12,-21,21,16,15,14,0,0,-6,-7,-8,0,0,-21,11:5 - 11:4 - 11:3 - 0:0 - 0:0
13512414,2023-08-18 13:30:00,Soghomonyan Hrayr - Petrosyan Davit,0:3,11:8 - 11:5 - 14:12 - 0:0 - 0:0,3,0,Soghomonyan Hrayr,Petrosyan Davit,fiurst,Petrosyan Davit - Soghomonyan Hrayr,61,25,36,11,-11,19,16,26,0,0,3,6,2,0,0,11,8:11 - 5:11 - 12:14 - 0:0 - 0:0
13512410,2023-08-18 13:15:00,Papyan Karen - Darbinyan Armen,0:3,11:9 - 11:7 - 12:10 - 0:0 - 0:0,3,0,Papyan Karen,Darbinyan Armen,fiurst,Darbinyan Armen - Papyan Karen,60,26,34,8,-8,20,18,22,0,0,2,4,2,0,0,8,9:11 - 7:11 - 10:12 - 0:0 - 0:0
13512406,2023-08-18 13:00:00,Antonyan Eduard - Nikoghosyan Narek,3:1,12:10 - 3:11 - 11:8 - 11:9 - 0:0,3,1,Antonyan Eduard,Nikoghosyan Narek,fiurst,Antonyan Eduard - Nikoghosyan Narek,75,37,38,1,-1,22,14,19,20,0,-2,8,-3,-2,0,1,12:10 - 3:11 - 11:8 - 11:9 - 0:0
13512403,2023-08-18 12:45:00,Darbinyan Armen - Petrosyan Davit,3:0,11:7 - 11:4 - 11:2 - 0:0 - 0:0,3,0,Darbinyan Armen,Petrosyan Davit,fiurst,Darbinyan Armen - Petrosyan Davit,46,33,13,-20,20,18,15,13,0,0,-4,-7,-9,0,0,-20,11:7 - 11:4 - 11:2 - 0:0 - 0:0
13512390,2023-08-18 12:30:00,Nikoghosyan Narek - Soghomonyan Hrayr,3:0,11:9 - 11:6 - 12:10 - 0:0 - 0:0,3,0,Nikoghosyan Narek,Soghomonyan Hrayr,fiurst,Nikoghosyan Narek - Soghomonyan Hrayr,59,34,25,-9,9,20,17,22,0,0,-2,-5,-2,0,0,-9,11:9 - 11:6 - 12:10 - 0:0 - 0:0
13512386,2023-08-18 12:15:00,Papyan Karen - Antonyan Eduard,1:3,11:9 - 11:8 - 5:11 - 11:4 - 0:0,3,1,Papyan Karen,Antonyan Eduard,fiurst,Antonyan Eduard - Papyan Karen,70,32,38,6,-6,20,19,16,15,0,2,3,-6,7,0,6,9:11 - 8:11 - 11:5 - 4:11 - 0:0
13512370,2023-08-18 12:00:00,Darbinyan Armen - Nikoghosyan Narek,0:3,7:11 - 9:11 - 6:11 - 0:0 - 0:0,0,3,Darbinyan Armen,Nikoghosyan Narek,fiurst,Darbinyan Armen - Nikoghosyan Narek,55,22,33,11,-11,18,20,17,0,0,4,2,5,0,0,11,7:11 - 9:11 - 6:11 - 0:0 - 0:0
13512362,2023-08-18 11:45:00,Petrosyan Davit - Papyan Karen,3:0,4:11 - 5:11 - 6:11 - 0:0 - 0:0,0,3,Petrosyan Davit,Papyan Karen,fiurst,Papyan Karen - Petrosyan Davit,48,33,15,-18,18,15,16,17,0,0,-7,-6,-5,0,0,-18,11:4 - 11:5 - 11:6 - 0:0 - 0:0
13512359,2023-08-18 11:30:00,Antonyan Eduard - Soghomonyan Hrayr,3:1,7:11 - 11:9 - 11:5 - 11:4 - 0:0,3,1,Antonyan Eduard,Soghomonyan Hrayr,fiurst,Antonyan Eduard - Soghomonyan Hrayr,69,40,29,-11,11,18,20,16,15,0,4,-2,-6,-7,0,-11,7:11 - 11:9 - 11:5 - 11:4 - 0:0
13512356,2023-08-18 11:15:00,Nikoghosyan Narek - Papyan Karen,0:3,9:11 - 10:12 - 10:12 - 0:0 - 0:0,0,3,Nikoghosyan Narek,Papyan Karen,fiurst,Nikoghosyan Narek - Papyan Karen,64,29,35,6,-6,20,22,22,0,0,2,2,2,0,0,6,9:11 - 10:12 - 10:12 - 0:0 - 0:0
13512353,2023-08-18 11:00:00,Soghomonyan Hrayr - Darbinyan Armen,0:3,11:5 - 11:5 - 11:6 - 0:0 - 0:0,3,0,Soghomonyan Hrayr,Darbinyan Armen,fiurst,Darbinyan Armen - Soghomonyan Hrayr,49,16,33,17,-17,16,16,17,0,0,6,6,5,0,0,17,5:11 - 5:11 - 6:11 - 0:0 - 0:0
13512348,2023-08-18 10:45:00,Petrosyan Davit - Antonyan Eduard,3:0,6:11 - 8:11 - 10:12 - 0:0 - 0:0,0,3,Petrosyan Davit,Antonyan Eduard,fiurst,Antonyan Eduard - Petrosyan Davit,58,34,24,-10,10,17,19,22,0,0,-5,-3,-2,0,0,-10,11:6 - 11:8 - 12:10 - 0:0 - 0:0
13512345,2023-08-18 10:30:00,Papyan Karen - Soghomonyan Hrayr,3:1,11:5 - 8:11 - 11:8 - 11:6 - 0:0,3,1,Papyan Karen,Soghomonyan Hrayr,fiurst,Papyan Karen - Soghomonyan Hrayr,71,41,30,-11,11,16,19,19,17,0,-6,3,-3,-5,0,-11,11:5 - 8:11 - 11:8 - 11:6 - 0:0
13512343,2023-08-18 10:15:00,Petrosyan Davit - Nikoghosyan Narek,3:1,11:6 - 4:11 - 6:11 - 9:11 - 0:0,1,3,Petrosyan Davit,Nikoghosyan Narek,fiurst,Nikoghosyan Narek - Petrosyan Davit,69,39,30,-9,9,17,15,17,20,0,5,-7,-5,-2,0,-9,6:11 - 11:4 - 11:6 - 11:9 - 0:0
13512331,2023-08-18 10:00:00,Antonyan Eduard - Darbinyan Armen,3:0,12:10 - 11:5 - 11:3 - 0:0 - 0:0,3,0,Antonyan Eduard,Darbinyan Armen,fiurst,Antonyan Eduard - Darbinyan Armen,52,34,18,-16,16,22,16,14,0,0,-2,-6,-8,0,0,-16,12:10 - 11:5 - 11:3 - 0:0 - 0:0
13482450,2023-08-17 17:45:00,Nikoghosyan Narek - Papyan Karen,3:1,11:13 - 11:9 - 13:11 - 11:9 - 0:0,3,1,Nikoghosyan Narek,Papyan Karen,fiurst,Nikoghosyan Narek - Papyan Karen,88,46,42,-4,4,24,20,24,20,0,2,-2,-2,-2,0,-4,11:13 - 11:9 - 13:11 - 11:9 - 0:0
13482449,2023-08-17 17:30:00,Antonyan Eduard - Soghomonyan Hrayr,3:1,11:4 - 9:11 - 11:7 - 11:4 - 0:0,3,1,Antonyan Eduard,Soghomonyan Hrayr,fiurst,Antonyan Eduard - Soghomonyan Hrayr,68,42,26,-16,16,15,20,18,15,0,-7,2,-4,-7,0,-16,11:4 - 9:11 - 11:7 - 11:4 - 0:0
13482447,2023-08-17 17:15:00,Petrosyan Davit - Mkrtchyan Andranik,3:0,11:13 - 14:16 - 10:12 - 0:0 - 0:0,0,3,Petrosyan Davit,Mkrtchyan Andranik,fiurst,Mkrtchyan Andranik - Petrosyan Davit,76,41,35,-6,6,24,30,22,0,0,-2,-2,-2,0,0,-6,13:11 - 16:14 - 12:10 - 0:0 - 0:0
13482437,2023-08-17 17:00:00,Nikoghosyan Narek - Antonyan Eduard,3:0,8:11 - 8:11 - 9:11 - 0:0 - 0:0,0,3,Nikoghosyan Narek,Antonyan Eduard,fiurst,Antonyan Eduard - Nikoghosyan Narek,58,33,25,-8,8,19,19,20,0,0,-3,-3,-2,0,0,-8,11:8 - 11:8 - 11:9 - 0:0 - 0:0
13482433,2023-08-17 16:45:00,Papyan Karen - Petrosyan Davit,3:0,11:8 - 11:7 - 11:6 - 0:0 - 0:0,3,0,Papyan Karen,Petrosyan Davit,fiurst,Papyan Karen - Petrosyan Davit,54,33,21,-12,12,19,18,17,0,0,-3,-4,-5,0,0,-12,11:8 - 11:7 - 11:6 - 0:0 - 0:0
13482430,2023-08-17 16:30:00,Mkrtchyan Andranik - Soghomonyan Hrayr,0:3,9:11 - 10:12 - 8:11 - 0:0 - 0:0,0,3,Mkrtchyan Andranik,Soghomonyan Hrayr,fiurst,Mkrtchyan Andranik - Soghomonyan Hrayr,61,27,34,7,-7,20,22,19,0,0,2,2,3,0,0,7,9:11 - 10:12 - 8:11 - 0:0 - 0:0
13482427,2023-08-17 16:15:00,Petrosyan Davit - Antonyan Eduard,3:0,8:11 - 4:11 - 9:11 - 0:0 - 0:0,0,3,Petrosyan Davit,Antonyan Eduard,fiurst,Antonyan Eduard - Petrosyan Davit,54,33,21,-12,12,19,15,20,0,0,-3,-7,-2,0,0,-12,11:8 - 11:4 - 11:9 - 0:0 - 0:0
13482425,2023-08-17 16:00:00,Soghomonyan Hrayr - Nikoghosyan Narek,3:0,6:11 - 8:11 - 6:11 - 0:0 - 0:0,0,3,Soghomonyan Hrayr,Nikoghosyan Narek,fiurst,Nikoghosyan Narek - Soghomonyan Hrayr,53,33,20,-13,13,17,19,17,0,0,-5,-3,-5,0,0,-13,11:6 - 11:8 - 11:6 - 0:0 - 0:0
13482424,2023-08-17 15:45:00,Papyan Karen - Mkrtchyan Andranik,0:3,11:5 - 11:5 - 11:4 - 0:0 - 0:0,3,0,Papyan Karen,Mkrtchyan Andranik,fiurst,Mkrtchyan Andranik - Papyan Karen,47,14,33,19,-19,16,16,15,0,0,6,6,7,0,0,19,5:11 - 5:11 - 4:11 - 0:0 - 0:0
13482422,2023-08-17 15:30:00,Soghomonyan Hrayr - Petrosyan Davit,0:3,11:3 - 11:1 - 11:5 - 0:0 - 0:0,3,0,Soghomonyan Hrayr,Petrosyan Davit,fiurst,Petrosyan Davit - Soghomonyan Hrayr,42,9,33,24,-24,14,12,16,0,0,8,10,6,0,0,24,3:11 - 1:11 - 5:11 - 0:0 - 0:0
13482421,2023-08-17 15:15:00,Antonyan Eduard - Papyan Karen,2:3,11:2 - 11:4 - 5:11 - 9:11 - 6:11,2,3,Antonyan Eduard,Papyan Karen,fiurst,Antonyan Eduard - Papyan Karen,81,42,39,-3,3,13,15,16,20,17,-9,-7,6,2,5,-3,11:2 - 11:4 - 5:11 - 9:11 - 6:11
13482420,2023-08-17 15:00:00,Mkrtchyan Andranik - Nikoghosyan Narek,0:3,4:11 - 8:11 - 3:11 - 0:0 - 0:0,0,3,Mkrtchyan Andranik,Nikoghosyan Narek,fiurst,Mkrtchyan Andranik - Nikoghosyan Narek,48,15,33,18,-18,15,19,14,0,0,7,3,8,0,0,18,4:11 - 8:11 - 3:11 - 0:0 - 0:0
13482419,2023-08-17 14:45:00,Papyan Karen - Soghomonyan Hrayr,3:0,11:7 - 12:10 - 11:7 - 0:0 - 0:0,3,0,Papyan Karen,Soghomonyan Hrayr,fiurst,Papyan Karen - Soghomonyan Hrayr,58,34,24,-10,10,18,22,18,0,0,-4,-2,-4,0,0,-10,11:7 - 12:10 - 11:7 - 0:0 - 0:0
13482411,2023-08-17 14:30:00,Petrosyan Davit - Nikoghosyan Narek,3:0,2:11 - 5:11 - 5:11 - 0:0 - 0:0,0,3,Petrosyan Davit,Nikoghosyan Narek,fiurst,Nikoghosyan Narek - Petrosyan Davit,45,33,12,-21,21,13,16,16,0,0,-9,-6,-6,0,0,-21,11:2 - 11:5 - 11:5 - 0:0 - 0:0
13482406,2023-08-17 13:45:00,Antonyan Eduard - Mkrtchyan Andranik,3:1,11:9 - 11:2 - 6:11 - 11:6 - 0:0,3,1,Antonyan Eduard,Mkrtchyan Andranik,fiurst,Antonyan Eduard - Mkrtchyan Andranik,67,39,28,-11,11,20,13,17,17,0,-2,-9,5,-5,0,-11,11:9 - 11:2 - 6:11 - 11:6 - 0:0
13482405,2023-08-17 13:30:00,Papyan Karen - Nikoghosyan Narek,3:1,11:9 - 8:11 - 3:11 - 10:12 - 0:0,1,3,Papyan Karen,Nikoghosyan Narek,fiurst,Nikoghosyan Narek - Papyan Karen,75,43,32,-11,11,20,19,14,22,0,2,-3,-8,-2,0,-11,9:11 - 11:8 - 11:3 - 12:10 - 0:0
13482404,2023-08-17 13:15:00,Soghomonyan Hrayr - Antonyan Eduard,3:2,6:11 - 1:11 - 11:9 - 11:7 - 8:11,2,3,Soghomonyan Hrayr,Antonyan Eduard,fiurst,Antonyan Eduard - Soghomonyan Hrayr,86,49,37,-12,12,17,12,20,18,19,-5,-10,2,4,-3,-12,11:6 - 11:1 - 9:11 - 7:11 - 11:8
13482403,2023-08-17 13:00:00,Mkrtchyan Andranik - Petrosyan Davit,3:1,6:11 - 11:8 - 11:3 - 11:2 - 0:0,3,1,Mkrtchyan Andranik,Petrosyan Davit,fiurst,Mkrtchyan Andranik - Petrosyan Davit,63,39,24,-15,15,17,19,14,13,0,5,-3,-8,-9,0,-15,6:11 - 11:8 - 11:3 - 11:2 - 0:0
13482400,2023-08-17 12:45:00,Antonyan Eduard - Nikoghosyan Narek,0:3,1:11 - 5:11 - 8:11 - 0:0 - 0:0,0,3,Antonyan Eduard,Nikoghosyan Narek,fiurst,Antonyan Eduard - Nikoghosyan Narek,47,14,33,19,-19,12,16,19,0,0,10,6,3,0,0,19,1:11 - 5:11 - 8:11 - 0:0 - 0:0
13482395,2023-08-17 12:30:00,Petrosyan Davit - Papyan Karen,3:0,8:11 - 9:11 - 2:11 - 0:0 - 0:0,0,3,Petrosyan Davit,Papyan Karen,fiurst,Papyan Karen - Petrosyan Davit,52,33,19,-14,14,19,20,13,0,0,-3,-2,-9,0,0,-14,11:8 - 11:9 - 11:2 - 0:0 - 0:0
13482392,2023-08-17 12:15:00,Soghomonyan Hrayr - Mkrtchyan Andranik,0:3,13:11 - 11:7 - 11:7 - 0:0 - 0:0,3,0,Soghomonyan Hrayr,Mkrtchyan Andranik,fiurst,Mkrtchyan Andranik - Soghomonyan Hrayr,60,25,35,10,-10,24,18,18,0,0,2,4,4,0,0,10,11:13 - 7:11 - 7:11 - 0:0 - 0:0
13482391,2023-08-17 12:00:00,Antonyan Eduard - Petrosyan Davit,3:0,12:10 - 11:6 - 11:6 - 0:0 - 0:0,3,0,Antonyan Eduard,Petrosyan Davit,fiurst,Antonyan Eduard - Petrosyan Davit,56,34,22,-12,12,22,17,17,0,0,-2,-5,-5,0,0,-12,12:10 - 11:6 - 11:6 - 0:0 - 0:0
13482387,2023-08-17 11:45:00,Nikoghosyan Narek - Soghomonyan Hrayr,0:3,8:11 - 5:11 - 1:11 - 0:0 - 0:0,0,3,Nikoghosyan Narek,Soghomonyan Hrayr,fiurst,Nikoghosyan Narek - Soghomonyan Hrayr,47,14,33,19,-19,19,16,12,0,0,3,6,10,0,0,19,8:11 - 5:11 - 1:11 - 0:0 - 0:0
13482382,2023-08-17 11:40:00,Mkrtchyan Andranik - Papyan Karen,0:3,7:11 - 9:11 - 10:12 - 0:0 - 0:0,0,3,Mkrtchyan Andranik,Papyan Karen,fiurst,Mkrtchyan Andranik - Papyan Karen,60,26,34,8,-8,18,20,22,0,0,4,2,2,0,0,8,7:11 - 9:11 - 10:12 - 0:0 - 0:0
13482370,2023-08-17 11:15:00,Petrosyan Davit - Soghomonyan Hrayr,0:3,6:11 - 7:11 - 9:11 - 0:0 - 0:0,0,3,Petrosyan Davit,Soghomonyan Hrayr,fiurst,Petrosyan Davit - Soghomonyan Hrayr,55,22,33,11,-11,17,18,20,0,0,5,4,2,0,0,11,6:11 - 7:11 - 9:11 - 0:0 - 0:0
13482369,2023-08-17 11:00:00,Papyan Karen - Antonyan Eduard,2:3,13:11 - 14:12 - 6:11 - 10:12 - 12:10,3,2,Papyan Karen,Antonyan Eduard,fiurst,Antonyan Eduard - Papyan Karen,111,56,55,-1,1,24,26,17,22,22,2,2,-5,-2,2,-1,11:13 - 12:14 - 11:6 - 12:10 - 10:12
13482368,2023-08-17 10:45:00,Nikoghosyan Narek - Mkrtchyan Andranik,0:3,11:4 - 11:8 - 11:5 - 0:0 - 0:0,3,0,Nikoghosyan Narek,Mkrtchyan Andranik,fiurst,Mkrtchyan Andranik - Nikoghosyan Narek,50,17,33,16,-16,15,19,16,0,0,7,3,6,0,0,16,4:11 - 8:11 - 5:11 - 0:0 - 0:0
13482367,2023-08-17 10:30:00,Soghomonyan Hrayr - Papyan Karen,3:2,11:7 - 0:11 - 4:11 - 11:8 - 5:11,2,3,Soghomonyan Hrayr,Papyan Karen,fiurst,Papyan Karen - Soghomonyan Hrayr,79,48,31,-17,17,18,11,15,19,16,4,-11,-7,3,-6,-17,7:11 - 11:0 - 11:4 - 8:11 - 11:5
13482365,2023-08-17 10:15:00,Nikoghosyan Narek - Petrosyan Davit,3:0,11:8 - 12:10 - 11:4 - 0:0 - 0:0,3,0,Nikoghosyan Narek,Petrosyan Davit,fiurst,Nikoghosyan Narek - Petrosyan Davit,56,34,22,-12,12,19,22,15,0,0,-3,-2,-7,0,0,-12,11:8 - 12:10 - 11:4 - 0:0 - 0:0
13482361,2023-08-17 10:00:00,Mkrtchyan Andranik - Antonyan Eduard,3:1,15:13 - 4:11 - 9:11 - 6:11 - 0:0,1,3,Mkrtchyan Andranik,Antonyan Eduard,fiurst,Antonyan Eduard - Mkrtchyan Andranik,80,46,34,-12,12,28,15,20,17,0,2,-7,-2,-5,0,-12,13:15 - 11:4 - 11:9 - 11:6 - 0:0
